id,url,index,confidence,xmin,ymin,xmax,ymax,w,h,ponies,artists
1000135.png,https://derpicdn.net/img/view/2015/10/11/1000135.png,0,0.9943539500236512,674,261,962,549,288,288,applejack|fluttershy|princess celestia|rainbow dash|rarity|twilight sparkle,ratofdrawn|rainbowscreen|crombiettw|fearingfun|shydale
1000135.png,https://derpicdn.net/img/view/2015/10/11/1000135.png,1,0.99136084318161,39,1,313,275,274,274,applejack|fluttershy|princess celestia|rainbow dash|rarity|twilight sparkle,ratofdrawn|rainbowscreen|crombiettw|fearingfun|shydale
1000135.png,https://derpicdn.net/img/view/2015/10/11/1000135.png,2,0.9761856198310852,649,487,975,813,326,326,applejack|fluttershy|princess celestia|rainbow dash|rarity|twilight sparkle,ratofdrawn|rainbowscreen|crombiettw|fearingfun|shydale
1000135.png,https://derpicdn.net/img/view/2015/10/11/1000135.png,3,0.95222407579422,89,260,383,554,294,294,applejack|fluttershy|princess celestia|rainbow dash|rarity|twilight sparkle,ratofdrawn|rainbowscreen|crombiettw|fearingfun|shydale
1000135.png,https://derpicdn.net/img/view/2015/10/11/1000135.png,4,0.9119000434875488,17,977,341,1280,324,303,applejack|fluttershy|princess celestia|rainbow dash|rarity|twilight sparkle,ratofdrawn|rainbowscreen|crombiettw|fearingfun|shydale
1000135.png,https://derpicdn.net/img/view/2015/10/11/1000135.png,0,0.9943539500236512,687,275,947,535,260,260,applejack|fluttershy|princess celestia|rainbow dash|rarity|twilight sparkle,ratofdrawn|rainbowscreen|crombiettw|fearingfun|shydale
1000135.png,https://derpicdn.net/img/view/2015/10/11/1000135.png,1,0.99136084318161,33,0,319,282,286,282,applejack|fluttershy|princess celestia|rainbow dash|rarity|twilight sparkle,ratofdrawn|rainbowscreen|crombiettw|fearingfun|shydale
1000135.png,https://derpicdn.net/img/view/2015/10/11/1000135.png,2,0.9761856198310852,663,502,961,800,298,298,applejack|fluttershy|princess celestia|rainbow dash|rarity|twilight sparkle,ratofdrawn|rainbowscreen|crombiettw|fearingfun|shydale
1000135.png,https://derpicdn.net/img/view/2015/10/11/1000135.png,3,0.95222407579422,103,275,369,541,266,266,applejack|fluttershy|princess celestia|rainbow dash|rarity|twilight sparkle,ratofdrawn|rainbowscreen|crombiettw|fearingfun|shydale
1000135.png,https://derpicdn.net/img/view/2015/10/11/1000135.png,4,0.9119000434875488,32,992,326,1280,294,288,applejack|fluttershy|princess celestia|rainbow dash|rarity|twilight sparkle,ratofdrawn|rainbowscreen|crombiettw|fearingfun|shydale
1000560.png,https://derpicdn.net/img/view/2015/10/12/1000560.png,0,0.9946498870849608,176,0,488,303,312,303,fluttershy|twilight sparkle,king-kakapo
1000560.png,https://derpicdn.net/img/view/2015/10/12/1000560.png,1,0.9925212860107422,446,43,732,329,286,286,fluttershy|twilight sparkle,king-kakapo
1000560.png,https://derpicdn.net/img/view/2015/10/12/1000560.png,0,0.9946498870849608,190,6,474,290,284,284,fluttershy|twilight sparkle,king-kakapo
1000560.png,https://derpicdn.net/img/view/2015/10/12/1000560.png,1,0.9925212860107422,459,56,719,316,260,260,fluttershy|twilight sparkle,king-kakapo
1000976.png,https://derpicdn.net/img/view/2015/10/13/1000976.png,0,0.9811215996742249,23,281,771,1029,748,748,princess luna|twilight sparkle,dragonfoorm|dfectivedvice
1000976.png,https://derpicdn.net/img/view/2015/10/13/1000976.png,0,0.9811215996742249,58,317,736,995,678,678,princess luna|twilight sparkle,dragonfoorm|dfectivedvice
1002217.png,https://derpicdn.net/img/view/2015/10/14/1002217.png,1,0.990380585193634,499,713,791,1005,292,292,applejack|fluttershy|mane six|pinkie pie|rainbow dash|rarity|twilight sparkle,king-kakapo
1002217.png,https://derpicdn.net/img/view/2015/10/14/1002217.png,2,0.9828868508338928,99,1,359,261,260,260,applejack|fluttershy|mane six|pinkie pie|rainbow dash|rarity|twilight sparkle,king-kakapo
1002217.png,https://derpicdn.net/img/view/2015/10/14/1002217.png,1,0.990380585193634,512,725,778,991,266,266,applejack|fluttershy|mane six|pinkie pie|rainbow dash|rarity|twilight sparkle,king-kakapo
1002217.png,https://derpicdn.net/img/view/2015/10/14/1002217.png,2,0.9828868508338928,110,13,346,249,236,236,applejack|fluttershy|mane six|pinkie pie|rainbow dash|rarity|twilight sparkle,king-kakapo
1003914.png,https://derpicdn.net/img/view/2015/10/17/1003914.png,0,0.9877034425735474,782,91,1232,541,450,450,spike|twilight sparkle,the smiling pony|marauder6272|advanceddefense
1003914.png,https://derpicdn.net/img/view/2015/10/17/1003914.png,0,0.9877034425735474,803,113,1213,523,410,410,spike|twilight sparkle,the smiling pony|marauder6272|advanceddefense
1003949.png,https://derpicdn.net/img/view/2015/10/17/1003949.png,0,0.968944251537323,1045,423,1375,753,330,330,applejack|fluttershy|mane six|pinkie pie|princess cadance|princess celestia|princess luna|rainbow dash|rarity|spike|twilight sparkle,kolshica
1003949.png,https://derpicdn.net/img/view/2015/10/17/1003949.png,0,0.968944251537323,1060,438,1360,738,300,300,applejack|fluttershy|mane six|pinkie pie|princess cadance|princess celestia|princess luna|rainbow dash|rarity|spike|twilight sparkle,kolshica
1004272.png,https://derpicdn.net/img/view/2015/10/17/1004272.png,1,0.9907366037368774,2374,0,2980,443,606,443,applejack|braeburn|fluttershy|mane six|pinkie pie|rainbow dash|rarity|twilight sparkle,dvixie
1004272.png,https://derpicdn.net/img/view/2015/10/17/1004272.png,2,0.9906566143035888,501,0,757,237,256,237,applejack|braeburn|fluttershy|mane six|pinkie pie|rainbow dash|rarity|twilight sparkle,dvixie
1004272.png,https://derpicdn.net/img/view/2015/10/17/1004272.png,4,0.974445104598999,275,612,571,908,296,296,applejack|braeburn|fluttershy|mane six|pinkie pie|rainbow dash|rarity|twilight sparkle,dvixie
1004272.png,https://derpicdn.net/img/view/2015/10/17/1004272.png,5,0.9473939538002014,683,575,963,855,280,280,applejack|braeburn|fluttershy|mane six|pinkie pie|rainbow dash|rarity|twilight sparkle,dvixie
1004272.png,https://derpicdn.net/img/view/2015/10/17/1004272.png,6,0.9231377243995668,2408,685,2698,975,290,290,applejack|braeburn|fluttershy|mane six|pinkie pie|rainbow dash|rarity|twilight sparkle,dvixie
1004272.png,https://derpicdn.net/img/view/2015/10/17/1004272.png,1,0.9907366037368774,2402,0,2952,415,550,415,applejack|braeburn|fluttershy|mane six|pinkie pie|rainbow dash|rarity|twilight sparkle,dvixie
1004272.png,https://derpicdn.net/img/view/2015/10/17/1004272.png,2,0.9906566143035888,512,0,746,222,234,222,applejack|braeburn|fluttershy|mane six|pinkie pie|rainbow dash|rarity|twilight sparkle,dvixie
1004272.png,https://derpicdn.net/img/view/2015/10/17/1004272.png,4,0.974445104598999,290,626,560,896,270,270,applejack|braeburn|fluttershy|mane six|pinkie pie|rainbow dash|rarity|twilight sparkle,dvixie
1004272.png,https://derpicdn.net/img/view/2015/10/17/1004272.png,5,0.9473939538002014,695,587,953,845,258,258,applejack|braeburn|fluttershy|mane six|pinkie pie|rainbow dash|rarity|twilight sparkle,dvixie
1004272.png,https://derpicdn.net/img/view/2015/10/17/1004272.png,6,0.9231377243995668,2421,698,2685,962,264,264,applejack|braeburn|fluttershy|mane six|pinkie pie|rainbow dash|rarity|twilight sparkle,dvixie
1005464.png,https://derpicdn.net/img/view/2015/10/18/1005464.png,0,0.992799699306488,12,101,782,871,770,770,sunset shimmer|twilight sparkle,luminousdazzle
1005464.png,https://derpicdn.net/img/view/2015/10/18/1005464.png,1,0.9870864748954772,588,0,1600,965,1012,965,sunset shimmer|twilight sparkle,luminousdazzle
1005464.png,https://derpicdn.net/img/view/2015/10/18/1005464.png,0,0.992799699306488,46,136,746,836,700,700,sunset shimmer|twilight sparkle,luminousdazzle
1005464.png,https://derpicdn.net/img/view/2015/10/18/1005464.png,1,0.9870864748954772,637,0,1600,925,963,925,sunset shimmer|twilight sparkle,luminousdazzle
1005498.png,https://derpicdn.net/img/view/2015/10/19/1005498.png,0,0.9347612857818604,47,55,867,875,820,820,princess celestia|twilight sparkle,akeahi
1005498.png,https://derpicdn.net/img/view/2015/10/19/1005498.png,0,0.9347612857818604,85,93,829,837,744,744,princess celestia|twilight sparkle,akeahi
1006293.png,https://derpicdn.net/img/view/2015/10/20/1006293.png,0,0.9857398867607116,2131,278,2995,1142,864,864,princess cadance|princess celestia|queen chrysalis|shining armor|twilight sparkle,ncmares
1006293.png,https://derpicdn.net/img/view/2015/10/20/1006293.png,0,0.9857398867607116,2171,318,2955,1102,784,784,princess cadance|princess celestia|queen chrysalis|shining armor|twilight sparkle,ncmares
1008383.png,https://derpicdn.net/img/view/2015/10/24/1008383.png,0,0.9947852492332458,186,179,364,357,178,178,applejack|twilight sparkle,jowybean
1008383.png,https://derpicdn.net/img/view/2015/10/24/1008383.png,1,0.9154781699180604,308,307,518,517,210,210,applejack|twilight sparkle,jowybean
1008383.png,https://derpicdn.net/img/view/2015/10/24/1008383.png,0,0.9947852492332458,195,188,355,348,160,160,applejack|twilight sparkle,jowybean
1008383.png,https://derpicdn.net/img/view/2015/10/24/1008383.png,1,0.9154781699180604,318,317,508,507,190,190,applejack|twilight sparkle,jowybean
1009386.jpg,https://derpicdn.net/img/view/2015/10/25/1009386.jpg,1,0.9862099885940552,250,0,1510,1116,1260,1116,rarity|twilight sparkle,bluecoffeedog
1009386.jpg,https://derpicdn.net/img/view/2015/10/25/1009386.jpg,1,0.9862099885940552,309,0,1451,1058,1142,1058,rarity|twilight sparkle,bluecoffeedog
1010384.png,https://derpicdn.net/img/view/2015/10/26/1010384.png,0,0.9695901274681092,285,0,927,528,642,528,rainbow dash|twilight sparkle,ramiras
1010384.png,https://derpicdn.net/img/view/2015/10/26/1010384.png,0,0.9695901274681092,313,0,899,499,586,499,rainbow dash|twilight sparkle,ramiras
1012540.png,https://derpicdn.net/img/view/2015/10/30/1012540.png,0,0.9988710284233092,222,316,426,520,204,204,applejack|twilight sparkle,jowybean
1012540.png,https://derpicdn.net/img/view/2015/10/30/1012540.png,0,0.9988710284233092,231,324,417,510,186,186,applejack|twilight sparkle,jowybean
1013084.png,https://derpicdn.net/img/view/2015/10/31/1013084.png,0,0.9851281642913818,327,385,707,765,380,380,applejack|fluttershy|mane six|pinkie pie|rainbow dash|rarity|twilight sparkle,php104
1013084.png,https://derpicdn.net/img/view/2015/10/31/1013084.png,1,0.9661158919334412,573,401,937,765,364,364,applejack|fluttershy|mane six|pinkie pie|rainbow dash|rarity|twilight sparkle,php104
1013084.png,https://derpicdn.net/img/view/2015/10/31/1013084.png,2,0.9096576571464542,841,387,1205,751,364,364,applejack|fluttershy|mane six|pinkie pie|rainbow dash|rarity|twilight sparkle,php104
1013084.png,https://derpicdn.net/img/view/2015/10/31/1013084.png,0,0.9851281642913818,345,402,691,748,346,346,applejack|fluttershy|mane six|pinkie pie|rainbow dash|rarity|twilight sparkle,php104
1013084.png,https://derpicdn.net/img/view/2015/10/31/1013084.png,1,0.9661158919334412,588,417,918,747,330,330,applejack|fluttershy|mane six|pinkie pie|rainbow dash|rarity|twilight sparkle,php104
1013084.png,https://derpicdn.net/img/view/2015/10/31/1013084.png,2,0.9096576571464542,858,404,1188,734,330,330,applejack|fluttershy|mane six|pinkie pie|rainbow dash|rarity|twilight sparkle,php104
1013342.jpg,https://derpicdn.net/img/view/2015/10/31/1013342.jpg,2,0.9459213614463806,136,328,318,510,182,182,applejack|fluttershy|mane six|pinkie pie|rainbow dash|rarity|twilight sparkle,notatoron
1013342.jpg,https://derpicdn.net/img/view/2015/10/31/1013342.jpg,2,0.9459213614463806,143,336,311,504,168,168,applejack|fluttershy|mane six|pinkie pie|rainbow dash|rarity|twilight sparkle,notatoron
1014981.png,https://derpicdn.net/img/view/2015/11/2/1014981.png,0,0.930611252784729,0,180,2184,2250,2184,2070,applejack|twilight sparkle,pirill|discorded
1014981.png,https://derpicdn.net/img/view/2015/11/2/1014981.png,0,0.930611252784729,0,234,2082,2250,2082,2016,applejack|twilight sparkle,pirill|discorded
1015347.png,https://derpicdn.net/img/view/2015/11/3/1015347.png,0,0.9765625596046448,57,0,437,360,380,360,shining armor|twilight sparkle,dm29
1015347.png,https://derpicdn.net/img/view/2015/11/3/1015347.png,0,0.9765625596046448,74,0,418,342,344,342,shining armor|twilight sparkle,dm29
1016179.jpg,https://derpicdn.net/img/view/2015/11/4/1016179.jpg,0,0.9858738780021667,523,516,1203,1196,680,680,applejack|fluttershy|mane six|pinkie pie|rainbow dash|rarity|twilight sparkle,redanon
1016179.jpg,https://derpicdn.net/img/view/2015/11/4/1016179.jpg,0,0.9858738780021667,556,547,1174,1165,618,618,applejack|fluttershy|mane six|pinkie pie|rainbow dash|rarity|twilight sparkle,redanon
1016972.png,https://derpicdn.net/img/view/2015/11/6/1016972.png,2,0.9279210567474364,1064,0,1732,629,668,629,applejack|fluttershy|mane six|pinkie pie|rainbow dash|rarity|spike|twilight sparkle,atryl edits
1016972.png,https://derpicdn.net/img/view/2015/11/6/1016972.png,2,0.9279210567474364,1093,0,1701,599,608,599,applejack|fluttershy|mane six|pinkie pie|rainbow dash|rarity|spike|twilight sparkle,atryl edits
1018057.png,https://derpicdn.net/img/view/2015/11/7/1018057.png,0,0.971329927444458,896,0,1672,729,776,729,sunset shimmer|twilight sparkle,lightof-dawn
1018057.png,https://derpicdn.net/img/view/2015/11/7/1018057.png,1,0.9360533356666564,311,92,1141,922,830,830,sunset shimmer|twilight sparkle,lightof-dawn
1018057.png,https://derpicdn.net/img/view/2015/11/7/1018057.png,0,0.971329927444458,929,0,1637,695,708,695,sunset shimmer|twilight sparkle,lightof-dawn
1018057.png,https://derpicdn.net/img/view/2015/11/7/1018057.png,1,0.9360533356666564,349,131,1101,883,752,752,sunset shimmer|twilight sparkle,lightof-dawn
1018122.png,https://derpicdn.net/img/view/2015/11/7/1018122.png,0,0.9565707445144652,44,0,854,795,810,795,applejack|discord|fluttershy|pinkie pie|rainbow dash|rarity|spike|twilight sparkle,mysticalpha
1018122.png,https://derpicdn.net/img/view/2015/11/7/1018122.png,0,0.9565707445144652,80,21,818,759,738,738,applejack|discord|fluttershy|pinkie pie|rainbow dash|rarity|spike|twilight sparkle,mysticalpha
1020466.png,https://derpicdn.net/img/view/2015/11/10/1020466.png,0,0.98139625787735,5,0,1119,910,1114,910,discord|twilight sparkle,tsitra360
1020466.png,https://derpicdn.net/img/view/2015/11/10/1020466.png,0,0.98139625787735,54,0,1068,842,1014,842,discord|twilight sparkle,tsitra360
1020480.jpg,https://derpicdn.net/img/view/2015/11/10/1020480.jpg,0,0.9776073098182678,310,329,626,645,316,316,applejack|fluttershy|mane six|pinkie pie|rainbow dash|rarity|shining armor|twilight sparkle,amida murasaki
1020480.jpg,https://derpicdn.net/img/view/2015/11/10/1020480.jpg,1,0.9749186635017396,13,582,193,754,180,172,applejack|fluttershy|mane six|pinkie pie|rainbow dash|rarity|shining armor|twilight sparkle,amida murasaki
1020480.jpg,https://derpicdn.net/img/view/2015/11/10/1020480.jpg,3,0.9506309032440186,104,411,374,681,270,270,applejack|fluttershy|mane six|pinkie pie|rainbow dash|rarity|shining armor|twilight sparkle,amida murasaki
1020480.jpg,https://derpicdn.net/img/view/2015/11/10/1020480.jpg,0,0.9776073098182678,324,343,612,631,288,288,applejack|fluttershy|mane six|pinkie pie|rainbow dash|rarity|shining armor|twilight sparkle,amida murasaki
1020480.jpg,https://derpicdn.net/img/view/2015/11/10/1020480.jpg,1,0.9749186635017396,21,589,187,754,166,165,applejack|fluttershy|mane six|pinkie pie|rainbow dash|rarity|shining armor|twilight sparkle,amida murasaki
1020480.jpg,https://derpicdn.net/img/view/2015/11/10/1020480.jpg,3,0.9506309032440186,117,424,361,668,244,244,applejack|fluttershy|mane six|pinkie pie|rainbow dash|rarity|shining armor|twilight sparkle,amida murasaki
1021183.png,https://derpicdn.net/img/view/2015/11/11/1021183.png,0,0.989602267742157,5906,340,7000,1526,1094,1186,applejack|fluttershy|mane six|pinkie pie|rainbow dash|rarity|sunset shimmer|twilight sparkle,silbersternenlicht
1021183.png,https://derpicdn.net/img/view/2015/11/11/1021183.png,1,0.988290011882782,651,0,1697,990,1046,990,applejack|fluttershy|mane six|pinkie pie|rainbow dash|rarity|sunset shimmer|twilight sparkle,silbersternenlicht
1021183.png,https://derpicdn.net/img/view/2015/11/11/1021183.png,0,0.989602267742157,5960,392,7000,1470,1040,1078,applejack|fluttershy|mane six|pinkie pie|rainbow dash|rarity|sunset shimmer|twilight sparkle,silbersternenlicht
1021183.png,https://derpicdn.net/img/view/2015/11/11/1021183.png,1,0.988290011882782,697,0,1649,942,952,942,applejack|fluttershy|mane six|pinkie pie|rainbow dash|rarity|sunset shimmer|twilight sparkle,silbersternenlicht
1022046.png,https://derpicdn.net/img/view/2015/11/13/1022046.png,0,0.9441062808036804,665,40,1047,422,382,382,applejack|twilight sparkle,jowybean
1022046.png,https://derpicdn.net/img/view/2015/11/13/1022046.png,0,0.9441062808036804,683,57,1031,405,348,348,applejack|twilight sparkle,jowybean
1022766.png,https://derpicdn.net/img/view/2015/11/14/1022766.png,0,0.989091157913208,272,0,570,297,298,297,applejack|fluttershy|mane six|pinkie pie|rainbow dash|rarity|spike|twilight sparkle,dm29
1022766.png,https://derpicdn.net/img/view/2015/11/14/1022766.png,0,0.989091157913208,285,13,555,283,270,270,applejack|fluttershy|mane six|pinkie pie|rainbow dash|rarity|spike|twilight sparkle,dm29
1023150.png,https://derpicdn.net/img/view/2015/11/15/1023150.png,0,0.9789676070213318,0,684,5311,6622,5311,5938,fluttershy|twilight sparkle,owlisun
1023150.png,https://derpicdn.net/img/view/2015/11/15/1023150.png,0,0.9789676070213318,0,948,4929,6358,4929,5410,fluttershy|twilight sparkle,owlisun
1023340.jpg,https://derpicdn.net/img/view/2015/11/15/1023340.jpg,1,0.9649992585182192,895,138,1451,694,556,556,rainbow dash|twilight sparkle,elzzombie
1023340.jpg,https://derpicdn.net/img/view/2015/11/15/1023340.jpg,1,0.9649992585182192,920,163,1426,669,506,506,rainbow dash|twilight sparkle,elzzombie
1024107.png,https://derpicdn.net/img/view/2015/11/16/1024107.png,0,0.9990276098251344,214,233,530,549,316,316,fluttershy|twilight sparkle,lumineko
1024107.png,https://derpicdn.net/img/view/2015/11/16/1024107.png,0,0.9990276098251344,228,247,516,535,288,288,fluttershy|twilight sparkle,lumineko
102484.png,https://derpicdn.net/img/view/2012/9/20/102484.png,0,0.9922314286231996,140,141,584,585,444,444,trixie|twilight sparkle,atryl
102484.png,https://derpicdn.net/img/view/2012/9/20/102484.png,0,0.9922314286231996,160,162,564,566,404,404,trixie|twilight sparkle,atryl
1025133.png,https://derpicdn.net/img/view/2015/11/18/1025133.png,0,0.9938400983810424,865,0,1589,691,724,691,rainbow dash|twilight sparkle,mykegreywolf
1025133.png,https://derpicdn.net/img/view/2015/11/18/1025133.png,1,0.9923534393310548,277,32,1055,810,778,778,rainbow dash|twilight sparkle,mykegreywolf
1025133.png,https://derpicdn.net/img/view/2015/11/18/1025133.png,0,0.9938400983810424,879,0,1573,677,694,677,rainbow dash|twilight sparkle,mykegreywolf
1025133.png,https://derpicdn.net/img/view/2015/11/18/1025133.png,1,0.9923534393310548,313,67,1021,775,708,708,rainbow dash|twilight sparkle,mykegreywolf
1026384.png,https://derpicdn.net/img/view/2015/11/20/1026384.png,0,0.931227684020996,340,0,821,487,481,487,applejack|twilight sparkle,jowybean
1026384.png,https://derpicdn.net/img/view/2015/11/20/1026384.png,0,0.931227684020996,363,0,821,475,458,475,applejack|twilight sparkle,jowybean
1026634.png,https://derpicdn.net/img/view/2015/11/20/1026634.png,0,0.9989601373672484,1663,558,2305,1200,642,642,princess cadance|princess celestia|princess luna|twilight sparkle,mysticalpha
1026634.png,https://derpicdn.net/img/view/2015/11/20/1026634.png,0,0.9989601373672484,1694,586,2278,1170,584,584,princess cadance|princess celestia|princess luna|twilight sparkle,mysticalpha
1026914.jpg,https://derpicdn.net/img/view/2015/11/21/1026914.jpg,0,0.987446129322052,436,59,956,579,520,520,princess luna|twilight sparkle,foxi-5
1026914.jpg,https://derpicdn.net/img/view/2015/11/21/1026914.jpg,0,0.987446129322052,459,82,933,556,474,474,princess luna|twilight sparkle,foxi-5
1027914.png,https://derpicdn.net/img/view/2015/11/22/1027914.png,0,0.9667657017707824,83,449,1395,1761,1312,1312,princess cadance|twilight sparkle,dilarus
1027914.png,https://derpicdn.net/img/view/2015/11/22/1027914.png,0,0.9667657017707824,143,509,1335,1701,1192,1192,princess cadance|twilight sparkle,dilarus
1030029.png,https://derpicdn.net/img/view/2015/11/25/1030029.png,0,0.9860489964485168,368,485,636,753,268,268,applejack|discord|fluttershy|mane six|pinkie pie|rainbow dash|rarity|soarin'|spike|twilight sparkle,bluesidearts
1030029.png,https://derpicdn.net/img/view/2015/11/25/1030029.png,2,0.9498114585876464,691,485,973,767,282,282,applejack|discord|fluttershy|mane six|pinkie pie|rainbow dash|rarity|soarin'|spike|twilight sparkle,bluesidearts
1030540.png,https://derpicdn.net/img/view/2015/11/26/1030540.png,1,0.9443086981773376,162,280,488,606,326,326,fluttershy|princess cadance|princess celestia|princess luna|rainbow dash|shining armor|spike|twilight sparkle,dm29
1030928.png,https://derpicdn.net/img/view/2015/11/27/1030928.png,0,0.9336504936218262,501,0,1805,1065,1304,1065,princess celestia|twilight sparkle,kinkypinkie
1031124.png,https://derpicdn.net/img/view/2015/11/27/1031124.png,0,0.9911084175109864,261,132,533,404,272,272,applejack|starlight glimmer|twilight sparkle,jowybean
1031518.png,https://derpicdn.net/img/view/2015/11/28/1031518.png,0,0.999630093574524,760,54,1524,818,764,764,applejack|discord|fluttershy|mane six|pinkie pie|rainbow dash|rarity|soarin'|spike|twilight sparkle,turrkoise
1031518.png,https://derpicdn.net/img/view/2015/11/28/1031518.png,3,0.9925156831741332,121,1250,1159,2288,1038,1038,applejack|discord|fluttershy|mane six|pinkie pie|rainbow dash|rarity|soarin'|spike|twilight sparkle,turrkoise
1031518.png,https://derpicdn.net/img/view/2015/11/28/1031518.png,5,0.9735206961631776,2101,1563,3113,2575,1012,1012,applejack|discord|fluttershy|mane six|pinkie pie|rainbow dash|rarity|soarin'|spike|twilight sparkle,turrkoise
1031518.png,https://derpicdn.net/img/view/2015/11/28/1031518.png,6,0.9720327258110046,0,179,876,1173,876,994,applejack|discord|fluttershy|mane six|pinkie pie|rainbow dash|rarity|soarin'|spike|twilight sparkle,turrkoise
1031518.png,https://derpicdn.net/img/view/2015/11/28/1031518.png,7,0.9606656432151794,871,3191,1813,4133,942,942,applejack|discord|fluttershy|mane six|pinkie pie|rainbow dash|rarity|soarin'|spike|twilight sparkle,turrkoise
1031788.png,https://derpicdn.net/img/view/2015/11/28/1031788.png,0,0.9939180612564088,1676,419,2292,1035,616,616,princess cadance|princess celestia|princess luna|twilight sparkle,mysticalpha
1031931.png,https://derpicdn.net/img/view/2015/11/28/1031931.png,0,0.9887791275978088,157,33,413,289,256,256,starlight glimmer|trixie|twilight sparkle,pixelkitties
1031931.png,https://derpicdn.net/img/view/2015/11/28/1031931.png,1,0.9695326089859008,358,608,640,890,282,282,starlight glimmer|trixie|twilight sparkle,pixelkitties
1031943.png,https://derpicdn.net/img/view/2015/11/28/1031943.png,2,0.9036421775817872,866,248,1090,472,224,224,apple bloom|applejack|big macintosh|cutie mark crusaders|diamond tiara|fluttershy|granny smith|mane six|pinkie pie|rainbow dash|rarity|scootaloo|silver spoon|spike|starlight glimmer|sweetie belle|twilight sparkle,
1033113.png,https://derpicdn.net/img/view/2015/11/29/1033113.png,0,0.9977091550827026,400,0,1024,673,624,673,starlight glimmer|twilight sparkle,ushiro no kukan
1033216.png,https://derpicdn.net/img/view/2015/11/29/1033216.png,0,0.9714096784591676,175,588,447,860,272,272,applejack|fluttershy|mane six|pinkie pie|rainbow dash|rarity|spike|starlight glimmer|twilight sparkle,
1033471.png,https://derpicdn.net/img/view/2015/11/30/1033471.png,1,0.9221853613853456,241,144,699,602,458,458,spike|starlight glimmer|twilight sparkle,jowybean
1034476.png,https://derpicdn.net/img/view/2015/12/1/1034476.png,0,0.969519317150116,596,235,1024,713,428,478,starlight glimmer|twilight sparkle,vanillafox2035
1037331.png,https://derpicdn.net/img/view/2015/12/5/1037331.png,0,0.9308909177780152,109,0,1211,1026,1102,1026,rainbow dash|starlight glimmer|twilight sparkle,fromamida
1038856.png,https://derpicdn.net/img/view/2015/12/7/1038856.png,0,0.994076669216156,559,0,1455,872,896,872,spike|twilight sparkle,bylisboa
1039453.png,https://derpicdn.net/img/view/2015/12/8/1039453.png,0,0.9848734140396118,2477,3799,3143,4465,666,666,applejack|fluttershy|mane six|pinkie pie|rainbow dash|rarity|spike|starlight glimmer|twilight sparkle,cheezedoodle96|kevinerino|blackgryph0n|noxwyll|kysss90|slim-shady|chainchomp2 edit
1039453.png,https://derpicdn.net/img/view/2015/12/8/1039453.png,3,0.9035608172416688,807,883,1083,1159,276,276,applejack|fluttershy|mane six|pinkie pie|rainbow dash|rarity|spike|starlight glimmer|twilight sparkle,cheezedoodle96|kevinerino|blackgryph0n|noxwyll|kysss90|slim-shady|chainchomp2 edit
1039729.png,https://derpicdn.net/img/view/2015/12/8/1039729.png,0,0.9989782571792604,184,0,460,210,276,210,applejack|fluttershy|mane six|pinkie pie|rainbow dash|rarity|twilight sparkle,seyrii
1039729.png,https://derpicdn.net/img/view/2015/12/8/1039729.png,3,0.9026761054992676,628,0,896,225,268,225,applejack|fluttershy|mane six|pinkie pie|rainbow dash|rarity|twilight sparkle,seyrii
1040362.jpg,https://derpicdn.net/img/view/2015/12/9/1040362.jpg,0,0.9286738038063048,0,0,544,556,544,556,princess cadance|twilight sparkle,ciciya
1040636.jpg,https://derpicdn.net/img/view/2015/12/9/1040636.jpg,0,0.9665043354034424,525,33,1201,709,676,676,rainbow dash|twilight sparkle,lightof-dawn
1041168.jpg,https://derpicdn.net/img/view/2015/12/10/1041168.jpg,0,0.9811400771141052,351,652,741,1042,390,390,applejack|fluttershy|mane six|pinkie pie|princess celestia|princess luna|rainbow dash|rarity|twilight sparkle,sweetsound
1041554.png,https://derpicdn.net/img/view/2015/12/11/1041554.png,0,0.9861283898353576,3439,455,4067,1083,628,628,applejack|fluttershy|mane six|pinkie pie|rainbow dash|rarity|twilight sparkle,lisa400
1041554.png,https://derpicdn.net/img/view/2015/12/11/1041554.png,1,0.93460875749588,32,216,660,844,628,628,applejack|fluttershy|mane six|pinkie pie|rainbow dash|rarity|twilight sparkle,lisa400
1041861.png,https://derpicdn.net/img/view/2015/12/11/1041861.png,0,0.9974297881126404,493,37,813,357,320,320,applejack|twilight sparkle,jowybean
1042580.png,https://derpicdn.net/img/view/2015/12/12/1042580.png,0,0.9908010363578796,563,370,999,806,436,436,starlight glimmer|twilight sparkle,berrypawnch
1042580.png,https://derpicdn.net/img/view/2015/12/12/1042580.png,1,0.960869073867798,299,457,669,827,370,370,starlight glimmer|twilight sparkle,berrypawnch
10438.jpg,https://derpicdn.net/img/view/2012/6/19/10438.jpg,0,0.9400397539138794,902,228,1604,930,702,702,rainbow dash|twilight sparkle,ss2sonic
1043890.png,https://derpicdn.net/img/view/2015/12/13/1043890.png,0,0.949779748916626,117,0,461,333,344,333,applejack|fluttershy|mane six|pinkie pie|rainbow dash|rarity|starlight glimmer|twilight sparkle,jirousan
1043890.png,https://derpicdn.net/img/view/2015/12/13/1043890.png,1,0.9386869668960572,42,872,374,1204,332,332,applejack|fluttershy|mane six|pinkie pie|rainbow dash|rarity|starlight glimmer|twilight sparkle,jirousan
1043890.png,https://derpicdn.net/img/view/2015/12/13/1043890.png,2,0.9364451169967652,388,275,792,679,404,404,applejack|fluttershy|mane six|pinkie pie|rainbow dash|rarity|starlight glimmer|twilight sparkle,jirousan
1044160.jpg,https://derpicdn.net/img/view/2015/12/14/1044160.jpg,0,0.9662478566169742,311,591,777,1057,466,466,princess celestia|princess luna|twilight sparkle,greyscaleart
1044624.png,https://derpicdn.net/img/view/2015/12/14/1044624.png,0,0.9967535734176636,435,530,865,960,430,430,princess celestia|twilight sparkle,b-epon
1044776.png,https://derpicdn.net/img/view/2015/12/15/1044776.png,0,0.9938614964485168,699,14,1201,516,502,502,princess cadance|twilight sparkle,arnachy
1046939.png,https://derpicdn.net/img/view/2015/12/18/1046939.png,0,0.9893125295639038,169,13,473,317,304,304,applejack|twilight sparkle,jowybean
1046939.png,https://derpicdn.net/img/view/2015/12/18/1046939.png,1,0.9671099781990052,462,0,826,339,364,339,applejack|twilight sparkle,jowybean
1049029.png,https://derpicdn.net/img/view/2015/12/20/1049029.png,0,0.9981924891471864,1026,154,1362,490,336,336,starlight glimmer|sunset shimmer|twilight sparkle,frostykat13
1049029.png,https://derpicdn.net/img/view/2015/12/20/1049029.png,2,0.9937329888343812,27,160,379,512,352,352,starlight glimmer|sunset shimmer|twilight sparkle,frostykat13
1049175.png,https://derpicdn.net/img/view/2015/12/20/1049175.png,0,0.9983887672424316,911,0,1181,262,270,262,applejack|fluttershy|mane six|pinkie pie|rainbow dash|rarity|twilight sparkle,siden
1049175.png,https://derpicdn.net/img/view/2015/12/20/1049175.png,1,0.9913701415061952,257,680,523,946,266,266,applejack|fluttershy|mane six|pinkie pie|rainbow dash|rarity|twilight sparkle,siden
1049624.png,https://derpicdn.net/img/view/2015/12/21/1049624.png,1,0.99347722530365,0,335,408,767,408,432,applejack|fluttershy|mane six|pinkie pie|rainbow dash|rarity|twilight sparkle,dstears
1049624.png,https://derpicdn.net/img/view/2015/12/21/1049624.png,4,0.9293115139007568,493,384,849,740,356,356,applejack|fluttershy|mane six|pinkie pie|rainbow dash|rarity|twilight sparkle,dstears
1050599.png,https://derpicdn.net/img/view/2015/12/22/1050599.png,0,0.9976360201835632,185,338,455,608,270,270,spike|twilight sparkle,maggwai
1050599.png,https://derpicdn.net/img/view/2015/12/22/1050599.png,1,0.995310366153717,76,0,322,246,246,246,spike|twilight sparkle,maggwai
1051436.png,https://derpicdn.net/img/view/2015/12/24/1051436.png,0,0.91970032453537,0,0,336,320,336,320,applejack|discord|fluttershy|mane six|pinkie pie|rainbow dash|rarity|spike|twilight sparkle,inuhoshi-to-darkpen
1052406.png,https://derpicdn.net/img/view/2015/12/25/1052406.png,0,0.9967515468597412,41,38,427,424,386,386,rarity|twilight sparkle,clouddg
1052498.png,https://derpicdn.net/img/view/2015/12/25/1052498.png,0,0.9708206057548524,1798,343,2592,1137,794,794,rainbow dash|twilight sparkle,ninjaspartankx5
1052534.png,https://derpicdn.net/img/view/2015/12/25/1052534.png,0,0.9738091230392456,86,492,334,740,248,248,spike|twilight sparkle,luciferamon
1052581.png,https://derpicdn.net/img/view/2015/12/25/1052581.png,0,0.9973180294036864,322,0,702,377,380,377,pinkie pie|twilight sparkle,nekubi
1054818.jpg,https://derpicdn.net/img/view/2015/12/29/1054818.jpg,0,0.9418026208877563,751,680,1257,1186,506,506,princess luna|twilight sparkle,silfoe
1055301.png,https://derpicdn.net/img/view/2015/12/29/1055301.png,0,0.989792823791504,764,527,1292,1055,528,528,princess celestia|twilight sparkle,1jaz
1055595.png,https://derpicdn.net/img/view/2015/12/30/1055595.png,0,0.9984719157218932,40,52,318,330,278,278,applejack|fluttershy|mane six|pinkie pie|princess celestia|rainbow dash|twilight sparkle,succubi samus
1055595.png,https://derpicdn.net/img/view/2015/12/30/1055595.png,1,0.9786294102668762,252,27,544,319,292,292,applejack|fluttershy|mane six|pinkie pie|princess celestia|rainbow dash|twilight sparkle,succubi samus
1055891.png,https://derpicdn.net/img/view/2015/12/30/1055891.png,0,0.9421181678771972,942,174,1452,684,510,510,starlight glimmer|sunset shimmer|trixie|twilight sparkle,browwning
1055891.png,https://derpicdn.net/img/view/2015/12/30/1055891.png,1,0.9026140570640564,1283,177,1871,765,588,588,starlight glimmer|sunset shimmer|trixie|twilight sparkle,browwning
1057014.png,https://derpicdn.net/img/view/2016/1/1/1057014.png,1,0.9894732236862184,269,0,733,443,464,443,applejack|fluttershy|mane six|pinkie pie|rainbow dash|rarity|spike|twilight sparkle,the-butch-x
1057014.png,https://derpicdn.net/img/view/2016/1/1/1057014.png,2,0.9615638852119446,943,476,1259,798,316,322,applejack|fluttershy|mane six|pinkie pie|rainbow dash|rarity|spike|twilight sparkle,the-butch-x
1057295.png,https://derpicdn.net/img/view/2016/1/1/1057295.png,0,0.990594744682312,327,131,531,335,204,204,applejack|fluttershy|mane six|pinkie pie|rainbow dash|rarity|twilight sparkle,aidapone
1057336.jpg,https://derpicdn.net/img/view/2016/1/1/1057336.jpg,0,0.9946421980857848,658,229,1078,649,420,420,starlight glimmer|sunset shimmer|trixie|twilight sparkle,hobilo
1058407.png,https://derpicdn.net/img/view/2016/1/3/1058407.png,0,0.9987121820449828,632,512,892,772,260,260,fluttershy|twilight sparkle,ambris
1058696.png,https://derpicdn.net/img/view/2016/1/3/1058696.png,0,0.9927508234977722,671,4,1600,1050,929,1046,pinkie pie|sunset shimmer|twilight sparkle,thegreatrouge
1060244.png,https://derpicdn.net/img/view/2016/1/5/1060244.png,0,0.9991909861564636,61,0,497,423,436,423,rainbow dash|twilight sparkle,ambris
1060244.png,https://derpicdn.net/img/view/2016/1/5/1060244.png,1,0.9973079562187196,525,113,907,495,382,382,rainbow dash|twilight sparkle,ambris
1060703.png,https://derpicdn.net/img/view/2016/1/6/1060703.png,4,0.9679582715034484,1288,198,1590,500,302,302,applejack|fluttershy|mane six|pinkie pie|rainbow dash|rarity|starlight glimmer|twilight sparkle,aidapone
1063126.jpg,https://derpicdn.net/img/view/2016/1/9/1063126.jpg,1,0.9935886263847352,76,435,428,787,352,352,princess celestia|princess luna|twilight sparkle,silfoe
1063162.png,https://derpicdn.net/img/view/2016/1/10/1063162.png,1,0.9718255400657654,34,252,684,902,650,650,princess luna|twilight sparkle,jubileeglider|dfectivedvice
1064.jpg,https://derpicdn.net/img/view/2012/1/21/1064.jpg,0,0.9974842071533204,0,0,332,336,332,336,applejack|fluttershy|mane six|pinkie pie|rainbow dash|rarity|twilight sparkle,whitediamonds
1067358.png,https://derpicdn.net/img/view/2016/1/15/1067358.png,0,0.99880051612854,313,0,529,195,216,195,applejack|fluttershy|mane six|pinkie pie|rainbow dash|rarity|twilight sparkle,aidapone
1067358.png,https://derpicdn.net/img/view/2016/1/15/1067358.png,1,0.9981747269630432,108,136,290,318,182,182,applejack|fluttershy|mane six|pinkie pie|rainbow dash|rarity|twilight sparkle,aidapone
1067358.png,https://derpicdn.net/img/view/2016/1/15/1067358.png,2,0.9924358129501344,689,188,891,390,202,202,applejack|fluttershy|mane six|pinkie pie|rainbow dash|rarity|twilight sparkle,aidapone
1067358.png,https://derpicdn.net/img/view/2016/1/15/1067358.png,3,0.9853352308273317,372,320,618,566,246,246,applejack|fluttershy|mane six|pinkie pie|rainbow dash|rarity|twilight sparkle,aidapone
1068070.png,https://derpicdn.net/img/view/2016/1/17/1068070.png,1,0.97721129655838,2510,0,3702,1121,1192,1121,applejack|fluttershy|mane six|pinkie pie|rainbow dash|rarity|spike|twilight sparkle,xebck
1068070.png,https://derpicdn.net/img/view/2016/1/17/1068070.png,2,0.9449213147163392,580,41,1936,1397,1356,1356,applejack|fluttershy|mane six|pinkie pie|rainbow dash|rarity|spike|twilight sparkle,xebck
1069763.png,https://derpicdn.net/img/view/2016/1/19/1069763.png,0,0.9972533583641052,1220,112,2436,1328,1216,1216,fluttershy|twilight sparkle,bugplayer
1069851.png,https://derpicdn.net/img/view/2016/1/19/1069851.png,0,0.9879940748214722,274,86,858,670,584,584,spike|starlight glimmer|twilight sparkle,ctb-36
1071100.png,https://derpicdn.net/img/view/2016/1/21/1071100.png,0,0.989938497543335,425,31,811,417,386,386,applejack|twilight sparkle,jowybean
1071148.jpg,https://derpicdn.net/img/view/2016/1/22/1071148.jpg,0,0.942594349384308,127,24,461,358,334,334,starlight glimmer|trixie|twilight sparkle,whale
1071449.png,https://derpicdn.net/img/view/2016/1/22/1071449.png,0,0.9970447421073914,0,0,429,397,429,397,princess cadance|shining armor|twilight sparkle,dm29
1071449.png,https://derpicdn.net/img/view/2016/1/22/1071449.png,1,0.9804936051368712,400,0,844,428,444,428,princess cadance|shining armor|twilight sparkle,dm29
1073371.png,https://derpicdn.net/img/view/2016/1/25/1073371.png,0,0.992890477180481,147,23,627,503,480,480,rainbow dash|twilight sparkle,hoodie
1074386.png,https://derpicdn.net/img/view/2016/1/27/1074386.png,0,0.9608647227287292,1388,0,1916,398,528,398,applejack|pinkie pie|rainbow dash|rarity|twilight sparkle,ambris
1076280.png,https://derpicdn.net/img/view/2016/1/30/1076280.png,0,0.9594122767448424,162,75,460,373,298,298,applejack|twilight sparkle,jowybean
1076280.png,https://derpicdn.net/img/view/2016/1/30/1076280.png,1,0.9281233549118042,353,74,705,426,352,352,applejack|twilight sparkle,jowybean
1076888.png,https://derpicdn.net/img/view/2016/1/30/1076888.png,1,0.9925506711006165,1362,5,1802,445,440,440,applejack|fluttershy|mane six|pinkie pie|rainbow dash|rarity|twilight sparkle,dshou
1076900.png,https://derpicdn.net/img/view/2016/1/30/1076900.png,0,0.9161064028739928,1632,362,1920,656,288,294,applejack|fluttershy|mane six|pinkie pie|rainbow dash|rarity|twilight sparkle,30clock
1077529.png,https://derpicdn.net/img/view/2016/1/31/1077529.png,0,0.9961869716644288,1647,0,3035,1352,1388,1352,rarity|twilight sparkle,hawthornss
1077529.png,https://derpicdn.net/img/view/2016/1/31/1077529.png,1,0.9933279156684875,187,214,1633,1660,1446,1446,rarity|twilight sparkle,hawthornss
1078062.png,https://derpicdn.net/img/view/2016/2/1/1078062.png,0,0.9969227313995358,273,156,849,732,576,576,fluttershy|twilight sparkle,lolepopenon
1078062.png,https://derpicdn.net/img/view/2016/2/1/1078062.png,1,0.9908621907234192,787,275,1339,827,552,552,fluttershy|twilight sparkle,lolepopenon
1079451.png,https://derpicdn.net/img/view/2016/2/3/1079451.png,0,0.9272696375846864,550,124,738,312,188,188,applejack|big macintosh|princess celestia|rarity|spike|sweetie belle|twilight sparkle,pixelkitties
1081745.png,https://derpicdn.net/img/view/2016/2/6/1081745.png,0,0.9981296062469482,830,179,1528,877,698,698,spike|twilight sparkle,alasou
1083206.png,https://derpicdn.net/img/view/2016/2/8/1083206.png,0,0.9990833401679992,1144,0,2610,1415,1466,1415,trixie|twilight sparkle,madacon
1085759.png,https://derpicdn.net/img/view/2016/2/11/1085759.png,1,0.9576990008354188,794,0,1160,326,366,326,applejack|fluttershy|mane six|pinkie pie|rainbow dash|rarity|spike|twilight sparkle,aleximusprime
108601.jpg,https://derpicdn.net/img/view/2012/9/28/108601.jpg,0,0.9887259602546692,64,233,326,495,262,262,princess celestia|twilight sparkle,longinius
1087264.jpg,https://derpicdn.net/img/view/2016/2/13/1087264.jpg,0,0.9964275956153872,130,111,640,621,510,510,rainbow dash|twilight sparkle,elzzombie
1087794.png,https://derpicdn.net/img/view/2016/2/14/1087794.png,0,0.995855987071991,1258,1784,2092,2618,834,834,princess celestia|twilight sparkle,coinpo
1087794.png,https://derpicdn.net/img/view/2016/2/14/1087794.png,1,0.9889981150627136,2450,1192,3586,2328,1136,1136,princess celestia|twilight sparkle,coinpo
1088163.png,https://derpicdn.net/img/view/2016/2/14/1088163.png,0,0.9213672280311584,1075,0,2063,889,988,889,pinkie pie|twilight sparkle,lunarmarshmallow
1090025.jpg,https://derpicdn.net/img/view/2016/2/16/1090025.jpg,0,0.980415105819702,118,51,356,289,238,238,sunset shimmer|twilight sparkle,kona1025
1090025.jpg,https://derpicdn.net/img/view/2016/2/16/1090025.jpg,1,0.9765377640724182,465,60,737,332,272,272,sunset shimmer|twilight sparkle,kona1025
1090025.jpg,https://derpicdn.net/img/view/2016/2/16/1090025.jpg,2,0.9707486629486084,235,228,471,464,236,236,sunset shimmer|twilight sparkle,kona1025
1091559.png,https://derpicdn.net/img/view/2016/2/18/1091559.png,0,0.999210238456726,256,88,526,358,270,270,applejack|fluttershy|mane six|pinkie pie|rainbow dash|rarity|spike|twilight sparkle,valcron
1091559.png,https://derpicdn.net/img/view/2016/2/18/1091559.png,1,0.983870565891266,771,207,1017,453,246,246,applejack|fluttershy|mane six|pinkie pie|rainbow dash|rarity|spike|twilight sparkle,valcron
1091559.png,https://derpicdn.net/img/view/2016/2/18/1091559.png,2,0.9696372151374816,585,374,813,602,228,228,applejack|fluttershy|mane six|pinkie pie|rainbow dash|rarity|spike|twilight sparkle,valcron
1091559.png,https://derpicdn.net/img/view/2016/2/18/1091559.png,3,0.9694119095802308,544,14,802,272,258,258,applejack|fluttershy|mane six|pinkie pie|rainbow dash|rarity|spike|twilight sparkle,valcron
1091559.png,https://derpicdn.net/img/view/2016/2/18/1091559.png,5,0.9387245178222656,529,702,771,944,242,242,applejack|fluttershy|mane six|pinkie pie|rainbow dash|rarity|spike|twilight sparkle,valcron
1092806.png,https://derpicdn.net/img/view/2016/2/20/1092806.png,0,0.997803270816803,244,512,964,1232,720,720,applejack|rainbow dash|rarity|twilight sparkle,blues64|marauder6272
1092806.png,https://derpicdn.net/img/view/2016/2/20/1092806.png,1,0.980168342590332,948,443,1654,1149,706,706,applejack|rainbow dash|rarity|twilight sparkle,blues64|marauder6272
1094378.png,https://derpicdn.net/img/view/2016/2/22/1094378.png,0,0.9919300675392152,2213,1390,3253,2430,1040,1040,applejack|fluttershy|rainbow dash|twilight sparkle,bugplayer
1094378.png,https://derpicdn.net/img/view/2016/2/22/1094378.png,1,0.991313099861145,1253,990,2227,1964,974,974,applejack|fluttershy|rainbow dash|twilight sparkle,bugplayer
1094378.png,https://derpicdn.net/img/view/2016/2/22/1094378.png,3,0.96984601020813,171,1044,1053,1926,882,882,applejack|fluttershy|rainbow dash|twilight sparkle,bugplayer
1094857.png,https://derpicdn.net/img/view/2016/2/23/1094857.png,0,0.9899165034294128,195,0,900,622,705,622,princess flurry heart|twilight sparkle,supermare
1095740.jpg,https://derpicdn.net/img/view/2016/2/24/1095740.jpg,0,0.9989705681800842,79,3,959,883,880,880,princess luna|twilight sparkle,magnaluna
1097637.png,https://derpicdn.net/img/view/2016/2/27/1097637.png,1,0.9959021210670472,654,58,1560,964,906,906,princess celestia|twilight sparkle,mili-kat
1098200.png,https://derpicdn.net/img/view/2016/2/28/1098200.png,0,0.987294614315033,0,0,1663,1459,1663,1459,starlight glimmer|twilight sparkle,madacon
1098200.png,https://derpicdn.net/img/view/2016/2/28/1098200.png,1,0.9829846024513244,2625,0,4000,1177,1375,1177,starlight glimmer|twilight sparkle,madacon
1099196.png,https://derpicdn.net/img/view/2016/2/29/1099196.png,0,0.9787619709968568,15,583,253,821,238,238,applejack|pinkie pie|rainbow dash|twilight sparkle,tsitra360
1102029.png,https://derpicdn.net/img/view/2016/3/4/1102029.png,1,0.9431995749473572,506,206,766,466,260,260,applejack|twilight sparkle,jowybean
1103075.png,https://derpicdn.net/img/view/2016/3/6/1103075.png,0,0.992050290107727,0,1098,1422,2536,1422,1438,starlight glimmer|sunset shimmer|trixie|twilight sparkle,osipush
1104794.png,https://derpicdn.net/img/view/2016/3/8/1104794.png,0,0.987964689731598,1250,0,2094,813,844,813,trixie|twilight sparkle,culu-bluebeaver
1105056.jpg,https://derpicdn.net/img/view/2016/3/8/1105056.jpg,0,0.9475806355476379,732,33,954,255,222,222,princess celestia|princess luna|shining armor|spike|twilight sparkle,silfoe
1105075.png,https://derpicdn.net/img/view/2016/3/8/1105075.png,0,0.948903501033783,1163,401,2349,1587,1186,1186,pinkie pie|trixie|twilight sparkle,thegreatrouge
1106603.png,https://derpicdn.net/img/view/2016/3/11/1106603.png,0,0.9606020450592041,623,166,883,426,260,260,applejack|twilight sparkle,jowybean
1106603.png,https://derpicdn.net/img/view/2016/3/11/1106603.png,1,0.9391227960586548,85,136,479,530,394,394,applejack|twilight sparkle,jowybean
1106713.png,https://derpicdn.net/img/view/2016/3/11/1106713.png,0,0.9579394459724426,256,0,822,468,566,468,starlight glimmer|sunset shimmer|twilight sparkle,majkashinoda626
1108646.png,https://derpicdn.net/img/view/2016/3/14/1108646.png,0,0.962914764881134,808,186,1066,444,258,258,princess cadance|princess flurry heart|twilight sparkle,panyang-panyang
1111047.png,https://derpicdn.net/img/view/2016/3/17/1111047.png,0,0.995662808418274,175,208,447,480,272,272,rainbow dash|twilight sparkle,aphexangel
1111499.png,https://derpicdn.net/img/view/2016/3/18/1111499.png,0,0.9982149004936218,307,762,609,1064,302,302,applejack|fluttershy|mane six|pinkie pie|princess celestia|princess luna|rainbow dash|rarity|twilight sparkle,stoic5
1111499.png,https://derpicdn.net/img/view/2016/3/18/1111499.png,1,0.9980884194374084,931,0,1275,317,344,317,applejack|fluttershy|mane six|pinkie pie|princess celestia|princess luna|rainbow dash|rarity|twilight sparkle,stoic5
1111499.png,https://derpicdn.net/img/view/2016/3/18/1111499.png,2,0.9969248175621032,946,768,1276,1098,330,330,applejack|fluttershy|mane six|pinkie pie|princess celestia|princess luna|rainbow dash|rarity|twilight sparkle,stoic5
1111499.png,https://derpicdn.net/img/view/2016/3/18/1111499.png,3,0.996618151664734,310,371,618,679,308,308,applejack|fluttershy|mane six|pinkie pie|princess celestia|princess luna|rainbow dash|rarity|twilight sparkle,stoic5
1111499.png,https://derpicdn.net/img/view/2016/3/18/1111499.png,4,0.9960864782333374,289,0,615,308,326,308,applejack|fluttershy|mane six|pinkie pie|princess celestia|princess luna|rainbow dash|rarity|twilight sparkle,stoic5
1111499.png,https://derpicdn.net/img/view/2016/3/18/1111499.png,5,0.9951348304748536,13,0,329,300,316,300,applejack|fluttershy|mane six|pinkie pie|princess celestia|princess luna|rainbow dash|rarity|twilight sparkle,stoic5
1111499.png,https://derpicdn.net/img/view/2016/3/18/1111499.png,6,0.9899598360061646,16,365,320,669,304,304,applejack|fluttershy|mane six|pinkie pie|princess celestia|princess luna|rainbow dash|rarity|twilight sparkle,stoic5
1111499.png,https://derpicdn.net/img/view/2016/3/18/1111499.png,7,0.988996148109436,939,394,1249,704,310,310,applejack|fluttershy|mane six|pinkie pie|princess celestia|princess luna|rainbow dash|rarity|twilight sparkle,stoic5
1111499.png,https://derpicdn.net/img/view/2016/3/18/1111499.png,8,0.9859739542007446,649,366,907,624,258,258,applejack|fluttershy|mane six|pinkie pie|princess celestia|princess luna|rainbow dash|rarity|twilight sparkle,stoic5
1111499.png,https://derpicdn.net/img/view/2016/3/18/1111499.png,9,0.9590250253677368,649,0,981,313,332,313,applejack|fluttershy|mane six|pinkie pie|princess celestia|princess luna|rainbow dash|rarity|twilight sparkle,stoic5
1111499.png,https://derpicdn.net/img/view/2016/3/18/1111499.png,10,0.9408033490180968,7,738,333,1064,326,326,applejack|fluttershy|mane six|pinkie pie|princess celestia|princess luna|rainbow dash|rarity|twilight sparkle,stoic5
1112096.png,https://derpicdn.net/img/view/2016/3/19/1112096.png,0,0.993341028690338,605,241,869,505,264,264,princess celestia|twilight sparkle,king-kakapo
1113236.png,https://derpicdn.net/img/view/2016/3/20/1113236.png,0,0.9717798829078674,356,94,724,462,368,368,princess celestia|princess luna|twilight sparkle,akeahi
1113236.png,https://derpicdn.net/img/view/2016/3/20/1113236.png,1,0.9457173943519592,741,176,1105,540,364,364,princess celestia|princess luna|twilight sparkle,akeahi
1114214.png,https://derpicdn.net/img/view/2016/3/22/1114214.png,0,0.9981608390808104,1658,0,3064,1384,1406,1384,rainbow dash|twilight sparkle,captainpudgemuffin
1114780.png,https://derpicdn.net/img/view/2016/3/22/1114780.png,0,0.9995966553688048,720,0,1022,291,302,291,rarity|twilight sparkle,king-kakapo
1114780.png,https://derpicdn.net/img/view/2016/3/22/1114780.png,1,0.997092604637146,257,313,543,599,286,286,rarity|twilight sparkle,king-kakapo
1114781.png,https://derpicdn.net/img/view/2016/3/22/1114781.png,0,0.997551679611206,257,315,539,597,282,282,rarity|twilight sparkle,king-kakapo
1114781.png,https://derpicdn.net/img/view/2016/3/22/1114781.png,1,0.991365611553192,765,24,1015,274,250,250,rarity|twilight sparkle,king-kakapo
1117612.png,https://derpicdn.net/img/view/2016/3/26/1117612.png,0,0.9982504844665528,424,0,754,327,330,327,applejack|twilight sparkle,jirousan
1117612.png,https://derpicdn.net/img/view/2016/3/26/1117612.png,1,0.9340845346450806,0,95,458,579,458,484,applejack|twilight sparkle,jirousan
1119078.png,https://derpicdn.net/img/view/2016/3/28/1119078.png,0,0.9927250742912292,0,261,704,997,704,736,starlight glimmer|sunset shimmer|trixie|twilight sparkle,geraritydevillefort
1119874.png,https://derpicdn.net/img/view/2016/3/29/1119874.png,0,0.9993277192115784,1448,140,1674,366,226,226,applejack|fluttershy|mane six|pinkie pie|rainbow dash|rarity|twilight sparkle,howxu
1119874.png,https://derpicdn.net/img/view/2016/3/29/1119874.png,1,0.9953185319900512,398,91,694,387,296,296,applejack|fluttershy|mane six|pinkie pie|rainbow dash|rarity|twilight sparkle,howxu
1119874.png,https://derpicdn.net/img/view/2016/3/29/1119874.png,2,0.9200403690338136,1749,133,2013,397,264,264,applejack|fluttershy|mane six|pinkie pie|rainbow dash|rarity|twilight sparkle,howxu
1119908.png,https://derpicdn.net/img/view/2016/3/29/1119908.png,0,0.9728438258171082,551,404,967,820,416,416,sweetie belle|twilight sparkle,vavacung
1120037.jpg,https://derpicdn.net/img/view/2016/3/30/1120037.jpg,0,0.9952422976493835,726,79,1100,453,374,374,princess luna|starlight glimmer|twilight sparkle,silfoe
1120037.jpg,https://derpicdn.net/img/view/2016/3/30/1120037.jpg,1,0.9919583797454834,35,145,245,355,210,210,princess luna|starlight glimmer|twilight sparkle,silfoe
1120037.jpg,https://derpicdn.net/img/view/2016/3/30/1120037.jpg,2,0.9612387418746948,265,27,595,357,330,330,princess luna|starlight glimmer|twilight sparkle,silfoe
1120501.png,https://derpicdn.net/img/view/2016/3/30/1120501.png,0,0.999520778656006,42,23,356,337,314,314,starlight glimmer|sunset shimmer|trixie|twilight sparkle,sion
1120501.png,https://derpicdn.net/img/view/2016/3/30/1120501.png,1,0.9988206028938292,554,30,1040,516,486,486,starlight glimmer|sunset shimmer|trixie|twilight sparkle,sion
1121372.jpg,https://derpicdn.net/img/view/2016/3/31/1121372.jpg,0,0.9990838766098022,0,0,609,649,609,649,fluttershy|twilight sparkle,onomec
1121379.png,https://derpicdn.net/img/view/2016/3/31/1121379.png,0,0.9095020294189452,69,0,385,315,316,315,spike|starlight glimmer|twilight sparkle,inuhoshi-to-darkpen
1122083.png,https://derpicdn.net/img/view/2016/4/1/1122083.png,0,0.9935322999954224,449,29,705,285,256,256,applejack|princess flurry heart|twilight sparkle,jowybean
1122083.png,https://derpicdn.net/img/view/2016/4/1/1122083.png,1,0.9889528751373292,110,47,338,275,228,228,applejack|princess flurry heart|twilight sparkle,jowybean
1122120.png,https://derpicdn.net/img/view/2016/4/2/1122120.png,0,0.9835810661315918,163,0,2165,1940,2002,1940,rainbow dash|twilight sparkle,captainpudgemuffin
1122155.png,https://derpicdn.net/img/view/2016/4/2/1122155.png,0,0.9980245232582092,734,164,980,410,246,246,applejack|fluttershy|mane six|pinkie pie|rainbow dash|rarity|twilight sparkle,doekitty
1122155.png,https://derpicdn.net/img/view/2016/4/2/1122155.png,1,0.9951140284538268,357,19,673,335,316,316,applejack|fluttershy|mane six|pinkie pie|rainbow dash|rarity|twilight sparkle,doekitty
1122155.png,https://derpicdn.net/img/view/2016/4/2/1122155.png,2,0.9948483109474182,358,570,640,852,282,282,applejack|fluttershy|mane six|pinkie pie|rainbow dash|rarity|twilight sparkle,doekitty
1122155.png,https://derpicdn.net/img/view/2016/4/2/1122155.png,3,0.9912133812904358,95,599,353,857,258,258,applejack|fluttershy|mane six|pinkie pie|rainbow dash|rarity|twilight sparkle,doekitty
1122155.png,https://derpicdn.net/img/view/2016/4/2/1122155.png,4,0.9457743167877196,727,530,1003,806,276,276,applejack|fluttershy|mane six|pinkie pie|rainbow dash|rarity|twilight sparkle,doekitty
1123708.png,https://derpicdn.net/img/view/2016/4/3/1123708.png,0,0.9974291920661926,768,41,1060,333,292,292,pinkie pie|twilight sparkle,king-kakapo
1123708.png,https://derpicdn.net/img/view/2016/4/3/1123708.png,1,0.9580137133598328,122,48,450,376,328,328,pinkie pie|twilight sparkle,king-kakapo
1123709.png,https://derpicdn.net/img/view/2016/4/3/1123709.png,0,0.9990473389625548,769,35,1077,343,308,308,pinkie pie|twilight sparkle,king-kakapo
1123709.png,https://derpicdn.net/img/view/2016/4/3/1123709.png,1,0.9591635465621948,129,38,473,382,344,344,pinkie pie|twilight sparkle,king-kakapo
1124407.png,https://derpicdn.net/img/view/2016/4/4/1124407.png,0,0.9990002512931824,1064,715,1380,1031,316,316,applejack|pinkie pie|rarity|spike|starlight glimmer|sunset shimmer|twilight sparkle,phyllismi
1124407.png,https://derpicdn.net/img/view/2016/4/4/1124407.png,1,0.9984250664711,467,1226,877,1636,410,410,applejack|pinkie pie|rarity|spike|starlight glimmer|sunset shimmer|twilight sparkle,phyllismi
1124407.png,https://derpicdn.net/img/view/2016/4/4/1124407.png,2,0.9977471232414246,1249,1245,1531,1527,282,282,applejack|pinkie pie|rarity|spike|starlight glimmer|sunset shimmer|twilight sparkle,phyllismi
1124407.png,https://derpicdn.net/img/view/2016/4/4/1124407.png,3,0.9952139258384703,152,1248,534,1630,382,382,applejack|pinkie pie|rarity|spike|starlight glimmer|sunset shimmer|twilight sparkle,phyllismi
1124407.png,https://derpicdn.net/img/view/2016/4/4/1124407.png,4,0.9002342820167542,36,10,448,422,412,412,applejack|pinkie pie|rarity|spike|starlight glimmer|sunset shimmer|twilight sparkle,phyllismi
1124891.png,https://derpicdn.net/img/view/2016/4/5/1124891.png,0,0.9925090074539183,578,10,926,358,348,348,rarity|twilight sparkle,king-kakapo
1124891.png,https://derpicdn.net/img/view/2016/4/5/1124891.png,1,0.9832058548927308,57,59,427,429,370,370,rarity|twilight sparkle,king-kakapo
1124892.png,https://derpicdn.net/img/view/2016/4/5/1124892.png,0,0.9991647005081176,50,37,444,431,394,394,rarity|twilight sparkle,king-kakapo
1124892.png,https://derpicdn.net/img/view/2016/4/5/1124892.png,1,0.9937117695808412,585,19,917,351,332,332,rarity|twilight sparkle,king-kakapo
1124893.png,https://derpicdn.net/img/view/2016/4/5/1124893.png,0,0.9892789721488952,592,17,914,339,322,322,rarity|twilight sparkle,king-kakapo
1124893.png,https://derpicdn.net/img/view/2016/4/5/1124893.png,1,0.9853951334953308,70,63,418,411,348,348,rarity|twilight sparkle,king-kakapo
1125158.png,https://derpicdn.net/img/view/2016/4/5/1125158.png,0,0.9174327254295348,187,394,635,842,448,448,princess cadance|princess celestia|princess flurry heart|princess luna|shining armor|starlight glimmer|twilight sparkle,berrypawnch
1125205.jpg,https://derpicdn.net/img/view/2016/4/5/1125205.jpg,1,0.983678698539734,886,0,1134,211,248,211,applejack|discord|fluttershy|mane six|pinkie pie|rainbow dash|rarity|trixie|twilight sparkle,yulyeen
1125205.jpg,https://derpicdn.net/img/view/2016/4/5/1125205.jpg,2,0.9305450916290284,75,304,307,536,232,232,applejack|discord|fluttershy|mane six|pinkie pie|rainbow dash|rarity|trixie|twilight sparkle,yulyeen
1127829.png,https://derpicdn.net/img/view/2016/4/9/1127829.png,0,0.9438318610191344,2982,646,3560,1224,578,578,applejack|fluttershy|mane six|pinkie pie|princess cadance|princess celestia|rainbow dash|rarity|twilight sparkle,underpable
1127914.png,https://derpicdn.net/img/view/2016/4/9/1127914.png,0,0.9992135763168336,748,1674,1358,2284,610,610,applejack|fluttershy|twilight sparkle,bugplayer
1127914.png,https://derpicdn.net/img/view/2016/4/9/1127914.png,1,0.9955743551254272,260,647,870,1257,610,610,applejack|fluttershy|twilight sparkle,bugplayer
1127914.png,https://derpicdn.net/img/view/2016/4/9/1127914.png,2,0.9947383999824524,1064,80,1776,792,712,712,applejack|fluttershy|twilight sparkle,bugplayer
1127914.png,https://derpicdn.net/img/view/2016/4/9/1127914.png,3,0.9783567786216736,1895,570,2453,1128,558,558,applejack|fluttershy|twilight sparkle,bugplayer
1127914.png,https://derpicdn.net/img/view/2016/4/9/1127914.png,4,0.95466411113739,1397,1937,2019,2559,622,622,applejack|fluttershy|twilight sparkle,bugplayer
1128405.png,https://derpicdn.net/img/view/2016/4/9/1128405.png,0,0.999285101890564,1726,40,2116,430,390,390,applejack|fluttershy|mane six|pinkie pie|rainbow dash|rarity|twilight sparkle,mysticalpha edits|talisa
1128405.png,https://derpicdn.net/img/view/2016/4/9/1128405.png,1,0.9856740236282348,0,87,378,527,378,440,applejack|fluttershy|mane six|pinkie pie|rainbow dash|rarity|twilight sparkle,mysticalpha edits|talisa
1128405.png,https://derpicdn.net/img/view/2016/4/9/1128405.png,2,0.9806169271469116,454,61,862,469,408,408,applejack|fluttershy|mane six|pinkie pie|rainbow dash|rarity|twilight sparkle,mysticalpha edits|talisa
1129423.png,https://derpicdn.net/img/view/2016/4/10/1129423.png,0,0.9897843599319458,551,184,759,392,208,208,applejack|fluttershy|mane six|pinkie pie|rainbow dash|rarity|twilight sparkle,mastergodai
1129423.png,https://derpicdn.net/img/view/2016/4/10/1129423.png,1,0.9896384477615356,885,176,1101,392,216,216,applejack|fluttershy|mane six|pinkie pie|rainbow dash|rarity|twilight sparkle,mastergodai
1130014.png,https://derpicdn.net/img/view/2016/4/11/1130014.png,0,0.999581515789032,632,65,998,431,366,366,applejack|fluttershy|mane six|pinkie pie|rainbow dash|rarity|twilight sparkle,king-kakapo
1130014.png,https://derpicdn.net/img/view/2016/4/11/1130014.png,2,0.998790979385376,667,789,1015,1137,348,348,applejack|fluttershy|mane six|pinkie pie|rainbow dash|rarity|twilight sparkle,king-kakapo
1130014.png,https://derpicdn.net/img/view/2016/4/11/1130014.png,3,0.9984951019287108,1093,795,1459,1161,366,366,applejack|fluttershy|mane six|pinkie pie|rainbow dash|rarity|twilight sparkle,king-kakapo
1130014.png,https://derpicdn.net/img/view/2016/4/11/1130014.png,4,0.9963667392730712,1070,0,1480,401,410,401,applejack|fluttershy|mane six|pinkie pie|rainbow dash|rarity|twilight sparkle,king-kakapo
1130014.png,https://derpicdn.net/img/view/2016/4/11/1130014.png,5,0.9960801601409912,131,38,505,412,374,374,applejack|fluttershy|mane six|pinkie pie|rainbow dash|rarity|twilight sparkle,king-kakapo
1131816.png,https://derpicdn.net/img/view/2016/4/14/1131816.png,0,0.9892499446868896,334,0,1000,656,666,656,starlight glimmer|twilight sparkle,glacierclear|3xlneet
1132368.png,https://derpicdn.net/img/view/2016/4/15/1132368.png,0,0.9869760870933532,432,107,646,321,214,214,applejack|twilight sparkle,jowybean
1133132.png,https://derpicdn.net/img/view/2016/4/16/1133132.png,0,0.9799533486366272,17,0,445,401,428,401,sunset shimmer|twilight sparkle,phyllismi
1133421.png,https://derpicdn.net/img/view/2016/4/16/1133421.png,0,0.9835159778594972,1080,398,1506,824,426,426,spike|twilight sparkle,hellticket
1133577.png,https://derpicdn.net/img/view/2016/4/16/1133577.png,1,0.9693984389305116,404,0,1048,598,644,598,starlight glimmer|twilight sparkle,braffy
1133577.png,https://derpicdn.net/img/view/2016/4/16/1133577.png,2,0.9178276658058168,1882,910,2498,1526,616,616,starlight glimmer|twilight sparkle,braffy
1137289.png,https://derpicdn.net/img/view/2016/4/21/1137289.png,0,0.9460663199424744,1295,0,1907,558,612,558,princess luna|twilight sparkle,twiren
1137426.jpg,https://derpicdn.net/img/view/2016/4/22/1137426.jpg,0,0.9957097768783568,1578,697,2234,1353,656,656,princess cadance|princess celestia|princess luna|twilight sparkle,brendahickey
1137639.png,https://derpicdn.net/img/view/2016/4/22/1137639.png,0,0.9726684093475342,130,139,360,369,230,230,applejack|spike|twilight sparkle,jowybean
1140048.png,https://derpicdn.net/img/view/2016/4/25/1140048.png,0,0.9591864943504332,446,0,2206,1559,1760,1559,trixie|twilight sparkle,badumsquish
1140254.png,https://derpicdn.net/img/view/2016/4/26/1140254.png,0,0.9878136515617372,550,789,960,1201,410,412,spike|twilight sparkle,tamersworld
1140254.png,https://derpicdn.net/img/view/2016/4/26/1140254.png,1,0.9813907146453856,191,167,501,477,310,310,spike|twilight sparkle,tamersworld
1141863.jpg,https://derpicdn.net/img/view/2016/4/28/1141863.jpg,0,0.9522078037261964,1127,147,1555,575,428,428,pinkie pie|spike|twilight sparkle,noben
1142137.png,https://derpicdn.net/img/view/2016/4/29/1142137.png,0,0.9914120435714722,9,241,255,487,246,246,applejack|fluttershy|mane six|pinkie pie|rainbow dash|rarity|twilight sparkle,okashi-na-artist
1142881.png,https://derpicdn.net/img/view/2016/4/30/1142881.png,0,0.9864820837974548,900,616,1202,918,302,302,applejack|fluttershy|mane six|pinkie pie|rainbow dash|rarity|twilight sparkle,kp-shadowsquirrel
1143057.png,https://derpicdn.net/img/view/2016/4/30/1143057.png,0,0.9782373905181884,205,0,900,598,695,598,rarity|spike|twilight sparkle,dm29
1143455.png,https://derpicdn.net/img/view/2016/4/30/1143455.png,0,0.9685394167900084,177,176,805,804,628,628,rainbow dash|twilight sparkle,blackgryph0n|studlyhorn|vitaj
1143598.png,https://derpicdn.net/img/view/2016/5/1/1143598.png,0,0.9909945130348206,267,0,795,520,528,520,starlight glimmer|twilight sparkle,
1143892.png,https://derpicdn.net/img/view/2016/5/1/1143892.png,0,0.9787318110466005,913,0,1931,1016,1018,1016,princess cadance|princess celestia|princess luna|twilight sparkle,kuzumori
1143892.png,https://derpicdn.net/img/view/2016/5/1/1143892.png,1,0.950254499912262,0,1417,870,2479,870,1062,princess cadance|princess celestia|princess luna|twilight sparkle,kuzumori
1144555.png,https://derpicdn.net/img/view/2016/5/2/1144555.png,0,0.9811280369758606,507,330,837,708,330,378,applejack|fluttershy|mane six|pinkie pie|rainbow dash|rarity|starlight glimmer|sunset shimmer|trixie|twilight sparkle,molochko-persik
1144555.png,https://derpicdn.net/img/view/2016/5/2/1144555.png,1,0.9359071254730223,501,643,837,1027,336,384,applejack|fluttershy|mane six|pinkie pie|rainbow dash|rarity|starlight glimmer|sunset shimmer|trixie|twilight sparkle,molochko-persik
1144884.png,https://derpicdn.net/img/view/2016/5/2/1144884.png,1,0.9033404588699341,81,0,907,779,826,779,starlight glimmer|trixie|twilight sparkle,phuocthiencreation
1145744.png,https://derpicdn.net/img/view/2016/5/3/1145744.png,0,0.989135205745697,1094,257,2208,1371,1114,1114,starlight glimmer|trixie|twilight sparkle,discorded
1145744.png,https://derpicdn.net/img/view/2016/5/3/1145744.png,1,0.9584701061248779,1689,46,3127,1484,1438,1438,starlight glimmer|trixie|twilight sparkle,discorded
1146379.png,https://derpicdn.net/img/view/2016/5/4/1146379.png,0,0.9707805514335632,423,517,869,963,446,446,apple bloom|applejack|big macintosh|fluttershy|mane six|pinkie pie|rainbow dash|rarity|sunset shimmer|sweetie belle|twilight sparkle,indigosfmworks
1146845.png,https://derpicdn.net/img/view/2016/5/5/1146845.png,0,0.9868881702423096,469,171,1147,849,678,678,discord|pinkie pie|princess celestia|princess luna|twilight sparkle,thegreatrouge
1146845.png,https://derpicdn.net/img/view/2016/5/5/1146845.png,1,0.9825370907783508,1097,13,1867,783,770,770,discord|pinkie pie|princess celestia|princess luna|twilight sparkle,thegreatrouge
1146845.png,https://derpicdn.net/img/view/2016/5/5/1146845.png,2,0.9535658359527588,227,793,891,1457,664,664,discord|pinkie pie|princess celestia|princess luna|twilight sparkle,thegreatrouge
1146935.png,https://derpicdn.net/img/view/2016/5/5/1146935.png,0,0.99486243724823,223,0,1345,1086,1122,1086,rainbow dash|twilight sparkle,captainpudgemuffin
1146999.png,https://derpicdn.net/img/view/2016/5/5/1146999.png,1,0.9359561800956726,985,299,1917,1231,932,932,fluttershy|twilight sparkle,cold blight
1147635.png,https://derpicdn.net/img/view/2016/5/6/1147635.png,0,0.9824075102806092,638,98,2166,1626,1528,1528,sunset shimmer|twilight sparkle,maren
1148873.jpg,https://derpicdn.net/img/view/2016/5/7/1148873.jpg,0,0.9956323504447936,0,990,488,1482,488,492,applejack|fluttershy|mane six|pinkie pie|rainbow dash|rarity|twilight sparkle,
1148873.jpg,https://derpicdn.net/img/view/2016/5/7/1148873.jpg,1,0.988038182258606,0,419,593,1035,593,616,applejack|fluttershy|mane six|pinkie pie|rainbow dash|rarity|twilight sparkle,
1151552.png,https://derpicdn.net/img/view/2016/5/11/1151552.png,0,0.991986095905304,545,1320,849,1624,304,304,apple bloom|babs seed|cutie mark crusaders|scootaloo|sweetie belle|twilight sparkle,viwrastupr
1151552.png,https://derpicdn.net/img/view/2016/5/11/1151552.png,1,0.9689052104949952,1023,1397,1333,1707,310,310,apple bloom|babs seed|cutie mark crusaders|scootaloo|sweetie belle|twilight sparkle,viwrastupr
1151552.png,https://derpicdn.net/img/view/2016/5/11/1151552.png,3,0.9072985649108888,224,583,554,913,330,330,apple bloom|babs seed|cutie mark crusaders|scootaloo|sweetie belle|twilight sparkle,viwrastupr
1152761.png,https://derpicdn.net/img/view/2016/5/13/1152761.png,0,0.9639546275138856,1410,899,2406,1895,996,996,princess celestia|twilight sparkle,nadnerbd
1154666.png,https://derpicdn.net/img/view/2016/5/15/1154666.png,0,0.997560739517212,2504,337,3024,857,520,520,starlight glimmer|sunset shimmer|trixie|twilight sparkle,bugplayer
1154666.png,https://derpicdn.net/img/view/2016/5/15/1154666.png,1,0.9663486480712892,1582,666,2132,1216,550,550,starlight glimmer|sunset shimmer|trixie|twilight sparkle,bugplayer
1155110.png,https://derpicdn.net/img/view/2016/5/15/1155110.png,1,0.9285183548927308,3145,1337,3651,1843,506,506,big macintosh|discord|fluttershy|princess cadance|princess celestia|princess flurry heart|princess luna|queen chrysalis|rainbow dash|rarity|shining armor|spike|sweetie belle|twilight sparkle,eagle1division|markiz93|joetheimpaler
1155698.png,https://derpicdn.net/img/view/2016/5/16/1155698.png,0,0.949236273765564,0,159,505,677,505,518,starlight glimmer|twilight sparkle,lumineko
1158672.png,https://derpicdn.net/img/view/2016/5/20/1158672.png,0,0.9892885088920592,90,291,314,515,224,224,applejack|twilight sparkle,jowybean
1159674.png,https://derpicdn.net/img/view/2016/5/21/1159674.png,1,0.95767480134964,1357,0,2605,1182,1248,1182,applejack|fluttershy|mane six|pinkie pie|rainbow dash|rarity|twilight sparkle,light262|lummh
1162415.png,https://derpicdn.net/img/view/2016/5/25/1162415.png,0,0.9642778635025024,815,317,1281,783,466,466,starlight glimmer|sunset shimmer|trixie|twilight sparkle,vulpessentia
1163634.jpg,https://derpicdn.net/img/view/2016/5/26/1163634.jpg,0,0.9974699020385742,999,160,2225,1386,1226,1226,princess cadance|princess celestia|princess luna|twilight sparkle,silfoe
1163974.png,https://derpicdn.net/img/view/2016/5/27/1163974.png,0,0.9731816053390504,611,462,1273,1124,662,662,starlight glimmer|sunset shimmer|trixie|twilight sparkle,anarchemitis
1166429.jpg,https://derpicdn.net/img/view/2016/5/30/1166429.jpg,0,0.9739899039268494,293,175,669,551,376,376,trixie|twilight sparkle,andypriceart
1169005.png,https://derpicdn.net/img/view/2016/6/3/1169005.png,0,0.9924080967903136,32,209,596,773,564,564,princess luna|twilight sparkle,pencils
1169293.png,https://derpicdn.net/img/view/2016/6/3/1169293.png,0,0.9115707874298096,276,202,504,430,228,228,applejack|fluttershy|mane six|pinkie pie|rainbow dash|rarity|twilight sparkle,metal-kitty
1173912.png,https://derpicdn.net/img/view/2016/6/8/1173912.png,0,0.9766655564308168,494,199,816,521,322,322,princess celestia|twilight sparkle,akeahi
1176982.jpg,https://derpicdn.net/img/view/2016/6/12/1176982.jpg,3,0.9668983221054076,537,1572,781,1816,244,244,princess cadance|princess flurry heart|shining armor|twilight sparkle,ohohokapi
1177445.jpg,https://derpicdn.net/img/view/2016/6/13/1177445.jpg,2,0.993314266204834,189,103,625,539,436,436,princess cadance|princess celestia|princess flurry heart|princess luna|twilight sparkle,silfoe
1180709.png,https://derpicdn.net/img/view/2016/6/17/1180709.png,0,0.9778922796249392,162,28,522,388,360,360,sunset shimmer|twilight sparkle,dvixie
1180709.png,https://derpicdn.net/img/view/2016/6/17/1180709.png,1,0.9288813471794128,667,150,1009,492,342,342,sunset shimmer|twilight sparkle,dvixie
1182922.png,https://derpicdn.net/img/view/2016/6/20/1182922.png,0,0.9976968765258788,285,421,531,667,246,246,applejack|fluttershy|mane six|pinkie pie|rainbow dash|rarity|twilight sparkle,tsaoshin
1182922.png,https://derpicdn.net/img/view/2016/6/20/1182922.png,1,0.9951115250587464,501,156,757,412,256,256,applejack|fluttershy|mane six|pinkie pie|rainbow dash|rarity|twilight sparkle,tsaoshin
1182922.png,https://derpicdn.net/img/view/2016/6/20/1182922.png,2,0.9881621599197388,463,573,755,865,292,292,applejack|fluttershy|mane six|pinkie pie|rainbow dash|rarity|twilight sparkle,tsaoshin
1182922.png,https://derpicdn.net/img/view/2016/6/20/1182922.png,4,0.962764859199524,60,558,396,894,336,336,applejack|fluttershy|mane six|pinkie pie|rainbow dash|rarity|twilight sparkle,tsaoshin
1183742.jpg,https://derpicdn.net/img/view/2016/6/21/1183742.jpg,0,0.9981738328933716,493,44,1063,614,570,570,shining armor|twilight sparkle,marcus todjel|ambris
1184068.jpg,https://derpicdn.net/img/view/2016/6/22/1184068.jpg,0,0.9066867828369141,280,62,704,486,424,424,applejack|fluttershy|mane six|pinkie pie|rainbow dash|rarity|twilight sparkle,jadedjynx|ganighost
1185038.png,https://derpicdn.net/img/view/2016/6/23/1185038.png,0,0.9939137697219848,0,4,267,294,267,290,applejack|fluttershy|mane six|pinkie pie|rainbow dash|rarity|twilight sparkle,arcadianphoenix
1185038.png,https://derpicdn.net/img/view/2016/6/23/1185038.png,1,0.9921432733535768,334,0,600,304,266,304,applejack|fluttershy|mane six|pinkie pie|rainbow dash|rarity|twilight sparkle,arcadianphoenix
1185097.png,https://derpicdn.net/img/view/2016/6/23/1185097.png,0,0.9943413734436036,570,183,836,449,266,266,applejack|fluttershy|mane six|pinkie pie|rainbow dash|rarity|twilight sparkle,maggwai
1185097.png,https://derpicdn.net/img/view/2016/6/23/1185097.png,1,0.983599841594696,622,485,872,735,250,250,applejack|fluttershy|mane six|pinkie pie|rainbow dash|rarity|twilight sparkle,maggwai
1185097.png,https://derpicdn.net/img/view/2016/6/23/1185097.png,2,0.954718053340912,397,654,611,868,214,214,applejack|fluttershy|mane six|pinkie pie|rainbow dash|rarity|twilight sparkle,maggwai
1185097.png,https://derpicdn.net/img/view/2016/6/23/1185097.png,3,0.9369134902954102,206,205,498,497,292,292,applejack|fluttershy|mane six|pinkie pie|rainbow dash|rarity|twilight sparkle,maggwai
1185097.png,https://derpicdn.net/img/view/2016/6/23/1185097.png,4,0.9164661765098572,245,504,467,726,222,222,applejack|fluttershy|mane six|pinkie pie|rainbow dash|rarity|twilight sparkle,maggwai
1185097.png,https://derpicdn.net/img/view/2016/6/23/1185097.png,5,0.90764057636261,414,408,650,644,236,236,applejack|fluttershy|mane six|pinkie pie|rainbow dash|rarity|twilight sparkle,maggwai
1185630.png,https://derpicdn.net/img/view/2016/6/24/1185630.png,0,0.995716631412506,365,459,635,729,270,270,princess cadance|shining armor|twilight sparkle,dm29
1186104.png,https://derpicdn.net/img/view/2016/6/24/1186104.png,0,0.9253274202346802,385,223,581,419,196,196,applejack|twilight sparkle,jowybean
1187413.png,https://derpicdn.net/img/view/2016/6/26/1187413.png,0,0.9387535452842712,605,0,1001,335,396,335,big macintosh|fluttershy|princess cadance|rainbow dash|twilight sparkle,tobibrocki
1187413.png,https://derpicdn.net/img/view/2016/6/26/1187413.png,1,0.9177619814872742,886,78,1198,390,312,312,big macintosh|fluttershy|princess cadance|rainbow dash|twilight sparkle,tobibrocki
1187885.png,https://derpicdn.net/img/view/2016/6/27/1187885.png,0,0.9889981746673584,83,34,373,324,290,290,pinkie pie|rainbow dash|soarin'|twilight sparkle,dm29
1188718.png,https://derpicdn.net/img/view/2016/6/28/1188718.png,0,0.980764627456665,318,57,898,637,580,580,rainbow dash|twilight sparkle,enjaadjital
1190569.png,https://derpicdn.net/img/view/2016/7/1/1190569.png,0,0.9653671979904176,750,131,1226,607,476,476,applejack|fluttershy|mane six|pinkie pie|rainbow dash|rarity|spike|twilight sparkle,siggie740
1190569.png,https://derpicdn.net/img/view/2016/7/1/1190569.png,1,0.9166337847709656,618,488,1040,910,422,422,applejack|fluttershy|mane six|pinkie pie|rainbow dash|rarity|spike|twilight sparkle,siggie740
1191180.png,https://derpicdn.net/img/view/2016/7/1/1191180.png,0,0.9973284602165222,1322,23,1920,685,598,662,princess cadance|shining armor|twilight sparkle,acesential
1193568.png,https://derpicdn.net/img/view/2016/7/4/1193568.png,0,0.9930466413497924,54,7,394,347,340,340,princess celestia|twilight sparkle,bow2yourwaifu
1194797.png,https://derpicdn.net/img/view/2016/7/6/1194797.png,0,0.96132093667984,6410,1169,7302,2061,892,892,applejack|fluttershy|pinkie pie|rainbow dash|rarity|twilight sparkle,verulence
1194797.png,https://derpicdn.net/img/view/2016/7/6/1194797.png,1,0.9216665029525756,2780,1346,3588,2154,808,808,applejack|fluttershy|pinkie pie|rainbow dash|rarity|twilight sparkle,verulence
1196069.png,https://derpicdn.net/img/view/2016/7/8/1196069.png,0,0.9547999501228333,262,39,582,359,320,320,applejack|twilight sparkle,jowybean
1196069.png,https://derpicdn.net/img/view/2016/7/8/1196069.png,1,0.9320866465568542,504,45,834,375,330,330,applejack|twilight sparkle,jowybean
1197199.png,https://derpicdn.net/img/view/2016/7/10/1197199.png,0,0.979307234287262,69,0,457,380,388,380,fluttershy|rainbow dash|twilight sparkle,magicalgirlmayhem
1198255.png,https://derpicdn.net/img/view/2016/7/11/1198255.png,0,0.9930292963981628,166,12,424,270,258,258,princess celestia|princess luna|twilight sparkle,kiki-kit
1202910.png,https://derpicdn.net/img/view/2016/7/17/1202910.png,0,0.9814783930778505,821,270,1093,542,272,272,rarity|twilight sparkle,king-kakapo
1202910.png,https://derpicdn.net/img/view/2016/7/17/1202910.png,1,0.9783394932746888,361,163,653,455,292,292,rarity|twilight sparkle,king-kakapo
1204643.png,https://derpicdn.net/img/view/2016/7/19/1204643.png,0,0.9052287936210632,318,87,602,371,284,284,trixie|twilight sparkle,sparkdraws
1206592.png,https://derpicdn.net/img/view/2016/7/22/1206592.png,0,0.9150649309158324,265,9,523,267,258,258,apple bloom|applejack|twilight sparkle,jowybean
1206592.png,https://derpicdn.net/img/view/2016/7/22/1206592.png,1,0.9126850962638856,476,62,724,310,248,248,apple bloom|applejack|twilight sparkle,jowybean
1207343.png,https://derpicdn.net/img/view/2016/7/23/1207343.png,0,0.9614925384521484,357,1123,1165,1931,808,808,rainbow dash|twilight sparkle,captainpudgemuffin
1207343.png,https://derpicdn.net/img/view/2016/7/23/1207343.png,1,0.933704137802124,230,0,1152,795,922,795,rainbow dash|twilight sparkle,captainpudgemuffin
1207979.png,https://derpicdn.net/img/view/2016/7/24/1207979.png,0,0.98857444524765,371,1011,653,1293,282,282,applejack|fluttershy|mane six|pinkie pie|rainbow dash|rarity|spike|twilight sparkle,ss2sonic|flawlessvictory20|fluttershysone
1207979.png,https://derpicdn.net/img/view/2016/7/24/1207979.png,1,0.9817754626274108,811,502,1143,834,332,332,applejack|fluttershy|mane six|pinkie pie|rainbow dash|rarity|spike|twilight sparkle,ss2sonic|flawlessvictory20|fluttershysone
1207979.png,https://derpicdn.net/img/view/2016/7/24/1207979.png,3,0.9503145217895508,622,996,966,1340,344,344,applejack|fluttershy|mane six|pinkie pie|rainbow dash|rarity|spike|twilight sparkle,ss2sonic|flawlessvictory20|fluttershysone
1207979.png,https://derpicdn.net/img/view/2016/7/24/1207979.png,4,0.922663688659668,681,761,923,1003,242,242,applejack|fluttershy|mane six|pinkie pie|rainbow dash|rarity|spike|twilight sparkle,ss2sonic|flawlessvictory20|fluttershysone
1208032.png,https://derpicdn.net/img/view/2016/7/24/1208032.png,0,0.9373257756233216,11,0,549,504,538,504,rarity|twilight sparkle,sandwich-anomaly
1209090.png,https://derpicdn.net/img/view/2016/7/25/1209090.png,2,0.9974676966667176,1587,82,1867,392,280,310,apple bloom|applejack|big macintosh|diamond tiara|fluttershy|pinkie pie|princess cadance|princess celestia|princess luna|queen chrysalis|rainbow dash|rarity|scootaloo|silver spoon|soarin'|spitfire|sweetie belle|trixie|twilight sparkle,howxu
1209090.png,https://derpicdn.net/img/view/2016/7/25/1209090.png,3,0.9952336549758912,889,530,1307,948,418,418,apple bloom|applejack|big macintosh|diamond tiara|fluttershy|pinkie pie|princess cadance|princess celestia|princess luna|queen chrysalis|rainbow dash|rarity|scootaloo|silver spoon|soarin'|spitfire|sweetie belle|trixie|twilight sparkle,howxu
1209090.png,https://derpicdn.net/img/view/2016/7/25/1209090.png,4,0.9939429759979248,1302,74,1616,388,314,314,apple bloom|applejack|big macintosh|diamond tiara|fluttershy|pinkie pie|princess cadance|princess celestia|princess luna|queen chrysalis|rainbow dash|rarity|scootaloo|silver spoon|soarin'|spitfire|sweetie belle|trixie|twilight sparkle,howxu
1209090.png,https://derpicdn.net/img/view/2016/7/25/1209090.png,5,0.9860126972198486,0,365,295,717,295,352,apple bloom|applejack|big macintosh|diamond tiara|fluttershy|pinkie pie|princess cadance|princess celestia|princess luna|queen chrysalis|rainbow dash|rarity|scootaloo|silver spoon|soarin'|spitfire|sweetie belle|trixie|twilight sparkle,howxu
1209090.png,https://derpicdn.net/img/view/2016/7/25/1209090.png,6,0.9337315559387208,0,648,218,922,218,274,apple bloom|applejack|big macintosh|diamond tiara|fluttershy|pinkie pie|princess cadance|princess celestia|princess luna|queen chrysalis|rainbow dash|rarity|scootaloo|silver spoon|soarin'|spitfire|sweetie belle|trixie|twilight sparkle,howxu
1210306.png,https://derpicdn.net/img/view/2016/7/27/1210306.png,0,0.9760237336158752,581,193,901,513,320,320,princess luna|twilight sparkle,grimorabob|silfoe
1214007.png,https://derpicdn.net/img/view/2016/7/31/1214007.png,0,0.9263997077941896,150,87,520,457,370,370,applejack|fluttershy|mane six|pinkie pie|rainbow dash|rarity|spike|twilight sparkle,siggie740
1215331.png,https://derpicdn.net/img/view/2016/8/2/1215331.png,0,0.9996160268783568,329,231,1283,1185,954,954,rainbow dash|twilight sparkle,v-d-k
1215331.png,https://derpicdn.net/img/view/2016/8/2/1215331.png,1,0.9877034425735474,1095,311,1975,1191,880,880,rainbow dash|twilight sparkle,v-d-k
1215339.png,https://derpicdn.net/img/view/2016/8/2/1215339.png,0,0.9444881081581116,883,205,1839,1161,956,956,princess cadance|twilight sparkle,v-d-k
1215805.png,https://derpicdn.net/img/view/2016/8/3/1215805.png,2,0.9277228713035583,253,612,555,914,302,302,applejack|fluttershy|mane six|pinkie pie|rainbow dash|rarity|twilight sparkle,dm29
1216021.png,https://derpicdn.net/img/view/2016/8/3/1216021.png,0,0.997352421283722,520,24,884,388,364,364,fluttershy|twilight sparkle,king-kakapo
1216021.png,https://derpicdn.net/img/view/2016/8/3/1216021.png,1,0.9626880288124084,100,27,470,397,370,370,fluttershy|twilight sparkle,king-kakapo
1216779.png,https://derpicdn.net/img/view/2016/8/4/1216779.png,0,0.9781398773193359,2793,92,4747,2046,1954,1954,princess cadance|princess celestia|princess luna|twilight sparkle,grennadder
1216779.png,https://derpicdn.net/img/view/2016/8/4/1216779.png,1,0.9186187982559204,609,0,2235,1616,1626,1616,princess cadance|princess celestia|princess luna|twilight sparkle,grennadder
12190.jpg,https://derpicdn.net/img/view/2012/6/20/12190.jpg,2,0.9398064017295836,176,436,554,814,378,378,applejack|fluttershy|mane six|pinkie pie|rainbow dash|rarity|twilight sparkle,sheela
12190.jpg,https://derpicdn.net/img/view/2012/6/20/12190.jpg,3,0.9047130942344666,836,431,1094,689,258,258,applejack|fluttershy|mane six|pinkie pie|rainbow dash|rarity|twilight sparkle,sheela
1219566.png,https://derpicdn.net/img/view/2016/8/7/1219566.png,0,0.98148775100708,819,290,1113,584,294,294,rainbow dash|twilight sparkle,koveliana
1221760.png,https://derpicdn.net/img/view/2016/8/10/1221760.png,0,0.9968259930610656,228,11,766,549,538,538,sunset shimmer|twilight sparkle,azurepicker
1222588.png,https://derpicdn.net/img/view/2016/8/11/1222588.png,1,0.9757026433944702,567,132,995,560,428,428,princess luna|twilight sparkle,magnaluna
1222748.png,https://derpicdn.net/img/view/2016/8/11/1222748.png,1,0.998004674911499,115,1136,411,1432,296,296,applejack|fluttershy|mane six|pinkie pie|rainbow dash|rarity|twilight sparkle,alasou
1222748.png,https://derpicdn.net/img/view/2016/8/11/1222748.png,2,0.9979026317596436,803,950,1239,1406,436,456,applejack|fluttershy|mane six|pinkie pie|rainbow dash|rarity|twilight sparkle,alasou
1222748.png,https://derpicdn.net/img/view/2016/8/11/1222748.png,3,0.9959763288497924,635,3,843,211,208,208,applejack|fluttershy|mane six|pinkie pie|rainbow dash|rarity|twilight sparkle,alasou
1222748.png,https://derpicdn.net/img/view/2016/8/11/1222748.png,4,0.9815680980682372,374,451,852,929,478,478,applejack|fluttershy|mane six|pinkie pie|rainbow dash|rarity|twilight sparkle,alasou
1222748.png,https://derpicdn.net/img/view/2016/8/11/1222748.png,5,0.9565249681472778,154,682,572,1100,418,418,applejack|fluttershy|mane six|pinkie pie|rainbow dash|rarity|twilight sparkle,alasou
1224428.png,https://derpicdn.net/img/view/2016/8/13/1224428.png,0,0.9925188422203064,349,54,563,268,214,214,princess cadance|princess celestia|princess luna|twilight sparkle,anticular
1224428.png,https://derpicdn.net/img/view/2016/8/13/1224428.png,1,0.9812714457511902,40,218,240,418,200,200,princess cadance|princess celestia|princess luna|twilight sparkle,anticular
1224428.png,https://derpicdn.net/img/view/2016/8/13/1224428.png,2,0.9166595339775084,209,149,417,357,208,208,princess cadance|princess celestia|princess luna|twilight sparkle,anticular
1225936.png,https://derpicdn.net/img/view/2016/8/15/1225936.png,0,0.9904392957687378,139,323,525,709,386,386,applejack|fluttershy|mane six|pinkie pie|rainbow dash|rarity|twilight sparkle,locksto
1225936.png,https://derpicdn.net/img/view/2016/8/15/1225936.png,1,0.9889472126960754,1250,225,1742,717,492,492,applejack|fluttershy|mane six|pinkie pie|rainbow dash|rarity|twilight sparkle,locksto
1225936.png,https://derpicdn.net/img/view/2016/8/15/1225936.png,2,0.926474153995514,774,127,1182,535,408,408,applejack|fluttershy|mane six|pinkie pie|rainbow dash|rarity|twilight sparkle,locksto
1226483.png,https://derpicdn.net/img/view/2016/8/16/1226483.png,1,0.9282285571098328,477,52,1089,664,612,612,apple bloom|applejack|cutie mark crusaders|fluttershy|mane six|pinkie pie|rainbow dash|rarity|scootaloo|sweetie belle|twilight sparkle,renokim
122833.png,https://derpicdn.net/img/view/2012/10/14/122833.png,0,0.9801225066184998,727,0,1019,281,292,281,big macintosh|rainbow dash|twilight sparkle,avante92
122833.png,https://derpicdn.net/img/view/2012/10/14/122833.png,1,0.9650439620018004,333,0,627,260,294,260,big macintosh|rainbow dash|twilight sparkle,avante92
1228777.png,https://derpicdn.net/img/view/2016/8/19/1228777.png,3,0.971712589263916,16,680,714,1378,698,698,applejack|fluttershy|mane six|pinkie pie|rainbow dash|rarity|twilight sparkle,alasou
1228777.png,https://derpicdn.net/img/view/2016/8/19/1228777.png,5,0.9641934633255004,1232,667,1984,1417,752,750,applejack|fluttershy|mane six|pinkie pie|rainbow dash|rarity|twilight sparkle,alasou
1229702.png,https://derpicdn.net/img/view/2016/8/20/1229702.png,0,0.9894737005233764,961,32,1237,308,276,276,rainbow dash|twilight sparkle,crimsonbugeye
1229968.png,https://derpicdn.net/img/view/2016/8/20/1229968.png,1,0.9944225549697876,265,0,531,263,266,263,princess cadance|princess celestia|starlight glimmer|twilight sparkle,caroo
1229968.png,https://derpicdn.net/img/view/2016/8/20/1229968.png,2,0.9884577989578248,71,10,313,252,242,242,princess cadance|princess celestia|starlight glimmer|twilight sparkle,caroo
1229968.png,https://derpicdn.net/img/view/2016/8/20/1229968.png,3,0.9638884663581848,674,0,1018,306,344,306,princess cadance|princess celestia|starlight glimmer|twilight sparkle,caroo
1230755.png,https://derpicdn.net/img/view/2016/8/21/1230755.png,2,0.9013684988021852,739,280,1109,650,370,370,applejack|fluttershy|mane six|pinkie pie|rainbow dash|rarity|spike|starlight glimmer|sunset shimmer|twilight sparkle,alasou
123105.jpg,https://derpicdn.net/img/view/2012/10/15/123105.jpg,0,0.9929887652397156,1016,67,1228,279,212,212,applejack|fluttershy|mane six|pinkie pie|rainbow dash|rarity|twilight sparkle,drbdnv
123105.jpg,https://derpicdn.net/img/view/2012/10/15/123105.jpg,1,0.9900050759315492,532,57,788,313,256,256,applejack|fluttershy|mane six|pinkie pie|rainbow dash|rarity|twilight sparkle,drbdnv
123105.jpg,https://derpicdn.net/img/view/2012/10/15/123105.jpg,3,0.9826924800872804,172,41,460,329,288,288,applejack|fluttershy|mane six|pinkie pie|rainbow dash|rarity|twilight sparkle,drbdnv
1233304.png,https://derpicdn.net/img/view/2016/8/25/1233304.png,0,0.9954985976219176,500,0,890,349,390,349,princess cadance|shining armor|spike|starlight glimmer|twilight sparkle,dm29
1233304.png,https://derpicdn.net/img/view/2016/8/25/1233304.png,1,0.954681932926178,70,146,382,458,312,312,princess cadance|shining armor|spike|starlight glimmer|twilight sparkle,dm29
1233304.png,https://derpicdn.net/img/view/2016/8/25/1233304.png,2,0.9437682032585144,619,202,1009,592,390,390,princess cadance|shining armor|spike|starlight glimmer|twilight sparkle,dm29
1233919.png,https://derpicdn.net/img/view/2016/8/26/1233919.png,0,0.9995827078819276,2203,2374,2797,2968,594,594,applejack|fluttershy|mane six|pinkie pie|rainbow dash|rarity|twilight sparkle,jittery-the-dragon
1233919.png,https://derpicdn.net/img/view/2016/8/26/1233919.png,1,0.9911348223686218,444,2447,1000,3003,556,556,applejack|fluttershy|mane six|pinkie pie|rainbow dash|rarity|twilight sparkle,jittery-the-dragon
1233919.png,https://derpicdn.net/img/view/2016/8/26/1233919.png,2,0.979069173336029,2155,1453,2685,1983,530,530,applejack|fluttershy|mane six|pinkie pie|rainbow dash|rarity|twilight sparkle,jittery-the-dragon
1233919.png,https://derpicdn.net/img/view/2016/8/26/1233919.png,3,0.9760283827781676,594,665,1170,1241,576,576,applejack|fluttershy|mane six|pinkie pie|rainbow dash|rarity|twilight sparkle,jittery-the-dragon
1236098.png,https://derpicdn.net/img/view/2016/8/28/1236098.png,0,0.9913030862808228,0,157,393,567,393,410,princess celestia|twilight sparkle,deusexequus
1238121.png,https://derpicdn.net/img/view/2016/8/31/1238121.png,0,0.9890090823173524,0,80,285,390,285,310,princess celestia|twilight sparkle,akeahi
1239913.png,https://derpicdn.net/img/view/2016/9/2/1239913.png,0,0.9958873391151428,148,656,440,948,292,292,applejack|fluttershy|mane six|pinkie pie|rainbow dash|rarity|twilight sparkle,davidmryan
1239913.png,https://derpicdn.net/img/view/2016/9/2/1239913.png,1,0.9922273755073548,290,125,642,477,352,352,applejack|fluttershy|mane six|pinkie pie|rainbow dash|rarity|twilight sparkle,davidmryan
1239913.png,https://derpicdn.net/img/view/2016/9/2/1239913.png,2,0.9551666975021362,558,365,868,675,310,310,applejack|fluttershy|mane six|pinkie pie|rainbow dash|rarity|twilight sparkle,davidmryan
1239913.png,https://derpicdn.net/img/view/2016/9/2/1239913.png,3,0.9172502756118774,359,545,639,825,280,280,applejack|fluttershy|mane six|pinkie pie|rainbow dash|rarity|twilight sparkle,davidmryan
1240030.png,https://derpicdn.net/img/view/2016/9/2/1240030.png,0,0.9676926732063292,432,581,660,809,228,228,applejack|fluttershy|mane six|pinkie pie|rainbow dash|rarity|twilight sparkle,kelsea-chan
1240654.png,https://derpicdn.net/img/view/2016/9/3/1240654.png,0,0.9991881847381592,512,0,2366,1631,1854,1631,sweetie belle|twilight sparkle,madacon
124174.jpg,https://derpicdn.net/img/view/2012/10/16/124174.jpg,0,0.9912521839141846,20,598,356,934,336,336,applejack|fluttershy|mane six|pinkie pie|rainbow dash|rarity|twilight sparkle,rakuyou
124174.jpg,https://derpicdn.net/img/view/2012/10/16/124174.jpg,1,0.9884100556373596,658,674,930,946,272,272,applejack|fluttershy|mane six|pinkie pie|rainbow dash|rarity|twilight sparkle,rakuyou
124174.jpg,https://derpicdn.net/img/view/2012/10/16/124174.jpg,3,0.9551286697387696,926,654,1244,972,318,318,applejack|fluttershy|mane six|pinkie pie|rainbow dash|rarity|twilight sparkle,rakuyou
124174.jpg,https://derpicdn.net/img/view/2012/10/16/124174.jpg,4,0.906567931175232,305,644,637,976,332,332,applejack|fluttershy|mane six|pinkie pie|rainbow dash|rarity|twilight sparkle,rakuyou
1243293.png,https://derpicdn.net/img/view/2016/9/6/1243293.png,0,0.9979939460754396,1132,318,2394,1580,1262,1262,fluttershy|princess cadance|princess celestia|princess luna|rainbow dash|twilight sparkle,maria-fly
1243293.png,https://derpicdn.net/img/view/2016/9/6/1243293.png,1,0.9754480719566344,163,338,1459,1634,1296,1296,fluttershy|princess cadance|princess celestia|princess luna|rainbow dash|twilight sparkle,maria-fly
1243941.png,https://derpicdn.net/img/view/2016/9/7/1243941.png,0,0.988976001739502,65,105,359,399,294,294,applejack|fluttershy|mane six|pinkie pie|rainbow dash|rarity|twilight sparkle,kelsea-chan
1243941.png,https://derpicdn.net/img/view/2016/9/7/1243941.png,1,0.9822538495063782,990,93,1374,477,384,384,applejack|fluttershy|mane six|pinkie pie|rainbow dash|rarity|twilight sparkle,kelsea-chan
1244613.png,https://derpicdn.net/img/view/2016/9/8/1244613.png,0,0.9965946674346924,339,566,559,786,220,220,applejack|fluttershy|mane six|pinkie pie|rainbow dash|rarity|spike|twilight sparkle,valcron
1245166.png,https://derpicdn.net/img/view/2016/9/9/1245166.png,0,0.9978795051574708,1118,66,1840,788,722,722,shining armor|twilight sparkle,evehly
1245166.png,https://derpicdn.net/img/view/2016/9/9/1245166.png,1,0.9917836785316468,388,384,982,978,594,594,shining armor|twilight sparkle,evehly
1245271.png,https://derpicdn.net/img/view/2016/9/9/1245271.png,0,0.9899868965148926,743,0,1487,687,744,687,princess luna|twilight sparkle,vavacung
1245722.png,https://derpicdn.net/img/view/2016/9/10/1245722.png,1,0.9698953032493592,679,470,1973,1764,1294,1294,rainbow dash|twilight sparkle,dilarus
1248290.png,https://derpicdn.net/img/view/2016/9/13/1248290.png,0,0.9826815128326416,757,242,1009,494,252,252,pinkie pie|twilight sparkle,dstears
1250578.png,https://derpicdn.net/img/view/2016/9/16/1250578.png,0,0.9757695198059082,0,0,586,576,586,576,rarity|twilight sparkle,acesrockz
125080.jpg,https://derpicdn.net/img/view/2012/10/17/125080.jpg,0,0.9984367489814758,656,0,902,234,246,234,applejack|fluttershy|mane six|pinkie pie|rainbow dash|rarity|twilight sparkle,shepherd0821
125080.jpg,https://derpicdn.net/img/view/2012/10/17/125080.jpg,2,0.98110693693161,0,18,248,270,248,252,applejack|fluttershy|mane six|pinkie pie|rainbow dash|rarity|twilight sparkle,shepherd0821
125080.jpg,https://derpicdn.net/img/view/2012/10/17/125080.jpg,3,0.938427209854126,388,181,576,369,188,188,applejack|fluttershy|mane six|pinkie pie|rainbow dash|rarity|twilight sparkle,shepherd0821
1254109.png,https://derpicdn.net/img/view/2016/9/20/1254109.png,0,0.9927407503128052,780,404,1224,848,444,444,princess celestia|sunset shimmer|twilight sparkle,phyllismi
1256988.png,https://derpicdn.net/img/view/2016/9/24/1256988.png,0,0.9947147965431212,556,58,768,270,212,212,discord|sunset shimmer|twilight sparkle,lopoddity
12582.png,https://derpicdn.net/img/view/2012/6/20/12582.png,0,0.9694080948829652,223,36,843,656,620,620,spike|twilight sparkle,atryl
1259391.png,https://derpicdn.net/img/view/2016/9/27/1259391.png,0,0.9875646233558656,0,0,455,399,455,399,starlight glimmer|twilight sparkle,okaces
1261224.png,https://derpicdn.net/img/view/2016/9/29/1261224.png,0,0.9884134531021118,33,27,337,331,304,304,applejack|starlight glimmer|twilight sparkle,jowybean
1263312.png,https://derpicdn.net/img/view/2016/10/2/1263312.png,0,0.99934321641922,586,0,1066,443,480,443,rainbow dash|twilight sparkle,ambris|bingodingo
1263312.png,https://derpicdn.net/img/view/2016/10/2/1263312.png,1,0.9908912181854248,224,0,540,313,316,313,rainbow dash|twilight sparkle,ambris|bingodingo
1264022.png,https://derpicdn.net/img/view/2016/10/3/1264022.png,0,0.9625408053398132,542,18,1480,956,938,938,sunset shimmer|twilight sparkle,haden-2375
1264401.png,https://derpicdn.net/img/view/2016/10/3/1264401.png,0,0.9849250912666321,2866,194,4586,1914,1720,1720,starlight glimmer|twilight sparkle,shutterflyeqd
1265606.png,https://derpicdn.net/img/view/2016/10/5/1265606.png,0,0.993639886379242,559,0,1827,1211,1268,1211,rainbow dash|twilight sparkle,gamijack
1269254.png,https://derpicdn.net/img/view/2016/10/9/1269254.png,0,0.9915738105773926,507,111,897,501,390,390,applejack|fluttershy|mane six|pinkie pie|rainbow dash|rarity|starlight glimmer|sunset shimmer|twilight sparkle,mkogwheel
1269254.png,https://derpicdn.net/img/view/2016/10/9/1269254.png,1,0.9087603092193604,127,141,303,317,176,176,applejack|fluttershy|mane six|pinkie pie|rainbow dash|rarity|starlight glimmer|sunset shimmer|twilight sparkle,mkogwheel
1269728.png,https://derpicdn.net/img/view/2016/10/10/1269728.png,0,0.9985933899879456,504,0,946,402,442,402,sunset shimmer|twilight sparkle,haden-2375
1269728.png,https://derpicdn.net/img/view/2016/10/10/1269728.png,1,0.9616166353225708,157,0,661,499,504,499,sunset shimmer|twilight sparkle,haden-2375
1275460.png,https://derpicdn.net/img/view/2016/10/17/1275460.png,0,0.9416977167129515,852,89,1256,493,404,404,fluttershy|pinkie pie|princess celestia|spike|twilight sparkle,pencils
1276207.png,https://derpicdn.net/img/view/2016/10/18/1276207.png,0,0.9082272052764891,196,12,500,326,304,314,princess celestia|princess luna|twilight sparkle,coltsteelstallion
1276336.png,https://derpicdn.net/img/view/2016/10/18/1276336.png,1,0.9978687763214112,1235,1007,2000,1851,765,844,applejack|big macintosh|fluttershy|mane six|pinkie pie|rainbow dash|rarity|soarin'|trixie|twilight sparkle,saphi-boo
1276336.png,https://derpicdn.net/img/view/2016/10/18/1276336.png,2,0.9966219067573548,1300,110,1956,766,656,656,applejack|big macintosh|fluttershy|mane six|pinkie pie|rainbow dash|rarity|soarin'|trixie|twilight sparkle,saphi-boo
1276336.png,https://derpicdn.net/img/view/2016/10/18/1276336.png,3,0.9958688020706176,510,1991,1200,2681,690,690,applejack|big macintosh|fluttershy|mane six|pinkie pie|rainbow dash|rarity|soarin'|trixie|twilight sparkle,saphi-boo
1276461.png,https://derpicdn.net/img/view/2016/10/18/1276461.png,0,0.9376845359802246,347,205,1157,1015,810,810,princess celestia|twilight sparkle,verawitch
1277863.png,https://derpicdn.net/img/view/2016/10/20/1277863.png,0,0.9725517630577089,0,260,364,636,364,376,queen chrysalis|twilight sparkle,deusexequus
1277873.png,https://derpicdn.net/img/view/2016/10/20/1277873.png,0,0.9821737408638,2684,168,4800,2300,2116,2132,rainbow dash|twilight sparkle,captainpudgemuffin
1279391.png,https://derpicdn.net/img/view/2016/10/23/1279391.png,0,0.9785954356193542,159,0,791,629,632,629,princess celestia|twilight sparkle,verawitch
1281678.png,https://derpicdn.net/img/view/2016/10/26/1281678.png,0,0.9731409549713136,283,66,625,408,342,342,princess celestia|twilight sparkle,verawitch
12841.png,https://derpicdn.net/img/view/2012/6/20/12841.png,0,0.9880347251892092,1795,578,2463,1246,668,668,princess celestia|twilight sparkle,mixermike622
1284691.png,https://derpicdn.net/img/view/2016/10/30/1284691.png,0,0.9919113516807556,324,105,1382,1163,1058,1058,sunset shimmer|twilight sparkle,audrarius
1284691.png,https://derpicdn.net/img/view/2016/10/30/1284691.png,1,0.9530636072158812,1121,434,2261,1574,1140,1140,sunset shimmer|twilight sparkle,audrarius
1286372.png,https://derpicdn.net/img/view/2016/11/1/1286372.png,0,0.9772074222564696,288,260,830,802,542,542,rainbow dash|twilight sparkle,haden-2375
1286372.png,https://derpicdn.net/img/view/2016/11/1/1286372.png,1,0.969608724117279,767,108,1355,696,588,588,rainbow dash|twilight sparkle,haden-2375
1287846.png,https://derpicdn.net/img/view/2016/11/3/1287846.png,0,0.9480289220809937,1446,858,2378,1790,932,932,rarity|twilight sparkle,ogaraorcynder
1287848.png,https://derpicdn.net/img/view/2016/11/3/1287848.png,0,0.9573973417282104,0,88,462,582,462,494,queen chrysalis|twilight sparkle,vavacung
1287848.png,https://derpicdn.net/img/view/2016/11/3/1287848.png,1,0.9558990597724916,417,0,1500,1075,1083,1075,queen chrysalis|twilight sparkle,vavacung
1294840.png,https://derpicdn.net/img/view/2016/11/13/1294840.png,0,0.9853772521018982,494,58,1948,1512,1454,1454,princess celestia|twilight sparkle,akeahi|amysticalartist
1295102.png,https://derpicdn.net/img/view/2016/11/13/1295102.png,0,0.9533056616783142,297,2597,911,3211,614,614,applejack|fluttershy|mane six|pinkie pie|rainbow dash|rarity|twilight sparkle,jittery-the-dragon
1295102.png,https://derpicdn.net/img/view/2016/11/13/1295102.png,1,0.9517776370048524,1502,2879,2043,3557,541,678,applejack|fluttershy|mane six|pinkie pie|rainbow dash|rarity|twilight sparkle,jittery-the-dragon
1297579.png,https://derpicdn.net/img/view/2016/11/17/1297579.png,0,0.9773913621902466,2413,15,3643,1245,1230,1230,applejack|fluttershy|mane six|pinkie pie|rainbow dash|rarity|twilight sparkle,scarlet-spectrum
1298338.png,https://derpicdn.net/img/view/2016/11/18/1298338.png,0,0.9944558143615724,163,0,1259,981,1096,981,sunset shimmer|twilight sparkle,buttersprinkle
1299199.png,https://derpicdn.net/img/view/2016/11/19/1299199.png,0,0.9966658353805542,380,51,662,333,282,282,rarity|twilight sparkle,king-kakapo
1299200.png,https://derpicdn.net/img/view/2016/11/19/1299200.png,0,0.9984253048896792,379,49,665,335,286,286,rarity|twilight sparkle,king-kakapo
130053.jpg,https://derpicdn.net/img/view/2012/10/22/130053.jpg,1,0.9886787533760072,1172,287,1762,877,590,590,applejack|twilight sparkle,ss2sonic
1303000.png,https://derpicdn.net/img/view/2016/11/25/1303000.png,0,0.9929729104042052,304,0,670,317,366,317,fluttershy|rainbow dash|twilight sparkle,dm29
1303000.png,https://derpicdn.net/img/view/2016/11/25/1303000.png,1,0.991476833820343,531,161,899,529,368,368,fluttershy|rainbow dash|twilight sparkle,dm29
1304578.png,https://derpicdn.net/img/view/2016/11/27/1304578.png,0,0.9827365279197692,112,319,722,929,610,610,rarity|twilight sparkle,ogaraorcynder
1305133.png,https://derpicdn.net/img/view/2016/11/28/1305133.png,0,0.9960403442382812,281,136,641,496,360,360,shining armor|twilight sparkle,blackgryph0n|inuhoshi-to-darkpen
1306230.png,https://derpicdn.net/img/view/2016/11/29/1306230.png,1,0.9787209630012512,196,342,472,618,276,276,sunset shimmer|twilight sparkle,ta-na
1306687.png,https://derpicdn.net/img/view/2016/11/30/1306687.png,0,0.995685338973999,531,0,949,409,418,409,princess cadance|twilight sparkle,dm29
1306822.png,https://derpicdn.net/img/view/2016/11/30/1306822.png,0,0.9995551705360411,116,19,594,497,478,478,applejack|fluttershy|mane six|pinkie pie|rainbow dash|rarity|twilight sparkle,windymils
1308520.png,https://derpicdn.net/img/view/2016/12/2/1308520.png,1,0.9661255478858948,1167,575,1377,785,210,210,apple bloom|applejack|cutie mark crusaders|fluttershy|mane six|pinkie pie|princess cadance|princess celestia|princess luna|rainbow dash|rarity|scootaloo|spike|spitfire|starlight glimmer|sunset shimmer|sweetie belle|trixie|twilight sparkle,vanillaghosties
1308520.png,https://derpicdn.net/img/view/2016/12/2/1308520.png,2,0.9633612632751464,648,10,938,300,290,290,apple bloom|applejack|cutie mark crusaders|fluttershy|mane six|pinkie pie|princess cadance|princess celestia|princess luna|rainbow dash|rarity|scootaloo|spike|spitfire|starlight glimmer|sunset shimmer|sweetie belle|trixie|twilight sparkle,vanillaghosties
1309331.png,https://derpicdn.net/img/view/2016/12/3/1309331.png,0,0.9684182405471802,452,239,676,463,224,224,applejack|twilight sparkle,jowybean
1310.jpg,https://derpicdn.net/img/view/2012/1/22/1310.jpg,1,0.9755759835243224,2626,1196,3000,1576,374,380,apple bloom|applejack|big macintosh|braeburn|cutie mark crusaders|diamond tiara|fluttershy|mane six|pinkie pie|princess celestia|princess luna|rainbow dash|rarity|scootaloo|silver spoon|spike|sweetie belle|trixie|twilight sparkle,johnjoseco
1312315.png,https://derpicdn.net/img/view/2016/12/8/1312315.png,0,0.9821273684501648,1383,584,2369,1570,986,986,rainbow dash|twilight sparkle,shutterflyeqd
1313328.png,https://derpicdn.net/img/view/2016/12/9/1313328.png,0,0.9966224431991576,541,21,879,359,338,338,princess cadance|shining armor|twilight sparkle,dm29
1314615.png,https://derpicdn.net/img/view/2016/12/11/1314615.png,0,0.9297583699226379,282,0,1066,777,784,777,spike|twilight sparkle,buttersprinkle
1318497.png,https://derpicdn.net/img/view/2016/12/16/1318497.png,0,0.9164124727249146,240,288,1376,1424,1136,1136,fluttershy|rarity|twilight sparkle,marauder6272|blues64
1322051.png,https://derpicdn.net/img/view/2016/12/21/1322051.png,0,0.9890109300613404,0,0,644,616,644,616,trixie|twilight sparkle,pshyzomancer
1323124.png,https://derpicdn.net/img/view/2016/12/23/1323124.png,0,0.9866177439689636,0,14,541,608,541,594,fluttershy|rainbow dash|rarity|spike|sweetie belle|trixie|twilight sparkle,indigosfmworks
1324642.png,https://derpicdn.net/img/view/2016/12/25/1324642.png,0,0.9849125742912292,2,17,270,285,268,268,applejack|fluttershy|mane six|pinkie pie|princess cadance|princess flurry heart|rainbow dash|rarity|shining armor|spike|starlight glimmer|twilight sparkle,dm29
1325943.png,https://derpicdn.net/img/view/2016/12/26/1325943.png,0,0.990924835205078,611,254,837,480,226,226,applejack|fluttershy|mane six|pinkie pie|rainbow dash|rarity|twilight sparkle,sugarberry
1326707.png,https://derpicdn.net/img/view/2016/12/28/1326707.png,0,0.9969111680984496,744,50,2300,1624,1556,1574,rainbow dash|twilight sparkle,dbleki
1326707.png,https://derpicdn.net/img/view/2016/12/28/1326707.png,1,0.9395822286605836,0,0,1744,1760,1744,1760,rainbow dash|twilight sparkle,dbleki
1326904.png,https://derpicdn.net/img/view/2016/12/28/1326904.png,0,0.9965139627456664,2691,0,4351,1556,1660,1556,sunset shimmer|twilight sparkle,novabytes
1327224.png,https://derpicdn.net/img/view/2016/12/28/1327224.png,0,0.998651385307312,254,203,650,599,396,396,sunset shimmer|twilight sparkle,novabytes
1327906.png,https://derpicdn.net/img/view/2016/12/29/1327906.png,0,0.990732729434967,185,0,671,451,486,451,princess celestia|twilight sparkle,mp-printer
1328891.png,https://derpicdn.net/img/view/2016/12/31/1328891.png,0,0.9989346861839294,0,523,436,967,436,444,apple bloom|applejack|cutie mark crusaders|fluttershy|mane six|pinkie pie|rainbow dash|rarity|scootaloo|spike|starlight glimmer|sweetie belle|trixie|twilight sparkle,windymils
1328891.png,https://derpicdn.net/img/view/2016/12/31/1328891.png,1,0.9958369135856628,2180,323,2568,749,388,426,apple bloom|applejack|cutie mark crusaders|fluttershy|mane six|pinkie pie|rainbow dash|rarity|scootaloo|spike|starlight glimmer|sweetie belle|trixie|twilight sparkle,windymils
1328891.png,https://derpicdn.net/img/view/2016/12/31/1328891.png,2,0.9904276132583618,575,535,1229,1189,654,654,apple bloom|applejack|cutie mark crusaders|fluttershy|mane six|pinkie pie|rainbow dash|rarity|scootaloo|spike|starlight glimmer|sweetie belle|trixie|twilight sparkle,windymils
1328891.png,https://derpicdn.net/img/view/2016/12/31/1328891.png,3,0.9842516183853148,1534,887,2086,1439,552,552,apple bloom|applejack|cutie mark crusaders|fluttershy|mane six|pinkie pie|rainbow dash|rarity|scootaloo|spike|starlight glimmer|sweetie belle|trixie|twilight sparkle,windymils
1328891.png,https://derpicdn.net/img/view/2016/12/31/1328891.png,4,0.9837225675582886,1082,388,1940,1246,858,858,apple bloom|applejack|cutie mark crusaders|fluttershy|mane six|pinkie pie|rainbow dash|rarity|scootaloo|spike|starlight glimmer|sweetie belle|trixie|twilight sparkle,windymils
1329464.png,https://derpicdn.net/img/view/2017/1/1/1329464.png,0,0.999192237854004,951,99,1763,911,812,812,rainbow dash|twilight sparkle,aurelleah
13323.jpg,https://derpicdn.net/img/view/2012/6/21/13323.jpg,0,0.9984116554260254,385,71,731,417,346,346,applejack|fluttershy|pinkie pie|princess celestia|princess luna|rainbow dash|rarity|twilight sparkle,madmax
13323.jpg,https://derpicdn.net/img/view/2012/6/21/13323.jpg,2,0.9832440018653872,384,533,622,771,238,238,applejack|fluttershy|pinkie pie|princess celestia|princess luna|rainbow dash|rarity|twilight sparkle,madmax
13323.jpg,https://derpicdn.net/img/view/2012/6/21/13323.jpg,4,0.9761752486228944,966,509,1246,789,280,280,applejack|fluttershy|pinkie pie|princess celestia|princess luna|rainbow dash|rarity|twilight sparkle,madmax
13323.jpg,https://derpicdn.net/img/view/2012/6/21/13323.jpg,5,0.9498669505119324,1083,272,1489,678,406,406,applejack|fluttershy|pinkie pie|princess celestia|princess luna|rainbow dash|rarity|twilight sparkle,madmax
1333412.png,https://derpicdn.net/img/view/2017/1/6/1333412.png,0,0.9779868125915528,24,389,472,837,448,448,spike|twilight sparkle,bobdude0
1333412.png,https://derpicdn.net/img/view/2017/1/6/1333412.png,1,0.9202495813369752,394,658,676,940,282,282,spike|twilight sparkle,bobdude0
1335302.png,https://derpicdn.net/img/view/2017/1/9/1335302.png,0,0.96687650680542,132,115,656,639,524,524,sunset shimmer|twilight sparkle,buttersprinkle
1335557.png,https://derpicdn.net/img/view/2017/1/9/1335557.png,1,0.9334408640861512,3721,186,4915,1380,1194,1194,applejack|fluttershy|mane six|pinkie pie|princess celestia|princess luna|rainbow dash|rarity|twilight sparkle,tomfraggle
1336390.png,https://derpicdn.net/img/view/2017/1/10/1336390.png,0,0.9376384019851683,125,5,999,750,874,745,pinkie pie|twilight sparkle,dm29
1338374.png,https://derpicdn.net/img/view/2017/1/13/1338374.png,2,0.9324215054512024,444,150,966,672,522,522,princess celestia|princess luna|sunset shimmer|twilight sparkle,raptor007
1338902.png,https://derpicdn.net/img/view/2017/1/14/1338902.png,0,0.990401327610016,1958,556,2554,1152,596,596,starlight glimmer|trixie|twilight sparkle,shutterflyeqd
1338902.png,https://derpicdn.net/img/view/2017/1/14/1338902.png,1,0.9761452078819276,2373,589,2949,1165,576,576,starlight glimmer|trixie|twilight sparkle,shutterflyeqd
1339363.png,https://derpicdn.net/img/view/2017/1/14/1339363.png,0,0.9941025376319884,767,368,1017,618,250,250,applejack|discord|fluttershy|mane six|pinkie pie|princess celestia|rainbow dash|rarity|twilight sparkle,stepandy
1339363.png,https://derpicdn.net/img/view/2017/1/14/1339363.png,2,0.9811809062957764,110,412,434,736,324,324,applejack|discord|fluttershy|mane six|pinkie pie|princess celestia|rainbow dash|rarity|twilight sparkle,stepandy
1339363.png,https://derpicdn.net/img/view/2017/1/14/1339363.png,3,0.97962486743927,101,748,395,1042,294,294,applejack|discord|fluttershy|mane six|pinkie pie|princess celestia|rainbow dash|rarity|twilight sparkle,stepandy
1339363.png,https://derpicdn.net/img/view/2017/1/14/1339363.png,4,0.9261967539787292,311,247,775,711,464,464,applejack|discord|fluttershy|mane six|pinkie pie|princess celestia|rainbow dash|rarity|twilight sparkle,stepandy
1340613.png,https://derpicdn.net/img/view/2017/1/16/1340613.png,0,0.9871697425842284,1902,367,3112,1577,1210,1210,applejack|fluttershy|mane six|pinkie pie|rainbow dash|rarity|spitfire|twilight sparkle,nightmaremoons
1340613.png,https://derpicdn.net/img/view/2017/1/16/1340613.png,1,0.98645681142807,3213,832,3893,1512,680,680,applejack|fluttershy|mane six|pinkie pie|rainbow dash|rarity|spitfire|twilight sparkle,nightmaremoons
1340613.png,https://derpicdn.net/img/view/2017/1/16/1340613.png,2,0.9779257774353028,842,73,1480,711,638,638,applejack|fluttershy|mane six|pinkie pie|rainbow dash|rarity|spitfire|twilight sparkle,nightmaremoons
1342335.png,https://derpicdn.net/img/view/2017/1/18/1342335.png,0,0.9460461735725404,27,0,493,361,466,361,rainbow dash|twilight sparkle,soccy|caboni32
1342469.png,https://derpicdn.net/img/view/2017/1/19/1342469.png,0,0.9787701964378356,1336,385,1764,813,428,428,spike|twilight sparkle,anontheanon
1342581.png,https://derpicdn.net/img/view/2017/1/19/1342581.png,0,0.9878059029579164,619,537,2217,2135,1598,1598,princess celestia|twilight sparkle,nadnerbd
1345152.png,https://derpicdn.net/img/view/2017/1/22/1345152.png,0,0.9904211163520812,249,0,769,482,520,482,princess celestia|twilight sparkle,whatsapokemon
1345152.png,https://derpicdn.net/img/view/2017/1/22/1345152.png,1,0.9736025929450988,401,274,745,618,344,344,princess celestia|twilight sparkle,whatsapokemon
1348185.png,https://derpicdn.net/img/view/2017/1/26/1348185.png,0,0.9882230162620544,630,12,1054,436,424,424,princess cadance|shining armor|twilight sparkle,dm29
1348846.png,https://derpicdn.net/img/view/2017/1/27/1348846.png,0,0.9708389043807985,589,0,1200,534,611,534,rainbow dash|twilight sparkle,1trick
1349095.png,https://derpicdn.net/img/view/2017/1/27/1349095.png,0,0.9593960046768188,610,703,2262,2355,1652,1652,starlight glimmer|sunset shimmer|trixie|twilight sparkle,limedazzle
1352189.png,https://derpicdn.net/img/view/2017/1/31/1352189.png,0,0.9699831008911132,0,0,982,831,982,831,princess celestia|twilight sparkle,fluffyxai
1356357.png,https://derpicdn.net/img/view/2017/2/6/1356357.png,0,0.9491651654243468,708,322,1042,656,334,334,princess cadance|shining armor|spike|twilight sparkle,dm29
1356449.png,https://derpicdn.net/img/view/2017/2/6/1356449.png,0,0.9987278580665588,862,68,1554,760,692,692,rarity|twilight sparkle,cabrony|danmakuman
1356839.png,https://derpicdn.net/img/view/2017/2/6/1356839.png,0,0.9975067973136902,341,50,813,522,472,472,spike|twilight sparkle,jimjamdoodles
1358698.png,https://derpicdn.net/img/view/2017/2/9/1358698.png,0,0.9939022064208984,0,4,267,294,267,290,applejack|fluttershy|mane six|pinkie pie|rainbow dash|rarity|twilight sparkle,arcadianphoenix
1358698.png,https://derpicdn.net/img/view/2017/2/9/1358698.png,1,0.9921194314956664,334,0,600,304,266,304,applejack|fluttershy|mane six|pinkie pie|rainbow dash|rarity|twilight sparkle,arcadianphoenix
1359014.png,https://derpicdn.net/img/view/2017/2/9/1359014.png,0,0.997714340686798,430,0,752,321,322,321,princess cadance|princess celestia|princess luna|twilight sparkle,rodrigues404
1359014.png,https://derpicdn.net/img/view/2017/2/9/1359014.png,1,0.9928963780403136,37,106,501,570,464,464,princess cadance|princess celestia|princess luna|twilight sparkle,rodrigues404
1359014.png,https://derpicdn.net/img/view/2017/2/9/1359014.png,2,0.9900024533271792,622,19,1098,495,476,476,princess cadance|princess celestia|princess luna|twilight sparkle,rodrigues404
1359995.png,https://derpicdn.net/img/view/2017/2/11/1359995.png,0,0.99954754114151,671,98,1489,916,818,818,pinkie pie|rainbow dash|trixie|twilight sparkle,senseidezzy
1359995.png,https://derpicdn.net/img/view/2017/2/11/1359995.png,1,0.9910041093826294,1526,11,2728,1213,1202,1202,pinkie pie|rainbow dash|trixie|twilight sparkle,senseidezzy
1361445.png,https://derpicdn.net/img/view/2017/2/13/1361445.png,0,0.9868355393409728,2114,1604,3616,3106,1502,1502,princess celestia|princess luna|twilight sparkle,amarynceus
1362280.png,https://derpicdn.net/img/view/2017/2/14/1362280.png,0,0.9991053938865662,55,383,381,709,326,326,princess cadance|princess celestia|princess luna|twilight sparkle,anticular
1362280.png,https://derpicdn.net/img/view/2017/2/14/1362280.png,1,0.9960204362869264,304,317,668,681,364,364,princess cadance|princess celestia|princess luna|twilight sparkle,anticular
1363507.png,https://derpicdn.net/img/view/2017/2/15/1363507.png,0,0.9157029390335084,0,733,527,1429,527,696,pinkie pie|twilight sparkle,vdru7
1364905.png,https://derpicdn.net/img/view/2017/2/16/1364905.png,0,0.9886072278022766,1172,140,1698,666,526,526,princess luna|twilight sparkle,silfoe|transgressors-reworks
136636.jpg,https://derpicdn.net/img/view/2012/10/30/136636.jpg,0,0.9955843687057496,1985,0,2849,717,864,717,applejack|fluttershy|mane six|pinkie pie|rainbow dash|rarity|twilight sparkle,jadenkaiba
136636.jpg,https://derpicdn.net/img/view/2012/10/30/136636.jpg,2,0.994426727294922,1312,0,2066,703,754,703,applejack|fluttershy|mane six|pinkie pie|rainbow dash|rarity|twilight sparkle,jadenkaiba
136636.jpg,https://derpicdn.net/img/view/2012/10/30/136636.jpg,3,0.9781365990638732,1369,1228,1989,1848,620,620,applejack|fluttershy|mane six|pinkie pie|rainbow dash|rarity|twilight sparkle,jadenkaiba
136636.jpg,https://derpicdn.net/img/view/2012/10/30/136636.jpg,5,0.939224123954773,1955,1221,2805,2071,850,850,applejack|fluttershy|mane six|pinkie pie|rainbow dash|rarity|twilight sparkle,jadenkaiba
1366362.png,https://derpicdn.net/img/view/2017/2/18/1366362.png,0,0.9973967671394348,173,0,673,430,500,430,princess luna|sweetie belle|twilight sparkle,bobdude0|silfoe
1366362.png,https://derpicdn.net/img/view/2017/2/18/1366362.png,1,0.996707320213318,709,71,1123,485,414,414,princess luna|sweetie belle|twilight sparkle,bobdude0|silfoe
1368461.png,https://derpicdn.net/img/view/2017/2/20/1368461.png,0,0.9892935156822203,340,257,766,683,426,426,princess cadance|princess celestia|princess flurry heart|princess luna|twilight sparkle,wynnchi
1368461.png,https://derpicdn.net/img/view/2017/2/20/1368461.png,1,0.9677785634994508,1064,237,1572,745,508,508,princess cadance|princess celestia|princess flurry heart|princess luna|twilight sparkle,wynnchi
1370906.png,https://derpicdn.net/img/view/2017/2/23/1370906.png,0,0.9425435662269592,454,193,1016,755,562,562,sunset shimmer|twilight sparkle,sion-ara
137264.png,https://derpicdn.net/img/view/2012/10/30/137264.png,0,0.980533003807068,488,507,766,785,278,278,apple bloom|applejack|cutie mark crusaders|fluttershy|mane six|pinkie pie|rainbow dash|rarity|scootaloo|sweetie belle|twilight sparkle,atryl
137264.png,https://derpicdn.net/img/view/2012/10/30/137264.png,1,0.9487907886505128,623,653,989,1019,366,366,apple bloom|applejack|cutie mark crusaders|fluttershy|mane six|pinkie pie|rainbow dash|rarity|scootaloo|sweetie belle|twilight sparkle,atryl
137264.png,https://derpicdn.net/img/view/2012/10/30/137264.png,2,0.9314044713974,455,839,691,1075,236,236,apple bloom|applejack|cutie mark crusaders|fluttershy|mane six|pinkie pie|rainbow dash|rarity|scootaloo|sweetie belle|twilight sparkle,atryl
1373961.png,https://derpicdn.net/img/view/2017/2/26/1373961.png,0,0.9936851859092712,206,0,748,488,542,488,starlight glimmer|sunset shimmer|twilight sparkle,majkashinoda626
1375951.png,https://derpicdn.net/img/view/2017/2/28/1375951.png,0,0.999444842338562,1270,0,1984,644,714,644,applejack|fluttershy|mane six|pinkie pie|rainbow dash|rarity|spike|twilight sparkle,alasou
1375951.png,https://derpicdn.net/img/view/2017/2/28/1375951.png,1,0.9989880919456482,26,615,708,1297,682,682,applejack|fluttershy|mane six|pinkie pie|rainbow dash|rarity|spike|twilight sparkle,alasou
1375951.png,https://derpicdn.net/img/view/2017/2/28/1375951.png,2,0.998943567276001,1294,722,1946,1374,652,652,applejack|fluttershy|mane six|pinkie pie|rainbow dash|rarity|spike|twilight sparkle,alasou
1375951.png,https://derpicdn.net/img/view/2017/2/28/1375951.png,3,0.9979094862937928,654,603,1362,1311,708,708,applejack|fluttershy|mane six|pinkie pie|rainbow dash|rarity|spike|twilight sparkle,alasou
1375951.png,https://derpicdn.net/img/view/2017/2/28/1375951.png,4,0.9933045506477356,663,0,1297,616,634,616,applejack|fluttershy|mane six|pinkie pie|rainbow dash|rarity|spike|twilight sparkle,alasou
1375955.png,https://derpicdn.net/img/view/2017/2/28/1375955.png,0,0.9974055886268616,121,682,623,1184,502,502,applejack|fluttershy|mane six|pinkie pie|rainbow dash|rarity|twilight sparkle,alasou
1375955.png,https://derpicdn.net/img/view/2017/2/28/1375955.png,1,0.9950652718544006,1455,791,1881,1217,426,426,applejack|fluttershy|mane six|pinkie pie|rainbow dash|rarity|twilight sparkle,alasou
1375955.png,https://derpicdn.net/img/view/2017/2/28/1375955.png,2,0.9509269595146179,78,163,422,507,344,344,applejack|fluttershy|mane six|pinkie pie|rainbow dash|rarity|twilight sparkle,alasou
1375956.png,https://derpicdn.net/img/view/2017/2/28/1375956.png,1,0.9967263340950012,692,654,1168,1130,476,476,applejack|fluttershy|mane six|pinkie pie|rainbow dash|rarity|twilight sparkle,alasou
1375956.png,https://derpicdn.net/img/view/2017/2/28/1375956.png,2,0.9905393123626708,1395,656,1877,1138,482,482,applejack|fluttershy|mane six|pinkie pie|rainbow dash|rarity|twilight sparkle,alasou
1375956.png,https://derpicdn.net/img/view/2017/2/28/1375956.png,3,0.9900458455085754,90,700,636,1246,546,546,applejack|fluttershy|mane six|pinkie pie|rainbow dash|rarity|twilight sparkle,alasou
1375956.png,https://derpicdn.net/img/view/2017/2/28/1375956.png,4,0.958522617816925,1302,0,1874,493,572,493,applejack|fluttershy|mane six|pinkie pie|rainbow dash|rarity|twilight sparkle,alasou
1375956.png,https://derpicdn.net/img/view/2017/2/28/1375956.png,5,0.9525815844535828,736,4,1176,444,440,440,applejack|fluttershy|mane six|pinkie pie|rainbow dash|rarity|twilight sparkle,alasou
1375958.png,https://derpicdn.net/img/view/2017/2/28/1375958.png,2,0.995829164981842,682,18,1126,462,444,444,applejack|fluttershy|mane six|pinkie pie|rainbow dash|rarity|twilight sparkle,alasou
1375958.png,https://derpicdn.net/img/view/2017/2/28/1375958.png,3,0.994996190071106,1435,706,1967,1238,532,532,applejack|fluttershy|mane six|pinkie pie|rainbow dash|rarity|twilight sparkle,alasou
1375958.png,https://derpicdn.net/img/view/2017/2/28/1375958.png,5,0.9749277234077454,157,702,591,1136,434,434,applejack|fluttershy|mane six|pinkie pie|rainbow dash|rarity|twilight sparkle,alasou
1376658.png,https://derpicdn.net/img/view/2017/3/1/1376658.png,0,0.9958996176719666,86,693,492,1099,406,406,applejack|fluttershy|mane six|pinkie pie|rainbow dash|rarity|twilight sparkle,alasou
1376658.png,https://derpicdn.net/img/view/2017/3/1/1376658.png,3,0.9532150030136108,145,0,457,281,312,281,applejack|fluttershy|mane six|pinkie pie|rainbow dash|rarity|twilight sparkle,alasou
1376664.png,https://derpicdn.net/img/view/2017/3/1/1376664.png,2,0.964366853237152,1402,877,1694,1169,292,292,applejack|fluttershy|mane six|pinkie pie|rainbow dash|rarity|twilight sparkle,alasou
1376664.png,https://derpicdn.net/img/view/2017/3/1/1376664.png,3,0.9562830924987792,889,776,1159,1046,270,270,applejack|fluttershy|mane six|pinkie pie|rainbow dash|rarity|twilight sparkle,alasou
1376664.png,https://derpicdn.net/img/view/2017/3/1/1376664.png,4,0.9182078242301941,1296,35,1636,375,340,340,applejack|fluttershy|mane six|pinkie pie|rainbow dash|rarity|twilight sparkle,alasou
1376664.png,https://derpicdn.net/img/view/2017/3/1/1376664.png,5,0.9008834362030028,832,0,1184,351,352,351,applejack|fluttershy|mane six|pinkie pie|rainbow dash|rarity|twilight sparkle,alasou
1376667.png,https://derpicdn.net/img/view/2017/3/1/1376667.png,1,0.956659197807312,332,0,630,270,298,270,applejack|fluttershy|mane six|pinkie pie|rainbow dash|rarity|spike|twilight sparkle,alasou
1376667.png,https://derpicdn.net/img/view/2017/3/1/1376667.png,2,0.9218271374702454,835,674,1139,978,304,304,applejack|fluttershy|mane six|pinkie pie|rainbow dash|rarity|spike|twilight sparkle,alasou
1376674.png,https://derpicdn.net/img/view/2017/3/1/1376674.png,0,0.9897925853729248,818,675,1190,1047,372,372,applejack|fluttershy|mane six|pinkie pie|rainbow dash|rarity|spike|twilight sparkle,alasou
1376674.png,https://derpicdn.net/img/view/2017/3/1/1376674.png,2,0.9639180898666382,178,0,528,343,350,343,applejack|fluttershy|mane six|pinkie pie|rainbow dash|rarity|spike|twilight sparkle,alasou
1376674.png,https://derpicdn.net/img/view/2017/3/1/1376674.png,3,0.943203330039978,1429,0,1793,354,364,354,applejack|fluttershy|mane six|pinkie pie|rainbow dash|rarity|spike|twilight sparkle,alasou
1376674.png,https://derpicdn.net/img/view/2017/3/1/1376674.png,4,0.9381863474845886,115,625,581,1091,466,466,applejack|fluttershy|mane six|pinkie pie|rainbow dash|rarity|spike|twilight sparkle,alasou
1376679.png,https://derpicdn.net/img/view/2017/3/1/1376679.png,3,0.9964815378189088,1344,662,1834,1152,490,490,applejack|fluttershy|mane six|pinkie pie|rainbow dash|rarity|twilight sparkle,alasou
1376679.png,https://derpicdn.net/img/view/2017/3/1/1376679.png,5,0.9697588682174684,776,0,1230,434,454,434,applejack|fluttershy|mane six|pinkie pie|rainbow dash|rarity|twilight sparkle,alasou
1377793.png,https://derpicdn.net/img/view/2017/3/2/1377793.png,0,0.996738851070404,768,1015,2600,3225,1832,2210,rainbow dash|twilight sparkle,cutepencilcase|fluffyxai
1378348.png,https://derpicdn.net/img/view/2017/3/3/1378348.png,1,0.9804420471191406,166,684,556,1074,390,390,applejack|fluttershy|mane six|pinkie pie|rainbow dash|rarity|spike|twilight sparkle,alasou
1378348.png,https://derpicdn.net/img/view/2017/3/3/1378348.png,2,0.9706500172615052,817,673,1203,1059,386,386,applejack|fluttershy|mane six|pinkie pie|rainbow dash|rarity|spike|twilight sparkle,alasou
1378348.png,https://derpicdn.net/img/view/2017/3/3/1378348.png,3,0.9609769582748412,808,0,1198,354,390,354,applejack|fluttershy|mane six|pinkie pie|rainbow dash|rarity|spike|twilight sparkle,alasou
1378349.png,https://derpicdn.net/img/view/2017/3/3/1378349.png,0,0.9979774951934814,1491,657,1899,1065,408,408,applejack|fluttershy|mane six|pinkie pie|rainbow dash|rarity|scootaloo|twilight sparkle,alasou
1378349.png,https://derpicdn.net/img/view/2017/3/3/1378349.png,1,0.9961482882499696,815,844,1127,1156,312,312,applejack|fluttershy|mane six|pinkie pie|rainbow dash|rarity|scootaloo|twilight sparkle,alasou
1378349.png,https://derpicdn.net/img/view/2017/3/3/1378349.png,4,0.9402586221694946,207,671,521,985,314,314,applejack|fluttershy|mane six|pinkie pie|rainbow dash|rarity|scootaloo|twilight sparkle,alasou
1378351.png,https://derpicdn.net/img/view/2017/3/3/1378351.png,1,0.9959385991096495,43,0,619,510,576,510,applejack|fluttershy|mane six|pinkie pie|rainbow dash|rarity|twilight sparkle,alasou
1378351.png,https://derpicdn.net/img/view/2017/3/3/1378351.png,2,0.9946136474609376,32,608,594,1170,562,562,applejack|fluttershy|mane six|pinkie pie|rainbow dash|rarity|twilight sparkle,alasou
1378351.png,https://derpicdn.net/img/view/2017/3/3/1378351.png,3,0.9943614602088928,887,713,1323,1149,436,436,applejack|fluttershy|mane six|pinkie pie|rainbow dash|rarity|twilight sparkle,alasou
1378351.png,https://derpicdn.net/img/view/2017/3/3/1378351.png,4,0.9126008152961732,713,174,1027,488,314,314,applejack|fluttershy|mane six|pinkie pie|rainbow dash|rarity|twilight sparkle,alasou
1378353.png,https://derpicdn.net/img/view/2017/3/3/1378353.png,0,0.9936543107032776,219,665,641,1087,422,422,applejack|fluttershy|mane six|pinkie pie|rainbow dash|rarity|twilight sparkle,alasou
1378353.png,https://derpicdn.net/img/view/2017/3/3/1378353.png,1,0.9860650300979614,835,736,1231,1132,396,396,applejack|fluttershy|mane six|pinkie pie|rainbow dash|rarity|twilight sparkle,alasou
1378353.png,https://derpicdn.net/img/view/2017/3/3/1378353.png,3,0.9810094833374025,202,6,594,398,392,392,applejack|fluttershy|mane six|pinkie pie|rainbow dash|rarity|twilight sparkle,alasou
1378353.png,https://derpicdn.net/img/view/2017/3/3/1378353.png,4,0.9686104655265808,1465,665,1763,963,298,298,applejack|fluttershy|mane six|pinkie pie|rainbow dash|rarity|twilight sparkle,alasou
1378353.png,https://derpicdn.net/img/view/2017/3/3/1378353.png,5,0.9627258777618408,863,0,1295,410,432,410,applejack|fluttershy|mane six|pinkie pie|rainbow dash|rarity|twilight sparkle,alasou
1379249.png,https://derpicdn.net/img/view/2017/3/4/1379249.png,0,0.9465847015380859,1850,832,2132,1114,282,282,applejack|fluttershy|mane six|pinkie pie|rainbow dash|rarity|spike|twilight sparkle,viwrastupr
1381249.png,https://derpicdn.net/img/view/2017/3/7/1381249.png,0,0.9805448651313782,72,0,670,621,598,621,starlight glimmer|twilight sparkle,maren
1385504.png,https://derpicdn.net/img/view/2017/3/12/1385504.png,0,0.9599837064743042,1567,0,2253,666,686,666,applejack|fluttershy|mane six|pinkie pie|princess cadance|princess celestia|princess luna|rainbow dash|rarity|spike|twilight sparkle,valcron
1385651.png,https://derpicdn.net/img/view/2017/3/12/1385651.png,0,0.9957590103149414,642,0,1254,581,612,581,rarity|twilight sparkle,zoarity
1386194.png,https://derpicdn.net/img/view/2017/3/13/1386194.png,1,0.9198554754257202,929,53,1567,691,638,638,applejack|fluttershy|mane six|pinkie pie|rainbow dash|rarity|spike|twilight sparkle,valcron
1389030.png,https://derpicdn.net/img/view/2017/3/17/1389030.png,0,0.9705451726913452,1529,0,2785,982,1256,982,princess celestia|twilight sparkle,noben
1391101.png,https://derpicdn.net/img/view/2017/3/19/1391101.png,0,0.9922739863395692,1572,0,2698,999,1126,999,starlight glimmer|twilight sparkle,raps|cabrony
1392596.png,https://derpicdn.net/img/view/2017/3/20/1392596.png,0,0.9968402981758118,1776,917,2280,1421,504,504,spike|twilight sparkle,otakuap
1396028.png,https://derpicdn.net/img/view/2017/3/25/1396028.png,0,0.9386774897575378,74,173,448,547,374,374,princess celestia|twilight sparkle,gashi-gashi
1400280.png,https://derpicdn.net/img/view/2017/3/31/1400280.png,0,0.9966119527816772,0,0,893,958,893,958,spike|twilight sparkle,badumsquish
1400439.png,https://derpicdn.net/img/view/2017/3/31/1400439.png,0,0.9977424740791321,128,48,670,590,542,542,fluttershy|twilight sparkle,howxu
1403059.png,https://derpicdn.net/img/view/2017/4/3/1403059.png,0,0.9669868350028992,791,206,1247,662,456,456,princess luna|sunset shimmer|twilight sparkle,little-tweenframes|silfoe
1405726.png,https://derpicdn.net/img/view/2017/4/6/1405726.png,0,0.9989379644393921,2,279,226,503,224,224,applejack|fluttershy|mane six|pinkie pie|rainbow dash|rarity|twilight sparkle,pettankochanv
1405726.png,https://derpicdn.net/img/view/2017/4/6/1405726.png,1,0.99776029586792,424,298,614,488,190,190,applejack|fluttershy|mane six|pinkie pie|rainbow dash|rarity|twilight sparkle,pettankochanv
1405726.png,https://derpicdn.net/img/view/2017/4/6/1405726.png,2,0.9974771738052368,0,0,224,213,224,213,applejack|fluttershy|mane six|pinkie pie|rainbow dash|rarity|twilight sparkle,pettankochanv
1406902.png,https://derpicdn.net/img/view/2017/4/8/1406902.png,0,0.993320643901825,804,151,1130,477,326,326,princess luna|twilight sparkle,silfoe|jase1505
1406902.png,https://derpicdn.net/img/view/2017/4/8/1406902.png,1,0.9679834842681884,0,51,594,673,594,622,princess luna|twilight sparkle,silfoe|jase1505
1409252.png,https://derpicdn.net/img/view/2017/4/11/1409252.png,0,0.9996681213378906,984,315,1358,689,374,374,applejack|big macintosh|twilight sparkle,alasou
1409252.png,https://derpicdn.net/img/view/2017/4/11/1409252.png,2,0.9911730289459229,676,333,1076,733,400,400,applejack|big macintosh|twilight sparkle,alasou
1411722.png,https://derpicdn.net/img/view/2017/4/15/1411722.png,0,0.9911327958106996,211,316,713,818,502,502,applejack|fluttershy|mane six|pinkie pie|rainbow dash|rarity|twilight sparkle,
1411722.png,https://derpicdn.net/img/view/2017/4/15/1411722.png,1,0.990697979927063,793,134,1173,514,380,380,applejack|fluttershy|mane six|pinkie pie|rainbow dash|rarity|twilight sparkle,
1415251.png,https://derpicdn.net/img/view/2017/4/18/1415251.png,0,0.9797990918159484,1230,135,1740,645,510,510,starlight glimmer|trixie|twilight sparkle,lance
1417394.png,https://derpicdn.net/img/view/2017/4/21/1417394.png,0,0.9978737235069276,267,0,1281,992,1014,992,trixie|twilight sparkle,captainpudgemuffin
1418065.png,https://derpicdn.net/img/view/2017/4/22/1418065.png,0,0.9964993596076964,740,93,1248,601,508,508,applejack|fluttershy|mane six|pinkie pie|rainbow dash|rarity|spike|twilight sparkle,joy-ang
1418065.png,https://derpicdn.net/img/view/2017/4/22/1418065.png,1,0.9388933181762696,150,649,552,1051,402,402,applejack|fluttershy|mane six|pinkie pie|rainbow dash|rarity|spike|twilight sparkle,joy-ang
1418225.png,https://derpicdn.net/img/view/2017/4/22/1418225.png,0,0.9980443716049194,271,26,615,370,344,344,princess celestia|spike|starlight glimmer|twilight sparkle,assasinmonkey
1418225.png,https://derpicdn.net/img/view/2017/4/22/1418225.png,1,0.9938889741897584,641,594,965,918,324,324,princess celestia|spike|starlight glimmer|twilight sparkle,assasinmonkey
1418225.png,https://derpicdn.net/img/view/2017/4/22/1418225.png,2,0.9937707781791688,186,837,584,1235,398,398,princess celestia|spike|starlight glimmer|twilight sparkle,assasinmonkey
1422009.png,https://derpicdn.net/img/view/2017/4/26/1422009.png,0,0.9085642099380492,582,74,1072,564,490,490,discord|twilight sparkle,lopoddity
142222.png,https://derpicdn.net/img/view/2012/11/4/142222.png,0,0.9704988598823548,1208,471,2548,1811,1340,1340,princess celestia|twilight sparkle,illuminatiums
1423377.png,https://derpicdn.net/img/view/2017/4/28/1423377.png,0,0.9889070987701416,1883,584,3000,1800,1117,1216,queen chrysalis|twilight sparkle,mlpshipper24
1424268.png,https://derpicdn.net/img/view/2017/4/29/1424268.png,0,0.978550374507904,2100,223,3888,2011,1788,1788,trixie|twilight sparkle,t.f.a.n.c.s.
1425358.png,https://derpicdn.net/img/view/2017/4/30/1425358.png,0,0.9541146159172058,70,528,350,808,280,280,apple bloom|fluttershy|pinkie pie|princess flurry heart|princess luna|rarity|sweetie belle|twilight sparkle,bobdude0
1426241.png,https://derpicdn.net/img/view/2017/5/1/1426241.png,0,0.9972188472747804,1954,768,2958,1772,1004,1004,princess celestia|spike|twilight sparkle,rossignolet
1429245.png,https://derpicdn.net/img/view/2017/5/5/1429245.png,0,0.9812994599342346,313,0,1223,803,910,803,princess luna|twilight sparkle,amarynceus
1432243.png,https://derpicdn.net/img/view/2017/5/9/1432243.png,0,0.9910297989845276,73,22,497,446,424,424,princess celestia|twilight sparkle,caroo
1432785.png,https://derpicdn.net/img/view/2017/5/9/1432785.png,0,0.9994081258773804,643,120,1045,522,402,402,rainbow dash|twilight sparkle,tsitra360
1432785.png,https://derpicdn.net/img/view/2017/5/9/1432785.png,1,0.9906766414642334,14,279,654,919,640,640,rainbow dash|twilight sparkle,tsitra360
1434330.png,https://derpicdn.net/img/view/2017/5/11/1434330.png,0,0.9965939521789552,541,711,779,949,238,238,applejack|fluttershy|mane six|pinkie pie|rainbow dash|rarity|twilight sparkle,succubi samus
1434330.png,https://derpicdn.net/img/view/2017/5/11/1434330.png,1,0.9930289387702942,273,750,545,1022,272,272,applejack|fluttershy|mane six|pinkie pie|rainbow dash|rarity|twilight sparkle,succubi samus
1434330.png,https://derpicdn.net/img/view/2017/5/11/1434330.png,2,0.9262925386428832,870,10,1098,238,228,228,applejack|fluttershy|mane six|pinkie pie|rainbow dash|rarity|twilight sparkle,succubi samus
1435314.png,https://derpicdn.net/img/view/2017/5/13/1435314.png,0,0.9944093823432922,297,193,771,667,474,474,princess flurry heart|twilight sparkle,mn27
1436672.png,https://derpicdn.net/img/view/2017/5/14/1436672.png,2,0.9928265810012816,2112,272,2602,762,490,490,applejack|fluttershy|mane six|pinkie pie|princess cadance|rainbow dash|rarity|twilight sparkle,bronypanda
1436672.png,https://derpicdn.net/img/view/2017/5/14/1436672.png,4,0.9824801087379456,149,252,625,728,476,476,applejack|fluttershy|mane six|pinkie pie|princess cadance|rainbow dash|rarity|twilight sparkle,bronypanda
1436994.png,https://derpicdn.net/img/view/2017/5/15/1436994.png,0,0.9076456427574158,505,181,875,551,370,370,princess celestia|twilight sparkle,sion
1438014.png,https://derpicdn.net/img/view/2017/5/16/1438014.png,0,0.9617525339126588,414,90,888,564,474,474,princess celestia|spike|twilight sparkle,dsana
1438014.png,https://derpicdn.net/img/view/2017/5/16/1438014.png,1,0.9596648812294006,740,190,1166,616,426,426,princess celestia|spike|twilight sparkle,dsana
1442095.png,https://derpicdn.net/img/view/2017/5/21/1442095.png,0,0.9588760733604432,92,114,432,454,340,340,princess luna|twilight sparkle,loladotz
1443257.png,https://derpicdn.net/img/view/2017/5/22/1443257.png,0,0.9964619278907776,897,0,1441,450,544,450,applejack|fluttershy|mane six|pinkie pie|rainbow dash|rarity|twilight sparkle,tcn1205
1445628.png,https://derpicdn.net/img/view/2017/5/25/1445628.png,0,0.9926608800888062,338,62,576,300,238,238,princess luna|spike|sunset shimmer|twilight sparkle,little-tweenframes
1445628.png,https://derpicdn.net/img/view/2017/5/25/1445628.png,1,0.9563259482383728,443,458,679,694,236,236,princess luna|spike|sunset shimmer|twilight sparkle,little-tweenframes
1449889.png,https://derpicdn.net/img/view/2017/5/30/1449889.png,1,0.972741425037384,171,109,573,511,402,402,spike|sunset shimmer|twilight sparkle,little-tweenframes
1450651.png,https://derpicdn.net/img/view/2017/5/31/1450651.png,0,0.995642364025116,632,1068,1062,1498,430,430,princess celestia|princess luna|rarity|twilight sparkle,fanch1
1450651.png,https://derpicdn.net/img/view/2017/5/31/1450651.png,1,0.986739993095398,1071,1085,1451,1465,380,380,princess celestia|princess luna|rarity|twilight sparkle,fanch1
1450651.png,https://derpicdn.net/img/view/2017/5/31/1450651.png,2,0.9828919172286988,1125,503,1565,943,440,440,princess celestia|princess luna|rarity|twilight sparkle,fanch1
1450651.png,https://derpicdn.net/img/view/2017/5/31/1450651.png,3,0.9017992615699768,590,503,1032,945,442,442,princess celestia|princess luna|rarity|twilight sparkle,fanch1
1452860.png,https://derpicdn.net/img/view/2017/6/3/1452860.png,0,0.9936841130256652,91,1312,329,1550,238,238,applejack|rainbow dash|twilight sparkle,ryuu
1452860.png,https://derpicdn.net/img/view/2017/6/3/1452860.png,2,0.9911708235740662,850,1336,1064,1550,214,214,applejack|rainbow dash|twilight sparkle,ryuu
1452860.png,https://derpicdn.net/img/view/2017/6/3/1452860.png,3,0.9897915124893188,984,340,1188,544,204,204,applejack|rainbow dash|twilight sparkle,ryuu
1452860.png,https://derpicdn.net/img/view/2017/6/3/1452860.png,4,0.9895076155662536,712,71,924,283,212,212,applejack|rainbow dash|twilight sparkle,ryuu
1452860.png,https://derpicdn.net/img/view/2017/6/3/1452860.png,5,0.9892931580543518,95,683,301,889,206,206,applejack|rainbow dash|twilight sparkle,ryuu
1452860.png,https://derpicdn.net/img/view/2017/6/3/1452860.png,7,0.979839563369751,509,10,721,222,212,212,applejack|rainbow dash|twilight sparkle,ryuu
1452860.png,https://derpicdn.net/img/view/2017/6/3/1452860.png,8,0.9775813817977904,0,973,197,1195,197,222,applejack|rainbow dash|twilight sparkle,ryuu
1452860.png,https://derpicdn.net/img/view/2017/6/3/1452860.png,9,0.97702956199646,704,1327,898,1521,194,194,applejack|rainbow dash|twilight sparkle,ryuu
1452860.png,https://derpicdn.net/img/view/2017/6/3/1452860.png,10,0.968054473400116,314,362,530,578,216,216,applejack|rainbow dash|twilight sparkle,ryuu
1452860.png,https://derpicdn.net/img/view/2017/6/3/1452860.png,12,0.9599322080612184,959,937,1203,1215,244,278,applejack|rainbow dash|twilight sparkle,ryuu
1452860.png,https://derpicdn.net/img/view/2017/6/3/1452860.png,13,0.9437440633773804,378,13,582,217,204,204,applejack|rainbow dash|twilight sparkle,ryuu
1452860.png,https://derpicdn.net/img/view/2017/6/3/1452860.png,14,0.930876076221466,23,66,219,262,196,196,applejack|rainbow dash|twilight sparkle,ryuu
1456038.png,https://derpicdn.net/img/view/2017/6/7/1456038.png,0,0.9985136985778807,2969,343,5009,2441,2040,2098,princess luna|twilight sparkle,zutheskunk
1457781.png,https://derpicdn.net/img/view/2017/6/9/1457781.png,0,0.9845461845397948,215,0,781,546,566,546,sunset shimmer|twilight sparkle,princesssnapdragon
1462271.png,https://derpicdn.net/img/view/2017/6/15/1462271.png,0,0.9875844717025756,534,503,866,835,332,332,rarity|spike|sweetie belle|twilight sparkle,tomatocoup
1463316.png,https://derpicdn.net/img/view/2017/6/16/1463316.png,0,0.9762613773345948,0,0,776,833,776,833,starlight glimmer|twilight sparkle,tsitra360
1463318.png,https://derpicdn.net/img/view/2017/6/16/1463318.png,0,0.995002031326294,0,0,688,825,688,825,princess celestia|princess luna|starlight glimmer|twilight sparkle,tsitra360
1464881.png,https://derpicdn.net/img/view/2017/6/18/1464881.png,0,0.9948680996894836,479,31,1273,825,794,794,rainbow dash|twilight sparkle,elzzombie
1465704.png,https://derpicdn.net/img/view/2017/6/19/1465704.png,0,0.997900664806366,377,172,739,534,362,362,sunset shimmer|twilight sparkle,little-tweenframes
1466889.png,https://derpicdn.net/img/view/2017/6/20/1466889.png,0,0.9464614987373352,1076,275,1582,781,506,506,princess celestia|twilight sparkle,verawitch|bri-sta
1469256.png,https://derpicdn.net/img/view/2017/6/22/1469256.png,0,0.9527683854103088,0,42,2332,2484,2332,2442,princess celestia|twilight sparkle,violise
1472785.png,https://derpicdn.net/img/view/2017/6/27/1472785.png,1,0.9867879152297974,1146,466,1404,724,258,258,apple bloom|applejack|babs seed|big macintosh|cutie mark crusaders|diamond tiara|discord|fluttershy|granny smith|mane six|pinkie pie|princess cadance|princess celestia|princess flurry heart|princess luna|rainbow dash|rarity|scootaloo|shining armor|silver spoon|spike|starlight glimmer|sunset shimmer|sweetie belle|trixie|twilight sparkle,phyllismi
1472785.png,https://derpicdn.net/img/view/2017/6/27/1472785.png,2,0.9761044979095459,1208,71,1394,257,186,186,apple bloom|applejack|babs seed|big macintosh|cutie mark crusaders|diamond tiara|discord|fluttershy|granny smith|mane six|pinkie pie|princess cadance|princess celestia|princess flurry heart|princess luna|rainbow dash|rarity|scootaloo|shining armor|silver spoon|spike|starlight glimmer|sunset shimmer|sweetie belle|trixie|twilight sparkle,phyllismi
1472785.png,https://derpicdn.net/img/view/2017/6/27/1472785.png,3,0.9485394358634948,721,142,897,318,176,176,apple bloom|applejack|babs seed|big macintosh|cutie mark crusaders|diamond tiara|discord|fluttershy|granny smith|mane six|pinkie pie|princess cadance|princess celestia|princess flurry heart|princess luna|rainbow dash|rarity|scootaloo|shining armor|silver spoon|spike|starlight glimmer|sunset shimmer|sweetie belle|trixie|twilight sparkle,phyllismi
1472785.png,https://derpicdn.net/img/view/2017/6/27/1472785.png,5,0.9430387616157532,1181,291,1391,501,210,210,apple bloom|applejack|babs seed|big macintosh|cutie mark crusaders|diamond tiara|discord|fluttershy|granny smith|mane six|pinkie pie|princess cadance|princess celestia|princess flurry heart|princess luna|rainbow dash|rarity|scootaloo|shining armor|silver spoon|spike|starlight glimmer|sunset shimmer|sweetie belle|trixie|twilight sparkle,phyllismi
1472785.png,https://derpicdn.net/img/view/2017/6/27/1472785.png,6,0.9286972284317015,875,9,1057,191,182,182,apple bloom|applejack|babs seed|big macintosh|cutie mark crusaders|diamond tiara|discord|fluttershy|granny smith|mane six|pinkie pie|princess cadance|princess celestia|princess flurry heart|princess luna|rainbow dash|rarity|scootaloo|shining armor|silver spoon|spike|starlight glimmer|sunset shimmer|sweetie belle|trixie|twilight sparkle,phyllismi
1475840.png,https://derpicdn.net/img/view/2017/7/1/1475840.png,0,0.9949604868888856,36,218,264,446,228,228,sunset shimmer|twilight sparkle,swev
1475840.png,https://derpicdn.net/img/view/2017/7/1/1475840.png,2,0.9194713830947876,432,562,694,824,262,262,sunset shimmer|twilight sparkle,swev
1483912.png,https://derpicdn.net/img/view/2017/7/11/1483912.png,0,0.9910094738006592,160,13,594,447,434,434,sunset shimmer|twilight sparkle,the-park
1483912.png,https://derpicdn.net/img/view/2017/7/11/1483912.png,1,0.980478823184967,82,329,258,505,176,176,sunset shimmer|twilight sparkle,the-park
1484685.png,https://derpicdn.net/img/view/2017/7/12/1484685.png,0,0.9916526675224304,0,226,244,472,244,246,applejack|fluttershy|mane six|pinkie pie|rainbow dash|rarity|twilight sparkle,sharmie
1484685.png,https://derpicdn.net/img/view/2017/7/12/1484685.png,1,0.9339876770973206,499,567,711,791,212,224,applejack|fluttershy|mane six|pinkie pie|rainbow dash|rarity|twilight sparkle,sharmie
1484685.png,https://derpicdn.net/img/view/2017/7/12/1484685.png,2,0.9185689091682434,337,223,549,435,212,212,applejack|fluttershy|mane six|pinkie pie|rainbow dash|rarity|twilight sparkle,sharmie
1486061.png,https://derpicdn.net/img/view/2017/7/14/1486061.png,0,0.9707857370376588,27,582,479,1034,452,452,applejack|fluttershy|pinkie pie|rainbow dash|rarity|starlight glimmer|twilight sparkle,symbianl
1486350.png,https://derpicdn.net/img/view/2017/7/14/1486350.png,1,0.9885402321815492,572,33,1063,539,491,506,rarity|twilight sparkle,dilarus|lilfunkman
1488137.png,https://derpicdn.net/img/view/2017/7/17/1488137.png,1,0.9987134337425232,757,117,1073,433,316,316,applejack|fluttershy|mane six|pinkie pie|rainbow dash|rarity|spike|starlight glimmer|twilight sparkle,silentwulv
1488137.png,https://derpicdn.net/img/view/2017/7/17/1488137.png,2,0.9977587461471558,959,503,1291,835,332,332,applejack|fluttershy|mane six|pinkie pie|rainbow dash|rarity|spike|starlight glimmer|twilight sparkle,silentwulv
1488137.png,https://derpicdn.net/img/view/2017/7/17/1488137.png,3,0.9973974227905272,1040,0,1350,265,310,265,applejack|fluttershy|mane six|pinkie pie|rainbow dash|rarity|spike|starlight glimmer|twilight sparkle,silentwulv
1488137.png,https://derpicdn.net/img/view/2017/7/17/1488137.png,4,0.9943574666976928,20,0,298,264,278,264,applejack|fluttershy|mane six|pinkie pie|rainbow dash|rarity|spike|starlight glimmer|twilight sparkle,silentwulv
1488137.png,https://derpicdn.net/img/view/2017/7/17/1488137.png,5,0.9893084168434144,636,463,994,821,358,358,applejack|fluttershy|mane six|pinkie pie|rainbow dash|rarity|spike|starlight glimmer|twilight sparkle,silentwulv
1488137.png,https://derpicdn.net/img/view/2017/7/17/1488137.png,6,0.988355040550232,85,380,409,704,324,324,applejack|fluttershy|mane six|pinkie pie|rainbow dash|rarity|spike|starlight glimmer|twilight sparkle,silentwulv
1488137.png,https://derpicdn.net/img/view/2017/7/17/1488137.png,7,0.986931085586548,426,450,738,762,312,312,applejack|fluttershy|mane six|pinkie pie|rainbow dash|rarity|spike|starlight glimmer|twilight sparkle,silentwulv
1489077.png,https://derpicdn.net/img/view/2017/7/18/1489077.png,0,0.9765493869781494,469,315,752,631,283,316,applejack|fluttershy|mane six|pinkie pie|rainbow dash|rarity|spike|starlight glimmer|sunset shimmer|twilight sparkle,dvixie
1489077.png,https://derpicdn.net/img/view/2017/7/18/1489077.png,1,0.9761118292808532,493,0,752,283,259,283,applejack|fluttershy|mane six|pinkie pie|rainbow dash|rarity|spike|starlight glimmer|sunset shimmer|twilight sparkle,dvixie
1489989.png,https://derpicdn.net/img/view/2017/7/19/1489989.png,0,0.9963427186012268,1158,1095,1640,1523,482,428,princess celestia|queen chrysalis|twilight sparkle,yakovlev-vad
1489989.png,https://derpicdn.net/img/view/2017/7/19/1489989.png,1,0.9935730695724488,1266,518,1554,806,288,288,princess celestia|queen chrysalis|twilight sparkle,yakovlev-vad
1490187.png,https://derpicdn.net/img/view/2017/7/19/1490187.png,0,0.986848533153534,0,192,236,438,236,246,pinkie pie|twilight sparkle,jowybean
1490187.png,https://derpicdn.net/img/view/2017/7/19/1490187.png,1,0.9519122838974,306,180,552,426,246,246,pinkie pie|twilight sparkle,jowybean
1490242.png,https://derpicdn.net/img/view/2017/7/20/1490242.png,0,0.9965185523033142,481,0,895,403,414,403,pinkie pie|twilight sparkle,dshou
1490242.png,https://derpicdn.net/img/view/2017/7/20/1490242.png,1,0.9557048082351683,3,60,477,534,474,474,pinkie pie|twilight sparkle,dshou
1490608.png,https://derpicdn.net/img/view/2017/7/20/1490608.png,0,0.9970643520355223,921,496,1201,776,280,280,apple bloom|applejack|diamond tiara|pinkie pie|princess celestia|princess luna|rainbow dash|rarity|scootaloo|silver spoon|spike|starlight glimmer|sunset shimmer|sweetie belle|trixie|twilight sparkle,bobdude0
1490608.png,https://derpicdn.net/img/view/2017/7/20/1490608.png,1,0.9952687621116638,623,1310,875,1562,252,252,apple bloom|applejack|diamond tiara|pinkie pie|princess celestia|princess luna|rainbow dash|rarity|scootaloo|silver spoon|spike|starlight glimmer|sunset shimmer|sweetie belle|trixie|twilight sparkle,bobdude0
1490608.png,https://derpicdn.net/img/view/2017/7/20/1490608.png,2,0.9939883351325988,753,117,1047,411,294,294,apple bloom|applejack|diamond tiara|pinkie pie|princess celestia|princess luna|rainbow dash|rarity|scootaloo|silver spoon|spike|starlight glimmer|sunset shimmer|sweetie belle|trixie|twilight sparkle,bobdude0
1490608.png,https://derpicdn.net/img/view/2017/7/20/1490608.png,3,0.9813525080680848,282,10,484,212,202,202,apple bloom|applejack|diamond tiara|pinkie pie|princess celestia|princess luna|rainbow dash|rarity|scootaloo|silver spoon|spike|starlight glimmer|sunset shimmer|sweetie belle|trixie|twilight sparkle,bobdude0
1490608.png,https://derpicdn.net/img/view/2017/7/20/1490608.png,5,0.9762853980064392,1057,0,1299,214,242,214,apple bloom|applejack|diamond tiara|pinkie pie|princess celestia|princess luna|rainbow dash|rarity|scootaloo|silver spoon|spike|starlight glimmer|sunset shimmer|sweetie belle|trixie|twilight sparkle,bobdude0
1490608.png,https://derpicdn.net/img/view/2017/7/20/1490608.png,7,0.9540390968322754,1095,1163,1350,1435,255,272,apple bloom|applejack|diamond tiara|pinkie pie|princess celestia|princess luna|rainbow dash|rarity|scootaloo|silver spoon|spike|starlight glimmer|sunset shimmer|sweetie belle|trixie|twilight sparkle,bobdude0
1491.jpg,https://derpicdn.net/img/view/2012/1/22/1491.jpg,0,0.9963917136192322,597,16,855,274,258,258,applejack|fluttershy|mane six|pinkie pie|rainbow dash|rarity|twilight sparkle,mysticalpha
1491.jpg,https://derpicdn.net/img/view/2012/1/22/1491.jpg,2,0.9810370802879332,278,71,534,327,256,256,applejack|fluttershy|mane six|pinkie pie|rainbow dash|rarity|twilight sparkle,mysticalpha
1491604.png,https://derpicdn.net/img/view/2017/7/21/1491604.png,0,0.9477994441986084,638,360,914,636,276,276,princess celestia|twilight sparkle,waackery
1491639.png,https://derpicdn.net/img/view/2017/7/21/1491639.png,0,0.9888409972190856,609,336,1041,768,432,432,discord|fluttershy|princess celestia|twilight sparkle,akeahi
1491640.png,https://derpicdn.net/img/view/2017/7/21/1491640.png,0,0.9973270893096924,342,350,860,868,518,518,princess celestia|twilight sparkle,akeahi
1492252.png,https://derpicdn.net/img/view/2017/7/22/1492252.png,0,0.9856196641921996,689,0,1709,905,1020,905,princess celestia|princess luna|twilight sparkle,sunlover
1492252.png,https://derpicdn.net/img/view/2017/7/22/1492252.png,1,0.950560986995697,0,1078,838,1948,838,870,princess celestia|princess luna|twilight sparkle,sunlover
1495005.png,https://derpicdn.net/img/view/2017/7/26/1495005.png,0,0.9935718178749084,894,158,1242,540,348,382,applejack|fluttershy|mane six|pinkie pie|rainbow dash|rarity|spike|twilight sparkle,valcron
1497096.png,https://derpicdn.net/img/view/2017/7/28/1497096.png,1,0.993829071521759,279,312,549,582,270,270,applejack|fluttershy|mane six|pinkie pie|princess celestia|princess luna|rainbow dash|rarity|spike|twilight sparkle,tysontan
1497096.png,https://derpicdn.net/img/view/2017/7/28/1497096.png,2,0.9170548915863036,553,716,909,1072,356,356,applejack|fluttershy|mane six|pinkie pie|princess celestia|princess luna|rainbow dash|rarity|spike|twilight sparkle,tysontan
1500104.png,https://derpicdn.net/img/view/2017/8/1/1500104.png,0,0.9988922476768494,506,0,948,395,442,395,princess cadance|twilight sparkle,vavacung
1500104.png,https://derpicdn.net/img/view/2017/8/1/1500104.png,1,0.9791651964187622,53,128,507,582,454,454,princess cadance|twilight sparkle,vavacung
1500653.png,https://derpicdn.net/img/view/2017/8/2/1500653.png,0,0.9615153074264526,239,33,1389,1183,1150,1150,rainbow dash|twilight sparkle,graphene
1501489.png,https://derpicdn.net/img/view/2017/8/3/1501489.png,0,0.9836576581001282,1471,194,2715,1438,1244,1244,spike|twilight sparkle,graphene
1501911.png,https://derpicdn.net/img/view/2017/8/3/1501911.png,0,0.9967502951622008,1876,0,3108,1054,1232,1054,applejack|fluttershy|mane six|pinkie pie|rainbow dash|rarity|twilight sparkle,foxcarp
1501911.png,https://derpicdn.net/img/view/2017/8/3/1501911.png,4,0.9877280592918396,594,848,1724,1978,1130,1130,applejack|fluttershy|mane six|pinkie pie|rainbow dash|rarity|twilight sparkle,foxcarp
1504876.png,https://derpicdn.net/img/view/2017/8/7/1504876.png,0,0.96770042181015,1036,1210,1860,2054,824,844,starlight glimmer|sunset shimmer|trixie|twilight sparkle,anibaruthecat
1505070.png,https://derpicdn.net/img/view/2017/8/7/1505070.png,1,0.9967151284217834,492,0,858,325,366,325,starlight glimmer|sunset shimmer|trixie|twilight sparkle,sion
1505070.png,https://derpicdn.net/img/view/2017/8/7/1505070.png,2,0.9875314235687256,143,9,525,391,382,382,starlight glimmer|sunset shimmer|trixie|twilight sparkle,sion
1509703.png,https://derpicdn.net/img/view/2017/8/13/1509703.png,0,0.983851432800293,1068,218,1330,480,262,262,applejack|fluttershy|mane six|pinkie pie|rainbow dash|rarity|twilight sparkle,saturdaymorningproj
1509703.png,https://derpicdn.net/img/view/2017/8/13/1509703.png,1,0.9791804552078248,55,149,389,483,334,334,applejack|fluttershy|mane six|pinkie pie|rainbow dash|rarity|twilight sparkle,saturdaymorningproj
1515958.png,https://derpicdn.net/img/view/2017/8/20/1515958.png,0,0.9214184284210204,1393,497,1807,911,414,414,starlight glimmer|twilight sparkle,tsitra360
1515996.png,https://derpicdn.net/img/view/2017/8/21/1515996.png,0,0.9962403178215028,222,0,745,539,523,539,starlight glimmer|twilight sparkle,
1518271.png,https://derpicdn.net/img/view/2017/8/23/1518271.png,1,0.9969767928123474,1421,1633,2517,2729,1096,1096,princess celestia|twilight sparkle,feellikeaplat
1521826.png,https://derpicdn.net/img/view/2017/8/28/1521826.png,0,0.9877535104751588,1679,0,2829,901,1150,901,applejack|fluttershy|mane six|pinkie pie|rainbow dash|rarity|starlight glimmer|sunset shimmer|twilight sparkle,phyllismi
1523535.png,https://derpicdn.net/img/view/2017/8/30/1523535.png,0,0.931361734867096,7,0,655,559,648,559,sunset shimmer|twilight sparkle,phyllismi
1524239.png,https://derpicdn.net/img/view/2017/8/31/1524239.png,0,0.963835835456848,1138,303,1442,607,304,304,applejack|fluttershy|mane six|pinkie pie|rainbow dash|rarity|twilight sparkle,vanillaghosties
1528511.png,https://derpicdn.net/img/view/2017/9/5/1528511.png,0,0.9948821663856506,142,0,1216,1044,1074,1044,rainbow dash|twilight sparkle,mrscurlystyles
1528511.png,https://derpicdn.net/img/view/2017/9/5/1528511.png,1,0.9615740180015564,806,0,1930,1110,1124,1110,rainbow dash|twilight sparkle,mrscurlystyles
1536028.png,https://derpicdn.net/img/view/2017/9/15/1536028.png,0,0.9861713647842408,0,222,744,978,744,756,rainbow dash|twilight sparkle,mrscurlystyles|neighday
1536538.png,https://derpicdn.net/img/view/2017/9/16/1536538.png,0,0.9396419525146484,376,0,872,469,496,469,starlight glimmer|twilight sparkle,zambies
1537798.png,https://derpicdn.net/img/view/2017/9/17/1537798.png,0,0.9990050792694092,0,0,896,714,896,714,rainbow dash|twilight sparkle,captainpudgemuffin
1537798.png,https://derpicdn.net/img/view/2017/9/17/1537798.png,1,0.904910147190094,957,96,1629,768,672,672,rainbow dash|twilight sparkle,captainpudgemuffin
1540172.png,https://derpicdn.net/img/view/2017/9/20/1540172.png,0,0.9977890253067015,1090,96,1404,410,314,314,applejack|fluttershy|mane six|pinkie pie|rainbow dash|rarity|twilight sparkle,probablyfakeblonde
1540172.png,https://derpicdn.net/img/view/2017/9/20/1540172.png,1,0.9751263856887816,1795,140,2095,440,300,300,applejack|fluttershy|mane six|pinkie pie|rainbow dash|rarity|twilight sparkle,probablyfakeblonde
1540828.png,https://derpicdn.net/img/view/2017/9/21/1540828.png,0,0.9940347671508788,372,167,902,697,530,530,starlight glimmer|trixie|twilight sparkle,scootiebloom
1540828.png,https://derpicdn.net/img/view/2017/9/21/1540828.png,1,0.9926028251647948,812,286,1126,600,314,314,starlight glimmer|trixie|twilight sparkle,scootiebloom
1541852.png,https://derpicdn.net/img/view/2017/9/22/1541852.png,0,0.9900900721549988,35,6,383,354,348,348,fluttershy|twilight sparkle,howxu
1541852.png,https://derpicdn.net/img/view/2017/9/22/1541852.png,1,0.9656202793121338,522,528,798,804,276,276,fluttershy|twilight sparkle,howxu
1544711.png,https://derpicdn.net/img/view/2017/9/25/1544711.png,0,0.9944289922714232,724,552,1112,940,388,388,applejack|rainbow dash|twilight sparkle,tsitra360
1545185.png,https://derpicdn.net/img/view/2017/9/26/1545185.png,0,0.9992077350616456,1390,2356,1832,2798,442,442,applejack|fluttershy|mane six|pinkie pie|princess celestia|princess luna|rainbow dash|rarity|spike|twilight sparkle,clockworkquartet
1545788.png,https://derpicdn.net/img/view/2017/9/27/1545788.png,0,0.9788634777069092,110,0,662,507,552,507,sunset shimmer|twilight sparkle,klavierpony
1547923.png,https://derpicdn.net/img/view/2017/9/29/1547923.png,0,0.9565148949623108,776,134,1804,1162,1028,1028,rarity|twilight sparkle,lilfunkman
1549225.png,https://derpicdn.net/img/view/2017/10/1/1549225.png,0,0.9850749373435974,821,1264,1303,1746,482,482,princess celestia|princess luna|sunset shimmer|twilight sparkle,symbianl
15494.jpg,https://derpicdn.net/img/view/2012/6/22/15494.jpg,0,0.9880415201187134,1566,1012,2338,1784,772,772,applejack|fluttershy|mane six|pinkie pie|rainbow dash|rarity|twilight sparkle,pyruvate
15494.jpg,https://derpicdn.net/img/view/2012/6/22/15494.jpg,1,0.9431257247924804,1609,0,2387,849,778,849,applejack|fluttershy|mane six|pinkie pie|rainbow dash|rarity|twilight sparkle,pyruvate
1550474.png,https://derpicdn.net/img/view/2017/10/2/1550474.png,1,0.9101182222366332,58,200,2358,2500,2300,2300,rarity|twilight sparkle,orangejuicerus
1551625.png,https://derpicdn.net/img/view/2017/10/4/1551625.png,1,0.9972601532936096,1483,0,2093,541,610,541,applejack|pinkie pie|twilight sparkle,ambris
1553204.png,https://derpicdn.net/img/view/2017/10/6/1553204.png,0,0.9987269043922424,261,0,713,379,452,379,applejack|fluttershy|mane six|pinkie pie|rainbow dash|rarity|twilight sparkle,probablyfakeblonde
1553204.png,https://derpicdn.net/img/view/2017/10/6/1553204.png,1,0.9806494712829592,385,387,801,803,416,416,applejack|fluttershy|mane six|pinkie pie|rainbow dash|rarity|twilight sparkle,probablyfakeblonde
1553204.png,https://derpicdn.net/img/view/2017/10/6/1553204.png,2,0.9704028964042664,966,608,1420,1062,454,454,applejack|fluttershy|mane six|pinkie pie|rainbow dash|rarity|twilight sparkle,probablyfakeblonde
1553204.png,https://derpicdn.net/img/view/2017/10/6/1553204.png,3,0.9308910369873048,740,155,1132,547,392,392,applejack|fluttershy|mane six|pinkie pie|rainbow dash|rarity|twilight sparkle,probablyfakeblonde
1555666.png,https://derpicdn.net/img/view/2017/10/8/1555666.png,0,0.9930205941200256,1283,1604,2059,2380,776,776,big macintosh|princess cadance|princess celestia|princess luna|scootaloo|starlight glimmer|sunset shimmer|trixie|twilight sparkle,docwario
1555666.png,https://derpicdn.net/img/view/2017/10/8/1555666.png,1,0.9881628155708312,2746,1180,3756,2190,1010,1010,big macintosh|princess cadance|princess celestia|princess luna|scootaloo|starlight glimmer|sunset shimmer|trixie|twilight sparkle,docwario
1555666.png,https://derpicdn.net/img/view/2017/10/8/1555666.png,2,0.9825029373168944,1920,1620,2652,2352,732,732,big macintosh|princess cadance|princess celestia|princess luna|scootaloo|starlight glimmer|sunset shimmer|trixie|twilight sparkle,docwario
1557995.png,https://derpicdn.net/img/view/2017/10/11/1557995.png,0,0.9980522394180298,341,341,831,831,490,490,applejack|fluttershy|mane six|pinkie pie|rainbow dash|rarity|spike|starlight glimmer|twilight sparkle,tcn1205
1557995.png,https://derpicdn.net/img/view/2017/10/11/1557995.png,2,0.9891745448112488,338,0,822,386,484,386,applejack|fluttershy|mane six|pinkie pie|rainbow dash|rarity|spike|starlight glimmer|twilight sparkle,tcn1205
1557995.png,https://derpicdn.net/img/view/2017/10/11/1557995.png,3,0.9547321200370787,1384,663,1860,1161,476,498,applejack|fluttershy|mane six|pinkie pie|rainbow dash|rarity|spike|starlight glimmer|twilight sparkle,tcn1205
1562336.png,https://derpicdn.net/img/view/2017/10/16/1562336.png,0,0.9962566494941713,1059,136,1567,644,508,508,apple bloom|applejack|discord|fluttershy|pinkie pie|princess cadance|princess flurry heart|queen chrysalis|rainbow dash|rarity|scootaloo|shining armor|spike|starlight glimmer|sweetie belle|trixie|twilight sparkle,dankflank
1562336.png,https://derpicdn.net/img/view/2017/10/16/1562336.png,1,0.9643202424049376,202,196,638,632,436,436,apple bloom|applejack|discord|fluttershy|pinkie pie|princess cadance|princess flurry heart|queen chrysalis|rainbow dash|rarity|scootaloo|shining armor|spike|starlight glimmer|sweetie belle|trixie|twilight sparkle,dankflank
1562336.png,https://derpicdn.net/img/view/2017/10/16/1562336.png,2,0.9612357020378112,21,2206,341,2526,320,320,apple bloom|applejack|discord|fluttershy|pinkie pie|princess cadance|princess flurry heart|queen chrysalis|rainbow dash|rarity|scootaloo|shining armor|spike|starlight glimmer|sweetie belle|trixie|twilight sparkle,dankflank
1562336.png,https://derpicdn.net/img/view/2017/10/16/1562336.png,3,0.929771900177002,1292,1410,1724,1842,432,432,apple bloom|applejack|discord|fluttershy|pinkie pie|princess cadance|princess flurry heart|queen chrysalis|rainbow dash|rarity|scootaloo|shining armor|spike|starlight glimmer|sweetie belle|trixie|twilight sparkle,dankflank
1562336.png,https://derpicdn.net/img/view/2017/10/16/1562336.png,4,0.9049088954925536,597,3532,965,3900,368,368,apple bloom|applejack|discord|fluttershy|pinkie pie|princess cadance|princess flurry heart|queen chrysalis|rainbow dash|rarity|scootaloo|shining armor|spike|starlight glimmer|sweetie belle|trixie|twilight sparkle,dankflank
1564194.png,https://derpicdn.net/img/view/2017/10/18/1564194.png,0,0.9985657930374146,1706,859,2692,1845,986,986,applejack|fluttershy|mane six|pinkie pie|rainbow dash|rarity|spike|twilight sparkle,tcn1205
1564194.png,https://derpicdn.net/img/view/2017/10/18/1564194.png,2,0.9285982251167296,1382,797,1960,1375,578,578,applejack|fluttershy|mane six|pinkie pie|rainbow dash|rarity|spike|twilight sparkle,tcn1205
1564194.png,https://derpicdn.net/img/view/2017/10/18/1564194.png,3,0.9236900210380554,316,754,870,1308,554,554,applejack|fluttershy|mane six|pinkie pie|rainbow dash|rarity|spike|twilight sparkle,tcn1205
1566549.png,https://derpicdn.net/img/view/2017/10/21/1566549.png,0,0.9305484294891356,843,144,1075,376,232,232,rainbow dash|scootaloo|spike|starlight glimmer|twilight sparkle,justasuta
1566792.png,https://derpicdn.net/img/view/2017/10/21/1566792.png,0,0.931369125843048,441,306,845,710,404,404,spike|starlight glimmer|sunset shimmer|trixie|twilight sparkle,xxmarkingxx
1568098.png,https://derpicdn.net/img/view/2017/10/23/1568098.png,0,0.9513649344444276,2023,428,3469,1874,1446,1446,starlight glimmer|trixie|twilight sparkle,pabbley
1568098.png,https://derpicdn.net/img/view/2017/10/23/1568098.png,1,0.9293140172958374,3023,651,4511,2139,1488,1488,starlight glimmer|trixie|twilight sparkle,pabbley
1568138.png,https://derpicdn.net/img/view/2017/10/23/1568138.png,0,0.9984546899795532,2538,2488,3346,3296,808,808,princess celestia|twilight sparkle,greyscaleart
1568597.png,https://derpicdn.net/img/view/2017/10/23/1568597.png,0,0.9594966769218444,677,91,1207,621,530,530,starlight glimmer|trixie|twilight sparkle,pabbley|pastelhorses
1569.png,https://derpicdn.net/img/view/2012/1/23/1569.png,0,0.9461677670478821,2202,168,2700,690,498,522,applejack|fluttershy|mane six|pinkie pie|rainbow dash|rarity|spike|twilight sparkle,madmax
1570232.png,https://derpicdn.net/img/view/2017/10/25/1570232.png,0,0.9211884140968324,2718,0,3840,1131,1122,1131,apple bloom|applejack|cutie mark crusaders|fluttershy|mane six|pinkie pie|princess celestia|princess luna|rainbow dash|rarity|scootaloo|spike|starlight glimmer|sunset shimmer|sweetie belle|trixie|twilight sparkle,pirill
1570734.png,https://derpicdn.net/img/view/2017/10/26/1570734.png,0,0.99205881357193,26,18,380,372,354,354,starlight glimmer|twilight sparkle,hoodie
1570734.png,https://derpicdn.net/img/view/2017/10/26/1570734.png,1,0.9919543862342834,377,30,701,354,324,324,starlight glimmer|twilight sparkle,hoodie
1570735.png,https://derpicdn.net/img/view/2017/10/26/1570735.png,0,0.9970702528953552,329,963,935,1569,606,606,applejack|fluttershy|mane six|pinkie pie|rainbow dash|rarity|twilight sparkle,varllai
1570735.png,https://derpicdn.net/img/view/2017/10/26/1570735.png,1,0.989470601081848,693,612,1237,1156,544,544,applejack|fluttershy|mane six|pinkie pie|rainbow dash|rarity|twilight sparkle,varllai
1570735.png,https://derpicdn.net/img/view/2017/10/26/1570735.png,2,0.9811932444572448,336,508,924,1096,588,588,applejack|fluttershy|mane six|pinkie pie|rainbow dash|rarity|twilight sparkle,varllai
1571204.png,https://derpicdn.net/img/view/2017/10/27/1571204.png,0,0.9684801697731018,851,156,1411,716,560,560,starlight glimmer|sunset shimmer|twilight sparkle,kuzumori
1583184.png,https://derpicdn.net/img/view/2017/11/10/1583184.png,0,0.954573392868042,578,0,1134,556,556,556,rarity|twilight sparkle,lilfunkman
1583184.png,https://derpicdn.net/img/view/2017/11/10/1583184.png,1,0.950934112071991,65,58,559,552,494,494,rarity|twilight sparkle,lilfunkman
1583986.png,https://derpicdn.net/img/view/2017/11/11/1583986.png,0,0.9826629757881165,1213,1014,2087,1888,874,874,princess celestia|twilight sparkle,greyscaleart|dilarus
1584905.png,https://derpicdn.net/img/view/2017/11/12/1584905.png,0,0.957777500152588,0,146,2394,2256,2394,2110,rainbow dash|twilight sparkle,php80
1585084.png,https://derpicdn.net/img/view/2017/11/13/1585084.png,0,0.9841800928115844,865,378,1407,920,542,542,princess celestia|twilight sparkle,artbymrsun
1585084.png,https://derpicdn.net/img/view/2017/11/13/1585084.png,1,0.9100991487503052,562,256,958,652,396,396,princess celestia|twilight sparkle,artbymrsun
1586072.png,https://derpicdn.net/img/view/2017/11/14/1586072.png,0,0.9880461096763612,11,0,433,405,422,405,spike|twilight sparkle,vavacung
1586072.png,https://derpicdn.net/img/view/2017/11/14/1586072.png,1,0.9730082750320436,757,885,1000,1179,243,294,spike|twilight sparkle,vavacung
1586072.png,https://derpicdn.net/img/view/2017/11/14/1586072.png,2,0.9563691020011902,482,172,694,384,212,212,spike|twilight sparkle,vavacung
1587075.png,https://derpicdn.net/img/view/2017/11/15/1587075.png,0,0.9961883425712584,672,101,988,417,316,316,applejack|fluttershy|mane six|pinkie pie|rainbow dash|rarity|twilight sparkle,saturdaymorningproj
1587075.png,https://derpicdn.net/img/view/2017/11/15/1587075.png,2,0.9285120368003844,421,89,737,405,316,316,applejack|fluttershy|mane six|pinkie pie|rainbow dash|rarity|twilight sparkle,saturdaymorningproj
1587094.png,https://derpicdn.net/img/view/2017/11/15/1587094.png,0,0.9962432384490968,0,0,569,591,569,591,starlight glimmer|twilight sparkle,sion
1589462.png,https://derpicdn.net/img/view/2017/11/18/1589462.png,0,0.9998341798782348,188,563,462,837,274,274,fluttershy|pinkie pie|rainbow dash|twilight sparkle,tsitra360
1589462.png,https://derpicdn.net/img/view/2017/11/18/1589462.png,1,0.9675386548042296,453,87,721,355,268,268,fluttershy|pinkie pie|rainbow dash|twilight sparkle,tsitra360
1589652.png,https://derpicdn.net/img/view/2017/11/19/1589652.png,0,0.9953410029411316,388,0,1360,880,972,880,rarity|twilight sparkle,tcn1205
1589736.png,https://derpicdn.net/img/view/2017/11/19/1589736.png,0,0.9587578773498536,0,0,1893,2122,1893,2122,princess celestia|twilight sparkle,greyscaleart|dilarus
1589736.png,https://derpicdn.net/img/view/2017/11/19/1589736.png,1,0.946397066116333,1090,893,1820,1623,730,730,princess celestia|twilight sparkle,greyscaleart|dilarus
1592076.png,https://derpicdn.net/img/view/2017/11/22/1592076.png,0,0.9989863634109496,29,0,337,276,308,276,applejack|fluttershy|mane six|pinkie pie|rainbow dash|rarity|twilight sparkle,snow angel
1592076.png,https://derpicdn.net/img/view/2017/11/22/1592076.png,1,0.998150646686554,362,0,682,284,320,284,applejack|fluttershy|mane six|pinkie pie|rainbow dash|rarity|twilight sparkle,snow angel
1592076.png,https://derpicdn.net/img/view/2017/11/22/1592076.png,2,0.99806946516037,674,0,978,280,304,280,applejack|fluttershy|mane six|pinkie pie|rainbow dash|rarity|twilight sparkle,snow angel
1592076.png,https://derpicdn.net/img/view/2017/11/22/1592076.png,3,0.9961698055267334,654,303,988,637,334,334,applejack|fluttershy|mane six|pinkie pie|rainbow dash|rarity|twilight sparkle,snow angel
1592076.png,https://derpicdn.net/img/view/2017/11/22/1592076.png,4,0.9898917675018308,12,298,356,642,344,344,applejack|fluttershy|mane six|pinkie pie|rainbow dash|rarity|twilight sparkle,snow angel
1592076.png,https://derpicdn.net/img/view/2017/11/22/1592076.png,5,0.9782819747924804,349,293,701,645,352,352,applejack|fluttershy|mane six|pinkie pie|rainbow dash|rarity|twilight sparkle,snow angel
1592569.png,https://derpicdn.net/img/view/2017/11/23/1592569.png,0,0.9995052814483644,27,0,495,461,468,461,spike|twilight sparkle,flourret
1592569.png,https://derpicdn.net/img/view/2017/11/23/1592569.png,1,0.9966941475868224,393,400,697,704,304,304,spike|twilight sparkle,flourret
1593065.png,https://derpicdn.net/img/view/2017/11/24/1593065.png,0,0.999618411064148,488,71,666,249,178,178,spike|twilight sparkle,dstears
1593065.png,https://derpicdn.net/img/view/2017/11/24/1593065.png,1,0.9869313240051272,70,21,460,411,390,390,spike|twilight sparkle,dstears
1593785.png,https://derpicdn.net/img/view/2017/11/25/1593785.png,0,0.9673298001289368,532,106,1026,600,494,494,rainbow dash|twilight sparkle,captainpudgemuffin|glacierclear edits|jt47
1593785.png,https://derpicdn.net/img/view/2017/11/25/1593785.png,1,0.9121165275573728,899,83,1423,607,524,524,rainbow dash|twilight sparkle,captainpudgemuffin|glacierclear edits|jt47
1595392.png,https://derpicdn.net/img/view/2017/11/27/1595392.png,0,0.9843413829803468,55,33,503,481,448,448,rarity|twilight sparkle,kkmrarar
1595750.png,https://derpicdn.net/img/view/2017/11/27/1595750.png,0,0.9631447196006776,562,529,844,811,282,282,rainbow dash|twilight sparkle,hierozaki
1595750.png,https://derpicdn.net/img/view/2017/11/27/1595750.png,1,0.9613894820213318,1235,468,1691,924,456,456,rainbow dash|twilight sparkle,hierozaki
1597867.png,https://derpicdn.net/img/view/2017/12/1/1597867.png,0,0.9987797737121582,1277,252,1673,648,396,396,applejack|fluttershy|mane six|pinkie pie|rainbow dash|rarity|twilight sparkle,xenon
1597867.png,https://derpicdn.net/img/view/2017/12/1/1597867.png,1,0.9923102259635924,33,234,377,578,344,344,applejack|fluttershy|mane six|pinkie pie|rainbow dash|rarity|twilight sparkle,xenon
1597867.png,https://derpicdn.net/img/view/2017/12/1/1597867.png,2,0.980057954788208,503,219,845,561,342,342,applejack|fluttershy|mane six|pinkie pie|rainbow dash|rarity|twilight sparkle,xenon
1598122.png,https://derpicdn.net/img/view/2017/12/1/1598122.png,0,0.9914427995681764,637,0,1547,774,910,774,sunset shimmer|twilight sparkle,little-tweenframes
1599416.png,https://derpicdn.net/img/view/2017/12/3/1599416.png,0,0.992215931415558,547,87,1181,721,634,634,trixie|twilight sparkle,marauder6272|speedbumpv-drop|evilfrenzy
1600051.png,https://derpicdn.net/img/view/2017/12/4/1600051.png,0,0.959517240524292,0,0,937,923,937,923,princess celestia|twilight sparkle,pencils
1600079.png,https://derpicdn.net/img/view/2017/12/4/1600079.png,0,0.9757438898086548,1856,1262,3426,2832,1570,1570,princess luna|twilight sparkle,silfoe
1600272.png,https://derpicdn.net/img/view/2017/12/4/1600272.png,0,0.9595171213150024,0,0,937,923,937,923,princess celestia|twilight sparkle,pencils
160069.png,https://derpicdn.net/img/view/2012/11/22/160069.png,0,0.9852051734924316,326,73,660,407,334,334,applejack|princess celestia|rarity|twilight sparkle,johnjoseco
160069.png,https://derpicdn.net/img/view/2012/11/22/160069.png,1,0.9520580172538756,29,55,339,365,310,310,applejack|princess celestia|rarity|twilight sparkle,johnjoseco
1601496.png,https://derpicdn.net/img/view/2017/12/6/1601496.png,0,0.959517240524292,0,0,937,923,937,923,princess celestia|twilight sparkle,pencils
1602250.png,https://derpicdn.net/img/view/2017/12/7/1602250.png,0,0.9980008006095886,891,1533,2000,2729,1109,1196,rarity|twilight sparkle,lilfunkman
1602250.png,https://derpicdn.net/img/view/2017/12/7/1602250.png,1,0.9804178476333618,0,1544,1165,2710,1165,1166,rarity|twilight sparkle,lilfunkman
1602620.png,https://derpicdn.net/img/view/2017/12/7/1602620.png,0,0.9077711701393129,13,0,907,886,894,886,princess celestia|twilight sparkle,pencils
1603986.png,https://derpicdn.net/img/view/2017/12/9/1603986.png,0,0.9138408899307252,102,12,636,546,534,534,spike|twilight sparkle,dawnfire
1605035.png,https://derpicdn.net/img/view/2017/12/11/1605035.png,0,0.9965903162956238,926,823,1450,1347,524,524,applejack|fluttershy|mane six|pinkie pie|rainbow dash|rarity|twilight sparkle,silverfox057
16059.png,https://derpicdn.net/img/view/2012/6/23/16059.png,0,0.9598013162612916,837,847,991,1001,154,154,applejack|fluttershy|mane six|pinkie pie|rainbow dash|rarity|twilight sparkle,calicopikachu
1606032.png,https://derpicdn.net/img/view/2017/12/12/1606032.png,0,0.9993741512298584,759,824,1000,1098,241,274,rainbow dash|spike|twilight sparkle,vavacung
1606032.png,https://derpicdn.net/img/view/2017/12/12/1606032.png,1,0.998618185520172,399,0,795,378,396,378,rainbow dash|spike|twilight sparkle,vavacung
1606032.png,https://derpicdn.net/img/view/2017/12/12/1606032.png,2,0.9905970096588136,146,1037,348,1239,202,202,rainbow dash|spike|twilight sparkle,vavacung
1608107.png,https://derpicdn.net/img/view/2017/12/15/1608107.png,0,0.9421266317367554,905,0,1057,149,152,149,applejack|pinkie pie|princess cadance|princess luna|rainbow dash|rarity|shining armor|spitfire|starlight glimmer|sunset shimmer|trixie|twilight sparkle,bluemeganium|omegaozone|wickedsilly|graboiidz|mkogwheel|zal-ah|rhorse|lockheart|candel|whatsapokemon|lemon|quarantinedchaoz|elijah|starry5643|anonymousdrawfig|monanniverse|horseface|an-m|tenenbris|blvckmagic|pabbley|anontheanon|lux|redxbacon|datte-before-dawn|aer0 zer0|marsminer|piesarts|conrie|dimfann|whydomenhavenipples|coinpo|shobieshy|cowsrtasty|beardie|angryburger|starkdust|joey|shinodage|jetwave|itspencilguy|replica|ashee|cremedelaclop|atmosseven|dankflank|dogg|frecklesfanatic
1608107.png,https://derpicdn.net/img/view/2017/12/15/1608107.png,1,0.9095939993858336,3,0,151,147,148,147,applejack|pinkie pie|princess cadance|princess luna|rainbow dash|rarity|shining armor|spitfire|starlight glimmer|sunset shimmer|trixie|twilight sparkle,bluemeganium|omegaozone|wickedsilly|graboiidz|mkogwheel|zal-ah|rhorse|lockheart|candel|whatsapokemon|lemon|quarantinedchaoz|elijah|starry5643|anonymousdrawfig|monanniverse|horseface|an-m|tenenbris|blvckmagic|pabbley|anontheanon|lux|redxbacon|datte-before-dawn|aer0 zer0|marsminer|piesarts|conrie|dimfann|whydomenhavenipples|coinpo|shobieshy|cowsrtasty|beardie|angryburger|starkdust|joey|shinodage|jetwave|itspencilguy|replica|ashee|cremedelaclop|atmosseven|dankflank|dogg|frecklesfanatic
1609166.png,https://derpicdn.net/img/view/2017/12/16/1609166.png,0,0.9812203049659728,155,0,453,288,298,288,princess luna|twilight sparkle,lulubell
1609424.png,https://derpicdn.net/img/view/2017/12/17/1609424.png,0,0.9895737171173096,1124,149,1744,769,620,620,rainbow dash|twilight sparkle,andelai
1610071.png,https://derpicdn.net/img/view/2017/12/17/1610071.png,0,0.9946272373199464,359,0,1211,850,852,850,princess luna|twilight sparkle,bugplayer
1610071.png,https://derpicdn.net/img/view/2017/12/17/1610071.png,1,0.9738042950630188,1287,576,1999,1288,712,712,princess luna|twilight sparkle,bugplayer
1610848.png,https://derpicdn.net/img/view/2017/12/18/1610848.png,0,0.9951974153518676,2199,1215,2843,1859,644,644,princess cadance|princess celestia|princess luna|twilight sparkle,awalex
1610848.png,https://derpicdn.net/img/view/2017/12/18/1610848.png,1,0.9782131910324096,453,918,1145,1610,692,692,princess cadance|princess celestia|princess luna|twilight sparkle,awalex
1611668.png,https://derpicdn.net/img/view/2017/12/20/1611668.png,0,0.9811602830886841,419,272,957,810,538,538,princess celestia|twilight sparkle,king-kakapo
1611696.png,https://derpicdn.net/img/view/2017/12/20/1611696.png,1,0.9931005835533142,0,576,394,988,394,412,applejack|fluttershy|mane six|pinkie pie|rainbow dash|rarity|twilight sparkle,xenon
1611696.png,https://derpicdn.net/img/view/2017/12/20/1611696.png,2,0.9861744046211244,820,3,1262,445,442,442,applejack|fluttershy|mane six|pinkie pie|rainbow dash|rarity|twilight sparkle,xenon
1611696.png,https://derpicdn.net/img/view/2017/12/20/1611696.png,3,0.979416012763977,849,581,1285,1017,436,436,applejack|fluttershy|mane six|pinkie pie|rainbow dash|rarity|twilight sparkle,xenon
1611696.png,https://derpicdn.net/img/view/2017/12/20/1611696.png,4,0.9784667491912842,383,0,793,404,410,404,applejack|fluttershy|mane six|pinkie pie|rainbow dash|rarity|twilight sparkle,xenon
1611696.png,https://derpicdn.net/img/view/2017/12/20/1611696.png,5,0.968331217765808,422,632,812,1022,390,390,applejack|fluttershy|mane six|pinkie pie|rainbow dash|rarity|twilight sparkle,xenon
1611827.png,https://derpicdn.net/img/view/2017/12/20/1611827.png,0,0.9931180477142334,1003,433,1667,1097,664,664,princess celestia|rarity|twilight sparkle,spacecolonie|nessacity
1615619.png,https://derpicdn.net/img/view/2017/12/25/1615619.png,0,0.955344021320343,1139,1660,1365,1886,226,226,applejack|discord|fluttershy|mane six|pinkie pie|rainbow dash|rarity|spike|starlight glimmer|trixie|twilight sparkle,inuhoshi-to-darkpen
1615850.png,https://derpicdn.net/img/view/2017/12/25/1615850.png,0,0.9997075200080872,827,311,1171,655,344,344,princess cadance|princess celestia|princess luna|twilight sparkle,brianblackberry
1615850.png,https://derpicdn.net/img/view/2017/12/25/1615850.png,1,0.9868831634521484,549,329,915,695,366,366,princess cadance|princess celestia|princess luna|twilight sparkle,brianblackberry
1617605.png,https://derpicdn.net/img/view/2017/12/27/1617605.png,0,0.9860404133796692,2,0,416,384,414,384,shining armor|twilight sparkle,lulubell
16189.jpg,https://derpicdn.net/img/view/2012/6/23/16189.jpg,0,0.9954433441162108,829,517,1167,855,338,338,pinkie pie|spike|twilight sparkle,ss2sonic
16189.jpg,https://derpicdn.net/img/view/2012/6/23/16189.jpg,1,0.9341591000556946,538,248,820,530,282,282,pinkie pie|spike|twilight sparkle,ss2sonic
1619790.png,https://derpicdn.net/img/view/2017/12/30/1619790.png,0,0.9918910264968872,109,219,607,717,498,498,starlight glimmer|twilight sparkle,pony-way
1619790.png,https://derpicdn.net/img/view/2017/12/30/1619790.png,1,0.9874843955039978,975,383,1255,663,280,280,starlight glimmer|twilight sparkle,pony-way
1621331.png,https://derpicdn.net/img/view/2018/1/1/1621331.png,0,0.9980422258377076,1205,834,1560,1220,355,386,applejack|fluttershy|mane six|pinkie pie|rainbow dash|rarity|spike|starlight glimmer|twilight sparkle,the-butch-x
1621331.png,https://derpicdn.net/img/view/2018/1/1/1621331.png,2,0.9271529912948608,31,995,361,1320,330,325,applejack|fluttershy|mane six|pinkie pie|rainbow dash|rarity|spike|starlight glimmer|twilight sparkle,the-butch-x
1621331.png,https://derpicdn.net/img/view/2018/1/1/1621331.png,3,0.911735475063324,323,500,681,858,358,358,applejack|fluttershy|mane six|pinkie pie|rainbow dash|rarity|spike|starlight glimmer|twilight sparkle,the-butch-x
1622166.png,https://derpicdn.net/img/view/2018/1/2/1622166.png,0,0.9910874962806702,250,15,620,385,370,370,starlight glimmer|twilight sparkle,hoodie
1625151.png,https://derpicdn.net/img/view/2018/1/6/1625151.png,0,0.9938204884529114,609,313,1897,1601,1288,1288,spike|twilight sparkle,shutterflyeqd
1634140.png,https://derpicdn.net/img/view/2018/1/17/1634140.png,0,0.9938790202140808,659,246,1199,786,540,540,princess celestia|twilight sparkle,scarlet-spectrum
1636473.png,https://derpicdn.net/img/view/2018/1/20/1636473.png,0,0.9400656819343568,186,0,662,414,476,414,princess luna|twilight sparkle,noctilucent-arts
1638074.png,https://derpicdn.net/img/view/2018/1/22/1638074.png,0,0.9747727513313292,595,13,1280,723,685,710,fluttershy|twilight sparkle,lilboulder
1640180.png,https://derpicdn.net/img/view/2018/1/25/1640180.png,0,0.9845837354660034,353,267,1641,1555,1288,1288,rarity|twilight sparkle,lilfunkman
1645322.png,https://derpicdn.net/img/view/2018/1/31/1645322.png,1,0.9940894246101379,457,101,1095,739,638,638,applejack|fluttershy|mane six|pinkie pie|rainbow dash|rarity|twilight sparkle,ryuu
1645322.png,https://derpicdn.net/img/view/2018/1/31/1645322.png,2,0.9923998117446899,566,736,1062,1232,496,496,applejack|fluttershy|mane six|pinkie pie|rainbow dash|rarity|twilight sparkle,ryuu
1645507.png,https://derpicdn.net/img/view/2018/1/31/1645507.png,0,0.9802486896514891,137,0,1105,782,968,782,pinkie pie|twilight sparkle,niggerfaggot
1647043.png,https://derpicdn.net/img/view/2018/2/2/1647043.png,0,0.9838358163833618,4408,2812,5478,3882,1070,1070,applejack|fluttershy|mane six|pinkie pie|rainbow dash|rarity|twilight sparkle,orin331
1647043.png,https://derpicdn.net/img/view/2018/2/2/1647043.png,1,0.9705333113670348,1667,3223,2603,4159,936,936,applejack|fluttershy|mane six|pinkie pie|rainbow dash|rarity|twilight sparkle,orin331
1647194.png,https://derpicdn.net/img/view/2018/2/3/1647194.png,0,0.9920899271965028,1330,658,1590,918,260,260,applejack|fluttershy|mane six|pinkie pie|rainbow dash|rarity|twilight sparkle,luckreza8|orin331|3d4d
1647194.png,https://derpicdn.net/img/view/2018/2/3/1647194.png,1,0.9919089078903198,924,560,1246,882,322,322,applejack|fluttershy|mane six|pinkie pie|rainbow dash|rarity|twilight sparkle,luckreza8|orin331|3d4d
1647194.png,https://derpicdn.net/img/view/2018/2/3/1647194.png,2,0.9676535725593568,1024,0,1304,276,280,276,applejack|fluttershy|mane six|pinkie pie|rainbow dash|rarity|twilight sparkle,luckreza8|orin331|3d4d
1647194.png,https://derpicdn.net/img/view/2018/2/3/1647194.png,3,0.9675515294075012,1480,64,1762,346,282,282,applejack|fluttershy|mane six|pinkie pie|rainbow dash|rarity|twilight sparkle,luckreza8|orin331|3d4d
1647194.png,https://derpicdn.net/img/view/2018/2/3/1647194.png,4,0.9434107542037964,351,1122,595,1366,244,244,applejack|fluttershy|mane six|pinkie pie|rainbow dash|rarity|twilight sparkle,luckreza8|orin331|3d4d
1647194.png,https://derpicdn.net/img/view/2018/2/3/1647194.png,5,0.927014410495758,0,1218,310,1534,310,316,applejack|fluttershy|mane six|pinkie pie|rainbow dash|rarity|twilight sparkle,luckreza8|orin331|3d4d
1647726.png,https://derpicdn.net/img/view/2018/2/3/1647726.png,0,0.9974167943000792,0,378,635,1018,635,640,applejack|queen chrysalis|starlight glimmer|twilight sparkle,kyokimute
1647726.png,https://derpicdn.net/img/view/2018/2/3/1647726.png,1,0.988541543483734,802,694,1255,1228,453,534,applejack|queen chrysalis|starlight glimmer|twilight sparkle,kyokimute
1647726.png,https://derpicdn.net/img/view/2018/2/3/1647726.png,2,0.9735986590385436,269,742,767,1240,498,498,applejack|queen chrysalis|starlight glimmer|twilight sparkle,kyokimute
1647726.png,https://derpicdn.net/img/view/2018/2/3/1647726.png,3,0.9268842935562134,642,105,1024,487,382,382,applejack|queen chrysalis|starlight glimmer|twilight sparkle,kyokimute
1651108.png,https://derpicdn.net/img/view/2018/2/8/1651108.png,0,0.9688747525215148,229,18,1849,1500,1620,1482,princess celestia|spike|twilight sparkle,itsalwayspony
1655470.png,https://derpicdn.net/img/view/2018/2/14/1655470.png,1,0.998572826385498,612,81,930,399,318,318,big macintosh|princess cadance|shining armor|spike|starlight glimmer|sweetie belle|twilight sparkle,dm29
1657201.png,https://derpicdn.net/img/view/2018/2/16/1657201.png,0,0.953829288482666,181,49,733,601,552,552,starlight glimmer|twilight sparkle,zouyugi
1662048.png,https://derpicdn.net/img/view/2018/2/21/1662048.png,0,0.9551590085029602,261,106,477,322,216,216,applejack|fluttershy|mane six|pinkie pie|rainbow dash|rarity|twilight sparkle,luciferamon
1666215.png,https://derpicdn.net/img/view/2018/2/26/1666215.png,0,0.9975460171699524,715,381,1201,867,486,486,rarity|twilight sparkle,frogbians
1666215.png,https://derpicdn.net/img/view/2018/2/26/1666215.png,1,0.9599310755729676,139,222,685,768,546,546,rarity|twilight sparkle,frogbians
1666711.png,https://derpicdn.net/img/view/2018/2/26/1666711.png,1,0.9643131494522096,132,113,282,263,150,150,applejack|fluttershy|mane six|pinkie pie|rainbow dash|rarity|twilight sparkle,caelynmlp
166725.png,https://derpicdn.net/img/view/2012/11/29/166725.png,0,0.9613388180732728,470,89,728,347,258,258,princess celestia|twilight sparkle,ratofdrawn
1667416.png,https://derpicdn.net/img/view/2018/2/27/1667416.png,0,0.9988266825675964,524,69,1508,1053,984,984,applejack|fluttershy|mane six|pinkie pie|rainbow dash|rarity|twilight sparkle,dsp2003
1667416.png,https://derpicdn.net/img/view/2018/2/27/1667416.png,1,0.9980596899986268,1849,1356,2801,2308,952,952,applejack|fluttershy|mane six|pinkie pie|rainbow dash|rarity|twilight sparkle,dsp2003
1667416.png,https://derpicdn.net/img/view/2018/2/27/1667416.png,2,0.9933745861053468,1682,4,2708,1030,1026,1026,applejack|fluttershy|mane six|pinkie pie|rainbow dash|rarity|twilight sparkle,dsp2003
1667416.png,https://derpicdn.net/img/view/2018/2/27/1667416.png,3,0.9802338480949402,1303,2065,2025,2787,722,722,applejack|fluttershy|mane six|pinkie pie|rainbow dash|rarity|twilight sparkle,dsp2003
1667416.png,https://derpicdn.net/img/view/2018/2/27/1667416.png,4,0.9765591025352478,370,1085,1382,2097,1012,1012,applejack|fluttershy|mane six|pinkie pie|rainbow dash|rarity|twilight sparkle,dsp2003
1671456.png,https://derpicdn.net/img/view/2018/3/4/1671456.png,0,0.9837677478790284,2508,150,2864,506,356,356,applejack|fluttershy|mane six|pinkie pie|rainbow dash|rarity|twilight sparkle,orchidpony
1675140.png,https://derpicdn.net/img/view/2018/3/9/1675140.png,1,0.9589267373085022,646,131,814,299,168,168,rarity|spike|twilight sparkle,pia-sama
1677047.png,https://derpicdn.net/img/view/2018/3/11/1677047.png,0,0.9972782731056212,80,0,570,400,490,400,pinkie pie|spike|twilight sparkle,shoutingisfun
1684197.png,https://derpicdn.net/img/view/2018/3/18/1684197.png,0,0.9551119804382324,258,155,548,445,290,290,princess cadance|princess celestia|princess luna|queen chrysalis|twilight sparkle,pusspuss
1686757.png,https://derpicdn.net/img/view/2018/3/21/1686757.png,0,0.9933542609214784,310,9,890,589,580,580,applejack|twilight sparkle,umejiru
1688494.png,https://derpicdn.net/img/view/2018/3/23/1688494.png,0,0.9913778305053712,502,287,890,675,388,388,starlight glimmer|trixie|twilight sparkle,andelai
1689556.png,https://derpicdn.net/img/view/2018/3/24/1689556.png,0,0.9873047471046448,463,132,801,470,338,338,princess celestia|queen chrysalis|twilight sparkle,stasysolitude
1690879.png,https://derpicdn.net/img/view/2018/3/26/1690879.png,0,0.9862122535705566,101,63,559,521,458,458,applejack|fluttershy|mane six|pinkie pie|rainbow dash|rarity|twilight sparkle,mickeymonster
1690879.png,https://derpicdn.net/img/view/2018/3/26/1690879.png,1,0.9760872721672058,610,0,1224,570,614,570,applejack|fluttershy|mane six|pinkie pie|rainbow dash|rarity|twilight sparkle,mickeymonster
1690879.png,https://derpicdn.net/img/view/2018/3/26/1690879.png,2,0.9130815267562866,733,758,1261,1286,528,528,applejack|fluttershy|mane six|pinkie pie|rainbow dash|rarity|twilight sparkle,mickeymonster
1691839.png,https://derpicdn.net/img/view/2018/3/27/1691839.png,0,0.9490317106246948,266,75,594,403,328,328,princess celestia|twilight sparkle,lulubell
1692915.png,https://derpicdn.net/img/view/2018/3/28/1692915.png,0,0.9786205291748048,807,329,1503,1025,696,696,fluttershy|twilight sparkle,sirzi
1692915.png,https://derpicdn.net/img/view/2018/3/28/1692915.png,1,0.9715831875801086,258,255,962,959,704,704,fluttershy|twilight sparkle,sirzi
1694097.png,https://derpicdn.net/img/view/2018/3/29/1694097.png,0,0.9625173807144164,88,0,824,672,736,672,spike|twilight sparkle,dsana
1695440.png,https://derpicdn.net/img/view/2018/3/31/1695440.png,0,0.986432671546936,264,203,808,747,544,544,sunset shimmer|twilight sparkle,jus+ice
1699941.png,https://derpicdn.net/img/view/2018/4/5/1699941.png,0,0.9648060202598572,2124,422,3288,1586,1164,1164,spike|twilight sparkle,taneysha
1700206.png,https://derpicdn.net/img/view/2018/4/5/1700206.png,0,0.9966942071914672,590,81,1392,883,802,802,princess luna|twilight sparkle,tracerhorse
1702283.png,https://derpicdn.net/img/view/2018/4/8/1702283.png,0,0.9794221520423888,0,674,731,1422,731,748,apple bloom|applejack|cutie mark crusaders|rainbow dash|scootaloo|spike|sweetie belle|twilight sparkle,mich-art
1702283.png,https://derpicdn.net/img/view/2018/4/8/1702283.png,1,0.9724034667015076,1484,564,1794,874,310,310,apple bloom|applejack|cutie mark crusaders|rainbow dash|scootaloo|spike|sweetie belle|twilight sparkle,mich-art
1705033.png,https://derpicdn.net/img/view/2018/4/11/1705033.png,2,0.9402078986167908,737,0,939,190,202,190,apple bloom|applejack|big macintosh|cutie mark crusaders|diamond tiara|fluttershy|mane six|pinkie pie|princess cadance|princess celestia|princess flurry heart|princess luna|rainbow dash|rarity|scootaloo|silver spoon|spike|spitfire|starlight glimmer|sunset shimmer|sweetie belle|trixie|twilight sparkle,bobdude0
1705033.png,https://derpicdn.net/img/view/2018/4/11/1705033.png,3,0.9312984347343444,0,60,159,240,159,180,apple bloom|applejack|big macintosh|cutie mark crusaders|diamond tiara|fluttershy|mane six|pinkie pie|princess cadance|princess celestia|princess flurry heart|princess luna|rainbow dash|rarity|scootaloo|silver spoon|spike|spitfire|starlight glimmer|sunset shimmer|sweetie belle|trixie|twilight sparkle,bobdude0
1710139.png,https://derpicdn.net/img/view/2018/4/17/1710139.png,0,0.970400869846344,114,21,408,315,294,294,rainbow dash|twilight sparkle,radiantrealm
1711183.png,https://derpicdn.net/img/view/2018/4/18/1711183.png,0,0.9986433386802672,1144,262,1856,974,712,712,rainbow dash|twilight sparkle,andelai
1711183.png,https://derpicdn.net/img/view/2018/4/18/1711183.png,1,0.9973946809768676,1705,0,2887,1162,1182,1162,rainbow dash|twilight sparkle,andelai
1714011.png,https://derpicdn.net/img/view/2018/4/21/1714011.png,0,0.957460641860962,419,85,1299,965,880,880,spike|twilight sparkle,the-butch-x
1714011.png,https://derpicdn.net/img/view/2018/4/21/1714011.png,1,0.9520717263221741,1151,224,1784,900,633,676,spike|twilight sparkle,the-butch-x
1715690.png,https://derpicdn.net/img/view/2018/4/24/1715690.png,0,0.9941800832748412,272,345,670,743,398,398,spike|twilight sparkle,tsitra360
1717224.png,https://derpicdn.net/img/view/2018/4/26/1717224.png,0,0.998184859752655,746,1127,1152,1533,406,406,applejack|fluttershy|mane six|pinkie pie|rainbow dash|rarity|spike|twilight sparkle,tsitra360
1717224.png,https://derpicdn.net/img/view/2018/4/26/1717224.png,1,0.9914623498916626,39,180,539,680,500,500,applejack|fluttershy|mane six|pinkie pie|rainbow dash|rarity|spike|twilight sparkle,tsitra360
1717224.png,https://derpicdn.net/img/view/2018/4/26/1717224.png,2,0.9832378625869752,1017,326,1405,714,388,388,applejack|fluttershy|mane six|pinkie pie|rainbow dash|rarity|spike|twilight sparkle,tsitra360
1717224.png,https://derpicdn.net/img/view/2018/4/26/1717224.png,3,0.9548885226249696,1038,1962,1354,2278,316,316,applejack|fluttershy|mane six|pinkie pie|rainbow dash|rarity|spike|twilight sparkle,tsitra360
1719109.png,https://derpicdn.net/img/view/2018/4/28/1719109.png,0,0.9889706373214722,670,140,1544,1014,874,874,princess celestia|princess luna|twilight sparkle,thisisnotyournormieblog
1720515.png,https://derpicdn.net/img/view/2018/4/30/1720515.png,0,0.9937368631362916,79,165,355,441,276,276,fluttershy|rarity|twilight sparkle,skorpionletun
17211.jpg,https://derpicdn.net/img/view/2012/6/23/17211.jpg,0,0.9774510860443116,16,2047,314,2345,298,298,applejack|fluttershy|pinkie pie|rainbow dash|rarity|spitfire|trixie|twilight sparkle,pyruvate
17211.jpg,https://derpicdn.net/img/view/2012/6/23/17211.jpg,1,0.9771609306335448,0,245,494,949,494,704,applejack|fluttershy|pinkie pie|rainbow dash|rarity|spitfire|trixie|twilight sparkle,pyruvate
17211.jpg,https://derpicdn.net/img/view/2012/6/23/17211.jpg,2,0.9769657254219056,322,2037,664,2379,342,342,applejack|fluttershy|pinkie pie|rainbow dash|rarity|spitfire|trixie|twilight sparkle,pyruvate
17211.jpg,https://derpicdn.net/img/view/2012/6/23/17211.jpg,3,0.9437503218650818,643,841,976,1177,333,336,applejack|fluttershy|pinkie pie|rainbow dash|rarity|spitfire|trixie|twilight sparkle,pyruvate
1722284.png,https://derpicdn.net/img/view/2018/5/2/1722284.png,1,0.9907292127609252,304,2446,1420,3562,1116,1116,applejack|fluttershy|mane six|pinkie pie|rainbow dash|rarity|twilight sparkle,ask-colorsound
1722284.png,https://derpicdn.net/img/view/2018/5/2/1722284.png,2,0.9890751242637634,1342,2515,2656,3829,1314,1314,applejack|fluttershy|mane six|pinkie pie|rainbow dash|rarity|twilight sparkle,ask-colorsound
1722284.png,https://derpicdn.net/img/view/2018/5/2/1722284.png,3,0.9774083495140076,1840,1365,3096,2621,1256,1256,applejack|fluttershy|mane six|pinkie pie|rainbow dash|rarity|twilight sparkle,ask-colorsound
1722284.png,https://derpicdn.net/img/view/2018/5/2/1722284.png,4,0.9745196700096128,2654,2401,3684,3431,1030,1030,applejack|fluttershy|mane six|pinkie pie|rainbow dash|rarity|twilight sparkle,ask-colorsound
1723607.png,https://derpicdn.net/img/view/2018/5/4/1723607.png,0,0.9913943409919742,1197,0,1829,500,632,500,starlight glimmer|sunset shimmer|twilight sparkle,wilvarin-liadon
1723607.png,https://derpicdn.net/img/view/2018/5/4/1723607.png,1,0.9752221703529358,209,0,647,419,438,419,starlight glimmer|sunset shimmer|twilight sparkle,wilvarin-liadon
1725015.png,https://derpicdn.net/img/view/2018/5/5/1725015.png,1,0.985444724559784,2366,702,3389,1844,1023,1142,fluttershy|pinkie pie|rainbow dash|twilight sparkle,mirroredsea
1725015.png,https://derpicdn.net/img/view/2018/5/5/1725015.png,2,0.9827543497085572,210,751,1316,1857,1106,1106,fluttershy|pinkie pie|rainbow dash|twilight sparkle,mirroredsea
1727751.png,https://derpicdn.net/img/view/2018/5/8/1727751.png,0,0.9976009130477904,961,232,1375,646,414,414,queen chrysalis|twilight sparkle,suirano
1730.png,https://derpicdn.net/img/view/2012/1/23/1730.png,0,0.989569127559662,239,0,883,583,644,583,rainbow dash|twilight sparkle,furseiseki
1732075.png,https://derpicdn.net/img/view/2018/5/13/1732075.png,0,0.9693254828453064,2283,1191,2945,1853,662,662,applejack|diamond tiara|discord|fluttershy|mane six|pinkie pie|rainbow dash|rarity|twilight sparkle,skitter
1732075.png,https://derpicdn.net/img/view/2018/5/13/1732075.png,2,0.9484625458717346,649,1168,1471,1990,822,822,applejack|diamond tiara|discord|fluttershy|mane six|pinkie pie|rainbow dash|rarity|twilight sparkle,skitter
1734618.png,https://derpicdn.net/img/view/2018/5/17/1734618.png,0,0.941873013973236,561,446,1713,1598,1152,1152,applejack|rarity|twilight sparkle,ohemo
1734618.png,https://derpicdn.net/img/view/2018/5/17/1734618.png,1,0.930134117603302,2132,115,2958,941,826,826,applejack|rarity|twilight sparkle,ohemo
173550.png,https://derpicdn.net/img/view/2012/12/5/173550.png,0,0.9918214082717896,551,0,763,192,212,192,fluttershy|princess cadance|princess celestia|princess luna|twilight sparkle,skykain
173550.png,https://derpicdn.net/img/view/2012/12/5/173550.png,1,0.9817428588867188,706,457,920,671,214,214,fluttershy|princess cadance|princess celestia|princess luna|twilight sparkle,skykain
1738480.png,https://derpicdn.net/img/view/2018/5/21/1738480.png,1,0.9208971261978148,275,1307,501,1533,226,226,spike|twilight sparkle,inuhoshi-to-darkpen
1742517.png,https://derpicdn.net/img/view/2018/5/27/1742517.png,0,0.9778311848640442,61,37,1711,1687,1650,1650,queen chrysalis|twilight sparkle,skitter
1744.jpg,https://derpicdn.net/img/view/2012/1/23/1744.jpg,0,0.9984166622161864,494,0,1190,582,696,582,princess celestia|twilight sparkle,johnjoseco
1746568.png,https://derpicdn.net/img/view/2018/6/1/1746568.png,1,0.9876309633255004,85,441,459,815,374,374,rainbow dash|twilight sparkle,bakuhaku
1749412.png,https://derpicdn.net/img/view/2018/6/4/1749412.png,0,0.9684118032455444,194,0,890,630,696,630,spike|twilight sparkle,heddopen
1749412.png,https://derpicdn.net/img/view/2018/6/4/1749412.png,1,0.9597533345222472,1042,0,1500,502,458,502,spike|twilight sparkle,heddopen
1749579.png,https://derpicdn.net/img/view/2018/6/4/1749579.png,0,0.9980683326721193,994,871,1408,1285,414,414,princess cadance|princess celestia|princess luna|twilight sparkle,rossignolet
175008.jpg,https://derpicdn.net/img/view/2012/12/7/175008.jpg,0,0.9915013909339904,521,643,739,861,218,218,applejack|fluttershy|mane six|pinkie pie|rainbow dash|rarity|spike|twilight sparkle,shalonesk
175008.jpg,https://derpicdn.net/img/view/2012/12/7/175008.jpg,1,0.982124090194702,54,394,332,672,278,278,applejack|fluttershy|mane six|pinkie pie|rainbow dash|rarity|spike|twilight sparkle,shalonesk
175008.jpg,https://derpicdn.net/img/view/2012/12/7/175008.jpg,2,0.9552977681159972,381,129,699,447,318,318,applejack|fluttershy|mane six|pinkie pie|rainbow dash|rarity|spike|twilight sparkle,shalonesk
1751034.png,https://derpicdn.net/img/view/2018/6/6/1751034.png,0,0.9948833584785458,142,0,1216,1044,1074,1044,rainbow dash|twilight sparkle,mrscurlystyles
1751034.png,https://derpicdn.net/img/view/2018/6/6/1751034.png,1,0.9615728855133056,806,0,1930,1110,1124,1110,rainbow dash|twilight sparkle,mrscurlystyles
1752006.png,https://derpicdn.net/img/view/2018/6/7/1752006.png,0,0.958779752254486,225,12,655,442,430,430,rainbow dash|twilight sparkle,hiccupsdoesart
1754441.png,https://derpicdn.net/img/view/2018/6/10/1754441.png,0,0.9930680990219116,19,131,619,731,600,600,sunset shimmer|twilight sparkle,iloota
175890.png,https://derpicdn.net/img/view/2012/12/8/175890.png,0,0.9918144345283508,429,0,887,449,458,449,big macintosh|trixie|twilight sparkle,carmelcube
175890.png,https://derpicdn.net/img/view/2012/12/8/175890.png,1,0.9913678765296936,1549,80,2000,582,451,502,big macintosh|trixie|twilight sparkle,carmelcube
175890.png,https://derpicdn.net/img/view/2012/12/8/175890.png,3,0.9046486020088196,0,233,427,667,427,434,big macintosh|trixie|twilight sparkle,carmelcube
1760763.png,https://derpicdn.net/img/view/2018/6/18/1760763.png,0,0.9990329742431641,437,384,643,590,206,206,princess celestia|twilight sparkle,draltruist
1760763.png,https://derpicdn.net/img/view/2018/6/18/1760763.png,1,0.998799204826355,126,253,338,465,212,212,princess celestia|twilight sparkle,draltruist
1761968.png,https://derpicdn.net/img/view/2018/6/20/1761968.png,0,0.9933326244354248,655,712,1357,1414,702,702,princess celestia|princess luna|twilight sparkle,peridotkitty
1761968.png,https://derpicdn.net/img/view/2018/6/20/1761968.png,1,0.9796910881996156,66,1162,846,1942,780,780,princess celestia|princess luna|twilight sparkle,peridotkitty
1761968.png,https://derpicdn.net/img/view/2018/6/20/1761968.png,2,0.9010927677154541,1761,1332,2457,2028,696,696,princess celestia|princess luna|twilight sparkle,peridotkitty
1762362.png,https://derpicdn.net/img/view/2018/6/20/1762362.png,0,0.9990174770355223,321,145,729,553,408,408,pinkie pie|twilight sparkle,baron engel
1762865.png,https://derpicdn.net/img/view/2018/6/21/1762865.png,0,0.9976551532745358,113,251,323,461,210,210,princess celestia|twilight sparkle,draltruist
1762931.png,https://derpicdn.net/img/view/2018/6/21/1762931.png,0,0.9743016958236694,273,45,553,325,280,280,spike|twilight sparkle,hc0
1763464.png,https://derpicdn.net/img/view/2018/6/22/1763464.png,0,0.9796406626701356,41,0,589,512,548,512,starlight glimmer|sunset shimmer|twilight sparkle,chautung|ch-chau|whiskyice
1763464.png,https://derpicdn.net/img/view/2018/6/22/1763464.png,1,0.9764729738235474,494,0,1044,517,550,517,starlight glimmer|sunset shimmer|twilight sparkle,chautung|ch-chau|whiskyice
1763464.png,https://derpicdn.net/img/view/2018/6/22/1763464.png,2,0.9067058563232422,841,0,1341,488,500,488,starlight glimmer|sunset shimmer|twilight sparkle,chautung|ch-chau|whiskyice
1764597.png,https://derpicdn.net/img/view/2018/6/24/1764597.png,0,0.9735562205314636,412,540,1138,1266,726,726,princess cadance|princess celestia|princess flurry heart|princess luna|twilight sparkle,ohemo
1768935.png,https://derpicdn.net/img/view/2018/6/29/1768935.png,0,0.9884912967681884,1019,1034,1597,1612,578,578,applejack|fluttershy|mane six|pinkie pie|rainbow dash|rarity|twilight sparkle,light262
1768935.png,https://derpicdn.net/img/view/2018/6/29/1768935.png,1,0.9835876226425172,452,777,960,1285,508,508,applejack|fluttershy|mane six|pinkie pie|rainbow dash|rarity|twilight sparkle,light262
1768935.png,https://derpicdn.net/img/view/2018/6/29/1768935.png,2,0.9585763812065125,1637,362,2103,828,466,466,applejack|fluttershy|mane six|pinkie pie|rainbow dash|rarity|twilight sparkle,light262
1769487.png,https://derpicdn.net/img/view/2018/6/30/1769487.png,0,0.9712193012237548,911,33,1953,1075,1042,1042,rainbow dash|twilight sparkle,elzzombie
1774999.png,https://derpicdn.net/img/view/2018/7/7/1774999.png,0,0.9924224019050598,425,76,755,406,330,330,princess celestia|twilight sparkle,jus+ice
1782026.png,https://derpicdn.net/img/view/2018/7/16/1782026.png,0,0.9767497181892396,715,2795,1045,3125,330,330,fluttershy|twilight sparkle,silfoe
1783242.png,https://derpicdn.net/img/view/2018/7/17/1783242.png,0,0.9891374111175536,558,209,860,511,302,302,princess cadance|princess celestia|princess flurry heart|princess luna|twilight sparkle,pohwaran
1783242.png,https://derpicdn.net/img/view/2018/7/17/1783242.png,2,0.9495234489440918,303,264,597,558,294,294,princess cadance|princess celestia|princess flurry heart|princess luna|twilight sparkle,pohwaran
1784605.png,https://derpicdn.net/img/view/2018/7/19/1784605.png,0,0.9993138313293456,1804,489,2350,1035,546,546,spike|twilight sparkle,luciferamon
1787757.png,https://derpicdn.net/img/view/2018/7/23/1787757.png,0,0.9971810579299928,264,462,644,842,380,380,princess celestia|twilight sparkle,king-kakapo
1787757.png,https://derpicdn.net/img/view/2018/7/23/1787757.png,1,0.9894506335258484,1003,160,1485,642,482,482,princess celestia|twilight sparkle,king-kakapo
1789279.png,https://derpicdn.net/img/view/2018/7/25/1789279.png,0,0.9670089483261108,721,305,1201,785,480,480,spike|twilight sparkle,dsana
179351.png,https://derpicdn.net/img/view/2012/12/11/179351.png,0,0.981723129749298,244,117,588,461,344,344,princess cadance|twilight sparkle,averagedraw
1794733.png,https://derpicdn.net/img/view/2018/8/1/1794733.png,0,0.9727164506912231,1094,319,1548,773,454,454,applejack|rainbow dash|twilight sparkle,malinetourmaline
1798.png,https://derpicdn.net/img/view/2012/1/23/1798.png,0,0.9961272478103638,604,37,870,303,266,266,princess celestia|twilight sparkle,johnjoseco
1799815.png,https://derpicdn.net/img/view/2018/8/6/1799815.png,0,0.9930459856987,1474,527,2460,1513,986,986,starlight glimmer|twilight sparkle,shutterflyeqd
1799815.png,https://derpicdn.net/img/view/2018/8/6/1799815.png,1,0.9853087067604064,586,390,1686,1490,1100,1100,starlight glimmer|twilight sparkle,shutterflyeqd
1804204.png,https://derpicdn.net/img/view/2018/8/11/1804204.png,0,0.9789204597473145,665,55,1143,533,478,478,fluttershy|twilight sparkle,king-kakapo
1804581.png,https://derpicdn.net/img/view/2018/8/12/1804581.png,0,0.9906368255615234,2581,0,4885,2091,2304,2091,rarity|twilight sparkle,jhayarr23
1804581.png,https://derpicdn.net/img/view/2018/8/12/1804581.png,1,0.9825930595397948,0,0,2526,2392,2526,2392,rarity|twilight sparkle,jhayarr23
1806083.png,https://derpicdn.net/img/view/2018/8/13/1806083.png,0,0.983914852142334,595,6,1024,448,429,442,rarity|twilight sparkle,inuhoshi-to-darkpen
1806478.png,https://derpicdn.net/img/view/2018/8/14/1806478.png,0,0.9518076181411744,1279,0,2195,817,916,817,starlight glimmer|trixie|twilight sparkle,wilvarin-liadon
1806849.png,https://derpicdn.net/img/view/2018/8/14/1806849.png,0,0.9975752830505372,1367,0,2885,1367,1518,1367,sunset shimmer|twilight sparkle,vanillaghosties
1808742.png,https://derpicdn.net/img/view/2018/8/16/1808742.png,0,0.9873980283737184,425,61,1043,679,618,618,princess celestia|twilight sparkle,magnaluna
1809604.png,https://derpicdn.net/img/view/2018/8/17/1809604.png,0,0.9426228404045104,212,18,556,362,344,344,pinkie pie|twilight sparkle,tzc
1810562.png,https://derpicdn.net/img/view/2018/8/19/1810562.png,0,0.9998745918273926,1728,0,2400,600,672,600,applejack|fluttershy|mane six|pinkie pie|princess cadance|princess celestia|princess luna|rainbow dash|rarity|starlight glimmer|sunset shimmer|trixie|twilight sparkle,sion-ara
1810562.png,https://derpicdn.net/img/view/2018/8/19/1810562.png,1,0.9985636472702026,41,0,599,538,558,538,applejack|fluttershy|mane six|pinkie pie|princess cadance|princess celestia|princess luna|rainbow dash|rarity|starlight glimmer|sunset shimmer|trixie|twilight sparkle,sion-ara
1810562.png,https://derpicdn.net/img/view/2018/8/19/1810562.png,2,0.998468816280365,604,0,1158,496,554,496,applejack|fluttershy|mane six|pinkie pie|princess cadance|princess celestia|princess luna|rainbow dash|rarity|starlight glimmer|sunset shimmer|trixie|twilight sparkle,sion-ara
1810562.png,https://derpicdn.net/img/view/2018/8/19/1810562.png,3,0.996658444404602,0,522,574,1098,574,576,applejack|fluttershy|mane six|pinkie pie|princess cadance|princess celestia|princess luna|rainbow dash|rarity|starlight glimmer|sunset shimmer|trixie|twilight sparkle,sion-ara
1810562.png,https://derpicdn.net/img/view/2018/8/19/1810562.png,4,0.9929336905479432,1762,529,2400,1175,638,646,applejack|fluttershy|mane six|pinkie pie|princess cadance|princess celestia|princess luna|rainbow dash|rarity|starlight glimmer|sunset shimmer|trixie|twilight sparkle,sion-ara
1810562.png,https://derpicdn.net/img/view/2018/8/19/1810562.png,5,0.9899863004684448,1859,1190,2400,1738,541,548,applejack|fluttershy|mane six|pinkie pie|princess cadance|princess celestia|princess luna|rainbow dash|rarity|starlight glimmer|sunset shimmer|trixie|twilight sparkle,sion-ara
1810562.png,https://derpicdn.net/img/view/2018/8/19/1810562.png,6,0.9759719967842102,1216,0,1828,569,612,569,applejack|fluttershy|mane six|pinkie pie|princess cadance|princess celestia|princess luna|rainbow dash|rarity|starlight glimmer|sunset shimmer|trixie|twilight sparkle,sion-ara
1810562.png,https://derpicdn.net/img/view/2018/8/19/1810562.png,7,0.9599298238754272,1165,1151,1749,1735,584,584,applejack|fluttershy|mane six|pinkie pie|princess cadance|princess celestia|princess luna|rainbow dash|rarity|starlight glimmer|sunset shimmer|trixie|twilight sparkle,sion-ara
1810562.png,https://derpicdn.net/img/view/2018/8/19/1810562.png,8,0.94595068693161,533,1056,1255,1778,722,722,applejack|fluttershy|mane six|pinkie pie|princess cadance|princess celestia|princess luna|rainbow dash|rarity|starlight glimmer|sunset shimmer|trixie|twilight sparkle,sion-ara
1810562.png,https://derpicdn.net/img/view/2018/8/19/1810562.png,9,0.924278736114502,588,529,1162,1103,574,574,applejack|fluttershy|mane six|pinkie pie|princess cadance|princess celestia|princess luna|rainbow dash|rarity|starlight glimmer|sunset shimmer|trixie|twilight sparkle,sion-ara
1814434.png,https://derpicdn.net/img/view/2018/8/23/1814434.png,0,0.9487983584403992,0,2,358,376,358,374,rarity|twilight sparkle,oneofyouare
1816715.png,https://derpicdn.net/img/view/2018/8/26/1816715.png,0,0.9244422912597656,1674,596,1904,826,230,230,princess celestia|twilight sparkle,hierozaki
1818150.png,https://derpicdn.net/img/view/2018/8/27/1818150.png,0,0.9969452619552612,0,0,1123,1425,1123,1425,applejack|fluttershy|mane six|pinkie pie|rainbow dash|rarity|spike|starlight glimmer|twilight sparkle,danmakuman
1821186.png,https://derpicdn.net/img/view/2018/8/31/1821186.png,0,0.9904620051383972,726,24,1336,634,610,610,princess cadance|twilight sparkle,tigra0118
1821381.png,https://derpicdn.net/img/view/2018/8/31/1821381.png,0,0.9778382182121276,552,202,742,392,190,190,fluttershy|rainbow dash|rarity|twilight sparkle,brother-lionheart
1821381.png,https://derpicdn.net/img/view/2018/8/31/1821381.png,1,0.9542903900146484,726,184,942,400,216,216,fluttershy|rainbow dash|rarity|twilight sparkle,brother-lionheart
1821691.png,https://derpicdn.net/img/view/2018/9/1/1821691.png,0,0.9860736131668092,18,128,462,572,444,444,applejack|fluttershy|mane six|pinkie pie|rainbow dash|rarity|twilight sparkle,ghostlymarie
1821691.png,https://derpicdn.net/img/view/2018/9/1/1821691.png,1,0.9750878810882568,765,61,1125,421,360,360,applejack|fluttershy|mane six|pinkie pie|rainbow dash|rarity|twilight sparkle,ghostlymarie
1821691.png,https://derpicdn.net/img/view/2018/9/1/1821691.png,2,0.9489567279815674,706,524,1064,882,358,358,applejack|fluttershy|mane six|pinkie pie|rainbow dash|rarity|twilight sparkle,ghostlymarie
1822457.png,https://derpicdn.net/img/view/2018/9/2/1822457.png,2,0.9124053120613098,330,23,716,409,386,386,applejack|fluttershy|mane six|pinkie pie|rainbow dash|rarity|twilight sparkle,glorious-rarien
1824425.png,https://derpicdn.net/img/view/2018/9/4/1824425.png,1,0.9664767384529114,506,37,704,235,198,198,spike|twilight sparkle,pia-sama
182463.png,https://derpicdn.net/img/view/2012/12/14/182463.png,0,0.9704315066337584,558,218,950,618,392,400,princess cadance|twilight sparkle,lustrous-dreams
1826080.png,https://derpicdn.net/img/view/2018/9/6/1826080.png,0,0.974351704120636,1354,1775,1952,2373,598,598,princess celestia|princess luna|spike|twilight sparkle,batonya12561
1826080.png,https://derpicdn.net/img/view/2018/9/6/1826080.png,1,0.9202574491500854,1046,910,1730,1594,684,684,princess celestia|princess luna|spike|twilight sparkle,batonya12561
1829793.png,https://derpicdn.net/img/view/2018/9/10/1829793.png,2,0.9271467328071594,1161,88,1777,704,616,616,applejack|fluttershy|mane six|pinkie pie|rainbow dash|rarity|twilight sparkle,chub-wub
1832112.png,https://derpicdn.net/img/view/2018/9/14/1832112.png,0,0.9918634295463562,79,0,725,498,646,498,applejack|fluttershy|pinkie pie|princess celestia|rainbow dash|rarity|starlight glimmer|sunset shimmer|twilight sparkle,spittfireart|snow angel|rocy canvas|fluffyxai|jhaller|hioshiru|30clock|light262|ende26|vanillaghosties|discorded|sapphfyr|mirroredsea
1832112.png,https://derpicdn.net/img/view/2018/9/14/1832112.png,1,0.942293643951416,1616,413,1892,689,276,276,applejack|fluttershy|pinkie pie|princess celestia|rainbow dash|rarity|starlight glimmer|sunset shimmer|twilight sparkle,spittfireart|snow angel|rocy canvas|fluffyxai|jhaller|hioshiru|30clock|light262|ende26|vanillaghosties|discorded|sapphfyr|mirroredsea
1832112.png,https://derpicdn.net/img/view/2018/9/14/1832112.png,2,0.9137674570083618,1627,698,1920,998,293,300,applejack|fluttershy|pinkie pie|princess celestia|rainbow dash|rarity|starlight glimmer|sunset shimmer|twilight sparkle,spittfireart|snow angel|rocy canvas|fluffyxai|jhaller|hioshiru|30clock|light262|ende26|vanillaghosties|discorded|sapphfyr|mirroredsea
1832112.png,https://derpicdn.net/img/view/2018/9/14/1832112.png,3,0.9040477871894836,0,0,143,154,143,154,applejack|fluttershy|pinkie pie|princess celestia|rainbow dash|rarity|starlight glimmer|sunset shimmer|twilight sparkle,spittfireart|snow angel|rocy canvas|fluffyxai|jhaller|hioshiru|30clock|light262|ende26|vanillaghosties|discorded|sapphfyr|mirroredsea
1833502.png,https://derpicdn.net/img/view/2018/9/15/1833502.png,0,0.9569536447525024,365,0,1622,1080,1257,1080,princess luna|twilight sparkle,lumineko
1835638.png,https://derpicdn.net/img/view/2018/9/18/1835638.png,0,0.9991042017936708,0,340,457,802,457,462,starlight glimmer|twilight sparkle,
1835638.png,https://derpicdn.net/img/view/2018/9/18/1835638.png,1,0.950003147125244,521,288,1407,1174,886,886,starlight glimmer|twilight sparkle,
1840217.png,https://derpicdn.net/img/view/2018/9/24/1840217.png,0,0.9979468584060668,25,107,509,591,484,484,sunset shimmer|twilight sparkle,rvceric
1840381.png,https://derpicdn.net/img/view/2018/9/24/1840381.png,0,0.9223688244819641,54,566,252,764,198,198,sunset shimmer|twilight sparkle,succubi samus
1841627.png,https://derpicdn.net/img/view/2018/9/26/1841627.png,0,0.9956392645835876,389,0,1157,744,768,744,rainbow dash|twilight sparkle,captainpudgemuffin
1842140.png,https://derpicdn.net/img/view/2018/9/27/1842140.png,0,0.9467359185218812,990,322,1326,658,336,336,rainbow dash|trixie|twilight sparkle,dstears
1846910.png,https://derpicdn.net/img/view/2018/10/3/1846910.png,0,0.9880642294883728,33,212,407,586,374,374,spike|twilight sparkle,greyscaleart
1848194.png,https://derpicdn.net/img/view/2018/10/4/1848194.png,1,0.999645471572876,3241,680,3981,1420,740,740,applejack|fluttershy|mane six|pinkie pie|rainbow dash|rarity|twilight sparkle,moozua
1850015.png,https://derpicdn.net/img/view/2018/10/6/1850015.png,0,0.9702816605567932,316,0,1214,792,898,792,princess celestia|princess luna|twilight sparkle,twiren
1852507.png,https://derpicdn.net/img/view/2018/10/9/1852507.png,0,0.997810125350952,0,27,378,423,378,396,applejack|fluttershy|mane six|pinkie pie|rainbow dash|rarity|spike|starlight glimmer|sunset shimmer|twilight sparkle,thebatfang
1852507.png,https://derpicdn.net/img/view/2018/10/9/1852507.png,1,0.9807095527648926,922,93,1200,427,278,334,applejack|fluttershy|mane six|pinkie pie|rainbow dash|rarity|spike|starlight glimmer|sunset shimmer|twilight sparkle,thebatfang
1852507.png,https://derpicdn.net/img/view/2018/10/9/1852507.png,3,0.9716520905494692,815,396,1189,770,374,374,applejack|fluttershy|mane six|pinkie pie|rainbow dash|rarity|spike|starlight glimmer|sunset shimmer|twilight sparkle,thebatfang
1852629.png,https://derpicdn.net/img/view/2018/10/10/1852629.png,0,0.9959323406219482,1829,0,3171,1170,1342,1170,applejack|fluttershy|mane six|pinkie pie|rainbow dash|rarity|twilight sparkle,moozua
1852629.png,https://derpicdn.net/img/view/2018/10/10/1852629.png,1,0.9942421317100524,17,761,1253,1997,1236,1236,applejack|fluttershy|mane six|pinkie pie|rainbow dash|rarity|twilight sparkle,moozua
1852629.png,https://derpicdn.net/img/view/2018/10/10/1852629.png,2,0.9534453749656676,2626,800,3874,2048,1248,1248,applejack|fluttershy|mane six|pinkie pie|rainbow dash|rarity|twilight sparkle,moozua
1855478.png,https://derpicdn.net/img/view/2018/10/13/1855478.png,0,0.9405442476272584,906,379,1130,603,224,224,apple bloom|applejack|big macintosh|cutie mark crusaders|discord|fluttershy|granny smith|lightning dust|pinkie pie|princess celestia|rainbow dash|rarity|scootaloo|spike|spitfire|starlight glimmer|sweetie belle|trixie|twilight sparkle,dm29
1855478.png,https://derpicdn.net/img/view/2018/10/13/1855478.png,1,0.9376481771469116,710,0,1040,271,330,271,apple bloom|applejack|big macintosh|cutie mark crusaders|discord|fluttershy|granny smith|lightning dust|pinkie pie|princess celestia|rainbow dash|rarity|scootaloo|spike|spitfire|starlight glimmer|sweetie belle|trixie|twilight sparkle,dm29
1857524.png,https://derpicdn.net/img/view/2018/10/15/1857524.png,0,0.999075174331665,682,132,996,446,314,314,princess cadance|shining armor|twilight sparkle,novaintellus
1857524.png,https://derpicdn.net/img/view/2018/10/15/1857524.png,1,0.9941302537918092,203,62,535,394,332,332,princess cadance|shining armor|twilight sparkle,novaintellus
1857524.png,https://derpicdn.net/img/view/2018/10/15/1857524.png,2,0.9939569234848022,470,276,702,508,232,232,princess cadance|shining armor|twilight sparkle,novaintellus
1858903.png,https://derpicdn.net/img/view/2018/10/17/1858903.png,0,0.9473817944526672,40,532,1672,2164,1632,1632,fluttershy|rainbow dash|twilight sparkle,atlas-66
1860223.png,https://derpicdn.net/img/view/2018/10/19/1860223.png,0,0.9986923933029176,141,0,1267,1078,1126,1078,applejack|fluttershy|mane six|pinkie pie|rainbow dash|rarity|twilight sparkle,kaleido-art
1860223.png,https://derpicdn.net/img/view/2018/10/19/1860223.png,1,0.9917532801628112,1081,1196,2089,2204,1008,1008,applejack|fluttershy|mane six|pinkie pie|rainbow dash|rarity|twilight sparkle,kaleido-art
1860223.png,https://derpicdn.net/img/view/2018/10/19/1860223.png,2,0.988211154937744,2121,251,3265,1429,1144,1178,applejack|fluttershy|mane six|pinkie pie|rainbow dash|rarity|twilight sparkle,kaleido-art
1860223.png,https://derpicdn.net/img/view/2018/10/19/1860223.png,3,0.9704189300537108,1174,29,2204,1059,1030,1030,applejack|fluttershy|mane six|pinkie pie|rainbow dash|rarity|twilight sparkle,kaleido-art
1860223.png,https://derpicdn.net/img/view/2018/10/19/1860223.png,4,0.9030799865722656,1994,1820,3108,2934,1114,1114,applejack|fluttershy|mane six|pinkie pie|rainbow dash|rarity|twilight sparkle,kaleido-art
186215.jpg,https://derpicdn.net/img/view/2012/12/18/186215.jpg,0,0.9996418952941896,555,70,967,482,412,412,trixie|twilight sparkle,ss2sonic
186215.jpg,https://derpicdn.net/img/view/2012/12/18/186215.jpg,1,0.9985188841819764,289,81,661,453,372,372,trixie|twilight sparkle,ss2sonic
1864696.png,https://derpicdn.net/img/view/2018/10/24/1864696.png,0,0.9466609358787536,0,0,966,915,966,915,apple bloom|applejack|fluttershy|pinkie pie|princess celestia|princess luna|rainbow dash|rarity|scootaloo|sweetie belle|trixie|twilight sparkle,bronypanda
1864698.png,https://derpicdn.net/img/view/2018/10/24/1864698.png,0,0.9852095246315002,468,0,774,296,306,296,princess celestia|twilight sparkle,bronypanda
1865779.png,https://derpicdn.net/img/view/2018/10/25/1865779.png,0,0.9991918206214904,1154,22,2890,1758,1736,1736,applejack|fluttershy|mane six|pinkie pie|rainbow dash|rarity|spike|starlight glimmer|twilight sparkle,setharu
1865779.png,https://derpicdn.net/img/view/2018/10/25/1865779.png,2,0.9917020797729492,3340,2127,4640,3427,1300,1300,applejack|fluttershy|mane six|pinkie pie|rainbow dash|rarity|spike|starlight glimmer|twilight sparkle,setharu
186667.png,https://derpicdn.net/img/view/2012/12/18/186667.png,0,0.9566184878349304,739,241,1163,665,424,424,princess celestia|twilight sparkle,senseidezzy
1871743.png,https://derpicdn.net/img/view/2018/10/31/1871743.png,0,0.9774615168571472,1419,1190,1917,1688,498,498,princess cadance|princess celestia|princess luna|twilight sparkle,dsp2003
1871743.png,https://derpicdn.net/img/view/2018/10/31/1871743.png,1,0.9750903248786926,1107,344,1675,912,568,568,princess cadance|princess celestia|princess luna|twilight sparkle,dsp2003
1878488.png,https://derpicdn.net/img/view/2018/11/9/1878488.png,0,0.9565185308456421,1444,897,3280,2733,1836,1836,princess luna|twilight sparkle,darkest-lunar-flower
1882219.png,https://derpicdn.net/img/view/2018/11/14/1882219.png,0,0.9664852619171144,219,77,423,281,204,204,princess celestia|princess luna|twilight sparkle,silfoe
1886532.png,https://derpicdn.net/img/view/2018/11/20/1886532.png,3,0.9615433216094972,344,1205,1766,2627,1422,1422,applejack|fluttershy|mane six|pinkie pie|rainbow dash|rarity|twilight sparkle,greyscaleart
1886597.png,https://derpicdn.net/img/view/2018/11/20/1886597.png,0,0.9727616310119628,0,0,579,605,579,605,applejack|fluttershy|mane six|pinkie pie|rainbow dash|rarity|starlight glimmer|twilight sparkle,buru-misu
1886916.png,https://derpicdn.net/img/view/2018/11/20/1886916.png,0,0.9994971752166748,1188,517,1762,1091,574,574,princess celestia|twilight sparkle,kirasunnight
1886916.png,https://derpicdn.net/img/view/2018/11/20/1886916.png,1,0.9748368263244628,164,87,1266,1189,1102,1102,princess celestia|twilight sparkle,kirasunnight
1894518.png,https://derpicdn.net/img/view/2018/11/30/1894518.png,0,0.9449117183685304,327,187,1313,1173,986,986,sunset shimmer|twilight sparkle,maren
1912036.png,https://derpicdn.net/img/view/2018/12/18/1912036.png,0,0.9752262830734252,0,585,145,753,145,168,princess luna|spike|starlight glimmer|twilight sparkle,vavacung
1912036.png,https://derpicdn.net/img/view/2018/12/18/1912036.png,1,0.9476309418678284,95,552,295,752,200,200,princess luna|spike|starlight glimmer|twilight sparkle,vavacung
1912036.png,https://derpicdn.net/img/view/2018/12/18/1912036.png,2,0.9209181070327759,230,42,578,390,348,348,princess luna|spike|starlight glimmer|twilight sparkle,vavacung
1912037.png,https://derpicdn.net/img/view/2018/12/18/1912037.png,0,0.9708507657051086,0,573,153,753,153,180,princess luna|spike|starlight glimmer|twilight sparkle,vavacung
1912037.png,https://derpicdn.net/img/view/2018/12/18/1912037.png,1,0.9066563844680786,226,36,580,390,354,354,princess luna|spike|starlight glimmer|twilight sparkle,vavacung
1912439.png,https://derpicdn.net/img/view/2018/12/19/1912439.png,2,0.9234579801559448,0,464,130,598,130,134,applejack|braeburn|discord|fluttershy|lightning dust|pinkie pie|princess celestia|princess luna|queen chrysalis|rainbow dash|rarity|soarin'|starlight glimmer|sunset shimmer|trixie|twilight sparkle,chromaskunk|marsminer|niggerfaggot|loneless-art|aer0 zer0|niggerdrawfag|fenixdust|invection|datte-before-dawn|lux|anontheanon|pabbley|omegapex|cinderdmutt|blvckmagic|replica|storyteller|ashee|atmosseven|frecklesfanatic|banbanji|yoditax|horseface|monanniverse|neighday|starry5643|anonymousdrawfig|an-m|lockheart|bluemeganium|omegaozone|wickedsilly|magic-violet|graboiidz|mkogwheel|coatieyay|kundofox|rhorse|candel|paulpeopless|cowsrtasty|n0nnny|galacticham|joey|eow|dimfann|shinodage|elijah|whatsapokemon|daf|sweetfilthyfun|aywen
1912439.png,https://derpicdn.net/img/view/2018/12/19/1912439.png,3,0.9165241122245787,18,1360,148,1490,130,130,applejack|braeburn|discord|fluttershy|lightning dust|pinkie pie|princess celestia|princess luna|queen chrysalis|rainbow dash|rarity|soarin'|starlight glimmer|sunset shimmer|trixie|twilight sparkle,chromaskunk|marsminer|niggerfaggot|loneless-art|aer0 zer0|niggerdrawfag|fenixdust|invection|datte-before-dawn|lux|anontheanon|pabbley|omegapex|cinderdmutt|blvckmagic|replica|storyteller|ashee|atmosseven|frecklesfanatic|banbanji|yoditax|horseface|monanniverse|neighday|starry5643|anonymousdrawfig|an-m|lockheart|bluemeganium|omegaozone|wickedsilly|magic-violet|graboiidz|mkogwheel|coatieyay|kundofox|rhorse|candel|paulpeopless|cowsrtasty|n0nnny|galacticham|joey|eow|dimfann|shinodage|elijah|whatsapokemon|daf|sweetfilthyfun|aywen
1913913.png,https://derpicdn.net/img/view/2018/12/20/1913913.png,0,0.993427574634552,586,351,998,763,412,412,applejack|fluttershy|mane six|pinkie pie|rainbow dash|rarity|twilight sparkle,longtailshort
1913913.png,https://derpicdn.net/img/view/2018/12/20/1913913.png,1,0.9854834675788879,1090,0,1546,391,456,391,applejack|fluttershy|mane six|pinkie pie|rainbow dash|rarity|twilight sparkle,longtailshort
1915435.png,https://derpicdn.net/img/view/2018/12/22/1915435.png,1,0.9725830554962158,95,760,931,1596,836,836,rainbow dash|twilight sparkle,ramiras
191752.png,https://derpicdn.net/img/view/2012/12/23/191752.png,0,0.9757821559906006,914,143,1116,345,202,202,princess celestia|queen chrysalis|twilight sparkle,toughset
1917949.png,https://derpicdn.net/img/view/2018/12/25/1917949.png,0,0.9840412139892578,314,466,564,716,250,250,applejack|discord|fluttershy|mane six|pinkie pie|rainbow dash|rarity|spike|starlight glimmer|trixie|twilight sparkle,inuhoshi-to-darkpen
1917949.png,https://derpicdn.net/img/view/2018/12/25/1917949.png,1,0.9626908302307128,805,475,1099,769,294,294,applejack|discord|fluttershy|mane six|pinkie pie|rainbow dash|rarity|spike|starlight glimmer|trixie|twilight sparkle,inuhoshi-to-darkpen
1918558.png,https://derpicdn.net/img/view/2018/12/25/1918558.png,0,0.9967230558395386,372,318,1346,1292,974,974,princess luna|twilight sparkle,magnaluna
1918890.png,https://derpicdn.net/img/view/2018/12/26/1918890.png,0,0.917994499206543,0,309,414,745,414,436,fluttershy|pinkie pie|twilight sparkle,hierozaki
1919397.png,https://derpicdn.net/img/view/2018/12/26/1919397.png,0,0.9940040111541748,1277,490,1929,1142,652,652,applejack|discord|fluttershy|mane six|pinkie pie|rainbow dash|rarity|spike|starlight glimmer|twilight sparkle,ladychimaera
1919397.png,https://derpicdn.net/img/view/2018/12/26/1919397.png,1,0.9553483724594116,1000,559,1390,949,390,390,applejack|discord|fluttershy|mane six|pinkie pie|rainbow dash|rarity|spike|starlight glimmer|twilight sparkle,ladychimaera
1923711.png,https://derpicdn.net/img/view/2019/1/1/1923711.png,0,0.9906290769577026,0,0,870,864,870,864,applejack|fluttershy|mane six|pinkie pie|rainbow dash|rarity|spike|starlight glimmer|twilight sparkle,oinktweetstudios
1923711.png,https://derpicdn.net/img/view/2019/1/1/1923711.png,1,0.9666543006896972,129,1167,849,1887,720,720,applejack|fluttershy|mane six|pinkie pie|rainbow dash|rarity|spike|starlight glimmer|twilight sparkle,oinktweetstudios
192425.png,https://derpicdn.net/img/view/2012/12/24/192425.png,0,0.9923200011253356,39,0,579,432,540,432,spike|twilight sparkle,siden
1925373.png,https://derpicdn.net/img/view/2019/1/3/1925373.png,0,0.9953876733779908,17,242,509,734,492,492,applejack|fluttershy|mane six|pinkie pie|rainbow dash|rarity|spike|starlight glimmer|twilight sparkle,the-butch-x
1925373.png,https://derpicdn.net/img/view/2019/1/3/1925373.png,1,0.9946738481521606,1181,652,1560,1092,379,440,applejack|fluttershy|mane six|pinkie pie|rainbow dash|rarity|spike|starlight glimmer|twilight sparkle,the-butch-x
1925373.png,https://derpicdn.net/img/view/2019/1/3/1925373.png,2,0.9777072668075562,567,348,1053,834,486,486,applejack|fluttershy|mane six|pinkie pie|rainbow dash|rarity|spike|starlight glimmer|twilight sparkle,the-butch-x
1925373.png,https://derpicdn.net/img/view/2019/1/3/1925373.png,3,0.9525903463363647,917,312,1459,854,542,542,applejack|fluttershy|mane six|pinkie pie|rainbow dash|rarity|spike|starlight glimmer|twilight sparkle,the-butch-x
1931731.png,https://derpicdn.net/img/view/2019/1/10/1931731.png,0,0.9218865036964417,57,207,371,521,314,314,spike|twilight sparkle,greyscaleart
1935591.png,https://derpicdn.net/img/view/2019/1/14/1935591.png,0,0.9931761622428894,1209,768,1717,1276,508,508,rarity|twilight sparkle,lilfunkman
1936978.png,https://derpicdn.net/img/view/2019/1/16/1936978.png,0,0.976767897605896,3314,266,4774,1726,1460,1460,applejack|fluttershy|pinkie pie|rainbow dash|rarity|sunset shimmer|twilight sparkle,jhayarr23
1938292.png,https://derpicdn.net/img/view/2019/1/18/1938292.png,0,0.9941641092300416,1019,0,1559,500,540,500,pinkie pie|twilight sparkle,mirroredsea
1943516.png,https://derpicdn.net/img/view/2019/1/24/1943516.png,0,0.9242344498634338,1748,41,2432,725,684,684,princess celestia|twilight sparkle,inspiredpixels
1944013.png,https://derpicdn.net/img/view/2019/1/25/1944013.png,0,0.9681227207183838,128,43,468,383,340,340,rainbow dash|twilight sparkle,tylerdashart
1945977.png,https://derpicdn.net/img/view/2019/1/27/1945977.png,0,0.9985079169273376,335,105,637,407,302,302,scootaloo|starlight glimmer|sunset shimmer|trixie|twilight sparkle,loveslove
1945977.png,https://derpicdn.net/img/view/2019/1/27/1945977.png,1,0.956382155418396,1295,43,1641,389,346,346,scootaloo|starlight glimmer|sunset shimmer|trixie|twilight sparkle,loveslove
1948669.png,https://derpicdn.net/img/view/2019/1/30/1948669.png,0,0.9945644736289978,906,58,1500,652,594,594,starlight glimmer|twilight sparkle,skitter
1948669.png,https://derpicdn.net/img/view/2019/1/30/1948669.png,1,0.9823305010795592,265,341,881,957,616,616,starlight glimmer|twilight sparkle,skitter
1949110.png,https://derpicdn.net/img/view/2019/1/31/1949110.png,0,0.9923222661018372,523,37,1191,705,668,668,rainbow dash|twilight sparkle,meow
1949558.png,https://derpicdn.net/img/view/2019/1/31/1949558.png,0,0.9573842883110046,427,516,1077,1166,650,650,applejack|fluttershy|mane six|pinkie pie|rainbow dash|rarity|twilight sparkle,sugar morning
1958147.png,https://derpicdn.net/img/view/2019/2/10/1958147.png,0,0.9991995692253112,617,267,1113,763,496,496,spike|twilight sparkle,skitter
1958147.png,https://derpicdn.net/img/view/2019/2/10/1958147.png,1,0.958352029323578,1324,642,1926,1244,602,602,spike|twilight sparkle,skitter
1958277.png,https://derpicdn.net/img/view/2019/2/10/1958277.png,0,0.9901325106620787,3043,394,4085,1436,1042,1042,sunset shimmer|twilight sparkle,flushthebatsanta
1958277.png,https://derpicdn.net/img/view/2019/2/10/1958277.png,1,0.9441398382186892,0,84,1668,1770,1668,1686,sunset shimmer|twilight sparkle,flushthebatsanta
1965715.png,https://derpicdn.net/img/view/2019/2/19/1965715.png,0,0.9995856881141664,737,36,1217,516,480,480,princess cadance|princess celestia|princess luna|twilight sparkle,darksprings
1965715.png,https://derpicdn.net/img/view/2019/2/19/1965715.png,1,0.919583022594452,1749,0,2355,568,606,568,princess cadance|princess celestia|princess luna|twilight sparkle,darksprings
1965845.png,https://derpicdn.net/img/view/2019/2/19/1965845.png,0,0.980076253414154,4168,693,4984,1509,816,816,applejack|fluttershy|mane six|pinkie pie|rainbow dash|rarity|twilight sparkle,cartoonboyfriends
1967702.png,https://derpicdn.net/img/view/2019/2/21/1967702.png,0,0.9976008534431458,258,107,1226,1075,968,968,fluttershy|rainbow dash|twilight sparkle,danmakuman
1967702.png,https://derpicdn.net/img/view/2019/2/21/1967702.png,2,0.911372721195221,3705,207,4721,1223,1016,1016,fluttershy|rainbow dash|twilight sparkle,danmakuman
1968945.png,https://derpicdn.net/img/view/2019/2/22/1968945.png,0,0.9506149888038636,245,80,517,352,272,272,princess celestia|twilight sparkle,droll3
1970000.png,https://derpicdn.net/img/view/2019/2/23/1970000.png,0,0.96922504901886,247,85,511,349,264,264,princess celestia|twilight sparkle,droll3
1971813.png,https://derpicdn.net/img/view/2019/2/26/1971813.png,0,0.9691142439842224,407,135,617,345,210,210,spike|twilight sparkle,coffee-draws
1972468.png,https://derpicdn.net/img/view/2019/2/26/1972468.png,1,0.9980068802833556,8,0,278,251,270,251,applejack|fluttershy|mane six|pinkie pie|rainbow dash|rarity|twilight sparkle,dvixie
1972468.png,https://derpicdn.net/img/view/2019/2/26/1972468.png,2,0.9958935379981996,45,469,305,729,260,260,applejack|fluttershy|mane six|pinkie pie|rainbow dash|rarity|twilight sparkle,dvixie
1972468.png,https://derpicdn.net/img/view/2019/2/26/1972468.png,3,0.995871365070343,624,422,938,736,314,314,applejack|fluttershy|mane six|pinkie pie|rainbow dash|rarity|twilight sparkle,dvixie
1972468.png,https://derpicdn.net/img/view/2019/2/26/1972468.png,4,0.9919688701629642,347,0,671,293,324,293,applejack|fluttershy|mane six|pinkie pie|rainbow dash|rarity|twilight sparkle,dvixie
1972468.png,https://derpicdn.net/img/view/2019/2/26/1972468.png,5,0.9870734214782716,1060,483,1300,723,240,240,applejack|fluttershy|mane six|pinkie pie|rainbow dash|rarity|twilight sparkle,dvixie
1973347.png,https://derpicdn.net/img/view/2019/2/28/1973347.png,0,0.9901779890060424,798,75,1096,373,298,298,applejack|fluttershy|pinkie pie|rainbow dash|rarity|sunset shimmer|twilight sparkle,jhayarr23
1973347.png,https://derpicdn.net/img/view/2019/2/28/1973347.png,1,0.9846720695495604,1148,8,1452,312,304,304,applejack|fluttershy|pinkie pie|rainbow dash|rarity|sunset shimmer|twilight sparkle,jhayarr23
1973347.png,https://derpicdn.net/img/view/2019/2/28/1973347.png,2,0.9772015213966372,1190,1110,1566,1486,376,376,applejack|fluttershy|pinkie pie|rainbow dash|rarity|sunset shimmer|twilight sparkle,jhayarr23
1975422.png,https://derpicdn.net/img/view/2019/3/2/1975422.png,0,0.9959123134613036,802,98,1338,634,536,536,princess cadance|twilight sparkle,vavacung
197871.png,https://derpicdn.net/img/view/2012/12/30/197871.png,0,0.9976844787597656,1435,505,1867,937,432,432,applejack|fluttershy|pinkie pie|queen chrysalis|rainbow dash|rarity|soarin'|spitfire|twilight sparkle,nastylady
1985658.png,https://derpicdn.net/img/view/2019/3/14/1985658.png,0,0.9719753861427308,1927,123,2253,449,326,326,spike|starlight glimmer|trixie|twilight sparkle,inuhoshi-to-darkpen
1985658.png,https://derpicdn.net/img/view/2019/3/14/1985658.png,1,0.9572938680648804,961,136,1297,472,336,336,spike|starlight glimmer|trixie|twilight sparkle,inuhoshi-to-darkpen
1985658.png,https://derpicdn.net/img/view/2019/3/14/1985658.png,2,0.9517099261283876,684,199,936,451,252,252,spike|starlight glimmer|trixie|twilight sparkle,inuhoshi-to-darkpen
1985658.png,https://derpicdn.net/img/view/2019/3/14/1985658.png,3,0.91658616065979,1129,329,1641,841,512,512,spike|starlight glimmer|trixie|twilight sparkle,inuhoshi-to-darkpen
1986967.png,https://derpicdn.net/img/view/2019/3/16/1986967.png,0,0.9639822244644164,76,0,1340,1010,1264,1010,pinkie pie|starlight glimmer|twilight sparkle,hierozaki
198739.png,https://derpicdn.net/img/view/2012/12/31/198739.png,0,0.9212735891342164,737,0,1280,548,543,548,rainbow dash|twilight sparkle,mattings
1987732.png,https://derpicdn.net/img/view/2019/3/16/1987732.png,0,0.995658814907074,535,0,1257,620,722,620,spike|twilight sparkle,skitter
1987732.png,https://derpicdn.net/img/view/2019/3/16/1987732.png,1,0.9711811542510986,824,408,1514,1098,690,690,spike|twilight sparkle,skitter
1988836.png,https://derpicdn.net/img/view/2019/3/18/1988836.png,0,0.9783226251602172,980,698,2062,1780,1082,1082,princess luna|twilight sparkle,nxyde
1991704.png,https://derpicdn.net/img/view/2019/3/21/1991704.png,0,0.9908240437507628,322,29,802,509,480,480,rainbow dash|twilight sparkle,andelai
1991711.png,https://derpicdn.net/img/view/2019/3/21/1991711.png,0,0.9792577028274536,64,0,482,405,418,405,rarity|twilight sparkle,andelai
1993259.png,https://derpicdn.net/img/view/2019/3/23/1993259.png,0,0.993022918701172,540,0,1256,620,716,620,spike|twilight sparkle,skitter
1993259.png,https://derpicdn.net/img/view/2019/3/23/1993259.png,1,0.9573844075202942,832,419,1504,1091,672,672,spike|twilight sparkle,skitter
1993839.png,https://derpicdn.net/img/view/2019/3/24/1993839.png,0,0.9985734224319458,464,884,3026,3446,2562,2562,sunset shimmer|twilight sparkle,theretroart88
1993839.png,https://derpicdn.net/img/view/2019/3/24/1993839.png,1,0.9862315058708192,3851,638,6900,3692,3049,3054,sunset shimmer|twilight sparkle,theretroart88
1995336.png,https://derpicdn.net/img/view/2019/3/26/1995336.png,0,0.9585018754005432,1141,454,1753,1066,612,612,pinkie pie|twilight sparkle,secretgoombaman12345
1995341.png,https://derpicdn.net/img/view/2019/3/26/1995341.png,0,0.9781509637832642,816,459,1490,1133,674,674,pinkie pie|twilight sparkle,secretgoombaman12345
1996158.png,https://derpicdn.net/img/view/2019/3/27/1996158.png,0,0.9958124756813048,650,1072,1240,1662,590,590,applejack|fluttershy|mane six|pinkie pie|rainbow dash|rarity|spike|starlight glimmer|twilight sparkle,annakitsun3
1996158.png,https://derpicdn.net/img/view/2019/3/27/1996158.png,1,0.9932804107666016,16,881,736,1601,720,720,applejack|fluttershy|mane six|pinkie pie|rainbow dash|rarity|spike|starlight glimmer|twilight sparkle,annakitsun3
1996158.png,https://derpicdn.net/img/view/2019/3/27/1996158.png,3,0.9807709455490112,1902,19,2840,957,938,938,applejack|fluttershy|mane six|pinkie pie|rainbow dash|rarity|spike|starlight glimmer|twilight sparkle,annakitsun3
1996158.png,https://derpicdn.net/img/view/2019/3/27/1996158.png,4,0.9365142583847046,1268,1078,1924,1734,656,656,applejack|fluttershy|mane six|pinkie pie|rainbow dash|rarity|spike|starlight glimmer|twilight sparkle,annakitsun3
1996222.png,https://derpicdn.net/img/view/2019/3/27/1996222.png,0,0.9975069761276244,228,673,748,1193,520,520,princess celestia|spike|starlight glimmer|twilight sparkle,dstears
20002.png,https://derpicdn.net/img/view/2012/6/25/20002.png,0,0.9889854192733764,1869,984,2667,1782,798,798,apple bloom|applejack|big macintosh|cutie mark crusaders|fluttershy|granny smith|mane six|pinkie pie|rainbow dash|rarity|scootaloo|spike|sweetie belle|twilight sparkle,rannva
2004773.png,https://derpicdn.net/img/view/2019/4/6/2004773.png,0,0.9759244918823242,0,135,312,519,312,384,starlight glimmer|twilight sparkle,lumineko
2006157.png,https://derpicdn.net/img/view/2019/4/8/2006157.png,1,0.9504216909408568,531,0,1187,651,656,651,starlight glimmer|twilight sparkle,ambris
2008571.png,https://derpicdn.net/img/view/2019/4/10/2008571.png,0,0.9552992582321168,61,0,681,563,620,563,starlight glimmer|sunset shimmer|twilight sparkle,cabbage-arts
2012541.png,https://derpicdn.net/img/view/2019/4/14/2012541.png,0,0.999894380569458,900,687,1358,1145,458,458,princess cadance|queen chrysalis|shining armor|twilight sparkle,tjpones
2017059.png,https://derpicdn.net/img/view/2019/4/19/2017059.png,0,0.9998962879180908,901,686,1359,1144,458,458,princess cadance|queen chrysalis|shining armor|twilight sparkle,tjpones
2022342.png,https://derpicdn.net/img/view/2019/4/25/2022342.png,0,0.9991777539253236,735,262,1177,704,442,442,applejack|fluttershy|mane six|pinkie pie|rainbow dash|rarity|twilight sparkle,arareroll
2022342.png,https://derpicdn.net/img/view/2019/4/25/2022342.png,1,0.99900221824646,1061,19,1439,397,378,378,applejack|fluttershy|mane six|pinkie pie|rainbow dash|rarity|twilight sparkle,arareroll
2022342.png,https://derpicdn.net/img/view/2019/4/25/2022342.png,2,0.9747157096862792,221,95,679,553,458,458,applejack|fluttershy|mane six|pinkie pie|rainbow dash|rarity|twilight sparkle,arareroll
2022342.png,https://derpicdn.net/img/view/2019/4/25/2022342.png,3,0.9552073478698728,188,775,584,1171,396,396,applejack|fluttershy|mane six|pinkie pie|rainbow dash|rarity|twilight sparkle,arareroll
2024737.png,https://derpicdn.net/img/view/2019/4/27/2024737.png,0,0.9796402454376221,493,1,750,267,257,266,spike|twilight sparkle,lumineko
2025187.png,https://derpicdn.net/img/view/2019/4/28/2025187.png,0,0.9997342228889464,680,571,1296,1187,616,616,princess cadance|princess celestia|princess luna|twilight sparkle,lifesharbinger
2025187.png,https://derpicdn.net/img/view/2019/4/28/2025187.png,1,0.9972254633903505,308,1124,856,1672,548,548,princess cadance|princess celestia|princess luna|twilight sparkle,lifesharbinger
2025732.png,https://derpicdn.net/img/view/2019/4/28/2025732.png,0,0.9878073930740356,460,14,736,290,276,276,applejack|fluttershy|pinkie pie|rainbow dash|rarity|twilight sparkle,the-butch-x
2025732.png,https://derpicdn.net/img/view/2019/4/28/2025732.png,1,0.9871135354042052,1185,28,1431,274,246,246,applejack|fluttershy|pinkie pie|rainbow dash|rarity|twilight sparkle,the-butch-x
2025732.png,https://derpicdn.net/img/view/2019/4/28/2025732.png,2,0.9489469528198242,46,7,274,235,228,228,applejack|fluttershy|pinkie pie|rainbow dash|rarity|twilight sparkle,the-butch-x
2025732.png,https://derpicdn.net/img/view/2019/4/28/2025732.png,3,0.9186506271362304,970,6,1240,276,270,270,applejack|fluttershy|pinkie pie|rainbow dash|rarity|twilight sparkle,the-butch-x
2025732.png,https://derpicdn.net/img/view/2019/4/28/2025732.png,4,0.9017025828361512,300,31,506,237,206,206,applejack|fluttershy|pinkie pie|rainbow dash|rarity|twilight sparkle,the-butch-x
2031628.png,https://derpicdn.net/img/view/2019/5/5/2031628.png,1,0.9500876069068908,443,0,995,530,552,530,princess cadance|princess celestia|princess luna|twilight sparkle,renciel
2032782.png,https://derpicdn.net/img/view/2019/5/6/2032782.png,0,0.9921249151229858,36,224,408,596,372,372,rainbow dash|twilight sparkle,tylerdashart
2034121.png,https://derpicdn.net/img/view/2019/5/8/2034121.png,0,0.9884828925132751,716,1213,1200,1765,484,552,applejack|fluttershy|mane six|pinkie pie|rainbow dash|rarity|spike|twilight sparkle,spacekitty
2034200.png,https://derpicdn.net/img/view/2019/5/8/2034200.png,1,0.9708710312843324,1020,0,1814,788,794,788,shining armor|spike|twilight sparkle,discorded
2036432.png,https://derpicdn.net/img/view/2019/5/11/2036432.png,0,0.9906972050666808,1393,0,2015,579,622,579,sunset shimmer|twilight sparkle,twistedscarlett60
2036696.png,https://derpicdn.net/img/view/2019/5/11/2036696.png,0,0.933301329612732,511,15,913,417,402,402,fluttershy|pinkie pie|twilight sparkle,tastyrainbow
2036711.png,https://derpicdn.net/img/view/2019/5/11/2036711.png,0,0.9450916647911072,1216,937,1870,1591,654,654,princess celestia|twilight sparkle,janegumball
2059794.png,https://derpicdn.net/img/view/2019/6/7/2059794.png,0,0.9738425612449646,87,824,721,1458,634,634,princess cadance|princess celestia|princess luna|queen chrysalis|twilight sparkle,loveslove
2059794.png,https://derpicdn.net/img/view/2019/6/7/2059794.png,1,0.9495099782943726,3017,860,3840,1722,823,862,princess cadance|princess celestia|princess luna|queen chrysalis|twilight sparkle,loveslove
2059794.png,https://derpicdn.net/img/view/2019/6/7/2059794.png,2,0.918631374835968,955,468,1781,1294,826,826,princess cadance|princess celestia|princess luna|queen chrysalis|twilight sparkle,loveslove
2059826.png,https://derpicdn.net/img/view/2019/6/7/2059826.png,0,0.9367459416389464,687,149,2803,2265,2116,2116,princess celestia|twilight sparkle,isorrayi
2063142.png,https://derpicdn.net/img/view/2019/6/11/2063142.png,0,0.9826173782348632,1131,179,3239,2287,2108,2108,spike|twilight sparkle,mricantdraw
20642.jpg,https://derpicdn.net/img/view/2012/6/25/20642.jpg,0,0.991884469985962,1266,962,1718,1414,452,452,applejack|fluttershy|mane six|pinkie pie|rainbow dash|rarity|twilight sparkle,uc77
2067118.png,https://derpicdn.net/img/view/2019/6/16/2067118.png,0,0.9876123666763306,89,153,2007,2071,1918,1918,rainbow dash|twilight sparkle,danli69
2080517.png,https://derpicdn.net/img/view/2019/7/1/2080517.png,1,0.927831768989563,1641,134,2213,706,572,572,applejack|fluttershy|mane six|pinkie pie|rainbow dash|rarity|spike|starlight glimmer|sunset shimmer|twilight sparkle,xjenn9
2082599.png,https://derpicdn.net/img/view/2019/7/4/2082599.png,0,0.997664511203766,899,88,1741,930,842,842,applejack|fluttershy|mane six|pinkie pie|rainbow dash|rarity|twilight sparkle,elstiv
2082599.png,https://derpicdn.net/img/view/2019/7/4/2082599.png,1,0.9752238988876344,178,651,554,1027,376,376,applejack|fluttershy|mane six|pinkie pie|rainbow dash|rarity|twilight sparkle,elstiv
2088338.png,https://derpicdn.net/img/view/2019/7/10/2088338.png,1,0.9951850771903992,85,173,797,885,712,712,princess cadance|princess celestia|princess luna|twilight sparkle,yakovlev-vad
2088338.png,https://derpicdn.net/img/view/2019/7/10/2088338.png,2,0.9899532198905944,2681,90,3485,894,804,804,princess cadance|princess celestia|princess luna|twilight sparkle,yakovlev-vad
2088338.png,https://derpicdn.net/img/view/2019/7/10/2088338.png,3,0.909932553768158,1806,102,2594,890,788,788,princess cadance|princess celestia|princess luna|twilight sparkle,yakovlev-vad
2088856.png,https://derpicdn.net/img/view/2019/7/11/2088856.png,0,0.995983362197876,1514,307,2306,1099,792,792,princess cadance|princess celestia|princess luna|twilight sparkle,xjenn9
2088856.png,https://derpicdn.net/img/view/2019/7/11/2088856.png,2,0.9805303812026978,22,495,694,1167,672,672,princess cadance|princess celestia|princess luna|twilight sparkle,xjenn9
2090114.png,https://derpicdn.net/img/view/2019/7/12/2090114.png,1,0.9937672615051272,851,612,1045,806,194,194,applejack|fluttershy|mane six|pinkie pie|rainbow dash|rarity|spike|twilight sparkle,pastel-pony-pictures
2094358.png,https://derpicdn.net/img/view/2019/7/17/2094358.png,0,0.9398491978645324,0,0,1106,1107,1106,1107,princess celestia|twilight sparkle,dimfann
2094554.png,https://derpicdn.net/img/view/2019/7/18/2094554.png,0,0.9955945014953612,0,0,1039,861,1039,861,pinkie pie|twilight sparkle,a-vomikaa
2096472.png,https://derpicdn.net/img/view/2019/7/20/2096472.png,0,0.997755765914917,337,627,567,857,230,230,princess celestia|twilight sparkle,jargon scott
20970.jpg,https://derpicdn.net/img/view/2012/6/26/20970.jpg,0,0.9863360524177552,296,241,560,505,264,264,applejack|fluttershy|twilight sparkle,mysticalpha
2099128.png,https://derpicdn.net/img/view/2019/7/23/2099128.png,0,0.9796831607818604,847,245,2480,2095,1633,1850,princess celestia|twilight sparkle,underpable
2099134.png,https://derpicdn.net/img/view/2019/7/23/2099134.png,2,0.9976983666419984,1595,0,2427,804,832,804,applejack|fluttershy|mane six|pinkie pie|rainbow dash|rarity|twilight sparkle,hakkids2
2099134.png,https://derpicdn.net/img/view/2019/7/23/2099134.png,3,0.9963844418525696,146,0,998,852,852,852,applejack|fluttershy|mane six|pinkie pie|rainbow dash|rarity|twilight sparkle,hakkids2
2099134.png,https://derpicdn.net/img/view/2019/7/23/2099134.png,4,0.99122416973114,728,1259,1892,2423,1164,1164,applejack|fluttershy|mane six|pinkie pie|rainbow dash|rarity|twilight sparkle,hakkids2
2100456.png,https://derpicdn.net/img/view/2019/7/24/2100456.png,0,0.9946891665458679,894,119,1372,597,478,478,princess cadance|princess celestia|princess flurry heart|princess luna|twilight sparkle,ncmares
2100456.png,https://derpicdn.net/img/view/2019/7/24/2100456.png,1,0.9923675656318665,172,116,722,666,550,550,princess cadance|princess celestia|princess flurry heart|princess luna|twilight sparkle,ncmares
2100456.png,https://derpicdn.net/img/view/2019/7/24/2100456.png,2,0.9894464015960692,924,719,1406,1201,482,482,princess cadance|princess celestia|princess flurry heart|princess luna|twilight sparkle,ncmares
2100456.png,https://derpicdn.net/img/view/2019/7/24/2100456.png,3,0.9596464037895204,254,820,724,1290,470,470,princess cadance|princess celestia|princess flurry heart|princess luna|twilight sparkle,ncmares
2106113.png,https://derpicdn.net/img/view/2019/8/1/2106113.png,0,0.9974374771118164,1667,968,2771,2072,1104,1104,applejack|rainbow dash|twilight sparkle,tsitra360
2106113.png,https://derpicdn.net/img/view/2019/8/1/2106113.png,1,0.9959729313850404,2262,308,3362,1408,1100,1100,applejack|rainbow dash|twilight sparkle,tsitra360
2106778.png,https://derpicdn.net/img/view/2019/8/2/2106778.png,0,0.9440410137176514,1058,1952,3234,4128,2176,2176,princess celestia|princess luna|shining armor|twilight sparkle,cyanlightning
2106778.png,https://derpicdn.net/img/view/2019/8/2/2106778.png,1,0.9309600591659546,4024,25,6456,2457,2432,2432,princess celestia|princess luna|shining armor|twilight sparkle,cyanlightning
2108132.png,https://derpicdn.net/img/view/2019/8/3/2108132.png,0,0.9786157608032228,1026,0,1616,518,590,518,applejack|fluttershy|mane six|pinkie pie|rainbow dash|rarity|spike|twilight sparkle,tcn1205
2115902.png,https://derpicdn.net/img/view/2019/8/12/2115902.png,0,0.9790859222412108,176,0,860,484,684,484,apple bloom|applejack|cutie mark crusaders|discord|fluttershy|mane six|pinkie pie|princess cadance|princess celestia|princess luna|queen chrysalis|rainbow dash|rarity|scootaloo|starlight glimmer|sweetie belle|twilight sparkle,mewy101
2117279.png,https://derpicdn.net/img/view/2019/8/13/2117279.png,0,0.9931902289390564,148,413,434,699,286,286,applejack|fluttershy|mane six|pinkie pie|rainbow dash|rarity|twilight sparkle,jumblehorse
2120461.png,https://derpicdn.net/img/view/2019/8/17/2120461.png,0,0.9959065318107604,791,12,1200,486,409,474,applejack|fluttershy|mane six|pinkie pie|rainbow dash|rarity|twilight sparkle,dawnfire
2120461.png,https://derpicdn.net/img/view/2019/8/17/2120461.png,1,0.9801278114318848,157,1025,603,1471,446,446,applejack|fluttershy|mane six|pinkie pie|rainbow dash|rarity|twilight sparkle,dawnfire
2123145.png,https://derpicdn.net/img/view/2019/8/20/2123145.png,0,0.9396167397499084,869,229,1369,729,500,500,princess cadance|princess celestia|princess luna|queen chrysalis|twilight sparkle,thelunarmoon
2125067.png,https://derpicdn.net/img/view/2019/8/23/2125067.png,0,0.9598950147628784,757,277,1257,777,500,500,pinkie pie|twilight sparkle,inuhoshi-to-darkpen
2127805.png,https://derpicdn.net/img/view/2019/8/26/2127805.png,1,0.9554215073585508,56,377,710,1031,654,654,applejack|fluttershy|mane six|pinkie pie|princess celestia|princess luna|rainbow dash|rarity|twilight sparkle,stupid works-stuwor|stuwor-art
2130434.png,https://derpicdn.net/img/view/2019/8/29/2130434.png,0,0.9818522930145264,989,806,1393,1210,404,404,spike|twilight sparkle,king-kakapo
2131671.png,https://derpicdn.net/img/view/2019/8/30/2131671.png,1,0.9402340650558472,2194,637,3452,1895,1258,1258,princess celestia|princess luna|twilight sparkle,duop-qoub
2132141.png,https://derpicdn.net/img/view/2019/8/31/2132141.png,0,0.9247320890426636,1089,419,1285,615,196,196,applejack|fluttershy|mane six|pinkie pie|rainbow dash|rarity|spike|twilight sparkle,
2137944.png,https://derpicdn.net/img/view/2019/9/6/2137944.png,0,0.9992275238037108,2330,252,3580,1502,1250,1250,princess celestia|princess luna|twilight sparkle,magnaluna
2137944.png,https://derpicdn.net/img/view/2019/9/6/2137944.png,1,0.9888942837715148,541,0,2309,1743,1768,1743,princess celestia|princess luna|twilight sparkle,magnaluna
2141400.png,https://derpicdn.net/img/view/2019/9/11/2141400.png,0,0.9809784889221193,31,7,617,593,586,586,princess celestia|twilight sparkle,jargon scott
2142465.png,https://derpicdn.net/img/view/2019/9/12/2142465.png,0,0.9994192719459534,1783,1151,2661,2029,878,878,trixie|twilight sparkle,feellikeaplat
2142465.png,https://derpicdn.net/img/view/2019/9/12/2142465.png,1,0.9880621433258056,966,545,1794,1373,828,828,trixie|twilight sparkle,feellikeaplat
2142469.png,https://derpicdn.net/img/view/2019/9/12/2142469.png,1,0.9938374161720276,741,251,1443,953,702,702,trixie|twilight sparkle,feellikeaplat
2144323.png,https://derpicdn.net/img/view/2019/9/14/2144323.png,0,0.956777811050415,468,25,1278,835,810,810,pinkie pie|twilight sparkle,notaletolivefor|lorenz3
2144571.png,https://derpicdn.net/img/view/2019/9/15/2144571.png,0,0.9841174483299256,1030,864,2050,1884,1020,1020,applejack|fluttershy|mane six|pinkie pie|rainbow dash|rarity|spike|twilight sparkle,auroriia
2144571.png,https://derpicdn.net/img/view/2019/9/15/2144571.png,1,0.9127646684646606,984,95,2094,1205,1110,1110,applejack|fluttershy|mane six|pinkie pie|rainbow dash|rarity|spike|twilight sparkle,auroriia
2146645.png,https://derpicdn.net/img/view/2019/9/17/2146645.png,0,0.9757722020149232,0,0,1450,1215,1450,1215,shining armor|twilight sparkle,crash9902
2147688.png,https://derpicdn.net/img/view/2019/9/19/2147688.png,0,0.9962246417999268,3446,1114,3800,1484,354,370,princess celestia|twilight sparkle,tklninja
2147688.png,https://derpicdn.net/img/view/2019/9/19/2147688.png,1,0.9737467169761658,11,0,1185,1151,1174,1151,princess celestia|twilight sparkle,tklninja
2153524.png,https://derpicdn.net/img/view/2019/9/26/2153524.png,0,0.9584541916847228,199,0,363,148,164,148,applejack|fluttershy|twilight sparkle,tatara94
2154228.png,https://derpicdn.net/img/view/2019/9/27/2154228.png,0,0.9801865220069884,41,250,269,478,228,228,applejack|fluttershy|mane six|pinkie pie|rainbow dash|rarity|spike|twilight sparkle,airiniblock
2154263.png,https://derpicdn.net/img/view/2019/9/27/2154263.png,0,0.9925250411033628,2132,2415,3570,3853,1438,1438,rarity|twilight sparkle,lilfunkman
2155084.png,https://derpicdn.net/img/view/2019/9/28/2155084.png,0,0.905984342098236,265,283,941,959,676,676,pinkie pie|rarity|twilight sparkle,katputze
2164875.png,https://derpicdn.net/img/view/2019/10/10/2164875.png,0,0.9790944457054138,230,0,546,287,316,287,applejack|fluttershy|mane six|pinkie pie|rainbow dash|rarity|twilight sparkle,jargon scott
2164875.png,https://derpicdn.net/img/view/2019/10/10/2164875.png,1,0.9676613211631776,534,379,784,629,250,250,applejack|fluttershy|mane six|pinkie pie|rainbow dash|rarity|twilight sparkle,jargon scott
2165078.png,https://derpicdn.net/img/view/2019/10/10/2165078.png,0,0.990106463432312,2076,1383,3202,2509,1126,1126,applejack|fluttershy|mane six|pinkie pie|rainbow dash|rarity|spike|starlight glimmer|sunset shimmer|twilight sparkle,artiks
2165078.png,https://derpicdn.net/img/view/2019/10/10/2165078.png,1,0.9879189133644104,1884,2555,2852,3509,968,954,applejack|fluttershy|mane six|pinkie pie|rainbow dash|rarity|spike|starlight glimmer|sunset shimmer|twilight sparkle,artiks
2166457.png,https://derpicdn.net/img/view/2019/10/12/2166457.png,0,0.996668815612793,1220,412,2480,1742,1260,1330,applejack|fluttershy|pinkie pie|rainbow dash|rarity|spike|twilight sparkle,hiccupsdoesart
2166510.png,https://derpicdn.net/img/view/2019/10/12/2166510.png,0,0.9813978672027588,1438,578,1755,930,317,352,apple bloom|applejack|cutie mark crusaders|discord|fluttershy|mane six|pinkie pie|princess cadance|princess celestia|princess flurry heart|princess luna|rainbow dash|rarity|scootaloo|shining armor|spike|starlight glimmer|sweetie belle|trixie|twilight sparkle,dm29
2166510.png,https://derpicdn.net/img/view/2019/10/12/2166510.png,1,0.9397813081741332,1127,159,1395,427,268,268,apple bloom|applejack|cutie mark crusaders|discord|fluttershy|mane six|pinkie pie|princess cadance|princess celestia|princess flurry heart|princess luna|rainbow dash|rarity|scootaloo|shining armor|spike|starlight glimmer|sweetie belle|trixie|twilight sparkle,dm29
2166565.png,https://derpicdn.net/img/view/2019/10/12/2166565.png,0,0.9980029463768004,871,150,1237,516,366,366,applejack|fluttershy|mane six|pinkie pie|rainbow dash|rarity|twilight sparkle,forsaken
2166565.png,https://derpicdn.net/img/view/2019/10/12/2166565.png,1,0.9977430701255798,239,597,575,933,336,336,applejack|fluttershy|mane six|pinkie pie|rainbow dash|rarity|twilight sparkle,forsaken
2166565.png,https://derpicdn.net/img/view/2019/10/12/2166565.png,2,0.9961323142051696,339,149,755,565,416,416,applejack|fluttershy|mane six|pinkie pie|rainbow dash|rarity|twilight sparkle,forsaken
2166565.png,https://derpicdn.net/img/view/2019/10/12/2166565.png,3,0.9924280643463136,632,769,1076,1213,444,444,applejack|fluttershy|mane six|pinkie pie|rainbow dash|rarity|twilight sparkle,forsaken
2166565.png,https://derpicdn.net/img/view/2019/10/12/2166565.png,4,0.9870412349700928,1373,484,1789,900,416,416,applejack|fluttershy|mane six|pinkie pie|rainbow dash|rarity|twilight sparkle,forsaken
2166565.png,https://derpicdn.net/img/view/2019/10/12/2166565.png,5,0.9060834646224976,1201,17,1543,359,342,342,applejack|fluttershy|mane six|pinkie pie|rainbow dash|rarity|twilight sparkle,forsaken
2166619.png,https://derpicdn.net/img/view/2019/10/12/2166619.png,1,0.9947216510772704,2703,0,4353,1463,1650,1463,applejack|discord|fluttershy|mane six|pinkie pie|rainbow dash|rarity|spike|starlight glimmer|sunset shimmer|trixie|twilight sparkle,light262
2166619.png,https://derpicdn.net/img/view/2019/10/12/2166619.png,4,0.939232349395752,989,1797,1557,2365,568,568,applejack|discord|fluttershy|mane six|pinkie pie|rainbow dash|rarity|spike|starlight glimmer|sunset shimmer|trixie|twilight sparkle,light262
2166785.png,https://derpicdn.net/img/view/2019/10/13/2166785.png,0,0.9989710450172424,1572,460,2388,1276,816,816,applejack|fluttershy|mane six|pinkie pie|rainbow dash|rarity|twilight sparkle,pinweena30
2166785.png,https://derpicdn.net/img/view/2019/10/13/2166785.png,1,0.989174485206604,171,1311,767,1907,596,596,applejack|fluttershy|mane six|pinkie pie|rainbow dash|rarity|twilight sparkle,pinweena30
2166785.png,https://derpicdn.net/img/view/2019/10/13/2166785.png,2,0.9873202443122864,1650,1371,2162,1883,512,512,applejack|fluttershy|mane six|pinkie pie|rainbow dash|rarity|twilight sparkle,pinweena30
2166916.png,https://derpicdn.net/img/view/2019/10/13/2166916.png,0,0.9934214949607848,77,89,497,509,420,420,applejack|fluttershy|mane six|pinkie pie|rainbow dash|rarity|spike|twilight sparkle,saturdaymorningproj
2166916.png,https://derpicdn.net/img/view/2019/10/13/2166916.png,1,0.9906821250915528,815,79,1335,599,520,520,applejack|fluttershy|mane six|pinkie pie|rainbow dash|rarity|spike|twilight sparkle,saturdaymorningproj
2166916.png,https://derpicdn.net/img/view/2019/10/13/2166916.png,2,0.9341391324996948,1155,440,1593,878,438,438,applejack|fluttershy|mane six|pinkie pie|rainbow dash|rarity|spike|twilight sparkle,saturdaymorningproj
2166930.png,https://derpicdn.net/img/view/2019/10/13/2166930.png,0,0.9677902460098268,1298,24,3150,2104,1852,2080,pinkie pie|twilight sparkle,viwrastupr
2166987.png,https://derpicdn.net/img/view/2019/10/13/2166987.png,0,0.9991737604141236,687,369,1017,699,330,330,applejack|fluttershy|mane six|pinkie pie|rainbow dash|rarity|spike|twilight sparkle,johnjoseco
2166987.png,https://derpicdn.net/img/view/2019/10/13/2166987.png,1,0.9972298741340636,480,431,704,655,224,224,applejack|fluttershy|mane six|pinkie pie|rainbow dash|rarity|spike|twilight sparkle,johnjoseco
2166987.png,https://derpicdn.net/img/view/2019/10/13/2166987.png,5,0.9294309616088868,224,381,564,721,340,340,applejack|fluttershy|mane six|pinkie pie|rainbow dash|rarity|spike|twilight sparkle,johnjoseco
2167084.png,https://derpicdn.net/img/view/2019/10/13/2167084.png,0,0.9896665811538696,572,389,1036,853,464,464,applejack|fluttershy|mane six|pinkie pie|rainbow dash|rarity|spike|twilight sparkle,mkogwheel
2167084.png,https://derpicdn.net/img/view/2019/10/13/2167084.png,1,0.9803887605667114,220,419,716,915,496,496,applejack|fluttershy|mane six|pinkie pie|rainbow dash|rarity|spike|twilight sparkle,mkogwheel
2167084.png,https://derpicdn.net/img/view/2019/10/13/2167084.png,2,0.937619149684906,1316,471,1716,871,400,400,applejack|fluttershy|mane six|pinkie pie|rainbow dash|rarity|spike|twilight sparkle,mkogwheel
2167227.png,https://derpicdn.net/img/view/2019/10/13/2167227.png,0,0.9972267746925354,112,0,1864,1487,1752,1487,applejack|fluttershy|mane six|pinkie pie|rainbow dash|rarity|twilight sparkle,caoscore
2167227.png,https://derpicdn.net/img/view/2019/10/13/2167227.png,1,0.9599499702453612,1476,216,3474,2214,1998,1998,applejack|fluttershy|mane six|pinkie pie|rainbow dash|rarity|twilight sparkle,caoscore
2167227.png,https://derpicdn.net/img/view/2019/10/13/2167227.png,2,0.9341370463371276,4154,1351,5212,2409,1058,1058,applejack|fluttershy|mane six|pinkie pie|rainbow dash|rarity|twilight sparkle,caoscore
2167711.png,https://derpicdn.net/img/view/2019/10/13/2167711.png,0,0.9860815405845642,576,396,1026,846,450,450,applejack|fluttershy|mane six|pinkie pie|rainbow dash|rarity|spike|twilight sparkle,mkogwheel
2167711.png,https://derpicdn.net/img/view/2019/10/13/2167711.png,1,0.9812444448471068,223,422,713,912,490,490,applejack|fluttershy|mane six|pinkie pie|rainbow dash|rarity|spike|twilight sparkle,mkogwheel
2167711.png,https://derpicdn.net/img/view/2019/10/13/2167711.png,2,0.9358807206153872,1311,469,1719,877,408,408,applejack|fluttershy|mane six|pinkie pie|rainbow dash|rarity|spike|twilight sparkle,mkogwheel
2167711.png,https://derpicdn.net/img/view/2019/10/13/2167711.png,3,0.9204180836677552,1876,747,2300,1191,424,444,applejack|fluttershy|mane six|pinkie pie|rainbow dash|rarity|spike|twilight sparkle,mkogwheel
2167958.png,https://derpicdn.net/img/view/2019/10/13/2167958.png,0,0.9790865182876588,147,12,769,634,622,622,applejack|fluttershy|mane six|pinkie pie|rainbow dash|rarity|twilight sparkle,lou
2167958.png,https://derpicdn.net/img/view/2019/10/13/2167958.png,1,0.9496201276779176,788,0,1540,705,752,705,applejack|fluttershy|mane six|pinkie pie|rainbow dash|rarity|twilight sparkle,lou
2167989.png,https://derpicdn.net/img/view/2019/10/13/2167989.png,0,0.9772133231163024,342,517,716,891,374,374,applejack|fluttershy|mane six|pinkie pie|rainbow dash|rarity|twilight sparkle,motger-mor
2168160.png,https://derpicdn.net/img/view/2019/10/14/2168160.png,0,0.9803937673568726,2470,731,3154,1415,684,684,applejack|fluttershy|mane six|pinkie pie|princess celestia|rainbow dash|rarity|spike|starlight glimmer|sunset shimmer|twilight sparkle,mkogwheel
2168160.png,https://derpicdn.net/img/view/2019/10/14/2168160.png,2,0.9495460987091064,2189,1574,2773,2158,584,584,applejack|fluttershy|mane six|pinkie pie|princess celestia|rainbow dash|rarity|spike|starlight glimmer|sunset shimmer|twilight sparkle,mkogwheel
2168912.png,https://derpicdn.net/img/view/2019/10/14/2168912.png,0,0.9993652701377868,490,252,1574,1336,1084,1084,applejack|fluttershy|mane six|pinkie pie|rainbow dash|rarity|starlight glimmer|trixie|twilight sparkle,muhjob
2168912.png,https://derpicdn.net/img/view/2019/10/14/2168912.png,2,0.9033472537994384,1190,726,2160,1772,970,1046,applejack|fluttershy|mane six|pinkie pie|rainbow dash|rarity|starlight glimmer|trixie|twilight sparkle,muhjob
2169023.png,https://derpicdn.net/img/view/2019/10/14/2169023.png,0,0.9971910715103148,92,97,1398,1403,1306,1306,trixie|twilight sparkle,nevobaster
2169023.png,https://derpicdn.net/img/view/2019/10/14/2169023.png,1,0.9669090509414672,2057,140,3139,1222,1082,1082,trixie|twilight sparkle,nevobaster
2169971.png,https://derpicdn.net/img/view/2019/10/15/2169971.png,0,0.9966228008270264,2235,2624,3679,4068,1444,1444,applejack|fluttershy|mane six|pinkie pie|princess cadance|princess celestia|princess luna|rainbow dash|rarity|twilight sparkle,forgottenrabbit28blr
2169971.png,https://derpicdn.net/img/view/2019/10/15/2169971.png,1,0.978415310382843,246,4224,1554,5532,1308,1308,applejack|fluttershy|mane six|pinkie pie|princess cadance|princess celestia|princess luna|rainbow dash|rarity|twilight sparkle,forgottenrabbit28blr
2171878.png,https://derpicdn.net/img/view/2019/10/17/2171878.png,0,0.938340663909912,758,0,1860,1080,1102,1080,applejack|fluttershy|mane six|pinkie pie|rainbow dash|rarity|twilight sparkle,fensu-san
2173655.png,https://derpicdn.net/img/view/2019/10/19/2173655.png,0,0.9571772813796996,692,469,1012,789,320,320,applejack|fluttershy|mane six|pinkie pie|rainbow dash|rarity|spike|twilight sparkle,ncmares
2174769.png,https://derpicdn.net/img/view/2019/10/20/2174769.png,1,0.9770349860191344,1487,706,2349,1568,862,862,princess celestia|twilight sparkle,avrameow
2176167.png,https://derpicdn.net/img/view/2019/10/22/2176167.png,1,0.9983677268028259,751,996,1647,1892,896,896,applejack|fluttershy|mane six|pinkie pie|rainbow dash|rarity|starlight glimmer|sunset shimmer|trixie|twilight sparkle,calveen|whiteskyline|alicorntwilysparkle
2176167.png,https://derpicdn.net/img/view/2019/10/22/2176167.png,2,0.9389162063598632,2213,857,2991,1635,778,778,applejack|fluttershy|mane six|pinkie pie|rainbow dash|rarity|starlight glimmer|sunset shimmer|trixie|twilight sparkle,calveen|whiteskyline|alicorntwilysparkle
2178923.png,https://derpicdn.net/img/view/2019/10/25/2178923.png,3,0.9231441617012024,717,641,1663,1587,946,946,applejack|fluttershy|mane six|pinkie pie|rainbow dash|rarity|twilight sparkle,dsp2003
2183673.png,https://derpicdn.net/img/view/2019/10/31/2183673.png,0,0.9966938495635986,0,82,1209,1320,1209,1238,applejack|fluttershy|mane six|pinkie pie|princess celestia|princess luna|rainbow dash|rarity|spike|twilight sparkle,luciferamon
2183673.png,https://derpicdn.net/img/view/2019/10/31/2183673.png,1,0.98855859041214,2311,0,3275,956,964,956,applejack|fluttershy|mane six|pinkie pie|princess celestia|princess luna|rainbow dash|rarity|spike|twilight sparkle,luciferamon
2183673.png,https://derpicdn.net/img/view/2019/10/31/2183673.png,4,0.9126121997833252,978,47,2184,1253,1206,1206,applejack|fluttershy|mane six|pinkie pie|princess celestia|princess luna|rainbow dash|rarity|spike|twilight sparkle,luciferamon
2188600.png,https://derpicdn.net/img/view/2019/11/6/2188600.png,0,0.9919738173484802,157,271,649,763,492,492,applejack|fluttershy|mane six|pinkie pie|rainbow dash|rarity|twilight sparkle,candyclumsy
2189249.png,https://derpicdn.net/img/view/2019/11/6/2189249.png,1,0.9965687394142152,89,1135,501,1547,412,412,applejack|fluttershy|mane six|pinkie pie|rainbow dash|rarity|spike|twilight sparkle,inuhoshi-to-darkpen
2189249.png,https://derpicdn.net/img/view/2019/11/6/2189249.png,2,0.9947437644004822,152,72,532,452,380,380,applejack|fluttershy|mane six|pinkie pie|rainbow dash|rarity|spike|twilight sparkle,inuhoshi-to-darkpen
2189249.png,https://derpicdn.net/img/view/2019/11/6/2189249.png,3,0.971523940563202,693,1167,1101,1575,408,408,applejack|fluttershy|mane six|pinkie pie|rainbow dash|rarity|spike|twilight sparkle,inuhoshi-to-darkpen
2189249.png,https://derpicdn.net/img/view/2019/11/6/2189249.png,4,0.9654836654663086,687,680,1089,1082,402,402,applejack|fluttershy|mane six|pinkie pie|rainbow dash|rarity|spike|twilight sparkle,inuhoshi-to-darkpen
2192245.png,https://derpicdn.net/img/view/2019/11/10/2192245.png,0,0.998754620552063,1402,2569,2418,3585,1016,1016,applejack|fluttershy|mane six|pinkie pie|rainbow dash|rarity|spike|twilight sparkle,seishinann
2193246.png,https://derpicdn.net/img/view/2019/11/11/2193246.png,0,0.996912956237793,2834,1476,3486,2128,652,652,applejack|fluttershy|pinkie pie|rainbow dash|rarity|sunset shimmer|twilight sparkle,uotapo
2193246.png,https://derpicdn.net/img/view/2019/11/11/2193246.png,1,0.9891977310180664,1591,2320,2249,2978,658,658,applejack|fluttershy|pinkie pie|rainbow dash|rarity|sunset shimmer|twilight sparkle,uotapo
2193246.png,https://derpicdn.net/img/view/2019/11/11/2193246.png,2,0.9866875410079956,541,2872,1181,3512,640,640,applejack|fluttershy|pinkie pie|rainbow dash|rarity|sunset shimmer|twilight sparkle,uotapo
2193246.png,https://derpicdn.net/img/view/2019/11/11/2193246.png,3,0.96787828207016,3051,2619,3765,3333,714,714,applejack|fluttershy|pinkie pie|rainbow dash|rarity|sunset shimmer|twilight sparkle,uotapo
2193246.png,https://derpicdn.net/img/view/2019/11/11/2193246.png,4,0.9669185876846312,583,2148,1297,2862,714,714,applejack|fluttershy|pinkie pie|rainbow dash|rarity|sunset shimmer|twilight sparkle,uotapo
2193248.png,https://derpicdn.net/img/view/2019/11/11/2193248.png,0,0.9963385462760924,2828,1467,3492,2131,664,664,applejack|fluttershy|mane six|pinkie pie|rainbow dash|rarity|sunset shimmer|twilight sparkle,uotapo
2193248.png,https://derpicdn.net/img/view/2019/11/11/2193248.png,1,0.9891979694366456,1591,2320,2249,2978,658,658,applejack|fluttershy|mane six|pinkie pie|rainbow dash|rarity|sunset shimmer|twilight sparkle,uotapo
2193248.png,https://derpicdn.net/img/view/2019/11/11/2193248.png,2,0.986687421798706,541,2872,1181,3512,640,640,applejack|fluttershy|mane six|pinkie pie|rainbow dash|rarity|sunset shimmer|twilight sparkle,uotapo
2193248.png,https://derpicdn.net/img/view/2019/11/11/2193248.png,3,0.96787828207016,3051,2619,3765,3333,714,714,applejack|fluttershy|mane six|pinkie pie|rainbow dash|rarity|sunset shimmer|twilight sparkle,uotapo
2193248.png,https://derpicdn.net/img/view/2019/11/11/2193248.png,4,0.966913640499115,583,2148,1297,2862,714,714,applejack|fluttershy|mane six|pinkie pie|rainbow dash|rarity|sunset shimmer|twilight sparkle,uotapo
2193522.png,https://derpicdn.net/img/view/2019/11/11/2193522.png,0,0.9996273517608644,1229,515,1705,991,476,476,applejack|fluttershy|mane six|pinkie pie|rainbow dash|rarity|twilight sparkle,lou
2193522.png,https://derpicdn.net/img/view/2019/11/11/2193522.png,1,0.9987999200820924,410,28,916,534,506,506,applejack|fluttershy|mane six|pinkie pie|rainbow dash|rarity|twilight sparkle,lou
2193522.png,https://derpicdn.net/img/view/2019/11/11/2193522.png,2,0.9931280016899108,921,537,1363,979,442,442,applejack|fluttershy|mane six|pinkie pie|rainbow dash|rarity|twilight sparkle,lou
2193522.png,https://derpicdn.net/img/view/2019/11/11/2193522.png,3,0.9898625016212464,37,574,417,954,380,380,applejack|fluttershy|mane six|pinkie pie|rainbow dash|rarity|twilight sparkle,lou
2193784.png,https://derpicdn.net/img/view/2019/11/12/2193784.png,1,0.9358243346214294,248,15,898,665,650,650,rarity|twilight sparkle,king-kakapo
2195871.png,https://derpicdn.net/img/view/2019/11/14/2195871.png,0,0.9974285960197448,324,49,592,317,268,268,applejack|fluttershy|mane six|pinkie pie|rainbow dash|rarity|twilight sparkle,kumikoponylk
2195871.png,https://derpicdn.net/img/view/2019/11/14/2195871.png,1,0.9936348795890808,541,39,795,293,254,254,applejack|fluttershy|mane six|pinkie pie|rainbow dash|rarity|twilight sparkle,kumikoponylk
2195871.png,https://derpicdn.net/img/view/2019/11/14/2195871.png,2,0.9908435344696044,92,95,330,333,238,238,applejack|fluttershy|mane six|pinkie pie|rainbow dash|rarity|twilight sparkle,kumikoponylk
2195871.png,https://derpicdn.net/img/view/2019/11/14/2195871.png,3,0.931788444519043,298,362,582,646,284,284,applejack|fluttershy|mane six|pinkie pie|rainbow dash|rarity|twilight sparkle,kumikoponylk
2195987.png,https://derpicdn.net/img/view/2019/11/14/2195987.png,1,0.9912511110305786,163,863,795,1495,632,632,applejack|fluttershy|mane six|pinkie pie|rainbow dash|rarity|twilight sparkle,silbersternenlicht
2196849.png,https://derpicdn.net/img/view/2019/11/15/2196849.png,0,0.985066294670105,707,621,1143,1057,436,436,applejack|fluttershy|mane six|pinkie pie|rainbow dash|rarity|spike|twilight sparkle,saturdaymorningproj
2196849.png,https://derpicdn.net/img/view/2019/11/15/2196849.png,2,0.9489277005195618,417,497,847,927,430,430,applejack|fluttershy|mane six|pinkie pie|rainbow dash|rarity|spike|twilight sparkle,saturdaymorningproj
2196860.png,https://derpicdn.net/img/view/2019/11/15/2196860.png,0,0.997915744781494,117,1074,569,1526,452,452,applejack|fluttershy|mane six|pinkie pie|rainbow dash|rarity|twilight sparkle,mofumofutchi
2196860.png,https://derpicdn.net/img/view/2019/11/15/2196860.png,2,0.9923787713050842,541,1006,901,1366,360,360,applejack|fluttershy|mane six|pinkie pie|rainbow dash|rarity|twilight sparkle,mofumofutchi
2196860.png,https://derpicdn.net/img/view/2019/11/15/2196860.png,3,0.9884952306747437,466,96,988,618,522,522,applejack|fluttershy|mane six|pinkie pie|rainbow dash|rarity|twilight sparkle,mofumofutchi
2196860.png,https://derpicdn.net/img/view/2019/11/15/2196860.png,4,0.9239822030067444,771,582,1339,1150,568,568,applejack|fluttershy|mane six|pinkie pie|rainbow dash|rarity|twilight sparkle,mofumofutchi
2196860.png,https://derpicdn.net/img/view/2019/11/15/2196860.png,5,0.9123474359512328,844,1209,1226,1591,382,382,applejack|fluttershy|mane six|pinkie pie|rainbow dash|rarity|twilight sparkle,mofumofutchi
2198543.png,https://derpicdn.net/img/view/2019/11/17/2198543.png,0,0.931282639503479,78,117,366,405,288,288,princess luna|twilight sparkle,lulubell
219936.jpg,https://derpicdn.net/img/view/2013/1/21/219936.jpg,1,0.9810277223587036,429,100,641,312,212,212,applejack|fluttershy|mane six|pinkie pie|rainbow dash|rarity|twilight sparkle,shepherd0821
219936.jpg,https://derpicdn.net/img/view/2013/1/21/219936.jpg,2,0.9782325625419616,110,0,288,178,178,178,applejack|fluttershy|mane six|pinkie pie|rainbow dash|rarity|twilight sparkle,shepherd0821
219936.jpg,https://derpicdn.net/img/view/2013/1/21/219936.jpg,3,0.9419500231742859,617,88,795,266,178,178,applejack|fluttershy|mane six|pinkie pie|rainbow dash|rarity|twilight sparkle,shepherd0821
2204665.png,https://derpicdn.net/img/view/2019/11/24/2204665.png,0,0.9954107999801636,2550,1672,3772,2894,1222,1222,princess celestia|twilight sparkle,avrameow
2205550.png,https://derpicdn.net/img/view/2019/11/25/2205550.png,0,0.9739949703216552,1843,1358,2659,2174,816,816,applejack|fluttershy|mane six|pinkie pie|rainbow dash|rarity|twilight sparkle,kuragekami|pinweena30
2206986.png,https://derpicdn.net/img/view/2019/11/27/2206986.png,0,0.9424781799316406,3223,523,5000,2327,1777,1804,applejack|fluttershy|mane six|pinkie pie|princess celestia|princess luna|rainbow dash|rarity|starlight glimmer|trixie|twilight sparkle,bunxl
2207013.png,https://derpicdn.net/img/view/2019/11/27/2207013.png,0,0.997567355632782,710,1374,1300,1964,590,590,applejack|fluttershy|mane six|pinkie pie|rainbow dash|rarity|twilight sparkle,dawnfire
2207013.png,https://derpicdn.net/img/view/2019/11/27/2207013.png,1,0.9169673323631288,1070,621,1654,1205,584,584,applejack|fluttershy|mane six|pinkie pie|rainbow dash|rarity|twilight sparkle,dawnfire
221319.png,https://derpicdn.net/img/view/2013/1/23/221319.png,0,0.9640096426010132,137,90,267,220,130,130,princess cadance|princess luna|twilight sparkle,starlight-gaze
2216474.png,https://derpicdn.net/img/view/2019/12/9/2216474.png,0,0.9920069575309752,134,19,498,383,364,364,princess luna|twilight sparkle,lulubell
2217689.png,https://derpicdn.net/img/view/2019/12/10/2217689.png,0,0.9321396946907043,224,57,540,373,316,316,applejack|fluttershy|mane six|pinkie pie|princess celestia|princess luna|rainbow dash|rarity|twilight sparkle,eqamrd
2217689.png,https://derpicdn.net/img/view/2019/12/10/2217689.png,1,0.9022518396377563,414,24,792,402,378,378,applejack|fluttershy|mane six|pinkie pie|princess celestia|princess luna|rainbow dash|rarity|twilight sparkle,eqamrd
2219597.png,https://derpicdn.net/img/view/2019/12/13/2219597.png,0,0.9955168366432192,261,46,587,372,326,326,fluttershy|spike|sunset shimmer|twilight sparkle,tzc
222279.png,https://derpicdn.net/img/view/2013/1/24/222279.png,0,0.9045507311820984,23,265,493,735,470,470,princess celestia|twilight sparkle,reiduran
2227722.png,https://derpicdn.net/img/view/2019/12/23/2227722.png,0,0.9940927624702454,1994,354,2558,918,564,564,applejack|spike|twilight sparkle,dimfann
2233565.png,https://derpicdn.net/img/view/2019/12/30/2233565.png,1,0.960718274116516,657,305,1029,719,372,414,starlight glimmer|sunset shimmer|twilight sparkle,patty-plmh
2234464.jpg,https://derpicdn.net/img/view/2019/12/31/2234464.jpg,0,0.9524012207984924,168,0,844,641,676,641,rarity|twilight sparkle,lilfunkman
2235497.png,https://derpicdn.net/img/view/2020/1/1/2235497.png,0,0.9983705878257751,234,0,680,390,446,390,applejack|fluttershy|mane six|pinkie pie|rainbow dash|rarity|twilight sparkle,oomles
223785.png,https://derpicdn.net/img/view/2013/1/26/223785.png,1,0.9967273473739624,1031,2036,1463,2468,432,432,apple bloom|applejack|babs seed|big macintosh|cutie mark crusaders|diamond tiara|discord|fluttershy|mane six|pinkie pie|princess cadance|princess celestia|princess luna|rainbow dash|rarity|scootaloo|shining armor|silver spoon|spike|sweetie belle|trixie|twilight sparkle,aruurara
223785.png,https://derpicdn.net/img/view/2013/1/26/223785.png,2,0.9927518367767334,918,1116,1346,1544,428,428,apple bloom|applejack|babs seed|big macintosh|cutie mark crusaders|diamond tiara|discord|fluttershy|mane six|pinkie pie|princess cadance|princess celestia|princess luna|rainbow dash|rarity|scootaloo|shining armor|silver spoon|spike|sweetie belle|trixie|twilight sparkle,aruurara
223785.png,https://derpicdn.net/img/view/2013/1/26/223785.png,4,0.9887346625328064,1865,508,2371,1014,506,506,apple bloom|applejack|babs seed|big macintosh|cutie mark crusaders|diamond tiara|discord|fluttershy|mane six|pinkie pie|princess cadance|princess celestia|princess luna|rainbow dash|rarity|scootaloo|shining armor|silver spoon|spike|sweetie belle|trixie|twilight sparkle,aruurara
223785.png,https://derpicdn.net/img/view/2013/1/26/223785.png,5,0.9883273839950562,1735,1530,2285,2080,550,550,apple bloom|applejack|babs seed|big macintosh|cutie mark crusaders|diamond tiara|discord|fluttershy|mane six|pinkie pie|princess cadance|princess celestia|princess luna|rainbow dash|rarity|scootaloo|shining armor|silver spoon|spike|sweetie belle|trixie|twilight sparkle,aruurara
223785.png,https://derpicdn.net/img/view/2013/1/26/223785.png,6,0.9322386384010316,2324,2153,2842,2671,518,518,apple bloom|applejack|babs seed|big macintosh|cutie mark crusaders|diamond tiara|discord|fluttershy|mane six|pinkie pie|princess cadance|princess celestia|princess luna|rainbow dash|rarity|scootaloo|shining armor|silver spoon|spike|sweetie belle|trixie|twilight sparkle,aruurara
223785.png,https://derpicdn.net/img/view/2013/1/26/223785.png,7,0.9312383532524108,1369,1917,1815,2363,446,446,apple bloom|applejack|babs seed|big macintosh|cutie mark crusaders|diamond tiara|discord|fluttershy|mane six|pinkie pie|princess cadance|princess celestia|princess luna|rainbow dash|rarity|scootaloo|shining armor|silver spoon|spike|sweetie belle|trixie|twilight sparkle,aruurara
2245565.png,https://derpicdn.net/img/view/2020/1/12/2245565.png,0,0.9989616870880128,409,505,2139,2235,1730,1730,princess celestia|twilight sparkle,empress-twilight
2249730.jpg,https://derpicdn.net/img/view/2020/1/17/2249730.jpg,0,0.999584138393402,420,54,1212,846,792,792,rarity|twilight sparkle,lilfunkman
2249730.jpg,https://derpicdn.net/img/view/2020/1/17/2249730.jpg,1,0.9975064396858216,1061,909,1817,1665,756,756,rarity|twilight sparkle,lilfunkman
2249955.png,https://derpicdn.net/img/view/2020/1/17/2249955.png,0,0.9232650399208068,746,206,1876,1336,1130,1130,princess luna|twilight sparkle,magnaluna
2251060.jpg,https://derpicdn.net/img/view/2020/1/19/2251060.jpg,0,0.9992022514343262,894,7,1464,577,570,570,fluttershy|rainbow dash|spike|twilight sparkle,dawnfire
2254094.jpg,https://derpicdn.net/img/view/2020/1/22/2254094.jpg,0,0.9902902245521544,552,253,772,473,220,220,spike|twilight sparkle,luciferamon
2254094.jpg,https://derpicdn.net/img/view/2020/1/22/2254094.jpg,1,0.9560533761978148,724,63,1034,373,310,310,spike|twilight sparkle,luciferamon
2254900.jpg,https://derpicdn.net/img/view/2020/1/23/2254900.jpg,0,0.9735395908355712,1220,486,1546,812,326,326,princess celestia|princess luna|twilight sparkle,anticular
2257929.png,https://derpicdn.net/img/view/2020/1/26/2257929.png,0,0.9721003770828248,986,198,1390,602,404,404,princess celestia|princess luna|twilight sparkle,king-kakapo
2262234.jpg,https://derpicdn.net/img/view/2020/1/31/2262234.jpg,0,0.9987057447433472,519,15,787,283,268,268,applejack|fluttershy|rainbow dash|rarity|spike|twilight sparkle,tjpones
2267234.jpg,https://derpicdn.net/img/view/2020/2/6/2267234.jpg,0,0.9652229547500608,841,36,1579,774,738,738,princess luna|twilight sparkle,magnaluna
2267240.jpg,https://derpicdn.net/img/view/2020/2/6/2267240.jpg,0,0.9904996156692504,1562,2094,2266,2798,704,704,spike|twilight sparkle,drtuo4
2267240.jpg,https://derpicdn.net/img/view/2020/2/6/2267240.jpg,1,0.9126825928688048,2475,2213,3169,2907,694,694,spike|twilight sparkle,drtuo4
22686.png,https://derpicdn.net/img/view/2012/6/27/22686.png,0,0.9971085786819458,386,292,1080,986,694,694,applejack|fluttershy|mane six|pinkie pie|rainbow dash|rarity|twilight sparkle,killryde
22686.png,https://derpicdn.net/img/view/2012/6/27/22686.png,2,0.9628961682319641,1474,526,2198,1250,724,724,applejack|fluttershy|mane six|pinkie pie|rainbow dash|rarity|twilight sparkle,killryde
2270338.png,https://derpicdn.net/img/view/2020/2/10/2270338.png,0,0.990784764289856,1201,434,2087,1320,886,886,fluttershy|pinkie pie|twilight sparkle,jack-pie
2270980.jpg,https://derpicdn.net/img/view/2020/2/11/2270980.jpg,0,0.9898055195808412,616,0,986,345,370,345,princess cadance|princess flurry heart|twilight sparkle,bunniiibabe
2271247.jpg,https://derpicdn.net/img/view/2020/2/11/2271247.jpg,0,0.988181173801422,937,722,1243,1028,306,306,applejack|fluttershy|mane six|pinkie pie|rainbow dash|rarity|spike|twilight sparkle,andrew hickinbottom
2271247.jpg,https://derpicdn.net/img/view/2020/2/11/2271247.jpg,2,0.9601314663887024,195,297,537,639,342,342,applejack|fluttershy|mane six|pinkie pie|rainbow dash|rarity|spike|twilight sparkle,andrew hickinbottom
2271247.jpg,https://derpicdn.net/img/view/2020/2/11/2271247.jpg,3,0.9590435028076172,601,848,917,1164,316,316,applejack|fluttershy|mane six|pinkie pie|rainbow dash|rarity|spike|twilight sparkle,andrew hickinbottom
2271270.jpg,https://derpicdn.net/img/view/2020/2/11/2271270.jpg,0,0.9266532063484192,1102,828,1606,1332,504,504,rarity|twilight sparkle,earthsong9405
2271270.jpg,https://derpicdn.net/img/view/2020/2/11/2271270.jpg,1,0.9220545887947084,814,7,1672,865,858,858,rarity|twilight sparkle,earthsong9405
2274732.jpg,https://derpicdn.net/img/view/2020/2/15/2274732.jpg,0,0.9368070363998412,796,0,1450,612,654,612,princess luna|twilight sparkle,amarynceus
2283152.png,https://derpicdn.net/img/view/2020/2/25/2283152.png,0,0.969176709651947,71,84,349,362,278,278,applejack|fluttershy|mane six|pinkie pie|rainbow dash|rarity|spike|twilight sparkle,dusthiel
2283152.png,https://derpicdn.net/img/view/2020/2/25/2283152.png,1,0.9475322961807252,0,312,265,584,265,272,applejack|fluttershy|mane six|pinkie pie|rainbow dash|rarity|spike|twilight sparkle,dusthiel
2283152.png,https://derpicdn.net/img/view/2020/2/25/2283152.png,2,0.9264653325080872,145,302,417,574,272,272,applejack|fluttershy|mane six|pinkie pie|rainbow dash|rarity|spike|twilight sparkle,dusthiel
2283416.png,https://derpicdn.net/img/view/2020/2/25/2283416.png,0,0.997641921043396,179,438,1213,1472,1034,1034,fluttershy|twilight sparkle,yinglongfujun
2283416.png,https://derpicdn.net/img/view/2020/2/25/2283416.png,1,0.9957554936408995,2102,577,3280,1755,1178,1178,fluttershy|twilight sparkle,yinglongfujun
2288684.png,https://derpicdn.net/img/view/2020/3/3/2288684.png,0,0.9903265833854676,802,166,1688,1052,886,886,princess celestia|sunset shimmer|twilight sparkle,snowballflo
2288724.png,https://derpicdn.net/img/view/2020/3/3/2288724.png,0,0.9992135763168336,375,119,1281,1025,906,906,sunset shimmer|twilight sparkle,snowballflo|truebluflo
2289734.jpg,https://derpicdn.net/img/view/2020/3/4/2289734.jpg,0,0.9767539501190186,2093,26,5011,2944,2918,2918,sunset shimmer|twilight sparkle,imafutureguitarhero
2290880.png,https://derpicdn.net/img/view/2020/3/5/2290880.png,0,0.9986626505851746,1112,205,2022,1115,910,910,spike|twilight sparkle,1an1
2292935.png,https://derpicdn.net/img/view/2020/3/8/2292935.png,0,0.9983419179916382,406,0,940,506,534,506,rarity|twilight sparkle,twistedscarlett60
2295657.png,https://derpicdn.net/img/view/2020/3/12/2295657.png,1,0.9838212728500366,361,104,479,222,118,118,applejack|fluttershy|mane six|pinkie pie|rainbow dash|rarity|twilight sparkle,hornygraphite
2295657.png,https://derpicdn.net/img/view/2020/3/12/2295657.png,2,0.9465265274047852,1361,67,1501,207,140,140,applejack|fluttershy|mane six|pinkie pie|rainbow dash|rarity|twilight sparkle,hornygraphite
2299672.jpg,https://derpicdn.net/img/view/2020/3/17/2299672.jpg,0,0.9918093085289,56,0,236,207,180,207,fluttershy|pinkie pie|princess celestia|twilight sparkle,pencils
2299672.jpg,https://derpicdn.net/img/view/2020/3/17/2299672.jpg,1,0.9492250084877014,30,98,236,309,206,211,fluttershy|pinkie pie|princess celestia|twilight sparkle,pencils
2302757.png,https://derpicdn.net/img/view/2020/3/21/2302757.png,1,0.9488403797149658,1513,1638,2591,2716,1078,1078,applejack|fluttershy|mane six|pinkie pie|rainbow dash|rarity|twilight sparkle,cleoziep
2303797.png,https://derpicdn.net/img/view/2020/3/22/2303797.png,0,0.9866246581077576,1256,666,1698,1108,442,442,fluttershy|twilight sparkle,thelunarmoon
2303797.png,https://derpicdn.net/img/view/2020/3/22/2303797.png,1,0.9613890051841736,1841,760,2177,1096,336,336,fluttershy|twilight sparkle,thelunarmoon
2303851.jpg,https://derpicdn.net/img/view/2020/3/23/2303851.jpg,0,0.9926164150238036,1281,321,2145,1185,864,864,rarity|twilight sparkle,lilfunkman
2303851.jpg,https://derpicdn.net/img/view/2020/3/23/2303851.jpg,1,0.9874858260154724,940,1265,1616,1941,676,676,rarity|twilight sparkle,lilfunkman
2304258.jpg,https://derpicdn.net/img/view/2020/3/23/2304258.jpg,0,0.9692226052284241,130,0,540,393,410,393,princess celestia|twilight sparkle,akeahi
2305229.jpg,https://derpicdn.net/img/view/2020/3/24/2305229.jpg,0,0.9967773556709292,629,375,1495,1241,866,866,rarity|twilight sparkle,lilfunkman
2305827.jpg,https://derpicdn.net/img/view/2020/3/25/2305827.jpg,0,0.9942440390586852,814,169,1490,845,676,676,princess celestia|princess luna|rainbow dash|twilight sparkle,dai-san31
2308173.png,https://derpicdn.net/img/view/2020/3/28/2308173.png,0,0.998340904712677,473,6,785,318,312,312,spike|twilight sparkle,zazush-una
2309824.png,https://derpicdn.net/img/view/2020/3/30/2309824.png,2,0.940065622329712,3141,775,4101,1735,960,960,starlight glimmer|sunset shimmer|trixie|twilight sparkle,rivin177
2310975.jpg,https://derpicdn.net/img/view/2020/4/1/2310975.jpg,0,0.9567530751228333,716,282,1776,1342,1060,1060,rarity|twilight sparkle,lilfunkman
2313599.png,https://derpicdn.net/img/view/2020/4/4/2313599.png,1,0.9697242975234984,201,542,551,892,350,350,applejack|fluttershy|mane six|pinkie pie|rainbow dash|rarity|twilight sparkle,gleamydreams
2316588.png,https://derpicdn.net/img/view/2020/4/7/2316588.png,1,0.9532310962677002,168,108,468,408,300,300,princess cadance|shining armor|twilight sparkle,ende26
2320094.jpg,https://derpicdn.net/img/view/2020/4/12/2320094.jpg,0,0.987817883491516,186,294,1030,1138,844,844,rarity|twilight sparkle,lollipony|sadtrooper
2324575.png,https://derpicdn.net/img/view/2020/4/17/2324575.png,0,0.9985401034355164,2770,514,3508,1286,738,772,princess celestia|princess luna|starlight glimmer|twilight sparkle,underpable
2324575.png,https://derpicdn.net/img/view/2020/4/17/2324575.png,1,0.9602437615394592,0,1027,1282,2361,1282,1334,princess celestia|princess luna|starlight glimmer|twilight sparkle,underpable
233032.png,https://derpicdn.net/img/view/2013/2/4/233032.png,0,0.9688400626182556,8,201,290,483,282,282,princess celestia|trixie|twilight sparkle,johnjoseco
2333182.png,https://derpicdn.net/img/view/2020/4/27/2333182.png,0,0.99983549118042,0,653,783,1473,783,820,applejack|fluttershy|mane six|pinkie pie|rainbow dash|rarity|twilight sparkle,kirionek
2333182.png,https://derpicdn.net/img/view/2020/4/27/2333182.png,1,0.9998139142990112,0,0,773,705,773,705,applejack|fluttershy|mane six|pinkie pie|rainbow dash|rarity|twilight sparkle,kirionek
2333182.png,https://derpicdn.net/img/view/2020/4/27/2333182.png,2,0.99945068359375,667,0,1529,743,862,743,applejack|fluttershy|mane six|pinkie pie|rainbow dash|rarity|twilight sparkle,kirionek
2333182.png,https://derpicdn.net/img/view/2020/4/27/2333182.png,3,0.9994238018989564,1513,0,2250,684,737,684,applejack|fluttershy|mane six|pinkie pie|rainbow dash|rarity|twilight sparkle,kirionek
2333182.png,https://derpicdn.net/img/view/2020/4/27/2333182.png,4,0.9973690509796144,736,643,1564,1471,828,828,applejack|fluttershy|mane six|pinkie pie|rainbow dash|rarity|twilight sparkle,kirionek
2333182.png,https://derpicdn.net/img/view/2020/4/27/2333182.png,5,0.9413780570030212,1470,622,2250,1430,780,808,applejack|fluttershy|mane six|pinkie pie|rainbow dash|rarity|twilight sparkle,kirionek
23337.jpg,https://derpicdn.net/img/view/2012/6/28/23337.jpg,0,0.998676300048828,0,0,571,564,571,564,princess cadance|shining armor|twilight sparkle,johnjoseco
233384.png,https://derpicdn.net/img/view/2013/2/4/233384.png,0,0.9850661754608154,1,177,149,325,148,148,applejack|fluttershy|mane six|pinkie pie|rainbow dash|rarity|spike|twilight sparkle,ichigoaimin
2334574.png,https://derpicdn.net/img/view/2020/4/29/2334574.png,0,0.9762082695961,1276,0,2534,1073,1258,1073,applejack|fluttershy|mane six|pinkie pie|rainbow dash|rarity|spike|starlight glimmer|twilight sparkle,skitsniga|hitbass
2334658.png,https://derpicdn.net/img/view/2020/4/29/2334658.png,1,0.9962793588638306,830,1126,1550,1846,720,720,applejack|fluttershy|mane six|pinkie pie|rainbow dash|rarity|twilight sparkle,littledreamycat|dreamy
2340065.jpg,https://derpicdn.net/img/view/2020/5/5/2340065.jpg,0,0.9770533442497252,67,407,523,863,456,456,starlight glimmer|sunset shimmer|twilight sparkle,rocket-lawnchair
2340155.png,https://derpicdn.net/img/view/2020/5/5/2340155.png,0,0.997954785823822,53,422,365,734,312,312,applejack|fluttershy|pinkie pie|rainbow dash|rarity|twilight sparkle,setharu
2340155.png,https://derpicdn.net/img/view/2020/5/5/2340155.png,1,0.9962320923805236,375,4,679,308,304,304,applejack|fluttershy|pinkie pie|rainbow dash|rarity|twilight sparkle,setharu
2340155.png,https://derpicdn.net/img/view/2020/5/5/2340155.png,2,0.99530291557312,71,5,377,311,306,306,applejack|fluttershy|pinkie pie|rainbow dash|rarity|twilight sparkle,setharu
2340155.png,https://derpicdn.net/img/view/2020/5/5/2340155.png,3,0.9902603030204772,686,411,1006,731,320,320,applejack|fluttershy|pinkie pie|rainbow dash|rarity|twilight sparkle,setharu
2340155.png,https://derpicdn.net/img/view/2020/5/5/2340155.png,4,0.9895111918449402,344,423,652,731,308,308,applejack|fluttershy|pinkie pie|rainbow dash|rarity|twilight sparkle,setharu
2340155.png,https://derpicdn.net/img/view/2020/5/5/2340155.png,5,0.9682912230491638,625,0,1021,353,396,353,applejack|fluttershy|pinkie pie|rainbow dash|rarity|twilight sparkle,setharu
2341950.png,https://derpicdn.net/img/view/2020/5/7/2341950.png,0,0.9339115619659424,870,160,1260,550,390,390,princess celestia|twilight sparkle,sparkleee-sprinkle
2342052.png,https://derpicdn.net/img/view/2020/5/7/2342052.png,3,0.9406911730766296,770,463,974,667,204,204,applejack|fluttershy|mane six|pinkie pie|rainbow dash|rarity|twilight sparkle,anthroponiessfm
2342179.png,https://derpicdn.net/img/view/2020/5/7/2342179.png,0,0.9920242428779602,544,69,930,455,386,386,spike|twilight sparkle,light262
2342179.png,https://derpicdn.net/img/view/2020/5/7/2342179.png,1,0.9918776750564576,12,0,492,466,480,466,spike|twilight sparkle,light262
2343172.png,https://derpicdn.net/img/view/2020/5/8/2343172.png,1,0.9953262805938721,219,0,487,222,268,222,applejack|fluttershy|mane six|pinkie pie|rainbow dash|rarity|twilight sparkle,evomanaphy
2343172.png,https://derpicdn.net/img/view/2020/5/8/2343172.png,3,0.9767524600028992,222,146,430,354,208,208,applejack|fluttershy|mane six|pinkie pie|rainbow dash|rarity|twilight sparkle,evomanaphy
2344073.jpg,https://derpicdn.net/img/view/2020/5/9/2344073.jpg,0,0.9989742636680604,39,651,793,1405,754,754,applejack|fluttershy|mane six|pinkie pie|rainbow dash|rarity|starlight glimmer|twilight sparkle,gryphon bbq
2344129.jpg,https://derpicdn.net/img/view/2020/5/9/2344129.jpg,0,0.9591275453567504,0,683,843,1553,843,870,apple bloom|applejack|big macintosh|cutie mark crusaders|discord|fluttershy|mane six|pinkie pie|rainbow dash|rarity|scootaloo|spike|starlight glimmer|sweetie belle|twilight sparkle,redstoneengine|midnight-note|bae-mon|now556|lollipony|blackligerth|thefloatingtree|tcn1205|aemantaslim|tikrs007|equinecheese|vaser888
2345681.jpg,https://derpicdn.net/img/view/2020/5/11/2345681.jpg,0,0.9587565660476683,436,408,1888,1860,1452,1452,rainbow dash|twilight sparkle,liaaqila
2346829.jpg,https://derpicdn.net/img/view/2020/5/12/2346829.jpg,0,0.9941041469573976,1034,109,2730,1805,1696,1696,spike|twilight sparkle,lilfunkman
2347153.jpg,https://derpicdn.net/img/view/2020/5/13/2347153.jpg,1,0.9874967932701112,897,934,1415,1452,518,518,rarity|twilight sparkle,raranfa
2347347.png,https://derpicdn.net/img/view/2020/5/13/2347347.png,0,0.998022198677063,722,0,1422,570,700,570,starlight glimmer|trixie|twilight sparkle,zuckergelee
2347347.png,https://derpicdn.net/img/view/2020/5/13/2347347.png,1,0.9929471611976624,1326,133,2108,915,782,782,starlight glimmer|trixie|twilight sparkle,zuckergelee
2348303.jpg,https://derpicdn.net/img/view/2020/5/14/2348303.jpg,0,0.9988120198249816,64,652,802,1390,738,738,applejack|fluttershy|mane six|pinkie pie|rainbow dash|rarity|starlight glimmer|twilight sparkle,gryphon bbq
2352094.jpg,https://derpicdn.net/img/view/2020/5/18/2352094.jpg,0,0.9998338222503662,1170,0,2734,1561,1564,1561,rainbow dash|twilight sparkle,taneysha
236752.png,https://derpicdn.net/img/view/2013/2/8/236752.png,0,0.9992904663085938,680,0,1022,316,342,316,princess celestia|spike|twilight sparkle,fizzy-dog
236752.png,https://derpicdn.net/img/view/2013/2/8/236752.png,1,0.9965112209320068,114,264,390,540,276,276,princess celestia|spike|twilight sparkle,fizzy-dog
240.png,https://derpicdn.net/img/view/2012/1/15/240.png,0,0.9549825191497804,184,700,560,1076,376,376,princess luna|twilight sparkle,mi-eau
241341.jpg,https://derpicdn.net/img/view/2013/2/12/241341.jpg,0,0.9759079813957214,79,44,541,506,462,462,rarity|twilight sparkle,mysticalpha
242252.jpg,https://derpicdn.net/img/view/2013/2/13/242252.jpg,0,0.9961455464363098,235,0,703,423,468,423,applejack|fluttershy|rarity|twilight sparkle,moophins
242277.png,https://derpicdn.net/img/view/2013/2/13/242277.png,0,0.9866765141487122,4167,1302,4945,2080,778,778,applejack|fluttershy|mane six|pinkie pie|rainbow dash|rarity|twilight sparkle,trinityinyang
242277.png,https://derpicdn.net/img/view/2013/2/13/242277.png,1,0.9021220803260804,2646,1427,3174,1955,528,528,applejack|fluttershy|mane six|pinkie pie|rainbow dash|rarity|twilight sparkle,trinityinyang
243878.jpg,https://derpicdn.net/img/view/2013/2/15/243878.jpg,0,0.9742106199264526,122,82,416,376,294,294,trixie|twilight sparkle,kandlin
247665.jpg,https://derpicdn.net/img/view/2013/2/18/247665.jpg,0,0.9914095997810364,0,51,352,445,352,394,apple bloom|applejack|babs seed|big macintosh|braeburn|cutie mark crusaders|discord|fluttershy|granny smith|mane six|pinkie pie|rainbow dash|rarity|scootaloo|shining armor|spike|spitfire|sweetie belle|trixie|twilight sparkle,
247665.jpg,https://derpicdn.net/img/view/2013/2/18/247665.jpg,1,0.966326117515564,81,1859,445,2223,364,364,apple bloom|applejack|babs seed|big macintosh|braeburn|cutie mark crusaders|discord|fluttershy|granny smith|mane six|pinkie pie|rainbow dash|rarity|scootaloo|shining armor|spike|spitfire|sweetie belle|trixie|twilight sparkle,
247665.jpg,https://derpicdn.net/img/view/2013/2/18/247665.jpg,2,0.953019082546234,279,810,595,1126,316,316,apple bloom|applejack|babs seed|big macintosh|braeburn|cutie mark crusaders|discord|fluttershy|granny smith|mane six|pinkie pie|rainbow dash|rarity|scootaloo|shining armor|spike|spitfire|sweetie belle|trixie|twilight sparkle,
247873.png,https://derpicdn.net/img/view/2013/2/18/247873.png,2,0.9852806329727172,27,516,623,1112,596,596,apple bloom|applejack|babs seed|cutie mark crusaders|fluttershy|mane six|pinkie pie|rainbow dash|rarity|scootaloo|spike|sweetie belle|twilight sparkle,loyaldis
251253.png,https://derpicdn.net/img/view/2013/2/21/251253.png,0,0.9237747192382812,891,91,1337,537,446,446,applejack|fluttershy|mane six|pinkie pie|princess celestia|rainbow dash|rarity|spike|twilight sparkle,rublegun
2522.png,https://derpicdn.net/img/view/2012/1/28/2522.png,0,0.9549785256385804,256,70,768,582,512,512,applejack|fluttershy|mane six|pinkie pie|rainbow dash|rarity|twilight sparkle,suikuzu
256017.png,https://derpicdn.net/img/view/2013/2/26/256017.png,0,0.9719762206077576,1,30,609,638,608,608,fluttershy|pinkie pie|twilight sparkle,si1vr
258111.png,https://derpicdn.net/img/view/2013/2/28/258111.png,0,0.9948972463607788,39,273,287,521,248,248,applejack|fluttershy|mane six|pinkie pie|rainbow dash|rarity|spike|twilight sparkle,braeburned
258111.png,https://derpicdn.net/img/view/2013/2/28/258111.png,1,0.9734990000724792,171,0,397,207,226,207,applejack|fluttershy|mane six|pinkie pie|rainbow dash|rarity|spike|twilight sparkle,braeburned
258440.png,https://derpicdn.net/img/view/2013/3/1/258440.png,0,0.9879611730575562,151,51,523,423,372,372,applejack|pinkie pie|rarity|twilight sparkle,racoonsan
258440.png,https://derpicdn.net/img/view/2013/3/1/258440.png,1,0.964776873588562,609,0,1097,422,488,422,applejack|pinkie pie|rarity|twilight sparkle,racoonsan
258440.png,https://derpicdn.net/img/view/2013/3/1/258440.png,2,0.9344094395637512,716,574,1162,1020,446,446,applejack|pinkie pie|rarity|twilight sparkle,racoonsan
259091.png,https://derpicdn.net/img/view/2013/3/1/259091.png,0,0.93523508310318,255,65,793,603,538,538,princess cadance|twilight sparkle,kaji-tanii
259233.png,https://derpicdn.net/img/view/2013/3/1/259233.png,0,0.995206654071808,99,0,579,377,480,377,applejack|fluttershy|pinkie pie|princess celestia|rainbow dash|rarity|twilight sparkle,racoonsan
259233.png,https://derpicdn.net/img/view/2013/3/1/259233.png,1,0.9947634935379028,1112,467,1478,833,366,366,applejack|fluttershy|pinkie pie|princess celestia|rainbow dash|rarity|twilight sparkle,racoonsan
259233.png,https://derpicdn.net/img/view/2013/3/1/259233.png,3,0.9570000767707824,1005,0,1439,361,434,361,applejack|fluttershy|pinkie pie|princess celestia|rainbow dash|rarity|twilight sparkle,racoonsan
271939.png,https://derpicdn.net/img/view/2013/3/16/271939.png,0,0.9822463393211364,357,133,705,481,348,348,applejack|big macintosh|shining armor|twilight sparkle,niggerfaggot
271939.png,https://derpicdn.net/img/view/2013/3/16/271939.png,1,0.9792822599411012,0,209,253,479,253,270,applejack|big macintosh|shining armor|twilight sparkle,niggerfaggot
274233.jpg,https://derpicdn.net/img/view/2013/3/19/274233.jpg,1,0.9113101363182068,394,102,750,458,356,356,pinkie pie|rainbow dash|twilight sparkle,mol
274803.png,https://derpicdn.net/img/view/2013/3/20/274803.png,0,0.9949873685836792,356,0,944,558,588,558,rainbow dash|twilight sparkle,pippy
275886.png,https://derpicdn.net/img/view/2013/3/21/275886.png,0,0.9976139664649964,274,0,686,359,412,359,big macintosh|pinkie pie|rarity|twilight sparkle,aruurara
284758.jpg,https://derpicdn.net/img/view/2013/4/1/284758.jpg,0,0.9855123162269592,172,608,532,968,360,360,princess cadance|princess celestia|princess luna|twilight sparkle,newyorkx3
284758.jpg,https://derpicdn.net/img/view/2013/4/1/284758.jpg,1,0.9041656255722046,790,217,1150,577,360,360,princess cadance|princess celestia|princess luna|twilight sparkle,newyorkx3
2861.png,https://derpicdn.net/img/view/2012/2/2/2861.png,0,0.9993098974227904,1577,699,1861,983,284,284,apple bloom|applejack|big macintosh|braeburn|cutie mark crusaders|diamond tiara|fluttershy|mane six|pinkie pie|princess celestia|princess luna|rainbow dash|rarity|scootaloo|silver spoon|spike|spitfire|sweetie belle|trixie|twilight sparkle,karzahnii
2861.png,https://derpicdn.net/img/view/2012/2/2/2861.png,2,0.9694840908050536,434,0,680,186,246,186,apple bloom|applejack|big macintosh|braeburn|cutie mark crusaders|diamond tiara|fluttershy|mane six|pinkie pie|princess celestia|princess luna|rainbow dash|rarity|scootaloo|silver spoon|spike|spitfire|sweetie belle|trixie|twilight sparkle,karzahnii
2861.png,https://derpicdn.net/img/view/2012/2/2/2861.png,3,0.9691015481948853,0,100,191,300,191,200,apple bloom|applejack|big macintosh|braeburn|cutie mark crusaders|diamond tiara|fluttershy|mane six|pinkie pie|princess celestia|princess luna|rainbow dash|rarity|scootaloo|silver spoon|spike|spitfire|sweetie belle|trixie|twilight sparkle,karzahnii
2861.png,https://derpicdn.net/img/view/2012/2/2/2861.png,4,0.9407806396484376,1250,471,1570,791,320,320,apple bloom|applejack|big macintosh|braeburn|cutie mark crusaders|diamond tiara|fluttershy|mane six|pinkie pie|princess celestia|princess luna|rainbow dash|rarity|scootaloo|silver spoon|spike|spitfire|sweetie belle|trixie|twilight sparkle,karzahnii
288202.jpg,https://derpicdn.net/img/view/2013/4/4/288202.jpg,0,0.9873310923576356,35,361,295,621,260,260,applejack|fluttershy|mane six|pinkie pie|rainbow dash|rarity|twilight sparkle,greyradian
288202.jpg,https://derpicdn.net/img/view/2013/4/4/288202.jpg,1,0.9664779305458068,611,248,999,636,388,388,applejack|fluttershy|mane six|pinkie pie|rainbow dash|rarity|twilight sparkle,greyradian
290688.png,https://derpicdn.net/img/view/2013/4/7/290688.png,0,0.9613138437271118,318,400,528,610,210,210,apple bloom|applejack|cutie mark crusaders|fluttershy|mane six|pinkie pie|princess celestia|princess luna|rainbow dash|rarity|scootaloo|spike|sweetie belle|trixie|twilight sparkle,rikose
291981.png,https://derpicdn.net/img/view/2013/4/8/291981.png,0,0.9369134902954102,1733,501,2157,925,424,424,applejack|fluttershy|mane six|pinkie pie|rainbow dash|rarity|sunset shimmer|twilight sparkle,loyaldis
291981.png,https://derpicdn.net/img/view/2013/4/8/291981.png,1,0.9192860722541808,884,796,1370,1282,486,486,applejack|fluttershy|mane six|pinkie pie|rainbow dash|rarity|sunset shimmer|twilight sparkle,loyaldis
291981.png,https://derpicdn.net/img/view/2013/4/8/291981.png,2,0.9153910875320436,1571,1100,2003,1532,432,432,applejack|fluttershy|mane six|pinkie pie|rainbow dash|rarity|sunset shimmer|twilight sparkle,loyaldis
291981.png,https://derpicdn.net/img/view/2013/4/8/291981.png,3,0.9064342975616456,1341,222,1755,636,414,414,applejack|fluttershy|mane six|pinkie pie|rainbow dash|rarity|sunset shimmer|twilight sparkle,loyaldis
306845.png,https://derpicdn.net/img/view/2013/4/24/306845.png,0,0.968172252178192,1802,538,2354,1090,552,552,rainbow dash|rarity|spike|twilight sparkle,niggerfaggot
314815.png,https://derpicdn.net/img/view/2013/5/2/314815.png,0,0.9908382892608644,336,0,1067,639,731,639,shining armor|twilight sparkle,blackswhites
316387.png,https://derpicdn.net/img/view/2013/5/4/316387.png,0,0.9123245477676392,550,816,800,1098,250,282,apple bloom|applejack|big macintosh|cutie mark crusaders|diamond tiara|fluttershy|granny smith|mane six|pinkie pie|princess cadance|princess celestia|princess luna|queen chrysalis|rainbow dash|rarity|scootaloo|shining armor|silver spoon|sweetie belle|twilight sparkle,cybersp0nge
317376.png,https://derpicdn.net/img/view/2013/5/5/317376.png,0,0.9739150404930116,1366,444,1918,996,552,552,princess celestia|twilight sparkle,silfoe
317695.jpg,https://derpicdn.net/img/view/2013/5/6/317695.jpg,0,0.9132469296455384,16,0,446,422,430,422,spike|twilight sparkle,spainfischer|kenket
319092.png,https://derpicdn.net/img/view/2013/5/7/319092.png,0,0.9950949549674988,2507,0,4709,1748,2202,1748,applejack|fluttershy|mane six|pinkie pie|rainbow dash|rarity|twilight sparkle,beavernator
320390.png,https://derpicdn.net/img/view/2013/5/9/320390.png,0,0.9865542054176332,137,52,371,286,234,234,trixie|twilight sparkle,sweethd
320390.png,https://derpicdn.net/img/view/2013/5/9/320390.png,1,0.960671067237854,140,351,374,585,234,234,trixie|twilight sparkle,sweethd
321029.jpg,https://derpicdn.net/img/view/2013/5/10/321029.jpg,0,0.9715721011161804,127,0,509,370,382,370,applejack|rainbow dash|twilight sparkle,blyzzarde
33244.png,https://derpicdn.net/img/view/2012/7/5/33244.png,0,0.9935203790664672,822,316,1086,580,264,264,applejack|fluttershy|mane six|pinkie pie|rainbow dash|rarity|twilight sparkle,madmax
33244.png,https://derpicdn.net/img/view/2012/7/5/33244.png,1,0.98466956615448,1255,226,1593,564,338,338,applejack|fluttershy|mane six|pinkie pie|rainbow dash|rarity|twilight sparkle,madmax
33244.png,https://derpicdn.net/img/view/2012/7/5/33244.png,2,0.9805333018302916,27,242,327,542,300,300,applejack|fluttershy|mane six|pinkie pie|rainbow dash|rarity|twilight sparkle,madmax
33244.png,https://derpicdn.net/img/view/2012/7/5/33244.png,3,0.9126253128051758,313,303,593,583,280,280,applejack|fluttershy|mane six|pinkie pie|rainbow dash|rarity|twilight sparkle,madmax
332682.png,https://derpicdn.net/img/view/2013/5/24/332682.png,0,0.9898421764373779,661,8,1999,1346,1338,1338,princess cadance|princess celestia|princess luna|twilight sparkle,lustrous-dreams
332682.png,https://derpicdn.net/img/view/2013/5/24/332682.png,1,0.9191824197769164,0,1697,1681,3469,1681,1772,princess cadance|princess celestia|princess luna|twilight sparkle,lustrous-dreams
33311.png,https://derpicdn.net/img/view/2012/7/5/33311.png,0,0.9978123307228088,538,71,850,445,312,374,applejack|fluttershy|mane six|pinkie pie|rainbow dash|rarity|twilight sparkle,ajin|leche|miu
33311.png,https://derpicdn.net/img/view/2012/7/5/33311.png,1,0.9664255380630492,255,630,629,1004,374,374,applejack|fluttershy|mane six|pinkie pie|rainbow dash|rarity|twilight sparkle,ajin|leche|miu
343942.png,https://derpicdn.net/img/view/2013/6/9/343942.png,0,0.9940032958984376,348,188,608,448,260,260,applejack|fluttershy|mane six|pinkie pie|rainbow dash|rarity|twilight sparkle,speccysy
343942.png,https://derpicdn.net/img/view/2013/6/9/343942.png,1,0.9854277968406676,1098,196,1310,408,212,212,applejack|fluttershy|mane six|pinkie pie|rainbow dash|rarity|twilight sparkle,speccysy
343942.png,https://derpicdn.net/img/view/2013/6/9/343942.png,2,0.964823305606842,658,163,892,397,234,234,applejack|fluttershy|mane six|pinkie pie|rainbow dash|rarity|twilight sparkle,speccysy
343942.png,https://derpicdn.net/img/view/2013/6/9/343942.png,3,0.9327238202095032,892,206,1086,400,194,194,applejack|fluttershy|mane six|pinkie pie|rainbow dash|rarity|twilight sparkle,speccysy
348554.png,https://derpicdn.net/img/view/2013/6/14/348554.png,0,0.9826496839523317,167,40,800,724,633,684,applejack|twilight sparkle,allosaurus|phurie edits
349160.png,https://derpicdn.net/img/view/2013/6/15/349160.png,0,0.9710754156112672,248,0,566,286,318,286,trixie|twilight sparkle,phurie edits|allosaurus
349631.png,https://derpicdn.net/img/view/2013/6/16/349631.png,0,0.9956143498420716,538,41,1110,613,572,572,princess cadance|princess celestia|twilight sparkle,silfoe
356043.png,https://derpicdn.net/img/view/2013/6/24/356043.png,0,0.9877284169197084,0,214,338,588,338,374,princess celestia|twilight sparkle,foxinshadow
359151.png,https://derpicdn.net/img/view/2013/6/28/359151.png,0,0.9789003729820251,233,334,621,722,388,388,princess celestia|twilight sparkle,giantmosquito
35987.png,https://derpicdn.net/img/view/2012/7/7/35987.png,0,0.9945799112319946,959,58,1137,236,178,178,applejack|fluttershy|pinkie pie|rainbow dash|rarity|spike|twilight sparkle,modern-warmare
35987.png,https://derpicdn.net/img/view/2012/7/7/35987.png,1,0.9912078976631165,779,67,961,249,182,182,applejack|fluttershy|pinkie pie|rainbow dash|rarity|spike|twilight sparkle,modern-warmare
364625.png,https://derpicdn.net/img/view/2013/7/4/364625.png,0,0.9631428718566896,1095,669,1463,1037,368,368,princess celestia|twilight sparkle,xeladuart
365521.png,https://derpicdn.net/img/view/2013/7/6/365521.png,0,0.9864065647125244,594,0,970,347,376,347,princess celestia|princess luna|twilight sparkle,camellia
367461.png,https://derpicdn.net/img/view/2013/7/8/367461.png,0,0.9237670302391052,59,0,341,264,282,264,princess cadance|princess celestia|princess luna|twilight sparkle,tsurime
372028.png,https://derpicdn.net/img/view/2013/7/12/372028.png,0,0.9993686676025392,91,54,601,564,510,510,spike|twilight sparkle,mi-eau
372615.jpg,https://derpicdn.net/img/view/2013/7/13/372615.jpg,0,0.9596691727638244,0,79,429,597,429,518,trixie|twilight sparkle,lurarin
373993.png,https://derpicdn.net/img/view/2013/7/14/373993.png,0,0.9852626323699952,185,0,519,320,334,320,spike|twilight sparkle,inuhoshi-to-darkpen
376206.png,https://derpicdn.net/img/view/2013/7/17/376206.png,0,0.961351215839386,0,24,384,512,384,488,princess cadance|twilight sparkle,lustrous-dreams
379270.png,https://derpicdn.net/img/view/2013/7/20/379270.png,0,0.9324851036071776,355,0,671,274,316,274,discord|fluttershy|princess celestia|twilight sparkle,paradigmpizza
380720.jpg,https://derpicdn.net/img/view/2013/7/21/380720.jpg,0,0.9872461557388306,397,9,557,169,160,160,applejack|fluttershy|mane six|pinkie pie|rainbow dash|rarity|twilight sparkle,doxy
381411.png,https://derpicdn.net/img/view/2013/7/22/381411.png,0,0.9977618455886841,465,385,1345,1265,880,880,rainbow dash|scootaloo|twilight sparkle,danmakuman
383251.png,https://derpicdn.net/img/view/2013/7/24/383251.png,0,0.9690110087394714,167,528,525,886,358,358,applejack|fluttershy|mane six|pinkie pie|rainbow dash|rarity|twilight sparkle,dm29
383251.png,https://derpicdn.net/img/view/2013/7/24/383251.png,1,0.9547219276428224,420,454,644,678,224,224,applejack|fluttershy|mane six|pinkie pie|rainbow dash|rarity|twilight sparkle,dm29
388727.png,https://derpicdn.net/img/view/2013/8/2/388727.png,0,0.9244661927223206,625,634,1043,1052,418,418,applejack|fluttershy|pinkie pie|rainbow dash|rarity|spike|twilight sparkle,0r0ch1
388732.png,https://derpicdn.net/img/view/2013/8/2/388732.png,0,0.95975923538208,641,645,1029,1033,388,388,applejack|fluttershy|pinkie pie|rainbow dash|rarity|spike|twilight sparkle,0r0ch1
390529.png,https://derpicdn.net/img/view/2013/8/3/390529.png,0,0.9958329796791076,1182,258,1592,668,410,410,applejack|fluttershy|mane six|pinkie pie|rainbow dash|rarity|twilight sparkle,flutterthrash
390529.png,https://derpicdn.net/img/view/2013/8/3/390529.png,1,0.9895251989364624,27,230,451,654,424,424,applejack|fluttershy|mane six|pinkie pie|rainbow dash|rarity|twilight sparkle,flutterthrash
392611.png,https://derpicdn.net/img/view/2013/8/6/392611.png,0,0.9786110520362854,0,749,365,1169,365,420,apple bloom|applejack|cutie mark crusaders|fluttershy|mane six|pinkie pie|rainbow dash|rarity|scootaloo|spike|sweetie belle|twilight sparkle,vest|tsitra360
392611.png,https://derpicdn.net/img/view/2013/8/6/392611.png,1,0.9754799008369446,219,438,785,1004,566,566,apple bloom|applejack|cutie mark crusaders|fluttershy|mane six|pinkie pie|rainbow dash|rarity|scootaloo|spike|sweetie belle|twilight sparkle,vest|tsitra360
392611.png,https://derpicdn.net/img/view/2013/8/6/392611.png,2,0.9057239890098572,1649,797,1920,1073,271,276,apple bloom|applejack|cutie mark crusaders|fluttershy|mane six|pinkie pie|rainbow dash|rarity|scootaloo|spike|sweetie belle|twilight sparkle,vest|tsitra360
393045.jpg,https://derpicdn.net/img/view/2013/8/6/393045.jpg,0,0.9942429065704346,94,251,488,645,394,394,princess celestia|twilight sparkle,muffinshire
393642.png,https://derpicdn.net/img/view/2013/8/7/393642.png,0,0.9963656067848206,511,0,893,341,382,341,trixie|twilight sparkle,egophiliac
3961.jpg,https://derpicdn.net/img/view/2012/4/17/3961.jpg,0,0.9992783665657043,1210,433,1740,963,530,530,applejack|fluttershy|mane six|pinkie pie|rainbow dash|rarity|twilight sparkle,harwick
3961.jpg,https://derpicdn.net/img/view/2012/4/17/3961.jpg,2,0.9829081296920776,561,408,957,804,396,396,applejack|fluttershy|mane six|pinkie pie|rainbow dash|rarity|twilight sparkle,harwick
3961.jpg,https://derpicdn.net/img/view/2012/4/17/3961.jpg,3,0.977146327495575,685,0,1163,400,478,400,applejack|fluttershy|mane six|pinkie pie|rainbow dash|rarity|twilight sparkle,harwick
39933.jpg,https://derpicdn.net/img/view/2012/7/10/39933.jpg,0,0.9902710914611816,183,32,525,374,342,342,spike|twilight sparkle,lionalliance|jaeh
399734.png,https://derpicdn.net/img/view/2013/8/14/399734.png,0,0.973219633102417,848,153,1352,657,504,504,fluttershy|pinkie pie|princess cadance|rainbow dash|shining armor|twilight sparkle,niggerfaggot
400037.png,https://derpicdn.net/img/view/2013/8/14/400037.png,0,0.9938032031059264,1283,0,3637,1952,2354,1952,sunset shimmer|trixie|twilight sparkle,beavernator
400447.png,https://derpicdn.net/img/view/2013/8/14/400447.png,1,0.9546950459480286,286,206,982,902,696,696,trixie|twilight sparkle,ihara
400952.png,https://derpicdn.net/img/view/2013/8/15/400952.png,0,0.9548370838165284,532,698,782,948,250,250,applejack|fluttershy|mane six|pinkie pie|rainbow dash|rarity|twilight sparkle,schnuffitrunks
401127.jpg,https://derpicdn.net/img/view/2013/8/15/401127.jpg,0,0.9018585085868835,731,387,1131,787,400,400,princess celestia|queen chrysalis|twilight sparkle,newyorkx3
403242.png,https://derpicdn.net/img/view/2013/8/18/403242.png,0,0.9927891492843628,149,910,833,1594,684,684,rainbow dash|twilight sparkle,zonkpunch|elslowmo
405345.jpg,https://derpicdn.net/img/view/2013/8/20/405345.jpg,1,0.9359538555145264,701,440,935,674,234,234,apple bloom|applejack|big macintosh|cutie mark crusaders|discord|fluttershy|pinkie pie|princess cadance|princess celestia|princess luna|rainbow dash|rarity|scootaloo|shining armor|spitfire|sweetie belle|trixie|twilight sparkle,yoona
405345.jpg,https://derpicdn.net/img/view/2013/8/20/405345.jpg,2,0.9017946124076844,959,432,1197,670,238,238,apple bloom|applejack|big macintosh|cutie mark crusaders|discord|fluttershy|pinkie pie|princess cadance|princess celestia|princess luna|rainbow dash|rarity|scootaloo|shining armor|spitfire|sweetie belle|trixie|twilight sparkle,yoona
407560.png,https://derpicdn.net/img/view/2013/8/23/407560.png,0,0.9672109484672546,337,494,837,994,500,500,rainbow dash|twilight sparkle,whatsapokemon
410073.jpg,https://derpicdn.net/img/view/2013/8/25/410073.jpg,0,0.9984912276268004,687,421,949,683,262,262,applejack|fluttershy|mane six|pinkie pie|rainbow dash|rarity|twilight sparkle,natsu-nori
410073.jpg,https://derpicdn.net/img/view/2013/8/25/410073.jpg,1,0.9972785711288452,545,589,795,839,250,250,applejack|fluttershy|mane six|pinkie pie|rainbow dash|rarity|twilight sparkle,natsu-nori
410073.jpg,https://derpicdn.net/img/view/2013/8/25/410073.jpg,2,0.9579198360443116,393,290,647,544,254,254,applejack|fluttershy|mane six|pinkie pie|rainbow dash|rarity|twilight sparkle,natsu-nori
410073.jpg,https://derpicdn.net/img/view/2013/8/25/410073.jpg,3,0.932603120803833,340,599,596,855,256,256,applejack|fluttershy|mane six|pinkie pie|rainbow dash|rarity|twilight sparkle,natsu-nori
410755.png,https://derpicdn.net/img/view/2013/8/26/410755.png,0,0.9888745546340942,1286,577,1578,869,292,292,applejack|fluttershy|mane six|pinkie pie|princess cadance|rainbow dash|rarity|shining armor|trixie|twilight sparkle,dm29
416220.png,https://derpicdn.net/img/view/2013/9/1/416220.png,0,0.93190336227417,1515,973,3205,2663,1690,1690,trixie|twilight sparkle,jittery-the-dragon
416448.png,https://derpicdn.net/img/view/2013/9/1/416448.png,0,0.9959439039230348,307,0,785,459,478,459,applejack|pinkie pie|twilight sparkle,sion
416448.png,https://derpicdn.net/img/view/2013/9/1/416448.png,1,0.9753808975219728,688,81,1218,611,530,530,applejack|pinkie pie|twilight sparkle,sion
418880.png,https://derpicdn.net/img/view/2013/9/4/418880.png,0,0.997824251651764,1102,477,1448,823,346,346,shining armor|twilight sparkle,laptopgun
419446.png,https://derpicdn.net/img/view/2013/9/5/419446.png,0,0.9976001977920532,523,22,985,484,462,462,rarity|twilight sparkle,mellowyellowpony|goat train
425.jpg,https://derpicdn.net/img/view/2012/1/16/425.jpg,0,0.996568500995636,1924,802,2700,1578,776,776,applejack|big macintosh|fluttershy|mane six|pinkie pie|princess celestia|princess luna|rainbow dash|rarity|spike|trixie|twilight sparkle,equestria-prevails
425.jpg,https://derpicdn.net/img/view/2012/1/16/425.jpg,1,0.9676669836044312,32,966,666,1600,634,634,applejack|big macintosh|fluttershy|mane six|pinkie pie|princess celestia|princess luna|rainbow dash|rarity|spike|trixie|twilight sparkle,equestria-prevails
426778.jpg,https://derpicdn.net/img/view/2013/9/13/426778.jpg,1,0.9956464767456056,0,334,471,806,471,472,applejack|fluttershy|mane six|pinkie pie|rainbow dash|rarity|twilight sparkle,dimwitdog
428317.png,https://derpicdn.net/img/view/2013/9/15/428317.png,0,0.9914944767951964,1281,1083,1823,1625,542,542,apple bloom|granny smith|twilight sparkle,dragonfoorm|joey darkmeat
428317.png,https://derpicdn.net/img/view/2013/9/15/428317.png,1,0.9738613367080688,74,804,730,1460,656,656,apple bloom|granny smith|twilight sparkle,dragonfoorm|joey darkmeat
428831.png,https://derpicdn.net/img/view/2013/9/16/428831.png,0,0.9706198573112488,57,244,351,538,294,294,applejack|big macintosh|princess celestia|princess luna|twilight sparkle,cakewasgood
428831.png,https://derpicdn.net/img/view/2013/9/16/428831.png,1,0.9142531752586364,225,0,669,405,444,405,applejack|big macintosh|princess celestia|princess luna|twilight sparkle,cakewasgood
428831.png,https://derpicdn.net/img/view/2013/9/16/428831.png,2,0.905708909034729,588,0,1128,480,540,480,applejack|big macintosh|princess celestia|princess luna|twilight sparkle,cakewasgood
432124.png,https://derpicdn.net/img/view/2013/9/21/432124.png,0,0.9641954898834229,0,454,577,1000,577,546,applejack|fluttershy|mane six|pinkie pie|rainbow dash|rarity|twilight sparkle,ponyecho
436642.jpg,https://derpicdn.net/img/view/2013/9/28/436642.jpg,0,0.9861421585083008,268,19,496,247,228,228,princess celestia|twilight sparkle,fizzy-dog|goat train
437829.png,https://derpicdn.net/img/view/2013/9/29/437829.png,0,0.91713148355484,92,8,632,548,540,540,princess celestia|twilight sparkle,allosaurus|longinius
442227.png,https://derpicdn.net/img/view/2013/10/5/442227.png,0,0.9984968900680542,417,43,739,365,322,322,trixie|twilight sparkle,sion
442917.png,https://derpicdn.net/img/view/2013/10/6/442917.png,0,0.9577215909957886,0,1160,286,1492,286,332,applejack|big macintosh|fluttershy|mane six|pinkie pie|princess celestia|princess luna|rainbow dash|rarity|spike|twilight sparkle,cakewasgood
443643.png,https://derpicdn.net/img/view/2013/10/7/443643.png,0,0.9929580092430116,2735,0,4303,1499,1568,1499,applejack|big macintosh|braeburn|fluttershy|mane six|pinkie pie|rainbow dash|rarity|spitfire|twilight sparkle,beavernator
444950.png,https://derpicdn.net/img/view/2013/10/9/444950.png,0,0.9995763897895812,198,0,688,487,490,487,trixie|twilight sparkle,sandwich-anomaly
446831.png,https://derpicdn.net/img/view/2013/10/12/446831.png,0,0.9005873799324036,257,211,651,605,394,394,princess cadance|shining armor|twilight sparkle,si1vr
448362.png,https://derpicdn.net/img/view/2013/10/14/448362.png,0,0.9878882169723512,933,59,1567,693,634,634,rainbow dash|rarity|spike|twilight sparkle,niggerfaggot
449382.jpg,https://derpicdn.net/img/view/2013/10/15/449382.jpg,0,0.9855934977531432,1203,879,1971,1647,768,768,applejack|fluttershy|mane six|pinkie pie|rainbow dash|rarity|scootaloo|spike|twilight sparkle,chibi-jen-hen
449651.png,https://derpicdn.net/img/view/2013/10/16/449651.png,0,0.9574562907218932,717,21,985,289,268,268,princess luna|twilight sparkle,silfoe
4524.png,https://derpicdn.net/img/view/2012/6/13/4524.png,0,0.9286635518074036,490,365,704,579,214,214,applejack|fluttershy|mane six|pinkie pie|rainbow dash|rarity|twilight sparkle,loyaldis
452758.jpg,https://derpicdn.net/img/view/2013/10/20/452758.jpg,0,0.956099569797516,235,329,565,659,330,330,princess celestia|twilight sparkle,superkeen
459752.png,https://derpicdn.net/img/view/2013/10/29/459752.png,0,0.9980892539024352,1047,563,1607,1123,560,560,princess cadance|princess celestia|shining armor|twilight sparkle,muffinshire
459752.png,https://derpicdn.net/img/view/2013/10/29/459752.png,1,0.9032965898513794,470,548,822,900,352,352,princess cadance|princess celestia|shining armor|twilight sparkle,muffinshire
460013.png,https://derpicdn.net/img/view/2013/10/30/460013.png,0,0.9943565726280212,383,65,735,417,352,352,rarity|spike|twilight sparkle,pia-sama
464407.png,https://derpicdn.net/img/view/2013/11/4/464407.png,0,0.9854739904403688,321,422,561,662,240,240,applejack|fluttershy|mane six|pinkie pie|rainbow dash|rarity|twilight sparkle,brianblackberry
464407.png,https://derpicdn.net/img/view/2013/11/4/464407.png,1,0.9746130108833312,519,0,775,221,256,221,applejack|fluttershy|mane six|pinkie pie|rainbow dash|rarity|twilight sparkle,brianblackberry
464407.png,https://derpicdn.net/img/view/2013/11/4/464407.png,2,0.9717926383018494,427,247,677,497,250,250,applejack|fluttershy|mane six|pinkie pie|rainbow dash|rarity|twilight sparkle,brianblackberry
466708.png,https://derpicdn.net/img/view/2013/11/7/466708.png,0,0.9269973039627076,376,66,538,228,162,162,princess cadance|princess celestia|princess luna|twilight sparkle,inuhoshi-to-darkpen
467265.png,https://derpicdn.net/img/view/2013/11/8/467265.png,0,0.9945666790008544,1201,1622,2415,2836,1214,1214,applejack|fluttershy|mane six|pinkie pie|princess luna|rainbow dash|rarity|spike|twilight sparkle,pridark
467265.png,https://derpicdn.net/img/view/2013/11/8/467265.png,1,0.9565292596817015,768,2588,1768,3588,1000,1000,applejack|fluttershy|mane six|pinkie pie|princess luna|rainbow dash|rarity|spike|twilight sparkle,pridark
4694.jpg,https://derpicdn.net/img/view/2012/6/17/4694.jpg,0,0.9055351614952089,85,21,343,279,258,258,applejack|fluttershy|mane six|pinkie pie|princess celestia|princess luna|rainbow dash|rarity|spike|twilight sparkle,andypriceart
469972.png,https://derpicdn.net/img/view/2013/11/11/469972.png,0,0.999840259552002,0,0,1446,1297,1446,1297,rainbow dash|twilight sparkle,ambris
475361.jpg,https://derpicdn.net/img/view/2013/11/18/475361.jpg,0,0.9994810819625854,939,0,2007,1057,1068,1057,applejack|fluttershy|mane six|pinkie pie|rainbow dash|rarity|spike|twilight sparkle,soulveiwinterfall
475361.jpg,https://derpicdn.net/img/view/2013/11/18/475361.jpg,1,0.9976456761360168,1868,216,2464,812,596,596,applejack|fluttershy|mane six|pinkie pie|rainbow dash|rarity|spike|twilight sparkle,soulveiwinterfall
475361.jpg,https://derpicdn.net/img/view/2013/11/18/475361.jpg,2,0.9968929290771484,552,241,1130,819,578,578,applejack|fluttershy|mane six|pinkie pie|rainbow dash|rarity|spike|twilight sparkle,soulveiwinterfall
475361.jpg,https://derpicdn.net/img/view/2013/11/18/475361.jpg,4,0.947065532207489,66,358,702,994,636,636,applejack|fluttershy|mane six|pinkie pie|rainbow dash|rarity|spike|twilight sparkle,soulveiwinterfall
477146.png,https://derpicdn.net/img/view/2013/11/21/477146.png,0,0.9728493690490724,0,3,497,561,497,558,rainbow dash|spike|twilight sparkle,frist44
479014.png,https://derpicdn.net/img/view/2013/11/23/479014.png,0,0.9970178008079528,760,0,1000,281,240,281,apple bloom|applejack|big macintosh|cutie mark crusaders|discord|fluttershy|mane six|pinkie pie|princess cadance|princess celestia|princess luna|rainbow dash|rarity|scootaloo|shining armor|spike|sweetie belle|trixie|twilight sparkle,30clock
479014.png,https://derpicdn.net/img/view/2013/11/23/479014.png,2,0.9897029995918274,344,535,636,827,292,292,apple bloom|applejack|big macintosh|cutie mark crusaders|discord|fluttershy|mane six|pinkie pie|princess cadance|princess celestia|princess luna|rainbow dash|rarity|scootaloo|shining armor|spike|sweetie belle|trixie|twilight sparkle,30clock
479014.png,https://derpicdn.net/img/view/2013/11/23/479014.png,3,0.9265002608299256,467,1,737,271,270,270,apple bloom|applejack|big macintosh|cutie mark crusaders|discord|fluttershy|mane six|pinkie pie|princess cadance|princess celestia|princess luna|rainbow dash|rarity|scootaloo|shining armor|spike|sweetie belle|trixie|twilight sparkle,30clock
481123.png,https://derpicdn.net/img/view/2013/11/25/481123.png,0,0.9986149072647096,617,321,905,609,288,288,applejack|fluttershy|mane six|pinkie pie|rainbow dash|rarity|twilight sparkle,umeguru
481123.png,https://derpicdn.net/img/view/2013/11/25/481123.png,1,0.9916595220565796,200,358,480,638,280,280,applejack|fluttershy|mane six|pinkie pie|rainbow dash|rarity|twilight sparkle,umeguru
481157.png,https://derpicdn.net/img/view/2013/11/25/481157.png,0,0.9652538299560548,399,44,645,290,246,246,princess celestia|twilight sparkle,goat train
485334.png,https://derpicdn.net/img/view/2013/11/29/485334.png,0,0.9967645406723022,953,0,2369,1357,1416,1357,princess cadance|princess celestia|princess luna|twilight sparkle,mirapony
485491.png,https://derpicdn.net/img/view/2013/11/29/485491.png,0,0.9827707409858704,624,154,1086,616,462,462,applejack|fluttershy|mane six|pinkie pie|rainbow dash|rarity|twilight sparkle,php56
48601.png,https://derpicdn.net/img/view/2012/7/19/48601.png,0,0.9267794489860536,0,1271,399,1709,399,438,apple bloom|applejack|cutie mark crusaders|fluttershy|pinkie pie|princess celestia|princess luna|rainbow dash|rarity|scootaloo|sweetie belle|twilight sparkle,valcron
492086.png,https://derpicdn.net/img/view/2013/12/7/492086.png,0,0.9693732261657716,728,298,996,566,268,268,discord|twilight sparkle,empyu
492959.png,https://derpicdn.net/img/view/2013/12/8/492959.png,0,0.9458310008049012,656,886,1372,1602,716,716,apple bloom|applejack|big macintosh|cutie mark crusaders|discord|fluttershy|mane six|pinkie pie|princess cadance|queen chrysalis|rainbow dash|rarity|scootaloo|spike|sweetie belle|trixie|twilight sparkle,doublewbrothers
493.png,https://derpicdn.net/img/view/2012/1/16/493.png,0,0.922664761543274,261,13,657,409,396,396,applejack|fluttershy|mane six|pinkie pie|rainbow dash|rarity|twilight sparkle,jiayi
494249.jpg,https://derpicdn.net/img/view/2013/12/10/494249.jpg,0,0.9978823065757751,154,3,458,307,304,304,applejack|fluttershy|mane six|pinkie pie|rainbow dash|rarity|twilight sparkle,akira bano
494824.png,https://derpicdn.net/img/view/2013/12/11/494824.png,0,0.9267715215682985,340,431,672,763,332,332,pinkie pie|twilight sparkle,berrypawnch
498336.png,https://derpicdn.net/img/view/2013/12/16/498336.png,0,0.990667998790741,691,347,1065,721,374,374,princess cadance|princess celestia|princess luna|twilight sparkle,frist44
503487.png,https://derpicdn.net/img/view/2013/12/22/503487.png,0,0.9935432672500608,13,261,303,551,290,290,trixie|twilight sparkle,ruffyyoshi
504602.jpg,https://derpicdn.net/img/view/2013/12/23/504602.jpg,0,0.9896820187568665,301,364,701,764,400,400,rainbow dash|twilight sparkle,gcrebel|cartoonlion
504602.jpg,https://derpicdn.net/img/view/2013/12/23/504602.jpg,1,0.9823006391525269,624,369,1004,749,380,380,rainbow dash|twilight sparkle,gcrebel|cartoonlion
504635.png,https://derpicdn.net/img/view/2013/12/23/504635.png,0,0.998615026473999,126,181,372,427,246,246,applejack|fluttershy|mane six|pinkie pie|rainbow dash|rarity|spike|twilight sparkle,inuhoshi-to-darkpen
504635.png,https://derpicdn.net/img/view/2013/12/23/504635.png,1,0.9972207546234132,207,454,401,648,194,194,applejack|fluttershy|mane six|pinkie pie|rainbow dash|rarity|spike|twilight sparkle,inuhoshi-to-darkpen
504635.png,https://derpicdn.net/img/view/2013/12/23/504635.png,2,0.9831499457359314,323,62,615,354,292,292,applejack|fluttershy|mane six|pinkie pie|rainbow dash|rarity|spike|twilight sparkle,inuhoshi-to-darkpen
505347.png,https://derpicdn.net/img/view/2013/12/24/505347.png,3,0.9106050729751588,48,537,602,1091,554,554,apple bloom|applejack|babs seed|cutie mark crusaders|fluttershy|mane six|pinkie pie|rainbow dash|rarity|scootaloo|spike|sweetie belle|twilight sparkle,loyaldis
505993.png,https://derpicdn.net/img/view/2013/12/25/505993.png,0,0.9955623745918274,540,0,782,212,242,212,applejack|fluttershy|mane six|pinkie pie|rainbow dash|rarity|twilight sparkle,brianblackberry
505993.png,https://derpicdn.net/img/view/2013/12/25/505993.png,1,0.9918612241744996,200,0,402,188,202,188,applejack|fluttershy|mane six|pinkie pie|rainbow dash|rarity|twilight sparkle,brianblackberry
505993.png,https://derpicdn.net/img/view/2013/12/25/505993.png,2,0.9832754731178284,730,300,941,514,211,214,applejack|fluttershy|mane six|pinkie pie|rainbow dash|rarity|twilight sparkle,brianblackberry
505993.png,https://derpicdn.net/img/view/2013/12/25/505993.png,3,0.9244593381881714,7,184,265,442,258,258,applejack|fluttershy|mane six|pinkie pie|rainbow dash|rarity|twilight sparkle,brianblackberry
505993.png,https://derpicdn.net/img/view/2013/12/25/505993.png,4,0.9009336233139038,432,240,662,470,230,230,applejack|fluttershy|mane six|pinkie pie|rainbow dash|rarity|twilight sparkle,brianblackberry
509278.png,https://derpicdn.net/img/view/2013/12/29/509278.png,1,0.987952709197998,790,1329,1094,1633,304,304,applejack|fluttershy|mane six|pinkie pie|rainbow dash|rarity|twilight sparkle,norang94
511086.png,https://derpicdn.net/img/view/2013/12/31/511086.png,0,0.9775729775428772,64,833,254,1023,190,190,applejack|fluttershy|pinkie pie|princess luna|rarity|twilight sparkle,mayocat
511086.png,https://derpicdn.net/img/view/2013/12/31/511086.png,2,0.9594932794570924,452,0,654,182,202,182,applejack|fluttershy|pinkie pie|princess luna|rarity|twilight sparkle,mayocat
511844.png,https://derpicdn.net/img/view/2014/1/1/511844.png,0,0.9980821013450624,990,132,1368,510,378,378,trixie|twilight sparkle,ss2sonic
512533.png,https://derpicdn.net/img/view/2014/1/2/512533.png,0,0.9945021867752076,1649,969,2805,2125,1156,1156,apple bloom|applejack|cutie mark crusaders|fluttershy|mane six|pinkie pie|princess celestia|princess luna|rainbow dash|rarity|scootaloo|spike|sweetie belle|twilight sparkle,pridark
512533.png,https://derpicdn.net/img/view/2014/1/2/512533.png,3,0.9174025654792786,784,1334,1522,2072,738,738,apple bloom|applejack|cutie mark crusaders|fluttershy|mane six|pinkie pie|princess celestia|princess luna|rainbow dash|rarity|scootaloo|spike|sweetie belle|twilight sparkle,pridark
512857.png,https://derpicdn.net/img/view/2014/1/2/512857.png,0,0.9939040541648864,218,0,986,608,768,608,spike|twilight sparkle,cakewasgood
516100.png,https://derpicdn.net/img/view/2014/1/5/516100.png,1,0.9874394536018372,773,26,1115,368,342,342,applejack|fluttershy|mane six|pinkie pie|rainbow dash|rarity|spike|twilight sparkle,deannart
516100.png,https://derpicdn.net/img/view/2014/1/5/516100.png,3,0.9754433035850524,433,279,733,579,300,300,applejack|fluttershy|mane six|pinkie pie|rainbow dash|rarity|spike|twilight sparkle,deannart
516100.png,https://derpicdn.net/img/view/2014/1/5/516100.png,4,0.9661669135093688,215,408,505,698,290,290,applejack|fluttershy|mane six|pinkie pie|rainbow dash|rarity|spike|twilight sparkle,deannart
516100.png,https://derpicdn.net/img/view/2014/1/5/516100.png,5,0.9570624232292176,795,338,1081,624,286,286,applejack|fluttershy|mane six|pinkie pie|rainbow dash|rarity|spike|twilight sparkle,deannart
516100.png,https://derpicdn.net/img/view/2014/1/5/516100.png,6,0.956160604953766,1410,433,1818,841,408,408,applejack|fluttershy|mane six|pinkie pie|rainbow dash|rarity|spike|twilight sparkle,deannart
523697.png,https://derpicdn.net/img/view/2014/1/13/523697.png,0,0.9966500997543336,993,118,1239,364,246,246,applejack|fluttershy|twilight sparkle,atryl
523697.png,https://derpicdn.net/img/view/2014/1/13/523697.png,1,0.9905478954315186,491,371,801,681,310,310,applejack|fluttershy|twilight sparkle,atryl
523697.png,https://derpicdn.net/img/view/2014/1/13/523697.png,2,0.9819118976593018,49,134,313,398,264,264,applejack|fluttershy|twilight sparkle,atryl
523697.png,https://derpicdn.net/img/view/2014/1/13/523697.png,3,0.9512472748756408,460,1013,728,1281,268,268,applejack|fluttershy|twilight sparkle,atryl
526528.png,https://derpicdn.net/img/view/2014/1/17/526528.png,0,0.9926964044570924,1008,34,1628,654,620,620,trixie|twilight sparkle,underpable
526528.png,https://derpicdn.net/img/view/2014/1/17/526528.png,1,0.9641470313072203,172,0,874,640,702,640,trixie|twilight sparkle,underpable
527324.png,https://derpicdn.net/img/view/2014/1/18/527324.png,0,0.9971359372138976,153,103,527,477,374,374,rainbow dash|twilight sparkle,yeendip
527949.jpg,https://derpicdn.net/img/view/2014/1/18/527949.jpg,0,0.9714475870132446,0,117,306,441,306,324,princess celestia|princess luna|twilight sparkle,屁屁貓|cat butt
540299.png,https://derpicdn.net/img/view/2014/2/1/540299.png,0,0.980925679206848,1323,123,1665,465,342,342,applejack|fluttershy|mane six|pinkie pie|rainbow dash|rarity|spike|twilight sparkle,siden
540299.png,https://derpicdn.net/img/view/2014/2/1/540299.png,1,0.9778802394866944,774,69,1102,397,328,328,applejack|fluttershy|mane six|pinkie pie|rainbow dash|rarity|spike|twilight sparkle,siden
540299.png,https://derpicdn.net/img/view/2014/2/1/540299.png,2,0.9512697458267212,205,123,547,465,342,342,applejack|fluttershy|mane six|pinkie pie|rainbow dash|rarity|spike|twilight sparkle,siden
540665.png,https://derpicdn.net/img/view/2014/2/1/540665.png,0,0.9851469993591307,428,228,714,514,286,286,applejack|fluttershy|mane six|pinkie pie|princess cadance|rainbow dash|rarity|shining armor|spike|twilight sparkle,jiayi
540665.png,https://derpicdn.net/img/view/2014/2/1/540665.png,1,0.984581172466278,0,469,277,785,277,316,applejack|fluttershy|mane six|pinkie pie|princess cadance|rainbow dash|rarity|shining armor|spike|twilight sparkle,jiayi
541279.png,https://derpicdn.net/img/view/2014/2/2/541279.png,0,0.9088293313980104,45,221,485,661,440,440,princess cadance|princess celestia|princess luna|twilight sparkle,evehly
542047.png,https://derpicdn.net/img/view/2014/2/3/542047.png,0,0.9908986687660216,186,92,396,302,210,210,applejack|twilight sparkle,brianblackberry
543688.png,https://derpicdn.net/img/view/2014/2/5/543688.png,0,0.9948331713676452,0,109,307,473,307,364,applejack|fluttershy|mane six|pinkie pie|rainbow dash|rarity|spike|twilight sparkle,ponjii
543688.png,https://derpicdn.net/img/view/2014/2/5/543688.png,1,0.9892563223838806,447,238,700,512,253,274,applejack|fluttershy|mane six|pinkie pie|rainbow dash|rarity|spike|twilight sparkle,ponjii
543688.png,https://derpicdn.net/img/view/2014/2/5/543688.png,2,0.9815450310707092,263,309,535,581,272,272,applejack|fluttershy|mane six|pinkie pie|rainbow dash|rarity|spike|twilight sparkle,ponjii
543688.png,https://derpicdn.net/img/view/2014/2/5/543688.png,3,0.9706144928932192,330,565,618,853,288,288,applejack|fluttershy|mane six|pinkie pie|rainbow dash|rarity|spike|twilight sparkle,ponjii
544000.png,https://derpicdn.net/img/view/2014/2/5/544000.png,0,0.9515296816825868,1446,55,1842,451,396,396,applejack|fluttershy|mane six|pinkie pie|rainbow dash|rarity|twilight sparkle,mostazathy
548.png,https://derpicdn.net/img/view/2012/1/16/548.png,0,0.9067788124084472,676,290,972,586,296,296,apple bloom|applejack|big macintosh|discord|fluttershy|mane six|pinkie pie|princess celestia|princess luna|rainbow dash|rarity|spike|trixie|twilight sparkle,akili-amethyst
550022.png,https://derpicdn.net/img/view/2014/2/12/550022.png,0,0.9371169209480286,0,0,852,862,852,862,fluttershy|twilight sparkle,underpable
554130.jpg,https://derpicdn.net/img/view/2014/2/16/554130.jpg,0,0.991071343421936,0,190,399,600,399,410,applejack|fluttershy|mane six|pinkie pie|princess celestia|princess luna|rainbow dash|rarity|twilight sparkle,arareroll
558189.png,https://derpicdn.net/img/view/2014/2/21/558189.png,0,0.9927994012832642,746,497,890,641,144,144,applejack|fluttershy|mane six|pinkie pie|rainbow dash|rarity|twilight sparkle,dvixie
558189.png,https://derpicdn.net/img/view/2014/2/21/558189.png,1,0.9923266172409058,163,0,381,204,218,204,applejack|fluttershy|mane six|pinkie pie|rainbow dash|rarity|twilight sparkle,dvixie
558189.png,https://derpicdn.net/img/view/2014/2/21/558189.png,2,0.9837290644645692,345,32,525,212,180,180,applejack|fluttershy|mane six|pinkie pie|rainbow dash|rarity|twilight sparkle,dvixie
559434.png,https://derpicdn.net/img/view/2014/2/22/559434.png,0,0.9805101156234741,564,595,900,953,336,358,apple bloom|applejack|cutie mark crusaders|fluttershy|mane six|pinkie pie|rainbow dash|rarity|scootaloo|sweetie belle|twilight sparkle,
560308.png,https://derpicdn.net/img/view/2014/2/24/560308.png,0,0.9461402297019958,222,384,578,740,356,356,applejack|pinkie pie|twilight sparkle,surgicalarts
563882.png,https://derpicdn.net/img/view/2014/3/1/563882.png,0,0.9933690428733826,1349,404,1770,846,421,442,applejack|rarity|twilight sparkle,pixel-prism
563882.png,https://derpicdn.net/img/view/2014/3/1/563882.png,1,0.9463406801223756,949,344,1485,880,536,536,applejack|rarity|twilight sparkle,pixel-prism
56470.png,https://derpicdn.net/img/view/2012/7/25/56470.png,0,0.9457029700279236,898,0,1290,304,392,304,applejack|fluttershy|mane six|pinkie pie|rainbow dash|rarity|twilight sparkle,schnuffitrunks
56470.png,https://derpicdn.net/img/view/2012/7/25/56470.png,1,0.9396286606788636,568,145,922,499,354,354,applejack|fluttershy|mane six|pinkie pie|rainbow dash|rarity|twilight sparkle,schnuffitrunks
565104.png,https://derpicdn.net/img/view/2014/3/2/565104.png,0,0.9647083878517152,530,0,1352,708,822,708,princess celestia|princess luna|twilight sparkle,phoenixperegrine
565648.jpg,https://derpicdn.net/img/view/2014/3/3/565648.jpg,0,0.9953773617744446,75,96,335,356,260,260,princess cadance|shining armor|twilight sparkle,the-wizard-of-art
565648.jpg,https://derpicdn.net/img/view/2014/3/3/565648.jpg,1,0.975252330303192,550,238,720,408,170,170,princess cadance|shining armor|twilight sparkle,the-wizard-of-art
565648.jpg,https://derpicdn.net/img/view/2014/3/3/565648.jpg,2,0.94698566198349,278,133,524,379,246,246,princess cadance|shining armor|twilight sparkle,the-wizard-of-art
566384.png,https://derpicdn.net/img/view/2014/3/4/566384.png,0,0.9984359741210938,467,0,903,434,436,434,pinkie pie|twilight sparkle,vavacung
568560.png,https://derpicdn.net/img/view/2014/3/7/568560.png,0,0.9514962434768676,2054,1918,2628,2492,574,574,applejack|fluttershy|mane six|pinkie pie|rainbow dash|rarity|twilight sparkle,jittery-the-dragon
568560.png,https://derpicdn.net/img/view/2014/3/7/568560.png,1,0.9406062364578248,560,524,1280,1244,720,720,applejack|fluttershy|mane six|pinkie pie|rainbow dash|rarity|twilight sparkle,jittery-the-dragon
568588.png,https://derpicdn.net/img/view/2014/3/7/568588.png,0,0.9677689075469972,441,0,819,311,378,311,shining armor|twilight sparkle,dm29
568935.png,https://derpicdn.net/img/view/2014/3/7/568935.png,0,0.9964134693145752,1390,303,2000,991,610,688,applejack|fluttershy|mane six|pinkie pie|rainbow dash|rarity|twilight sparkle,fearingfun
573120.jpg,https://derpicdn.net/img/view/2014/3/12/573120.jpg,0,0.9374153017997742,441,88,600,276,159,188,apple bloom|applejack|twilight sparkle,nekubi
573219.jpg,https://derpicdn.net/img/view/2014/3/12/573219.jpg,0,0.9947709441184998,2638,358,3368,1088,730,730,princess cadance|princess celestia|shining armor|spike|twilight sparkle,artknorke
573219.jpg,https://derpicdn.net/img/view/2014/3/12/573219.jpg,1,0.9133368134498596,1098,293,1792,987,694,694,princess cadance|princess celestia|shining armor|spike|twilight sparkle,artknorke
574959.png,https://derpicdn.net/img/view/2014/3/14/574959.png,1,0.9971346855163574,3980,567,5892,2479,1912,1912,applejack|fluttershy|mane six|pinkie pie|rainbow dash|rarity|twilight sparkle,vector-brony
574959.png,https://derpicdn.net/img/view/2014/3/14/574959.png,2,0.979306936264038,6754,1842,8168,3256,1414,1414,applejack|fluttershy|mane six|pinkie pie|rainbow dash|rarity|twilight sparkle,vector-brony
576901.png,https://derpicdn.net/img/view/2014/3/16/576901.png,0,0.9155570864677428,0,231,861,1093,861,862,pinkie pie|twilight sparkle,momo
578971.png,https://derpicdn.net/img/view/2014/3/18/578971.png,0,0.9972608685493468,981,0,1239,242,258,242,applejack|fluttershy|mane six|pinkie pie|rainbow dash|rarity|twilight sparkle,stoic5
58158.jpg,https://derpicdn.net/img/view/2012/7/27/58158.jpg,1,0.9792528748512268,0,431,239,707,239,276,applejack|fluttershy|mane six|pinkie pie|rainbow dash|rarity|spike|twilight sparkle,ss2sonic
5828.jpg,https://derpicdn.net/img/view/2012/6/18/5828.jpg,0,0.9427052736282348,1371,158,1833,620,462,462,applejack|fluttershy|mane six|pinkie pie|rainbow dash|rarity|spike|twilight sparkle,shepherd0821
583814.png,https://derpicdn.net/img/view/2014/3/24/583814.png,0,0.9965535402297974,34,44,274,284,240,240,applejack|fluttershy|mane six|pinkie pie|rainbow dash|rarity|twilight sparkle,senaydragon
583814.png,https://derpicdn.net/img/view/2014/3/24/583814.png,2,0.9095311760902404,295,50,527,282,232,232,applejack|fluttershy|mane six|pinkie pie|rainbow dash|rarity|twilight sparkle,senaydragon
5883.jpg,https://derpicdn.net/img/view/2012/6/18/5883.jpg,0,0.9150338768959044,823,76,981,234,158,158,applejack|fluttershy|mane six|pinkie pie|rainbow dash|rarity|spike|twilight sparkle,shepherd0821
588853.png,https://derpicdn.net/img/view/2014/3/30/588853.png,0,0.980658769607544,744,1683,1626,2565,882,882,princess luna|twilight sparkle,silfoe
589558.png,https://derpicdn.net/img/view/2014/3/31/589558.png,0,0.9773378372192384,765,0,1275,472,510,472,rainbow dash|twilight sparkle,strangerdanger
591813.jpg,https://derpicdn.net/img/view/2014/4/3/591813.jpg,0,0.998793125152588,189,333,539,683,350,350,princess luna|twilight sparkle,longinius
592353.jpg,https://derpicdn.net/img/view/2014/4/4/592353.jpg,0,0.9977239966392516,5,0,293,247,288,247,applejack|fluttershy|mane six|pinkie pie|rainbow dash|rarity|twilight sparkle,shepherd0821
592353.jpg,https://derpicdn.net/img/view/2014/4/4/592353.jpg,1,0.9966841340065002,491,679,763,951,272,272,applejack|fluttershy|mane six|pinkie pie|rainbow dash|rarity|twilight sparkle,shepherd0821
592353.jpg,https://derpicdn.net/img/view/2014/4/4/592353.jpg,2,0.9945238828659058,1138,348,1416,626,278,278,applejack|fluttershy|mane six|pinkie pie|rainbow dash|rarity|twilight sparkle,shepherd0821
592353.jpg,https://derpicdn.net/img/view/2014/4/4/592353.jpg,3,0.9943481683731079,609,348,887,626,278,278,applejack|fluttershy|mane six|pinkie pie|rainbow dash|rarity|twilight sparkle,shepherd0821
592353.jpg,https://derpicdn.net/img/view/2014/4/4/592353.jpg,4,0.986238181591034,153,340,445,632,292,292,applejack|fluttershy|mane six|pinkie pie|rainbow dash|rarity|twilight sparkle,shepherd0821
592353.jpg,https://derpicdn.net/img/view/2014/4/4/592353.jpg,5,0.9489901661872864,980,0,1256,252,276,252,applejack|fluttershy|mane six|pinkie pie|rainbow dash|rarity|twilight sparkle,shepherd0821
592353.jpg,https://derpicdn.net/img/view/2014/4/4/592353.jpg,6,0.9422894716262816,436,0,760,271,324,271,applejack|fluttershy|mane six|pinkie pie|rainbow dash|rarity|twilight sparkle,shepherd0821
592353.jpg,https://derpicdn.net/img/view/2014/4/4/592353.jpg,7,0.9063587784767152,11,652,343,984,332,332,applejack|fluttershy|mane six|pinkie pie|rainbow dash|rarity|twilight sparkle,shepherd0821
5925.png,https://derpicdn.net/img/view/2012/6/18/5925.png,2,0.9445464611053468,383,183,555,355,172,172,applejack|fluttershy|mane six|pinkie pie|rainbow dash|rarity|twilight sparkle,shepherd0821
5925.png,https://derpicdn.net/img/view/2012/6/18/5925.png,4,0.913152277469635,160,16,424,280,264,264,applejack|fluttershy|mane six|pinkie pie|rainbow dash|rarity|twilight sparkle,shepherd0821
594275.jpg,https://derpicdn.net/img/view/2014/4/6/594275.jpg,0,0.9848978519439696,160,453,462,755,302,302,rainbow dash|spike|twilight sparkle,audrarius
596057.png,https://derpicdn.net/img/view/2014/4/8/596057.png,0,0.9841092824935912,164,0,402,208,238,208,princess celestia|princess luna|twilight sparkle,goat train
596061.jpg,https://derpicdn.net/img/view/2014/4/8/596061.jpg,0,0.9935552477836608,358,536,776,954,418,418,applejack|fluttershy|mane six|pinkie pie|rainbow dash|rarity|spike|twilight sparkle,audrarius
596061.jpg,https://derpicdn.net/img/view/2014/4/8/596061.jpg,1,0.9467344284057616,205,0,645,427,440,427,applejack|fluttershy|mane six|pinkie pie|rainbow dash|rarity|spike|twilight sparkle,audrarius
596064.jpg,https://derpicdn.net/img/view/2014/4/8/596064.jpg,0,0.998553454875946,395,11,577,193,182,182,rainbow dash|twilight sparkle,carelessdoodler
6.png,https://derpicdn.net/img/view/2012/1/2/6.png,0,0.9487010836601256,0,3,411,497,411,494,applejack|fluttershy|rarity|twilight sparkle,
605480.png,https://derpicdn.net/img/view/2014/4/20/605480.png,0,0.964046835899353,753,0,1849,1021,1096,1021,applejack|fluttershy|mane six|pinkie pie|rainbow dash|rarity|scootaloo|twilight sparkle,midnightpremiere
605857.png,https://derpicdn.net/img/view/2014/4/20/605857.png,0,0.9891107678413392,911,212,1353,654,442,442,spike|twilight sparkle,niggerfaggot
607118.jpg,https://derpicdn.net/img/view/2014/4/22/607118.jpg,1,0.9901877045631408,207,40,389,222,182,182,applejack|fluttershy|mane six|pinkie pie|rainbow dash|rarity|twilight sparkle,ratachu666
607118.jpg,https://derpicdn.net/img/view/2014/4/22/607118.jpg,2,0.9812046885490416,744,20,958,234,214,214,applejack|fluttershy|mane six|pinkie pie|rainbow dash|rarity|twilight sparkle,ratachu666
607118.jpg,https://derpicdn.net/img/view/2014/4/22/607118.jpg,4,0.933031976222992,958,20,1152,222,194,202,applejack|fluttershy|mane six|pinkie pie|rainbow dash|rarity|twilight sparkle,ratachu666
607365.png,https://derpicdn.net/img/view/2014/4/22/607365.png,0,0.9906947612762452,804,773,1202,1171,398,398,applejack|fluttershy|rarity|scootaloo|twilight sparkle,danmakuman
607690.png,https://derpicdn.net/img/view/2014/4/23/607690.png,0,0.9888920187950134,2026,502,2924,1400,898,898,applejack|fluttershy|mane six|pinkie pie|rainbow dash|rarity|twilight sparkle,lostinthetrees
609132.png,https://derpicdn.net/img/view/2014/4/25/609132.png,1,0.991509199142456,54,33,744,723,690,690,applejack|fluttershy|mane six|pinkie pie|rainbow dash|rarity|twilight sparkle,ambris
609132.png,https://derpicdn.net/img/view/2014/4/25/609132.png,2,0.991253137588501,4323,326,5023,1026,700,700,applejack|fluttershy|mane six|pinkie pie|rainbow dash|rarity|twilight sparkle,ambris
609132.png,https://derpicdn.net/img/view/2014/4/25/609132.png,3,0.9738630056381226,3276,284,3960,968,684,684,applejack|fluttershy|mane six|pinkie pie|rainbow dash|rarity|twilight sparkle,ambris
609132.png,https://derpicdn.net/img/view/2014/4/25/609132.png,4,0.9714081287384032,912,217,1470,775,558,558,applejack|fluttershy|mane six|pinkie pie|rainbow dash|rarity|twilight sparkle,ambris
610892.png,https://derpicdn.net/img/view/2014/4/27/610892.png,0,0.9604384303092957,426,371,700,681,274,310,queen chrysalis|twilight sparkle,karpet-shark
611027.png,https://derpicdn.net/img/view/2014/4/27/611027.png,0,0.9779154658317566,136,254,496,614,360,360,spike|twilight sparkle,dawntrotter
613228.jpg,https://derpicdn.net/img/view/2014/4/29/613228.jpg,0,0.9602302312850952,346,1512,1364,2530,1018,1018,pinkie pie|rainbow dash|rarity|twilight sparkle,inkypsycho
614098.png,https://derpicdn.net/img/view/2014/4/30/614098.png,0,0.993362307548523,914,196,1184,466,270,270,shining armor|twilight sparkle,muffinshire
614098.png,https://derpicdn.net/img/view/2014/4/30/614098.png,1,0.9773384928703308,493,492,867,866,374,374,shining armor|twilight sparkle,muffinshire
615.jpg,https://derpicdn.net/img/view/2012/1/17/615.jpg,0,0.9363268613815308,2631,252,3747,1368,1116,1116,applejack|discord|fluttershy|mane six|pinkie pie|princess celestia|rainbow dash|rarity|spike|twilight sparkle,harwick
615.jpg,https://derpicdn.net/img/view/2012/1/17/615.jpg,1,0.9126070141792296,1399,1399,2209,2160,810,761,applejack|discord|fluttershy|mane six|pinkie pie|princess celestia|rainbow dash|rarity|spike|twilight sparkle,harwick
617315.png,https://derpicdn.net/img/view/2014/5/4/617315.png,0,0.938198447227478,584,0,1920,1047,1336,1047,rainbow dash|twilight sparkle,ambris
618368.png,https://derpicdn.net/img/view/2014/5/5/618368.png,0,0.9910107851028442,2,114,292,404,290,290,princess cadance|twilight sparkle,atlur
622486.jpg,https://derpicdn.net/img/view/2014/5/10/622486.jpg,0,0.9665733575820924,5,35,275,305,270,270,shining armor|twilight sparkle,spainfischer|kenket
622794.jpg,https://derpicdn.net/img/view/2014/5/10/622794.jpg,0,0.9983121752738952,347,4,687,344,340,340,princess cadance|princess celestia|princess luna|twilight sparkle,kolshica
622794.jpg,https://derpicdn.net/img/view/2014/5/10/622794.jpg,1,0.9773780703544616,352,472,672,792,320,320,princess cadance|princess celestia|princess luna|twilight sparkle,kolshica
623507.png,https://derpicdn.net/img/view/2014/5/11/623507.png,0,0.93537038564682,0,0,632,547,632,547,princess cadance|princess celestia|princess luna|twilight sparkle,inky-pinkie
624670.png,https://derpicdn.net/img/view/2014/5/12/624670.png,0,0.9664918780326844,994,33,1496,535,502,502,princess cadance|princess celestia|princess luna|twilight sparkle,loyaldis
625040.png,https://derpicdn.net/img/view/2014/5/12/625040.png,0,0.9951693415641784,2435,194,2905,664,470,470,applejack|fluttershy|mane six|pinkie pie|rainbow dash|rarity|twilight sparkle,thenationmaker|ambris
625040.png,https://derpicdn.net/img/view/2014/5/12/625040.png,1,0.9950631856918336,612,231,1060,679,448,448,applejack|fluttershy|mane six|pinkie pie|rainbow dash|rarity|twilight sparkle,thenationmaker|ambris
625040.png,https://derpicdn.net/img/view/2014/5/12/625040.png,2,0.9859436750411988,968,224,1468,724,500,500,applejack|fluttershy|mane six|pinkie pie|rainbow dash|rarity|twilight sparkle,thenationmaker|ambris
625040.png,https://derpicdn.net/img/view/2014/5/12/625040.png,3,0.9760440587997437,0,56,726,794,726,738,applejack|fluttershy|mane six|pinkie pie|rainbow dash|rarity|twilight sparkle,thenationmaker|ambris
6268.png,https://derpicdn.net/img/view/2012/6/18/6268.png,0,0.9986810684204102,125,0,447,300,322,300,shining armor|twilight sparkle,theuselesstoe
628286.png,https://derpicdn.net/img/view/2014/5/16/628286.png,0,0.9324992895126344,803,1574,1747,2518,944,944,applejack|babs seed|big macintosh|fluttershy|mane six|pinkie pie|rainbow dash|rarity|spike|twilight sparkle,flavinbagel
629663.png,https://derpicdn.net/img/view/2014/5/18/629663.png,1,0.9818946719169616,540,0,1010,443,470,443,princess celestia|twilight sparkle,no-ink
629794.png,https://derpicdn.net/img/view/2014/5/18/629794.png,0,0.9833247661590576,177,0,541,355,364,355,princess luna|twilight sparkle,silfoe
631268.png,https://derpicdn.net/img/view/2014/5/19/631268.png,0,0.9994381070137024,608,54,862,308,254,254,fluttershy|princess cadance|rarity|twilight sparkle,elbdot
631268.png,https://derpicdn.net/img/view/2014/5/19/631268.png,1,0.9978556632995604,355,6,663,314,308,308,fluttershy|princess cadance|rarity|twilight sparkle,elbdot
635999.png,https://derpicdn.net/img/view/2014/5/25/635999.png,0,0.9950302243232728,141,342,367,568,226,226,princess cadance|princess celestia|princess luna|twilight sparkle,assasinmonkey
638731.png,https://derpicdn.net/img/view/2014/5/28/638731.png,0,0.997684895992279,488,157,1046,715,558,558,applejack|fluttershy|mane six|pinkie pie|rainbow dash|rarity|twilight sparkle,alasou
638731.png,https://derpicdn.net/img/view/2014/5/28/638731.png,1,0.9727733731269836,596,716,1156,1276,560,560,applejack|fluttershy|mane six|pinkie pie|rainbow dash|rarity|twilight sparkle,alasou
639150.png,https://derpicdn.net/img/view/2014/5/28/639150.png,0,0.9983971118927002,332,0,932,583,600,583,princess celestia|twilight sparkle,seidouryu
640669.png,https://derpicdn.net/img/view/2014/5/30/640669.png,0,0.9982467889785768,935,363,1241,669,306,306,rarity|spike|twilight sparkle,ss2sonic
640669.png,https://derpicdn.net/img/view/2014/5/30/640669.png,2,0.9870604872703552,665,21,869,225,204,204,rarity|spike|twilight sparkle,ss2sonic
640669.png,https://derpicdn.net/img/view/2014/5/30/640669.png,3,0.9558589458465576,420,376,722,678,302,302,rarity|spike|twilight sparkle,ss2sonic
640669.png,https://derpicdn.net/img/view/2014/5/30/640669.png,4,0.9245049357414246,223,892,631,1280,408,388,rarity|spike|twilight sparkle,ss2sonic
640669.png,https://derpicdn.net/img/view/2014/5/30/640669.png,5,0.9077807664871216,906,0,1224,295,318,295,rarity|spike|twilight sparkle,ss2sonic
64484.jpg,https://derpicdn.net/img/view/2012/8/1/64484.jpg,1,0.9190326929092408,1851,3220,2879,4248,1028,1028,princess celestia|princess luna|twilight sparkle,aoi takayuki
647049.png,https://derpicdn.net/img/view/2014/6/7/647049.png,0,0.962588906288147,0,597,326,933,326,336,spike|twilight sparkle,pedantia
64724.png,https://derpicdn.net/img/view/2012/8/2/64724.png,0,0.9762676954269408,1089,1,2595,1507,1506,1506,rainbow dash|twilight sparkle,grumblepluck
648300.png,https://derpicdn.net/img/view/2014/6/8/648300.png,0,0.9933103919029236,767,0,1739,832,972,832,applejack|twilight sparkle,maren
648300.png,https://derpicdn.net/img/view/2014/6/8/648300.png,1,0.9642691016197203,186,494,1124,1432,938,938,applejack|twilight sparkle,maren
652107.png,https://derpicdn.net/img/view/2014/6/13/652107.png,0,0.9934765100479126,2456,117,3018,679,562,562,applejack|fluttershy|mane six|pinkie pie|rainbow dash|rarity|spike|twilight sparkle,valcron
652107.png,https://derpicdn.net/img/view/2014/6/13/652107.png,1,0.9367513656616212,907,290,1381,764,474,474,applejack|fluttershy|mane six|pinkie pie|rainbow dash|rarity|spike|twilight sparkle,valcron
652851.png,https://derpicdn.net/img/view/2014/6/14/652851.png,0,0.998998761177063,751,130,1917,1296,1166,1166,fluttershy|twilight sparkle,color-spark
653608.png,https://derpicdn.net/img/view/2014/6/15/653608.png,0,0.9841283559799194,679,383,1181,885,502,502,princess celestia|princess luna|twilight sparkle,php92
655768.png,https://derpicdn.net/img/view/2014/6/17/655768.png,0,0.99848735332489,1749,336,3049,1636,1300,1300,trixie|twilight sparkle,theparagon
655768.png,https://derpicdn.net/img/view/2014/6/17/655768.png,1,0.995699107646942,403,424,1625,1646,1222,1222,trixie|twilight sparkle,theparagon
6580.jpg,https://derpicdn.net/img/view/2012/6/18/6580.jpg,1,0.9083082675933838,1393,0,1899,382,506,382,applejack|fluttershy|mane six|pinkie pie|rainbow dash|rarity|twilight sparkle,jinzhan
658032.png,https://derpicdn.net/img/view/2014/6/21/658032.png,0,0.9937822818756104,6798,1894,8054,3150,1256,1256,applejack|fluttershy|mane six|pinkie pie|rainbow dash|rarity|twilight sparkle,theshadowstone
658374.jpg,https://derpicdn.net/img/view/2014/6/21/658374.jpg,0,0.9991540312767028,192,84,528,420,336,336,applejack|fluttershy|pinkie pie|rainbow dash|rarity|twilight sparkle,redanon
658374.jpg,https://derpicdn.net/img/view/2014/6/21/658374.jpg,1,0.9988744854927064,554,716,944,1106,390,390,applejack|fluttershy|pinkie pie|rainbow dash|rarity|twilight sparkle,redanon
658374.jpg,https://derpicdn.net/img/view/2014/6/21/658374.jpg,3,0.9184633493423462,697,0,1063,320,366,320,applejack|fluttershy|pinkie pie|rainbow dash|rarity|twilight sparkle,redanon
659146.png,https://derpicdn.net/img/view/2014/6/22/659146.png,0,0.9492071270942688,997,0,1213,169,216,169,pinkie pie|rainbow dash|twilight sparkle,madacon
659249.png,https://derpicdn.net/img/view/2014/6/22/659249.png,0,0.955172061920166,197,42,605,450,408,408,princess cadance|twilight sparkle,kaji-tanii
660037.jpg,https://derpicdn.net/img/view/2014/6/23/660037.jpg,1,0.9530783295631408,1191,365,1615,789,424,424,applejack|fluttershy|mane six|pinkie pie|rainbow dash|rarity|twilight sparkle,tysontan
661304.png,https://derpicdn.net/img/view/2014/6/25/661304.png,1,0.9785872101783752,511,271,947,707,436,436,applejack|fluttershy|mane six|pinkie pie|rainbow dash|rarity|twilight sparkle,php41
661304.png,https://derpicdn.net/img/view/2014/6/25/661304.png,2,0.9732228517532348,1062,333,1494,765,432,432,applejack|fluttershy|mane six|pinkie pie|rainbow dash|rarity|twilight sparkle,php41
661304.png,https://derpicdn.net/img/view/2014/6/25/661304.png,4,0.9645236134529114,7,348,421,762,414,414,applejack|fluttershy|mane six|pinkie pie|rainbow dash|rarity|twilight sparkle,php41
661304.png,https://derpicdn.net/img/view/2014/6/25/661304.png,5,0.9010360836982728,15,0,393,347,378,347,applejack|fluttershy|mane six|pinkie pie|rainbow dash|rarity|twilight sparkle,php41
661321.png,https://derpicdn.net/img/view/2014/6/25/661321.png,0,0.987993597984314,281,700,605,1024,324,324,applejack|fluttershy|mane six|pinkie pie|rainbow dash|rarity|twilight sparkle,mlpanon
663440.png,https://derpicdn.net/img/view/2014/6/28/663440.png,0,0.9773379564285278,295,36,512,316,217,280,princess cadance|princess celestia|princess luna|twilight sparkle,pepooni
66528.png,https://derpicdn.net/img/view/2012/8/4/66528.png,1,0.9983605742454528,383,44,851,512,468,468,applejack|fluttershy|mane six|pinkie pie|rainbow dash|rarity|twilight sparkle,ambris
66528.png,https://derpicdn.net/img/view/2012/8/4/66528.png,3,0.9905147552490234,686,293,1130,737,444,444,applejack|fluttershy|mane six|pinkie pie|rainbow dash|rarity|twilight sparkle,ambris
66528.png,https://derpicdn.net/img/view/2012/8/4/66528.png,4,0.9512913823127748,36,411,496,871,460,460,applejack|fluttershy|mane six|pinkie pie|rainbow dash|rarity|twilight sparkle,ambris
668720.png,https://derpicdn.net/img/view/2014/7/6/668720.png,0,0.9979790449142456,262,0,852,468,590,468,applejack|fluttershy|mane six|pinkie pie|rainbow dash|rarity|spike|twilight sparkle,assasinmonkey
669157.png,https://derpicdn.net/img/view/2014/7/7/669157.png,0,0.9795362949371338,479,4,933,458,454,454,pinkie pie|twilight sparkle,suikuzu
669157.png,https://derpicdn.net/img/view/2014/7/7/669157.png,1,0.9665167927742004,50,0,436,378,386,378,pinkie pie|twilight sparkle,suikuzu
669901.png,https://derpicdn.net/img/view/2014/7/8/669901.png,0,0.9903421998023988,45,0,1005,926,960,926,trixie|twilight sparkle,misspolycysticovary
669901.png,https://derpicdn.net/img/view/2014/7/8/669901.png,1,0.9643357396125792,996,0,1966,822,970,822,trixie|twilight sparkle,misspolycysticovary
670960.jpg,https://derpicdn.net/img/view/2014/7/9/670960.jpg,0,0.9868042469024658,88,2678,880,3470,792,792,applejack|fluttershy|mane six|pinkie pie|rainbow dash|rarity|twilight sparkle,akamei
670960.jpg,https://derpicdn.net/img/view/2014/7/9/670960.jpg,1,0.9179264903068542,1019,1319,1831,2131,812,812,applejack|fluttershy|mane six|pinkie pie|rainbow dash|rarity|twilight sparkle,akamei
671325.png,https://derpicdn.net/img/view/2014/7/9/671325.png,0,0.9480472803115844,1131,173,1355,397,224,224,apple bloom|cutie mark crusaders|princess cadance|princess celestia|princess luna|scootaloo|spike|sweetie belle|twilight sparkle,kp-shadowsquirrel|crazypurplebat
675740.png,https://derpicdn.net/img/view/2014/7/15/675740.png,1,0.9813971519470216,82,24,650,592,568,568,princess cadance|princess celestia|twilight sparkle,elbdot
677446.png,https://derpicdn.net/img/view/2014/7/18/677446.png,0,0.9974681735038756,293,27,571,305,278,278,applejack|fluttershy|mane six|pinkie pie|rainbow dash|rarity|twilight sparkle,anibaruthecat
677446.png,https://derpicdn.net/img/view/2014/7/18/677446.png,1,0.9524122476577759,415,260,643,488,228,228,applejack|fluttershy|mane six|pinkie pie|rainbow dash|rarity|twilight sparkle,anibaruthecat
677446.png,https://derpicdn.net/img/view/2014/7/18/677446.png,2,0.9407694339752196,191,355,465,629,274,274,applejack|fluttershy|mane six|pinkie pie|rainbow dash|rarity|twilight sparkle,anibaruthecat
683192.png,https://derpicdn.net/img/view/2014/7/25/683192.png,0,0.9739179015159608,503,0,999,460,496,460,spike|twilight sparkle,rainbowscreen
683192.png,https://derpicdn.net/img/view/2014/7/25/683192.png,2,0.9389941096305848,904,410,1326,832,422,422,spike|twilight sparkle,rainbowscreen
683803.png,https://derpicdn.net/img/view/2014/7/26/683803.png,0,0.9315247535705566,458,305,670,517,212,212,discord|fluttershy|pinkie pie|princess celestia|twilight sparkle,raichi
683840.png,https://derpicdn.net/img/view/2014/7/26/683840.png,0,0.9925069212913512,0,0,842,700,842,700,sunset shimmer|twilight sparkle,sion-ara
683855.png,https://derpicdn.net/img/view/2014/7/26/683855.png,0,0.9991707801818848,192,643,616,1067,424,424,rainbow dash|twilight sparkle,ambris
683855.png,https://derpicdn.net/img/view/2014/7/26/683855.png,1,0.996717929840088,542,0,952,409,410,409,rainbow dash|twilight sparkle,ambris
6840.png,https://derpicdn.net/img/view/2012/6/18/6840.png,0,0.9617654085159302,829,28,1123,322,294,294,rainbow dash|twilight sparkle,fiarel
687592.png,https://derpicdn.net/img/view/2014/7/31/687592.png,0,0.989968717098236,903,587,1227,911,324,324,applejack|fluttershy|mane six|pinkie pie|rainbow dash|rarity|twilight sparkle,karzahnii
687592.png,https://derpicdn.net/img/view/2014/7/31/687592.png,1,0.9331520199775696,0,479,554,1139,554,660,applejack|fluttershy|mane six|pinkie pie|rainbow dash|rarity|twilight sparkle,karzahnii
687592.png,https://derpicdn.net/img/view/2014/7/31/687592.png,2,0.9108619093894958,1205,496,1600,948,395,452,applejack|fluttershy|mane six|pinkie pie|rainbow dash|rarity|twilight sparkle,karzahnii
69023.jpg,https://derpicdn.net/img/view/2012/8/7/69023.jpg,0,0.9934266805648804,1288,0,1850,444,562,444,applejack|big macintosh|fluttershy|pinkie pie|rarity|trixie|twilight sparkle,mysticalpha
692.png,https://derpicdn.net/img/view/2012/1/17/692.png,0,0.9771016240119934,237,477,653,893,416,416,apple bloom|applejack|cutie mark crusaders|diamond tiara|fluttershy|mane six|pinkie pie|princess celestia|princess luna|rainbow dash|rarity|scootaloo|silver spoon|spike|spitfire|sweetie belle|trixie|twilight sparkle,empty-10
693069.png,https://derpicdn.net/img/view/2014/8/6/693069.png,0,0.9997450709342957,110,0,364,237,254,237,applejack|fluttershy|mane six|pinkie pie|rainbow dash|rarity|spike|twilight sparkle,pixel-prism
693069.png,https://derpicdn.net/img/view/2014/8/6/693069.png,3,0.9802950024604796,406,34,644,272,238,238,applejack|fluttershy|mane six|pinkie pie|rainbow dash|rarity|spike|twilight sparkle,pixel-prism
695791.png,https://derpicdn.net/img/view/2014/8/9/695791.png,0,0.9921686053276062,270,369,584,683,314,314,discord|twilight sparkle,inuhoshi-to-darkpen
697076.png,https://derpicdn.net/img/view/2014/8/11/697076.png,1,0.9424559473991394,45,136,603,694,558,558,trixie|twilight sparkle,suirano
697207.png,https://derpicdn.net/img/view/2014/8/11/697207.png,1,0.9865393042564392,174,135,532,493,358,358,princess luna|twilight sparkle,sammy-upvotes
697245.png,https://derpicdn.net/img/view/2014/8/11/697245.png,0,0.9911053776741028,408,76,642,310,234,234,princess cadance|princess celestia|princess luna|twilight sparkle,princrim
697245.png,https://derpicdn.net/img/view/2014/8/11/697245.png,1,0.9908715486526488,231,46,487,302,256,256,princess cadance|princess celestia|princess luna|twilight sparkle,princrim
697605.png,https://derpicdn.net/img/view/2014/8/12/697605.png,0,0.9856964945793152,703,0,1149,421,446,421,sunset shimmer|twilight sparkle,berrypawnch
697605.png,https://derpicdn.net/img/view/2014/8/12/697605.png,1,0.902674674987793,0,66,456,562,456,496,sunset shimmer|twilight sparkle,berrypawnch
699464.png,https://derpicdn.net/img/view/2014/8/14/699464.png,0,0.9217762351036072,181,0,877,499,696,499,big macintosh|twilight sparkle,dm29
701742.jpg,https://derpicdn.net/img/view/2014/8/17/701742.jpg,0,0.9200986623764038,640,335,994,689,354,354,princess celestia|twilight sparkle,yodachan
705127.png,https://derpicdn.net/img/view/2014/8/21/705127.png,0,0.9583854675292968,116,0,370,238,254,238,spike|twilight sparkle,lulubell
705198.png,https://derpicdn.net/img/view/2014/8/22/705198.png,0,0.96821528673172,213,45,1015,847,802,802,spike|twilight sparkle,alasou
70643.jpg,https://derpicdn.net/img/view/2012/8/9/70643.jpg,0,0.9925137162208556,493,433,783,723,290,290,fluttershy|rainbow dash|twilight sparkle,mysticalpha
70643.jpg,https://derpicdn.net/img/view/2012/8/9/70643.jpg,1,0.9848000407218932,714,430,1004,720,290,290,fluttershy|rainbow dash|twilight sparkle,mysticalpha
707043.png,https://derpicdn.net/img/view/2014/8/24/707043.png,0,0.9898919463157654,1308,400,1698,790,390,390,applejack|fluttershy|pinkie pie|rainbow dash|rarity|twilight sparkle,
71.png,https://derpicdn.net/img/view/2012/1/6/71.png,0,0.9960413575172424,172,0,1542,1118,1370,1118,rainbow dash|twilight sparkle,grumblepluck
711354.png,https://derpicdn.net/img/view/2014/8/30/711354.png,0,0.948856234550476,1397,145,2000,755,603,610,applejack|rainbow dash|twilight sparkle,foudubulbe
713509.jpg,https://derpicdn.net/img/view/2014/9/2/713509.jpg,0,0.9814779758453368,941,1252,1747,2058,806,806,spike|twilight sparkle,otakuap
715165.png,https://derpicdn.net/img/view/2014/9/5/715165.png,2,0.987899899482727,996,389,1402,795,406,406,fluttershy|princess luna|rainbow dash|twilight sparkle,zorbitas
715165.png,https://derpicdn.net/img/view/2014/9/5/715165.png,3,0.9651638269424438,1293,78,2000,818,707,740,fluttershy|princess luna|rainbow dash|twilight sparkle,zorbitas
715165.png,https://derpicdn.net/img/view/2014/9/5/715165.png,4,0.95020592212677,0,0,657,659,657,659,fluttershy|princess luna|rainbow dash|twilight sparkle,zorbitas
716148.png,https://derpicdn.net/img/view/2014/9/6/716148.png,0,0.9994264841079712,361,0,947,518,586,518,applejack|fluttershy|mane six|pinkie pie|rainbow dash|rarity|sunset shimmer|twilight sparkle,the-butch-x
716148.png,https://derpicdn.net/img/view/2014/9/6/716148.png,1,0.9016887545585632,1113,457,1458,865,345,408,applejack|fluttershy|mane six|pinkie pie|rainbow dash|rarity|sunset shimmer|twilight sparkle,the-butch-x
716423.png,https://derpicdn.net/img/view/2014/9/6/716423.png,0,0.9967602491378784,447,57,727,337,280,280,princess celestia|twilight sparkle,lizombie
716423.png,https://derpicdn.net/img/view/2014/9/6/716423.png,1,0.928413987159729,181,135,561,515,380,380,princess celestia|twilight sparkle,lizombie
716893.png,https://derpicdn.net/img/view/2014/9/7/716893.png,0,0.980861485004425,163,460,463,760,300,300,applejack|fluttershy|mane six|pinkie pie|princess celestia|princess luna|rainbow dash|rarity|spike|twilight sparkle,sunibee
717197.png,https://derpicdn.net/img/view/2014/9/7/717197.png,0,0.989485502243042,135,0,467,303,332,303,applejack|fluttershy|mane six|pinkie pie|rainbow dash|rarity|twilight sparkle,mick-o-maikeru
717197.png,https://derpicdn.net/img/view/2014/9/7/717197.png,1,0.946963906288147,649,496,825,672,176,176,applejack|fluttershy|mane six|pinkie pie|rainbow dash|rarity|twilight sparkle,mick-o-maikeru
721791.jpg,https://derpicdn.net/img/view/2014/9/14/721791.jpg,0,0.9906892180442808,0,876,813,1744,813,868,applejack|rainbow dash|twilight sparkle,mistydash
725510.png,https://derpicdn.net/img/view/2014/9/19/725510.png,0,0.9441136717796326,161,0,609,421,448,421,spike|twilight sparkle,casynuf
729320.png,https://derpicdn.net/img/view/2014/9/25/729320.png,0,0.9617533087730408,599,4,715,120,116,116,applejack|fluttershy|mane six|pinkie pie|rainbow dash|rarity|twilight sparkle,mastergodai
729320.png,https://derpicdn.net/img/view/2014/9/25/729320.png,1,0.938078999519348,740,14,836,110,96,96,applejack|fluttershy|mane six|pinkie pie|rainbow dash|rarity|twilight sparkle,mastergodai
730573.png,https://derpicdn.net/img/view/2014/9/27/730573.png,0,0.9646145105361938,826,0,1270,423,444,423,fluttershy|pinkie pie|rainbow dash|twilight sparkle,gmrqor
732312.png,https://derpicdn.net/img/view/2014/9/29/732312.png,0,0.9939407110214232,186,467,536,817,350,350,princess cadance|princess celestia|princess luna|twilight sparkle,poniesforparents|ambris
734707.jpg,https://derpicdn.net/img/view/2014/10/3/734707.jpg,1,0.9799654483795166,1180,213,1660,693,480,480,applejack|fluttershy|mane six|pinkie pie|rainbow dash|rarity|twilight sparkle,nekubi
734707.jpg,https://derpicdn.net/img/view/2014/10/3/734707.jpg,2,0.9672045707702636,761,188,1047,474,286,286,applejack|fluttershy|mane six|pinkie pie|rainbow dash|rarity|twilight sparkle,nekubi
736768.png,https://derpicdn.net/img/view/2014/10/6/736768.png,0,0.9860650897026062,442,0,860,324,418,324,rainbow dash|twilight sparkle,slypon
737035.png,https://derpicdn.net/img/view/2014/10/6/737035.png,0,0.9711544513702391,343,121,717,495,374,374,princess celestia|twilight sparkle,kolshica
737035.png,https://derpicdn.net/img/view/2014/10/6/737035.png,1,0.957155168056488,7,929,803,1725,796,796,princess celestia|twilight sparkle,kolshica
738610.png,https://derpicdn.net/img/view/2014/10/8/738610.png,0,0.9940050840377808,240,241,666,667,426,426,applejack|pinkie pie|rainbow dash|rarity|twilight sparkle,whitediamonds
738632.png,https://derpicdn.net/img/view/2014/10/8/738632.png,0,0.9891324043273926,10,159,288,437,278,278,spike|twilight sparkle,dm29
740826.png,https://derpicdn.net/img/view/2014/10/11/740826.png,0,0.9780259728431702,0,82,722,864,722,782,spike|twilight sparkle,aymint
741449.png,https://derpicdn.net/img/view/2014/10/12/741449.png,0,0.9932233095169068,434,39,680,285,246,246,applejack|fluttershy|mane six|pinkie pie|rainbow dash|rarity|twilight sparkle,mahoxyshoujo
741449.png,https://derpicdn.net/img/view/2014/10/12/741449.png,1,0.9530227780342102,0,87,211,301,211,214,applejack|fluttershy|mane six|pinkie pie|rainbow dash|rarity|twilight sparkle,mahoxyshoujo
744436.png,https://derpicdn.net/img/view/2014/10/17/744436.png,0,0.9942991137504578,55,604,635,1184,580,580,applejack|fluttershy|mane six|pinkie pie|rainbow dash|rarity|twilight sparkle,valcron
745596.png,https://derpicdn.net/img/view/2014/10/18/745596.png,0,0.9230579137802124,786,482,998,694,212,212,applejack|fluttershy|mane six|pinkie pie|rainbow dash|rarity|spike|sunset shimmer|twilight sparkle,dvixie
746954.png,https://derpicdn.net/img/view/2014/10/20/746954.png,0,0.9927897453308104,357,73,617,333,260,260,pinkie pie|rainbow dash|twilight sparkle,arnachy
747141.png,https://derpicdn.net/img/view/2014/10/21/747141.png,0,0.984465718269348,10,0,444,389,434,389,sunset shimmer|twilight sparkle,dilemmas4u
747155.png,https://derpicdn.net/img/view/2014/10/21/747155.png,0,0.998923122882843,190,0,840,639,650,639,rarity|twilight sparkle,danmakuman|ponyguy67
747249.jpg,https://derpicdn.net/img/view/2014/10/21/747249.jpg,0,0.9996150732040404,246,178,706,638,460,460,fluttershy|twilight sparkle,skecchiart
747249.jpg,https://derpicdn.net/img/view/2014/10/21/747249.jpg,1,0.993394672870636,880,126,1432,678,552,552,fluttershy|twilight sparkle,skecchiart
748313.png,https://derpicdn.net/img/view/2014/10/22/748313.png,0,0.9933180212974548,1139,87,1683,631,544,544,trixie|twilight sparkle,basilloon
748313.png,https://derpicdn.net/img/view/2014/10/22/748313.png,1,0.9922144412994384,270,51,830,611,560,560,trixie|twilight sparkle,basilloon
749269.png,https://derpicdn.net/img/view/2014/10/24/749269.png,0,0.9934075474739076,4570,0,6340,1448,1770,1448,apple bloom|applejack|cutie mark crusaders|fluttershy|pinkie pie|princess celestia|princess luna|queen chrysalis|rainbow dash|rarity|scootaloo|sunset shimmer|sweetie belle|trixie|twilight sparkle,zodiacnicola
749269.png,https://derpicdn.net/img/view/2014/10/24/749269.png,2,0.972871959209442,1903,1389,3017,2503,1114,1114,apple bloom|applejack|cutie mark crusaders|fluttershy|pinkie pie|princess celestia|princess luna|queen chrysalis|rainbow dash|rarity|scootaloo|sunset shimmer|sweetie belle|trixie|twilight sparkle,zodiacnicola
749269.png,https://derpicdn.net/img/view/2014/10/24/749269.png,3,0.9518192410469056,2874,72,4384,1582,1510,1510,apple bloom|applejack|cutie mark crusaders|fluttershy|pinkie pie|princess celestia|princess luna|queen chrysalis|rainbow dash|rarity|scootaloo|sunset shimmer|sweetie belle|trixie|twilight sparkle,zodiacnicola
749269.png,https://derpicdn.net/img/view/2014/10/24/749269.png,5,0.9019691944122314,1106,174,2302,1370,1196,1196,apple bloom|applejack|cutie mark crusaders|fluttershy|pinkie pie|princess celestia|princess luna|queen chrysalis|rainbow dash|rarity|scootaloo|sunset shimmer|sweetie belle|trixie|twilight sparkle,zodiacnicola
749604.png,https://derpicdn.net/img/view/2014/10/24/749604.png,0,0.9166656732559204,933,542,1421,1030,488,488,princess celestia|twilight sparkle,yakovlev-vad
750515.png,https://derpicdn.net/img/view/2014/10/25/750515.png,0,0.994346022605896,317,0,550,222,233,222,sunset shimmer|trixie|twilight sparkle,tami-kitten
750515.png,https://derpicdn.net/img/view/2014/10/25/750515.png,1,0.922720432281494,151,0,383,219,232,219,sunset shimmer|trixie|twilight sparkle,tami-kitten
750802.png,https://derpicdn.net/img/view/2014/10/26/750802.png,0,0.9984262585639954,2210,155,2558,503,348,348,applejack|fluttershy|mane six|pinkie pie|rainbow dash|rarity|spike|twilight sparkle,kando123|marauder6272
750975.jpg,https://derpicdn.net/img/view/2014/10/26/750975.jpg,0,0.9622828364372252,342,0,774,414,432,414,shining armor|twilight sparkle,dm29
752875.png,https://derpicdn.net/img/view/2014/10/29/752875.png,1,0.9961358904838562,1485,2771,2225,3511,740,740,applejack|fluttershy|mane six|pinkie pie|rainbow dash|rarity|spike|sunset shimmer|twilight sparkle,jacky-bunny
752875.png,https://derpicdn.net/img/view/2014/10/29/752875.png,5,0.9874763488769532,69,84,1309,1324,1240,1240,applejack|fluttershy|mane six|pinkie pie|rainbow dash|rarity|spike|sunset shimmer|twilight sparkle,jacky-bunny
752875.png,https://derpicdn.net/img/view/2014/10/29/752875.png,6,0.9711130857467652,1290,3622,2098,4430,808,808,applejack|fluttershy|mane six|pinkie pie|rainbow dash|rarity|spike|sunset shimmer|twilight sparkle,jacky-bunny
752875.png,https://derpicdn.net/img/view/2014/10/29/752875.png,7,0.9621176719665528,1935,3359,2647,4071,712,712,applejack|fluttershy|mane six|pinkie pie|rainbow dash|rarity|spike|sunset shimmer|twilight sparkle,jacky-bunny
752875.png,https://derpicdn.net/img/view/2014/10/29/752875.png,8,0.9575614333152772,92,1470,1098,2476,1006,1006,applejack|fluttershy|mane six|pinkie pie|rainbow dash|rarity|spike|sunset shimmer|twilight sparkle,jacky-bunny
752875.png,https://derpicdn.net/img/view/2014/10/29/752875.png,10,0.94206041097641,0,2797,985,4119,985,1322,applejack|fluttershy|mane six|pinkie pie|rainbow dash|rarity|spike|sunset shimmer|twilight sparkle,jacky-bunny
756588.png,https://derpicdn.net/img/view/2014/11/2/756588.png,0,0.9965924024581908,1197,0,1853,602,656,602,applejack|fluttershy|mane six|pinkie pie|rainbow dash|rarity|twilight sparkle,atryl
756588.png,https://derpicdn.net/img/view/2014/11/2/756588.png,1,0.9387357831001282,2405,1502,2819,1916,414,414,applejack|fluttershy|mane six|pinkie pie|rainbow dash|rarity|twilight sparkle,atryl
758.png,https://derpicdn.net/img/view/2012/1/17/758.png,0,0.9919812679290771,364,27,764,427,400,400,applejack|twilight sparkle,johnjoseco
759034.jpg,https://derpicdn.net/img/view/2014/11/6/759034.jpg,0,0.9922298789024352,126,14,354,242,228,228,sunset shimmer|twilight sparkle,sibashen
759568.png,https://derpicdn.net/img/view/2014/11/7/759568.png,0,0.9862325191497804,1507,276,2225,994,718,718,princess luna|twilight sparkle,darkflame75
759568.png,https://derpicdn.net/img/view/2014/11/7/759568.png,1,0.9696722030639648,1478,888,2184,1594,706,706,princess luna|twilight sparkle,darkflame75
759691.png,https://derpicdn.net/img/view/2014/11/7/759691.png,0,0.97895610332489,663,377,841,555,178,178,queen chrysalis|twilight sparkle,tsitra360
761279.png,https://derpicdn.net/img/view/2014/11/9/761279.png,0,0.9935864806175232,431,176,991,736,560,560,trixie|twilight sparkle,ponyguy67|ryuseihikari
76179.png,https://derpicdn.net/img/view/2012/8/17/76179.png,0,0.9898268580436708,959,293,1201,535,242,242,applejack|big macintosh|fluttershy|pinkie pie|princess cadance|princess celestia|princess luna|queen chrysalis|rainbow dash|rarity|spitfire|trixie|twilight sparkle,xxoomorathxx
76179.png,https://derpicdn.net/img/view/2012/8/17/76179.png,2,0.9727289080619812,234,448,474,688,240,240,applejack|big macintosh|fluttershy|pinkie pie|princess cadance|princess celestia|princess luna|queen chrysalis|rainbow dash|rarity|spitfire|trixie|twilight sparkle,xxoomorathxx
76179.png,https://derpicdn.net/img/view/2012/8/17/76179.png,4,0.9312503933906556,1077,817,1289,1029,212,212,applejack|big macintosh|fluttershy|pinkie pie|princess cadance|princess celestia|princess luna|queen chrysalis|rainbow dash|rarity|spitfire|trixie|twilight sparkle,xxoomorathxx
763550.png,https://derpicdn.net/img/view/2014/11/13/763550.png,0,0.9849870800971984,699,126,1163,590,464,464,rarity|trixie|twilight sparkle,fearingfun
766401.jpg,https://derpicdn.net/img/view/2014/11/17/766401.jpg,1,0.970460057258606,1112,77,1332,297,220,220,applejack|fluttershy|mane six|pinkie pie|rainbow dash|rarity|twilight sparkle,caibaoreturn
766401.jpg,https://derpicdn.net/img/view/2014/11/17/766401.jpg,2,0.9652060270309448,338,107,558,327,220,220,applejack|fluttershy|mane six|pinkie pie|rainbow dash|rarity|twilight sparkle,caibaoreturn
767682.png,https://derpicdn.net/img/view/2014/11/19/767682.png,0,0.998988926410675,739,112,1500,876,761,764,trixie|twilight sparkle,malamol
772046.png,https://derpicdn.net/img/view/2014/11/26/772046.png,0,0.9178864359855652,466,635,1744,1913,1278,1278,rarity|twilight sparkle,nightmaremoons
773265.png,https://derpicdn.net/img/view/2014/11/28/773265.png,0,0.9592404961586,686,337,836,487,150,150,applejack|discord|fluttershy|mane six|pinkie pie|princess cadance|princess celestia|princess luna|rainbow dash|rarity|shining armor|spike|twilight sparkle,lumineko
776323.png,https://derpicdn.net/img/view/2014/12/2/776323.png,0,0.9939058423042296,116,4,710,598,594,594,discord|twilight sparkle,lopoddity
776984.png,https://derpicdn.net/img/view/2014/12/3/776984.png,0,0.9624000787734984,212,152,414,354,202,202,fluttershy|princess celestia|twilight sparkle,tinker-tock
778040.png,https://derpicdn.net/img/view/2014/12/4/778040.png,0,0.9927066564559937,23,419,355,751,332,332,applejack|fluttershy|mane six|pinkie pie|rainbow dash|rarity|twilight sparkle,hawthornss
778040.png,https://derpicdn.net/img/view/2014/12/4/778040.png,1,0.9836460947990416,599,409,899,709,300,300,applejack|fluttershy|mane six|pinkie pie|rainbow dash|rarity|twilight sparkle,hawthornss
778040.png,https://derpicdn.net/img/view/2014/12/4/778040.png,3,0.95306658744812,502,0,866,318,364,318,applejack|fluttershy|mane six|pinkie pie|rainbow dash|rarity|twilight sparkle,hawthornss
779850.jpg,https://derpicdn.net/img/view/2014/12/7/779850.jpg,2,0.9855411648750304,609,294,943,628,334,334,applejack|fluttershy|mane six|pinkie pie|rainbow dash|rarity|twilight sparkle,sweetsound|xin yu hua yin
782826.png,https://derpicdn.net/img/view/2014/12/11/782826.png,0,0.9944748878479004,677,388,1561,1272,884,884,spike|twilight sparkle,imsokyo
784542.png,https://derpicdn.net/img/view/2014/12/14/784542.png,0,0.9773908853530884,312,0,806,449,494,449,princess celestia|twilight sparkle,i am nude
787096.png,https://derpicdn.net/img/view/2014/12/17/787096.png,0,0.9967331290245056,1617,784,4315,3482,2698,2698,princess celestia|twilight sparkle,joey darkmeat|krazy3
788685.png,https://derpicdn.net/img/view/2014/12/20/788685.png,2,0.9264819622039796,454,153,702,401,248,248,princess cadance|shining armor|twilight sparkle,dm29
789011.png,https://derpicdn.net/img/view/2014/12/20/789011.png,0,0.9916094541549684,516,539,960,983,444,444,applejack|fluttershy|mane six|pinkie pie|rainbow dash|rarity|twilight sparkle,narbarnar
789464.png,https://derpicdn.net/img/view/2014/12/21/789464.png,0,0.9558284282684326,284,194,564,474,280,280,trixie|twilight sparkle,pixelkitties
792579.png,https://derpicdn.net/img/view/2014/12/25/792579.png,0,0.99576735496521,58,0,714,633,656,633,sunset shimmer|twilight sparkle,maren
795440.png,https://derpicdn.net/img/view/2014/12/29/795440.png,0,0.9143437743186952,1111,412,2025,1326,914,914,applejack|fluttershy|mane six|pinkie pie|rainbow dash|rarity|spike|twilight sparkle,audrarius
795731.png,https://derpicdn.net/img/view/2014/12/30/795731.png,0,0.9934535622596741,21,240,275,494,254,254,princess celestia|princess luna|sunset shimmer|twilight sparkle,bluse
795731.png,https://derpicdn.net/img/view/2014/12/30/795731.png,1,0.9808521270751952,370,311,572,513,202,202,princess celestia|princess luna|sunset shimmer|twilight sparkle,bluse
800464.png,https://derpicdn.net/img/view/2015/1/6/800464.png,0,0.9970487356185912,468,551,798,881,330,330,sunset shimmer|twilight sparkle,sion-ara
801442.png,https://derpicdn.net/img/view/2015/1/7/801442.png,0,0.9863486289978028,63,0,253,183,190,183,sunset shimmer|twilight sparkle,baekgup
801789.jpg,https://derpicdn.net/img/view/2015/1/8/801789.jpg,0,0.9970521330833436,914,0,1460,543,546,543,rainbow dash|twilight sparkle,skipsy
801804.png,https://derpicdn.net/img/view/2015/1/8/801804.png,1,0.9683436155319214,226,144,468,386,242,242,princess celestia|twilight sparkle,probablyfakeblonde
801850.png,https://derpicdn.net/img/view/2015/1/8/801850.png,1,0.958253800868988,1783,1979,2689,2885,906,906,rarity|spike|twilight sparkle,imsokyo
803219.png,https://derpicdn.net/img/view/2015/1/10/803219.png,1,0.9808453321456908,590,164,948,522,358,358,rainbow dash|spike|twilight sparkle,dm29
807079.png,https://derpicdn.net/img/view/2015/1/15/807079.png,0,0.9565801620483398,420,112,942,634,522,522,applejack|fluttershy|pinkie pie|rarity|twilight sparkle,whitediamonds
807367.jpg,https://derpicdn.net/img/view/2015/1/15/807367.jpg,0,0.9976947903633118,6,27,408,429,402,402,princess luna|twilight sparkle,silfoe
807492.png,https://derpicdn.net/img/view/2015/1/16/807492.png,1,0.9871465563774108,301,84,555,338,254,254,applejack|twilight sparkle,jowybean
807492.png,https://derpicdn.net/img/view/2015/1/16/807492.png,2,0.9430707693099976,767,0,1053,254,286,254,applejack|twilight sparkle,jowybean
807508.jpg,https://derpicdn.net/img/view/2015/1/16/807508.jpg,0,0.9010155200958252,164,157,688,681,524,524,princess celestia|princess luna|twilight sparkle,silfoe
807828.png,https://derpicdn.net/img/view/2015/1/16/807828.png,0,0.9991102814674376,492,196,784,492,292,296,discord|twilight sparkle,baekgup
807828.png,https://derpicdn.net/img/view/2015/1/16/807828.png,1,0.9347580671310424,199,2,477,280,278,278,discord|twilight sparkle,baekgup
808151.png,https://derpicdn.net/img/view/2015/1/17/808151.png,0,0.9782944917678832,792,456,1548,1212,756,756,rainbow dash|twilight sparkle,b-epon
808715.png,https://derpicdn.net/img/view/2015/1/17/808715.png,0,0.9966051578521729,119,0,565,396,446,396,applejack|fluttershy|mane six|pinkie pie|rainbow dash|rarity|twilight sparkle,atryl
808715.png,https://derpicdn.net/img/view/2015/1/17/808715.png,1,0.981582522392273,934,1154,1458,1678,524,524,applejack|fluttershy|mane six|pinkie pie|rainbow dash|rarity|twilight sparkle,atryl
808715.png,https://derpicdn.net/img/view/2015/1/17/808715.png,2,0.969353437423706,1871,0,2373,428,502,428,applejack|fluttershy|mane six|pinkie pie|rainbow dash|rarity|twilight sparkle,atryl
808715.png,https://derpicdn.net/img/view/2015/1/17/808715.png,3,0.9681452512741088,283,1163,703,1583,420,420,applejack|fluttershy|mane six|pinkie pie|rainbow dash|rarity|twilight sparkle,atryl
808918.png,https://derpicdn.net/img/view/2015/1/18/808918.png,1,0.9498780369758606,1298,0,2820,1163,1522,1163,princess celestia|twilight sparkle,captainpudgemuffin
810622.png,https://derpicdn.net/img/view/2015/1/20/810622.png,0,0.995194137096405,324,0,732,390,408,390,applejack|fluttershy|mane six|pinkie pie|rainbow dash|rarity|twilight sparkle,atryl edits|flyingbrickanimation|atryl
810622.png,https://derpicdn.net/img/view/2015/1/20/810622.png,1,0.9906686544418336,704,0,1080,360,376,360,applejack|fluttershy|mane six|pinkie pie|rainbow dash|rarity|twilight sparkle,atryl edits|flyingbrickanimation|atryl
810622.png,https://derpicdn.net/img/view/2015/1/20/810622.png,2,0.9856469631195068,1724,0,2133,435,409,435,applejack|fluttershy|mane six|pinkie pie|rainbow dash|rarity|twilight sparkle,atryl edits|flyingbrickanimation|atryl
810622.png,https://derpicdn.net/img/view/2015/1/20/810622.png,3,0.9590259194374084,1302,8,1702,408,400,400,applejack|fluttershy|mane six|pinkie pie|rainbow dash|rarity|twilight sparkle,atryl edits|flyingbrickanimation|atryl
810656.png,https://derpicdn.net/img/view/2015/1/20/810656.png,0,0.9451756477355956,523,218,1011,706,488,488,princess celestia|twilight sparkle,wicked-at-heart
810961.png,https://derpicdn.net/img/view/2015/1/20/810961.png,0,0.9418343305587769,677,7,909,239,232,232,princess celestia|twilight sparkle,probablyfakeblonde
811144.png,https://derpicdn.net/img/view/2015/1/20/811144.png,0,0.9906105995178224,376,99,888,611,512,512,pinkie pie|twilight sparkle,kelsea-chan
811144.png,https://derpicdn.net/img/view/2015/1/20/811144.png,1,0.98080712556839,0,138,493,654,493,516,pinkie pie|twilight sparkle,kelsea-chan
812590.jpg,https://derpicdn.net/img/view/2015/1/23/812590.jpg,0,0.9959842562675476,634,275,1242,883,608,608,discord|princess celestia|princess luna|twilight sparkle,magnaluna
812590.jpg,https://derpicdn.net/img/view/2015/1/23/812590.jpg,1,0.9895697236061096,1295,530,1781,1016,486,486,discord|princess celestia|princess luna|twilight sparkle,magnaluna
812834.png,https://derpicdn.net/img/view/2015/1/23/812834.png,0,0.9529968500137328,406,110,692,396,286,286,applejack|fluttershy|mane six|pinkie pie|princess celestia|rainbow dash|rarity|sunset shimmer|twilight sparkle,majkashinoda626
813964.jpg,https://derpicdn.net/img/view/2015/1/24/813964.jpg,0,0.9987192749977112,162,0,460,262,298,262,princess cadance|princess celestia|princess luna|twilight sparkle,silfoe
816298.png,https://derpicdn.net/img/view/2015/1/28/816298.png,0,0.9995887875556946,754,212,1168,626,414,414,rainbow dash|shining armor|twilight sparkle,koportable
816298.png,https://derpicdn.net/img/view/2015/1/28/816298.png,1,0.9986487030982972,472,137,862,527,390,390,rainbow dash|shining armor|twilight sparkle,koportable
817261.png,https://derpicdn.net/img/view/2015/1/29/817261.png,1,0.9091092944145204,355,364,593,602,238,238,rainbow dash|rarity|spike|twilight sparkle,nekubi
817337.jpg,https://derpicdn.net/img/view/2015/1/29/817337.jpg,0,0.9744714498519896,229,137,777,685,548,548,applejack|spike|twilight sparkle,ss2sonic
817337.jpg,https://derpicdn.net/img/view/2015/1/29/817337.jpg,1,0.9369761943817142,782,172,1172,562,390,390,applejack|spike|twilight sparkle,ss2sonic
817584.jpg,https://derpicdn.net/img/view/2015/1/30/817584.jpg,0,0.9837204217910768,745,755,1977,1987,1232,1232,princess celestia|princess luna|twilight sparkle,magnaluna
817999.png,https://derpicdn.net/img/view/2015/1/30/817999.png,0,0.9976084232330322,2202,808,3020,1626,818,818,rainbow dash|twilight sparkle,wicked-at-heart
820332.png,https://derpicdn.net/img/view/2015/2/3/820332.png,0,0.9438515901565552,1508,1664,2562,2730,1054,1066,princess cadance|spike|twilight sparkle,reimon-master-ii|ponyguy67
820332.png,https://derpicdn.net/img/view/2015/2/3/820332.png,1,0.9294382333755492,925,389,1867,1331,942,942,princess cadance|spike|twilight sparkle,reimon-master-ii|ponyguy67
821089.png,https://derpicdn.net/img/view/2015/2/4/821089.png,0,0.9953311085700988,653,0,1471,739,818,739,rainbow dash|twilight sparkle,underpable
821209.png,https://derpicdn.net/img/view/2015/2/4/821209.png,0,0.9935868382453918,0,579,623,1215,623,636,discord|twilight sparkle,lopoddity
821209.png,https://derpicdn.net/img/view/2015/2/4/821209.png,1,0.9796884655952454,486,44,1182,824,696,780,discord|twilight sparkle,lopoddity
821618.jpg,https://derpicdn.net/img/view/2015/2/4/821618.jpg,0,0.9980826377868652,1671,385,2391,1105,720,720,applejack|fluttershy|rarity|twilight sparkle,creamygravy
821618.jpg,https://derpicdn.net/img/view/2015/2/4/821618.jpg,1,0.9976417422294616,516,0,1136,591,620,591,applejack|fluttershy|rarity|twilight sparkle,creamygravy
821640.png,https://derpicdn.net/img/view/2015/2/5/821640.png,1,0.9079272747039796,535,151,1031,647,496,496,applejack|fluttershy|mane six|pinkie pie|princess celestia|princess luna|rainbow dash|rarity|twilight sparkle,ollywiicious
822177.png,https://derpicdn.net/img/view/2015/2/5/822177.png,0,0.9982782006263732,271,46,559,334,288,288,applejack|fluttershy|mane six|pinkie pie|rainbow dash|rarity|twilight sparkle,dvixie
822177.png,https://derpicdn.net/img/view/2015/2/5/822177.png,1,0.9980283975601196,50,355,336,641,286,286,applejack|fluttershy|mane six|pinkie pie|rainbow dash|rarity|twilight sparkle,dvixie
822177.png,https://derpicdn.net/img/view/2015/2/5/822177.png,2,0.9848895072937012,0,38,293,342,293,304,applejack|fluttershy|mane six|pinkie pie|rainbow dash|rarity|twilight sparkle,dvixie
822177.png,https://derpicdn.net/img/view/2015/2/5/822177.png,3,0.981164276599884,428,254,686,512,258,258,applejack|fluttershy|mane six|pinkie pie|rainbow dash|rarity|twilight sparkle,dvixie
822177.png,https://derpicdn.net/img/view/2015/2/5/822177.png,4,0.9328020215034484,512,0,806,266,294,266,applejack|fluttershy|mane six|pinkie pie|rainbow dash|rarity|twilight sparkle,dvixie
823885.png,https://derpicdn.net/img/view/2015/2/8/823885.png,0,0.99630469083786,1862,0,3360,1281,1498,1281,rainbow dash|rarity|twilight sparkle,captainpudgemuffin
823885.png,https://derpicdn.net/img/view/2015/2/8/823885.png,1,0.9920935034751892,759,993,1387,1621,628,628,rainbow dash|rarity|twilight sparkle,captainpudgemuffin
823991.png,https://derpicdn.net/img/view/2015/2/8/823991.png,0,0.998198390007019,1521,0,2791,1166,1270,1166,rainbow dash|rarity|twilight sparkle,captainpudgemuffin
823991.png,https://derpicdn.net/img/view/2015/2/8/823991.png,1,0.9898859262466432,261,973,927,1639,666,666,rainbow dash|rarity|twilight sparkle,captainpudgemuffin
824237.png,https://derpicdn.net/img/view/2015/2/8/824237.png,0,0.9749448299407959,1631,96,1895,360,264,264,applejack|big macintosh|fluttershy|mane six|pinkie pie|princess celestia|princess luna|queen chrysalis|rainbow dash|rarity|twilight sparkle,lumineko
824344.png,https://derpicdn.net/img/view/2015/2/8/824344.png,0,0.9662882685661316,161,0,547,351,386,351,sunset shimmer|twilight sparkle,baekgup
826376.png,https://derpicdn.net/img/view/2015/2/11/826376.png,0,0.9805996417999268,103,0,301,189,198,189,trixie|twilight sparkle,cotta
827076.png,https://derpicdn.net/img/view/2015/2/12/827076.png,0,0.9892806410789492,362,301,546,485,184,184,applejack|twilight sparkle,jowybean
827209.png,https://derpicdn.net/img/view/2015/2/12/827209.png,2,0.971943199634552,812,490,1164,842,352,352,big macintosh|trixie|twilight sparkle,berrypawnch
827523.png,https://derpicdn.net/img/view/2015/2/13/827523.png,0,0.956476628780365,718,181,1288,751,570,570,rarity|twilight sparkle,lumineko
827524.png,https://derpicdn.net/img/view/2015/2/13/827524.png,0,0.9535691142082214,722,186,1282,746,560,560,rarity|twilight sparkle,lumineko
828852.png,https://derpicdn.net/img/view/2015/2/15/828852.png,1,0.905351996421814,1380,0,1978,552,598,552,applejack|fluttershy|mane six|pinkie pie|rainbow dash|rarity|twilight sparkle,lucy-tan
830343.png,https://derpicdn.net/img/view/2015/2/16/830343.png,0,0.9987706542015076,561,414,859,712,298,298,applejack|fluttershy|mane six|pinkie pie|rainbow dash|rarity|spike|sunset shimmer|twilight sparkle,deannart
830343.png,https://derpicdn.net/img/view/2015/2/16/830343.png,1,0.9981539845466614,319,63,819,563,500,500,applejack|fluttershy|mane six|pinkie pie|rainbow dash|rarity|spike|sunset shimmer|twilight sparkle,deannart
830343.png,https://derpicdn.net/img/view/2015/2/16/830343.png,2,0.9960948824882508,1302,286,1598,582,296,296,applejack|fluttershy|mane six|pinkie pie|rainbow dash|rarity|spike|sunset shimmer|twilight sparkle,deannart
830343.png,https://derpicdn.net/img/view/2015/2/16/830343.png,3,0.98390793800354,83,230,479,626,396,396,applejack|fluttershy|mane six|pinkie pie|rainbow dash|rarity|spike|sunset shimmer|twilight sparkle,deannart
830343.png,https://derpicdn.net/img/view/2015/2/16/830343.png,5,0.9415916800498962,988,470,1434,916,446,446,applejack|fluttershy|mane six|pinkie pie|rainbow dash|rarity|spike|sunset shimmer|twilight sparkle,deannart
830343.png,https://derpicdn.net/img/view/2015/2/16/830343.png,6,0.901333212852478,777,286,1107,616,330,330,applejack|fluttershy|mane six|pinkie pie|rainbow dash|rarity|spike|sunset shimmer|twilight sparkle,deannart
831445.png,https://derpicdn.net/img/view/2015/2/17/831445.png,0,0.9895265102386476,250,540,590,880,340,340,rainbow dash|twilight sparkle,ninjapony
832196.png,https://derpicdn.net/img/view/2015/2/19/832196.png,0,0.9960157871246338,564,781,1176,1393,612,612,applejack|fluttershy|mane six|pinkie pie|rainbow dash|rarity|twilight sparkle,madacon
832196.png,https://derpicdn.net/img/view/2015/2/19/832196.png,1,0.9906434416770936,1045,810,1615,1380,570,570,applejack|fluttershy|mane six|pinkie pie|rainbow dash|rarity|twilight sparkle,madacon
832196.png,https://derpicdn.net/img/view/2015/2/19/832196.png,2,0.9618045687675476,1526,856,1996,1326,470,470,applejack|fluttershy|mane six|pinkie pie|rainbow dash|rarity|twilight sparkle,madacon
832196.png,https://derpicdn.net/img/view/2015/2/19/832196.png,3,0.959851324558258,1434,146,2004,716,570,570,applejack|fluttershy|mane six|pinkie pie|rainbow dash|rarity|twilight sparkle,madacon
833219.png,https://derpicdn.net/img/view/2015/2/20/833219.png,0,0.9770681858062744,264,144,428,308,164,164,apple bloom|applejack|cutie mark crusaders|discord|fluttershy|mane six|pinkie pie|rainbow dash|rarity|scootaloo|sweetie belle|twilight sparkle,luciferamon
833219.png,https://derpicdn.net/img/view/2015/2/20/833219.png,1,0.9593122601509094,770,267,1140,637,370,370,apple bloom|applejack|cutie mark crusaders|discord|fluttershy|mane six|pinkie pie|rainbow dash|rarity|scootaloo|sweetie belle|twilight sparkle,luciferamon
834251.jpg,https://derpicdn.net/img/view/2015/2/21/834251.jpg,0,0.96906977891922,378,196,722,540,344,344,princess luna|twilight sparkle,silfoe
834762.png,https://derpicdn.net/img/view/2015/2/22/834762.png,0,0.9990920424461364,1213,0,2437,969,1224,969,spike|twilight sparkle,grennadder
836595.png,https://derpicdn.net/img/view/2015/2/24/836595.png,0,0.9371103048324584,405,10,671,276,266,266,sunset shimmer|twilight sparkle,ta-na
837059.png,https://derpicdn.net/img/view/2015/2/25/837059.png,0,0.9842847585678101,2003,0,3425,1401,1422,1401,rainbow dash|twilight sparkle,thenornonthego
837059.png,https://derpicdn.net/img/view/2015/2/25/837059.png,1,0.9306678175926208,532,1849,1516,2833,984,984,rainbow dash|twilight sparkle,thenornonthego
841012.png,https://derpicdn.net/img/view/2015/3/2/841012.png,0,0.9966587424278259,171,0,569,350,398,350,trixie|twilight sparkle,thepolymath|longinius
841676.png,https://derpicdn.net/img/view/2015/3/3/841676.png,0,0.9891830086708068,699,142,1003,446,304,304,applejack|fluttershy|mane six|pinkie pie|rainbow dash|rarity|twilight sparkle,avante92
841676.png,https://derpicdn.net/img/view/2015/3/3/841676.png,2,0.9825537204742432,1306,155,1596,445,290,290,applejack|fluttershy|mane six|pinkie pie|rainbow dash|rarity|twilight sparkle,avante92
841676.png,https://derpicdn.net/img/view/2015/3/3/841676.png,3,0.9756163358688354,20,135,358,473,338,338,applejack|fluttershy|mane six|pinkie pie|rainbow dash|rarity|twilight sparkle,avante92
8419.png,https://derpicdn.net/img/view/2012/6/18/8419.png,0,0.9973917007446288,3934,1099,4920,2113,986,1014,applejack|fluttershy|mane six|pinkie pie|princess celestia|rainbow dash|rarity|twilight sparkle,cuteskitty
842416.png,https://derpicdn.net/img/view/2015/3/5/842416.png,0,0.9340646266937256,455,358,655,558,200,200,applejack|twilight sparkle,jowybean
843720.png,https://derpicdn.net/img/view/2015/3/6/843720.png,0,0.9960935711860656,1056,0,2720,1539,1664,1539,princess luna|twilight sparkle,wodahseht|dfectivedvice
843720.png,https://derpicdn.net/img/view/2015/3/6/843720.png,1,0.9886549115180968,22,672,1300,1950,1278,1278,princess luna|twilight sparkle,wodahseht|dfectivedvice
844402.png,https://derpicdn.net/img/view/2015/3/7/844402.png,0,0.9875092506408693,106,67,444,405,338,338,spike|twilight sparkle,i am nude
845863.png,https://derpicdn.net/img/view/2015/3/9/845863.png,0,0.998351514339447,231,536,865,1170,634,634,discord|rarity|twilight sparkle,palolabg
847205.png,https://derpicdn.net/img/view/2015/3/11/847205.png,0,0.9892812967300416,3291,624,4317,1650,1026,1026,applejack|fluttershy|mane six|pinkie pie|rainbow dash|rarity|twilight sparkle,antiander
847918.png,https://derpicdn.net/img/view/2015/3/12/847918.png,2,0.9430038928985596,935,72,1201,338,266,266,applejack|fluttershy|mane six|pinkie pie|rainbow dash|rarity|twilight sparkle,lopoddity
848961.png,https://derpicdn.net/img/view/2015/3/14/848961.png,0,0.9987685084342957,99,368,417,686,318,318,princess luna|twilight sparkle,king-kakapo
848961.png,https://derpicdn.net/img/view/2015/3/14/848961.png,1,0.9749394059181212,533,540,805,812,272,272,princess luna|twilight sparkle,king-kakapo
849236.png,https://derpicdn.net/img/view/2015/3/14/849236.png,1,0.9766769409179688,427,111,709,393,282,282,pinkie pie|twilight sparkle,brianblackberry
84943.jpg,https://derpicdn.net/img/view/2012/8/28/84943.jpg,0,0.9329341650009156,604,234,978,608,374,374,applejack|pinkie pie|rainbow dash|twilight sparkle,harwick
850197.png,https://derpicdn.net/img/view/2015/3/15/850197.png,0,0.9993151426315308,14,1011,614,1611,600,600,princess cadance|princess celestia|princess luna|queen chrysalis|trixie|twilight sparkle,kp-shadowsquirrel
850197.png,https://derpicdn.net/img/view/2015/3/15/850197.png,1,0.9989647865295408,59,495,637,1073,578,578,princess cadance|princess celestia|princess luna|queen chrysalis|trixie|twilight sparkle,kp-shadowsquirrel
850197.png,https://derpicdn.net/img/view/2015/3/15/850197.png,2,0.9877547621726992,37,0,625,564,588,564,princess cadance|princess celestia|princess luna|queen chrysalis|trixie|twilight sparkle,kp-shadowsquirrel
850197.png,https://derpicdn.net/img/view/2015/3/15/850197.png,3,0.9839527606964112,667,0,1205,514,538,514,princess cadance|princess celestia|princess luna|queen chrysalis|trixie|twilight sparkle,kp-shadowsquirrel
850197.png,https://derpicdn.net/img/view/2015/3/15/850197.png,4,0.9583110213279724,576,471,1194,1089,618,618,princess cadance|princess celestia|princess luna|queen chrysalis|trixie|twilight sparkle,kp-shadowsquirrel
850197.png,https://derpicdn.net/img/view/2015/3/15/850197.png,5,0.9279063940048218,674,997,1226,1549,552,552,princess cadance|princess celestia|princess luna|queen chrysalis|trixie|twilight sparkle,kp-shadowsquirrel
851005.png,https://derpicdn.net/img/view/2015/3/16/851005.png,0,0.9932256937026978,580,0,1234,634,654,634,trixie|twilight sparkle,maren
851963.png,https://derpicdn.net/img/view/2015/3/18/851963.png,0,0.9963538646697998,579,76,1675,1172,1096,1096,princess celestia|twilight sparkle,nadnerbd
85207.png,https://derpicdn.net/img/view/2012/8/29/85207.png,0,0.9842641949653624,251,15,913,677,662,662,rainbow dash|twilight sparkle,atryl
852303.png,https://derpicdn.net/img/view/2015/3/18/852303.png,1,0.990537405014038,13,4,367,358,354,354,applejack|starlight glimmer|twilight sparkle,jowybean
852304.png,https://derpicdn.net/img/view/2015/3/18/852304.png,0,0.9705383777618408,143,18,403,278,260,260,applejack|twilight sparkle,jowybean
856285.png,https://derpicdn.net/img/view/2015/3/24/856285.png,0,0.999699056148529,25,14,351,340,326,326,apple bloom|applejack|cutie mark crusaders|fluttershy|mane six|pinkie pie|princess celestia|princess luna|rainbow dash|rarity|scootaloo|spike|sweetie belle|twilight sparkle,kp-shadowsquirrel
856285.png,https://derpicdn.net/img/view/2015/3/24/856285.png,1,0.9994012117385864,707,15,1027,335,320,320,apple bloom|applejack|cutie mark crusaders|fluttershy|mane six|pinkie pie|princess celestia|princess luna|rainbow dash|rarity|scootaloo|spike|sweetie belle|twilight sparkle,kp-shadowsquirrel
856285.png,https://derpicdn.net/img/view/2015/3/24/856285.png,2,0.9991797804832458,355,678,729,1052,374,374,apple bloom|applejack|cutie mark crusaders|fluttershy|mane six|pinkie pie|princess celestia|princess luna|rainbow dash|rarity|scootaloo|spike|sweetie belle|twilight sparkle,kp-shadowsquirrel
856285.png,https://derpicdn.net/img/view/2015/3/24/856285.png,3,0.9989951252937316,353,344,707,698,354,354,apple bloom|applejack|cutie mark crusaders|fluttershy|mane six|pinkie pie|princess celestia|princess luna|rainbow dash|rarity|scootaloo|spike|sweetie belle|twilight sparkle,kp-shadowsquirrel
856285.png,https://derpicdn.net/img/view/2015/3/24/856285.png,4,0.9987996816635132,0,670,382,1074,382,404,apple bloom|applejack|cutie mark crusaders|fluttershy|mane six|pinkie pie|princess celestia|princess luna|rainbow dash|rarity|scootaloo|spike|sweetie belle|twilight sparkle,kp-shadowsquirrel
856285.png,https://derpicdn.net/img/view/2015/3/24/856285.png,5,0.9986030459403992,345,0,715,364,370,364,apple bloom|applejack|cutie mark crusaders|fluttershy|mane six|pinkie pie|princess celestia|princess luna|rainbow dash|rarity|scootaloo|spike|sweetie belle|twilight sparkle,kp-shadowsquirrel
856285.png,https://derpicdn.net/img/view/2015/3/24/856285.png,6,0.9984294772148132,324,1030,690,1388,366,358,apple bloom|applejack|cutie mark crusaders|fluttershy|mane six|pinkie pie|princess celestia|princess luna|rainbow dash|rarity|scootaloo|spike|sweetie belle|twilight sparkle,kp-shadowsquirrel
856285.png,https://derpicdn.net/img/view/2015/3/24/856285.png,7,0.997458040714264,53,1010,395,1352,342,342,apple bloom|applejack|cutie mark crusaders|fluttershy|mane six|pinkie pie|princess celestia|princess luna|rainbow dash|rarity|scootaloo|spike|sweetie belle|twilight sparkle,kp-shadowsquirrel
856285.png,https://derpicdn.net/img/view/2015/3/24/856285.png,8,0.9920291900634766,658,710,1010,1062,352,352,apple bloom|applejack|cutie mark crusaders|fluttershy|mane six|pinkie pie|princess celestia|princess luna|rainbow dash|rarity|scootaloo|spike|sweetie belle|twilight sparkle,kp-shadowsquirrel
856285.png,https://derpicdn.net/img/view/2015/3/24/856285.png,9,0.9866702556610109,668,379,1036,747,368,368,apple bloom|applejack|cutie mark crusaders|fluttershy|mane six|pinkie pie|princess celestia|princess luna|rainbow dash|rarity|scootaloo|spike|sweetie belle|twilight sparkle,kp-shadowsquirrel
856285.png,https://derpicdn.net/img/view/2015/3/24/856285.png,10,0.9728797674179076,42,369,344,671,302,302,apple bloom|applejack|cutie mark crusaders|fluttershy|mane six|pinkie pie|princess celestia|princess luna|rainbow dash|rarity|scootaloo|spike|sweetie belle|twilight sparkle,kp-shadowsquirrel
856285.png,https://derpicdn.net/img/view/2015/3/24/856285.png,11,0.9552448391914368,674,1020,1000,1346,326,326,apple bloom|applejack|cutie mark crusaders|fluttershy|mane six|pinkie pie|princess celestia|princess luna|rainbow dash|rarity|scootaloo|spike|sweetie belle|twilight sparkle,kp-shadowsquirrel
856889.png,https://derpicdn.net/img/view/2015/3/25/856889.png,0,0.9281772971153259,88,43,646,601,558,558,sunset shimmer|twilight sparkle,ta-na
859091.png,https://derpicdn.net/img/view/2015/3/28/859091.png,0,0.998659372329712,1967,1009,2383,1425,416,416,apple bloom|cutie mark crusaders|diamond tiara|scootaloo|silver spoon|sweetie belle|twilight sparkle,lamia
859091.png,https://derpicdn.net/img/view/2015/3/28/859091.png,1,0.9882802963256836,1943,324,2353,734,410,410,apple bloom|cutie mark crusaders|diamond tiara|scootaloo|silver spoon|sweetie belle|twilight sparkle,lamia
859091.png,https://derpicdn.net/img/view/2015/3/28/859091.png,2,0.9838741421699524,1335,1777,1705,2147,370,370,apple bloom|cutie mark crusaders|diamond tiara|scootaloo|silver spoon|sweetie belle|twilight sparkle,lamia
859091.png,https://derpicdn.net/img/view/2015/3/28/859091.png,3,0.9814900159835817,722,1736,1128,2142,406,406,apple bloom|cutie mark crusaders|diamond tiara|scootaloo|silver spoon|sweetie belle|twilight sparkle,lamia
859091.png,https://derpicdn.net/img/view/2015/3/28/859091.png,4,0.940265417098999,1298,981,1796,1479,498,498,apple bloom|cutie mark crusaders|diamond tiara|scootaloo|silver spoon|sweetie belle|twilight sparkle,lamia
860311.jpg,https://derpicdn.net/img/view/2015/3/30/860311.jpg,0,0.9995273351669312,452,718,1234,1500,782,782,applejack|twilight sparkle,lil miss jay|kaixxxcorner
861259.jpg,https://derpicdn.net/img/view/2015/3/31/861259.jpg,0,0.9942258596420288,65,91,531,557,466,466,rainbow dash|twilight sparkle,tsitra360
861384.png,https://derpicdn.net/img/view/2015/3/31/861384.png,0,0.9950869679450988,376,36,514,174,138,138,apple bloom|applejack|cutie mark crusaders|fluttershy|mane six|pinkie pie|princess cadance|princess celestia|princess luna|rainbow dash|rarity|scootaloo|spitfire|sunset shimmer|sweetie belle|trixie|twilight sparkle,poisonicpen
861384.png,https://derpicdn.net/img/view/2015/3/31/861384.png,1,0.9888477325439452,333,134,525,326,192,192,apple bloom|applejack|cutie mark crusaders|fluttershy|mane six|pinkie pie|princess cadance|princess celestia|princess luna|rainbow dash|rarity|scootaloo|spitfire|sunset shimmer|sweetie belle|trixie|twilight sparkle,poisonicpen
861907.png,https://derpicdn.net/img/view/2015/4/1/861907.png,0,0.9926523566246032,582,48,1004,470,422,422,rarity|shining armor|twilight sparkle,braeburned
861907.png,https://derpicdn.net/img/view/2015/4/1/861907.png,1,0.9756016135215759,309,0,727,360,418,360,rarity|shining armor|twilight sparkle,braeburned
863966.png,https://derpicdn.net/img/view/2015/4/3/863966.png,0,0.9600461721420288,2523,0,3061,523,538,523,applejack|fluttershy|mane six|pinkie pie|rainbow dash|rarity|spike|twilight sparkle,marauder6272|pervynamek02
8657.png,https://derpicdn.net/img/view/2012/6/18/8657.png,0,0.916146457195282,24,0,718,693,694,693,rarity|twilight sparkle,kloudmutt
865731.png,https://derpicdn.net/img/view/2015/4/5/865731.png,0,0.9781063199043274,51,318,499,766,448,448,trixie|twilight sparkle,king-kakapo
866644.png,https://derpicdn.net/img/view/2015/4/6/866644.png,0,0.9969416856765748,404,18,814,428,410,410,rainbow dash|spike|twilight sparkle,girgrunny
866644.png,https://derpicdn.net/img/view/2015/4/6/866644.png,1,0.9434391260147096,674,199,1012,537,338,338,rainbow dash|spike|twilight sparkle,girgrunny
866955.png,https://derpicdn.net/img/view/2015/4/6/866955.png,1,0.9675828814506532,634,29,1092,487,458,458,shining armor|twilight sparkle,dm29
867575.png,https://derpicdn.net/img/view/2015/4/7/867575.png,0,0.993646502494812,0,1461,1235,2739,1235,1278,applejack|fluttershy|mane six|pinkie pie|rainbow dash|rarity|twilight sparkle,thecheeseburger
867575.png,https://derpicdn.net/img/view/2015/4/7/867575.png,3,0.9674556255340576,3585,1749,4991,3155,1406,1406,applejack|fluttershy|mane six|pinkie pie|rainbow dash|rarity|twilight sparkle,thecheeseburger
867575.png,https://derpicdn.net/img/view/2015/4/7/867575.png,4,0.959272801876068,466,0,1896,1306,1430,1306,applejack|fluttershy|mane six|pinkie pie|rainbow dash|rarity|twilight sparkle,thecheeseburger
868610.png,https://derpicdn.net/img/view/2015/4/8/868610.png,0,0.9881329536437988,0,371,919,1331,919,960,rainbow dash|twilight sparkle,captainpudgemuffin
871086.png,https://derpicdn.net/img/view/2015/4/11/871086.png,1,0.9945882558822632,163,36,417,290,254,254,princess cadance|princess celestia|princess luna|twilight sparkle,caroo
871938.png,https://derpicdn.net/img/view/2015/4/11/871938.png,0,0.9977487325668336,24,67,610,653,586,586,rainbow dash|twilight sparkle,ambris
871938.png,https://derpicdn.net/img/view/2015/4/11/871938.png,1,0.9373615980148317,546,38,1148,640,602,602,rainbow dash|twilight sparkle,ambris
872729.png,https://derpicdn.net/img/view/2015/4/12/872729.png,0,0.9974921941757202,123,0,423,276,300,276,princess cadance|shining armor|twilight sparkle,sibsy
872729.png,https://derpicdn.net/img/view/2015/4/12/872729.png,1,0.9255619645118712,389,29,677,317,288,288,princess cadance|shining armor|twilight sparkle,sibsy
873566.png,https://derpicdn.net/img/view/2015/4/14/873566.png,0,0.9892680644989014,175,360,707,892,532,532,starlight glimmer|trixie|twilight sparkle,kittyhawk-contrail
873693.png,https://derpicdn.net/img/view/2015/4/14/873693.png,0,0.9997187256813048,32,843,974,1785,942,942,princess cadance|princess celestia|princess luna|starlight glimmer|twilight sparkle,theshadowstone
873693.png,https://derpicdn.net/img/view/2015/4/14/873693.png,1,0.9452437162399292,2487,698,3579,1790,1092,1092,princess cadance|princess celestia|princess luna|starlight glimmer|twilight sparkle,theshadowstone
873942.jpg,https://derpicdn.net/img/view/2015/4/14/873942.jpg,0,0.921021044254303,60,544,262,746,202,202,applejack|fluttershy|pinkie pie|princess celestia|rainbow dash|rarity|trixie|twilight sparkle,
874373.png,https://derpicdn.net/img/view/2015/4/15/874373.png,0,0.9007931351661682,786,433,1150,797,364,364,fluttershy|twilight sparkle,assasinmonkey
874381.png,https://derpicdn.net/img/view/2015/4/15/874381.png,0,0.9558318257331848,439,0,923,394,484,394,rarity|spike|twilight sparkle,dm29
875885.png,https://derpicdn.net/img/view/2015/4/17/875885.png,0,0.9036795496940612,2,84,200,282,198,198,applejack|twilight sparkle,jowybean
879591.png,https://derpicdn.net/img/view/2015/4/21/879591.png,0,0.9650917053222656,1589,42,2921,1374,1332,1332,spike|twilight sparkle,pirill
880634.png,https://derpicdn.net/img/view/2015/4/23/880634.png,0,0.9822207689285278,428,2,1078,652,650,650,princess celestia|twilight sparkle,ensayne
881153.png,https://derpicdn.net/img/view/2015/4/23/881153.png,0,0.9858343601226808,452,71,786,421,334,350,applejack|twilight sparkle,jowybean
881421.png,https://derpicdn.net/img/view/2015/4/24/881421.png,1,0.9397308230400084,540,491,918,869,378,378,apple bloom|cutie mark crusaders|princess cadance|princess celestia|princess luna|scootaloo|spike|sweetie belle|twilight sparkle,kp-shadowsquirrel
884387.png,https://derpicdn.net/img/view/2015/4/27/884387.png,0,0.9951217770576476,0,178,628,840,628,662,rarity|twilight sparkle,ponyguy67|danmakuman
884650.png,https://derpicdn.net/img/view/2015/4/28/884650.png,0,0.9484156966209412,629,637,1039,1047,410,410,applejack|fluttershy|mane six|pinkie pie|rainbow dash|rarity|spike|twilight sparkle,0r0ch1
886355.png,https://derpicdn.net/img/view/2015/5/1/886355.png,1,0.9437896609306335,797,43,1155,401,358,358,princess cadance|shining armor|spike|twilight sparkle,dm29
886355.png,https://derpicdn.net/img/view/2015/5/1/886355.png,2,0.9239237308502196,182,53,612,483,430,430,princess cadance|shining armor|spike|twilight sparkle,dm29
886489.png,https://derpicdn.net/img/view/2015/5/1/886489.png,0,0.9819391369819641,266,2,722,458,456,456,applejack|twilight sparkle,jowybean
888679.png,https://derpicdn.net/img/view/2015/5/4/888679.png,0,0.9681317210197448,1770,41,3156,1427,1386,1386,rainbow dash|twilight sparkle,captainpudgemuffin
889023.png,https://derpicdn.net/img/view/2015/5/4/889023.png,0,0.997483253479004,378,424,742,788,364,364,spike|twilight sparkle,piesarts
889023.png,https://derpicdn.net/img/view/2015/5/4/889023.png,1,0.997258722782135,93,588,425,920,332,332,spike|twilight sparkle,piesarts
892303.png,https://derpicdn.net/img/view/2015/5/9/892303.png,0,0.9848229885101318,1070,946,2470,2346,1400,1400,rainbow dash|twilight sparkle,ambris
892303.png,https://derpicdn.net/img/view/2015/5/9/892303.png,1,0.9104878902435304,2274,682,3668,2076,1394,1394,rainbow dash|twilight sparkle,ambris
893000.png,https://derpicdn.net/img/view/2015/5/10/893000.png,0,0.9980233907699584,152,583,454,885,302,302,princess celestia|twilight sparkle,caroo
893000.png,https://derpicdn.net/img/view/2015/5/10/893000.png,1,0.9781799912452698,474,49,712,287,238,238,princess celestia|twilight sparkle,caroo
893060.png,https://derpicdn.net/img/view/2015/5/10/893060.png,0,0.9709556698799132,450,33,704,287,254,254,princess cadance|princess celestia|princess luna|shining armor|twilight sparkle,dm29
893202.png,https://derpicdn.net/img/view/2015/5/10/893202.png,0,0.995358109474182,411,258,1003,850,592,592,rainbow dash|twilight sparkle,underpable
893706.png,https://derpicdn.net/img/view/2015/5/11/893706.png,1,0.9714748859405518,390,1825,802,2237,412,412,applejack|fluttershy|mane six|pinkie pie|rainbow dash|rarity|twilight sparkle,viwrastupr
893706.png,https://derpicdn.net/img/view/2015/5/11/893706.png,2,0.9449153542518616,2630,2303,3068,2741,438,438,applejack|fluttershy|mane six|pinkie pie|rainbow dash|rarity|twilight sparkle,viwrastupr
8952.png,https://derpicdn.net/img/view/2012/6/19/8952.png,0,0.9537766575813292,903,663,1189,949,286,286,applejack|fluttershy|mane six|pinkie pie|rainbow dash|rarity|twilight sparkle,atryl|siden
8952.png,https://derpicdn.net/img/view/2012/6/19/8952.png,1,0.9348694086074828,97,19,365,287,268,268,applejack|fluttershy|mane six|pinkie pie|rainbow dash|rarity|twilight sparkle,atryl|siden
895217.png,https://derpicdn.net/img/view/2015/5/13/895217.png,0,0.9575906991958618,39,0,569,464,530,464,pinkie pie|princess celestia|twilight sparkle,php41
89670.png,https://derpicdn.net/img/view/2012/9/4/89670.png,0,0.9972151517868042,496,879,912,1295,416,416,princess celestia|princess luna|twilight sparkle,whitecloud72988|aoi takayuki
89670.png,https://derpicdn.net/img/view/2012/9/4/89670.png,1,0.9957579970359802,112,3,598,489,486,486,princess celestia|princess luna|twilight sparkle,whitecloud72988|aoi takayuki
89670.png,https://derpicdn.net/img/view/2012/9/4/89670.png,2,0.944891631603241,315,472,729,886,414,414,princess celestia|princess luna|twilight sparkle,whitecloud72988|aoi takayuki
898954.png,https://derpicdn.net/img/view/2015/5/18/898954.png,0,0.9750316739082336,499,225,1143,869,644,644,rarity|twilight sparkle,ryuseihikari|ponyguy67
900382.png,https://derpicdn.net/img/view/2015/5/20/900382.png,1,0.969865381717682,630,178,1182,730,552,552,rainbow dash|trixie|twilight sparkle,tinker-tock
901622.png,https://derpicdn.net/img/view/2015/5/22/901622.png,0,0.9737924933433532,259,124,509,374,250,250,applejack|twilight sparkle,jowybean
905471.png,https://derpicdn.net/img/view/2015/5/28/905471.png,0,0.9887046813964844,368,136,984,752,616,616,rainbow dash|twilight sparkle,yeendip
905763.png,https://derpicdn.net/img/view/2015/5/28/905763.png,0,0.9946380853652954,416,101,832,517,416,416,rainbow dash|sunset shimmer|twilight sparkle,falleninthedark
906179.png,https://derpicdn.net/img/view/2015/5/29/906179.png,0,0.9588363170623779,307,9,715,417,408,408,applejack|twilight sparkle,jowybean
907641.png,https://derpicdn.net/img/view/2015/5/31/907641.png,0,0.9991156458854676,870,619,1308,1057,438,438,applejack|fluttershy|mane six|pinkie pie|rainbow dash|rarity|twilight sparkle,skitea
907641.png,https://derpicdn.net/img/view/2015/5/31/907641.png,3,0.9602122306823728,626,37,1110,521,484,484,applejack|fluttershy|mane six|pinkie pie|rainbow dash|rarity|twilight sparkle,skitea
907641.png,https://derpicdn.net/img/view/2015/5/31/907641.png,4,0.9273406267166138,1616,310,2214,908,598,598,applejack|fluttershy|mane six|pinkie pie|rainbow dash|rarity|twilight sparkle,skitea
908246.png,https://derpicdn.net/img/view/2015/6/1/908246.png,0,0.9483498930931092,656,60,966,370,310,310,rarity|starlight glimmer|sunset shimmer|trixie|twilight sparkle,riouku
908660.png,https://derpicdn.net/img/view/2015/6/2/908660.png,0,0.9704499840736388,209,0,815,579,606,579,sunset shimmer|trixie|twilight sparkle,ushiro no kukan
908660.png,https://derpicdn.net/img/view/2015/6/2/908660.png,1,0.9594124555587769,577,312,1000,802,423,490,sunset shimmer|trixie|twilight sparkle,ushiro no kukan
911402.png,https://derpicdn.net/img/view/2015/6/6/911402.png,0,0.9911907315254213,133,47,713,627,580,580,applejack|princess celestia|rainbow dash|rarity|twilight sparkle,zoarity
911873.jpg,https://derpicdn.net/img/view/2015/6/6/911873.jpg,0,0.986692190170288,123,1070,1369,2316,1246,1246,spike|twilight sparkle,candylux
911873.jpg,https://derpicdn.net/img/view/2015/6/6/911873.jpg,1,0.9794683456420898,2114,2789,3088,3763,974,974,spike|twilight sparkle,candylux
912377.png,https://derpicdn.net/img/view/2015/6/7/912377.png,0,0.9216006994247437,403,171,719,487,316,316,sunset shimmer|twilight sparkle,ta-na
9130.png,https://derpicdn.net/img/view/2012/6/19/9130.png,0,0.986836314201355,314,649,686,1021,372,372,princess cadance|twilight sparkle,atryl
913226.jpg,https://derpicdn.net/img/view/2015/6/8/913226.jpg,0,0.9955469369888306,688,93,976,381,288,288,applejack|fluttershy|mane six|pinkie pie|rainbow dash|rarity|twilight sparkle,muffinexplosion
913643.png,https://derpicdn.net/img/view/2015/6/9/913643.png,0,0.9849650859832764,911,62,2057,1208,1146,1146,princess cadance|princess celestia|princess luna|twilight sparkle,yakovlev-vad
914151.png,https://derpicdn.net/img/view/2015/6/10/914151.png,0,0.9869875907897948,1683,270,2301,888,618,618,princess cadance|princess celestia|princess luna|twilight sparkle,discosweetruletik
915447.png,https://derpicdn.net/img/view/2015/6/12/915447.png,0,0.9913639426231384,478,0,896,389,418,389,sunset shimmer|twilight sparkle,silbersternenlicht
915883.jpg,https://derpicdn.net/img/view/2015/6/13/915883.jpg,0,0.951516330242157,24,0,478,400,454,400,princess luna|twilight sparkle,aoi takayuki
916332.png,https://derpicdn.net/img/view/2015/6/13/916332.png,0,0.9899540543556212,445,313,645,513,200,200,princess celestia|twilight sparkle,deusexequus
917241.png,https://derpicdn.net/img/view/2015/6/15/917241.png,0,0.9895596504211426,677,359,1800,1527,1123,1168,rainbow dash|twilight sparkle,glacierclear edits|glacierclear|captainpudgemuffin
918625.png,https://derpicdn.net/img/view/2015/6/17/918625.png,0,0.9655911922454834,830,946,1084,1200,254,254,apple bloom|applejack|big macintosh|braeburn|cutie mark crusaders|diamond tiara|fluttershy|granny smith|mane six|pinkie pie|princess cadance|princess celestia|princess luna|rainbow dash|rarity|scootaloo|shining armor|silver spoon|spike|sweetie belle|twilight sparkle,whitediamonds
918887.png,https://derpicdn.net/img/view/2015/6/17/918887.png,0,0.9907774925231934,1172,0,2770,1556,1598,1556,trixie|twilight sparkle,zacatron94
919536.png,https://derpicdn.net/img/view/2015/6/19/919536.png,0,0.9765598177909852,672,499,970,797,298,298,applejack|fluttershy|mane six|pinkie pie|rainbow dash|rarity|twilight sparkle,mousu
921068.png,https://derpicdn.net/img/view/2015/6/21/921068.png,0,0.9922903776168824,84,1503,766,2185,682,682,applejack|discord|fluttershy|mane six|pinkie pie|rainbow dash|rarity|twilight sparkle,elephanteddie
921068.png,https://derpicdn.net/img/view/2015/6/21/921068.png,1,0.9883105754852296,2973,1599,3709,2335,736,736,applejack|discord|fluttershy|mane six|pinkie pie|rainbow dash|rarity|twilight sparkle,elephanteddie
921068.png,https://derpicdn.net/img/view/2015/6/21/921068.png,2,0.9669337272644044,646,1449,1378,2181,732,732,applejack|discord|fluttershy|mane six|pinkie pie|rainbow dash|rarity|twilight sparkle,elephanteddie
921068.png,https://derpicdn.net/img/view/2015/6/21/921068.png,3,0.9495214819908142,1240,1529,1946,2235,706,706,applejack|discord|fluttershy|mane six|pinkie pie|rainbow dash|rarity|twilight sparkle,elephanteddie
921103.png,https://derpicdn.net/img/view/2015/6/21/921103.png,0,0.9544453024864196,354,119,648,413,294,294,princess celestia|princess luna|twilight sparkle,underpable
922271.png,https://derpicdn.net/img/view/2015/6/23/922271.png,0,0.9975655674934388,2361,0,3269,773,908,773,applejack|fluttershy|mane six|pinkie pie|rainbow dash|rarity|twilight sparkle,mistydash
922271.png,https://derpicdn.net/img/view/2015/6/23/922271.png,1,0.9706404805183412,230,19,1190,979,960,960,applejack|fluttershy|mane six|pinkie pie|rainbow dash|rarity|twilight sparkle,mistydash
922879.png,https://derpicdn.net/img/view/2015/6/24/922879.png,0,0.9641824960708618,86,91,738,743,652,652,fluttershy|twilight sparkle,whydomenhavenipples
922924.jpg,https://derpicdn.net/img/view/2015/6/24/922924.jpg,0,0.9988416433334352,1824,82,4188,2446,2364,2364,princess celestia|twilight sparkle,candylux
923100.png,https://derpicdn.net/img/view/2015/6/24/923100.png,0,0.9984229803085328,2632,0,4658,1795,2026,1795,apple bloom|fluttershy|sweetie belle|twilight sparkle,ketticat55
923100.png,https://derpicdn.net/img/view/2015/6/24/923100.png,1,0.9952497482299804,1411,1,2633,1223,1222,1222,apple bloom|fluttershy|sweetie belle|twilight sparkle,ketticat55
923100.png,https://derpicdn.net/img/view/2015/6/24/923100.png,2,0.9889822602272034,996,2001,2034,3039,1038,1038,apple bloom|fluttershy|sweetie belle|twilight sparkle,ketticat55
923100.png,https://derpicdn.net/img/view/2015/6/24/923100.png,3,0.9813626408576964,78,0,796,660,718,660,apple bloom|fluttershy|sweetie belle|twilight sparkle,ketticat55
923100.png,https://derpicdn.net/img/view/2015/6/24/923100.png,4,0.9292576909065248,1877,1330,2787,2240,910,910,apple bloom|fluttershy|sweetie belle|twilight sparkle,ketticat55
923176.jpg,https://derpicdn.net/img/view/2015/6/24/923176.jpg,0,0.9576404690742492,83,89,739,745,656,656,fluttershy|twilight sparkle,whydomenhavenipples
923475.png,https://derpicdn.net/img/view/2015/6/25/923475.png,0,0.997965395450592,769,93,1089,413,320,320,princess cadance|rarity|twilight sparkle,danmakuman
923475.png,https://derpicdn.net/img/view/2015/6/25/923475.png,1,0.9972981214523317,424,67,766,409,342,342,princess cadance|rarity|twilight sparkle,danmakuman
924370.png,https://derpicdn.net/img/view/2015/6/27/924370.png,0,0.9789983034133912,725,755,1501,1531,776,776,fluttershy|pinkie pie|rainbow dash|spike|twilight sparkle,mykegreywolf
928360.jpg,https://derpicdn.net/img/view/2015/7/2/928360.jpg,0,0.9991869330406188,3946,1405,5650,3109,1704,1704,princess celestia|twilight sparkle,candylux
928360.jpg,https://derpicdn.net/img/view/2015/7/2/928360.jpg,1,0.9963385462760924,982,285,2880,2183,1898,1898,princess celestia|twilight sparkle,candylux
928424.png,https://derpicdn.net/img/view/2015/7/2/928424.png,0,0.955888032913208,358,75,676,393,318,318,spike|twilight sparkle,dvixie
928792.png,https://derpicdn.net/img/view/2015/7/3/928792.png,0,0.988466203212738,1267,727,2367,1827,1100,1100,princess celestia|twilight sparkle,bri-sta|wodahseht
929425.png,https://derpicdn.net/img/view/2015/7/4/929425.png,0,0.9932433366775512,609,248,1503,1142,894,894,princess celestia|twilight sparkle,nadnerbd
930953.png,https://derpicdn.net/img/view/2015/7/6/930953.png,0,0.9989094734191896,220,73,454,307,234,234,rainbow dash|twilight sparkle,siden
930953.png,https://derpicdn.net/img/view/2015/7/6/930953.png,1,0.9965234994888306,767,101,1019,353,252,252,rainbow dash|twilight sparkle,siden
931233.png,https://derpicdn.net/img/view/2015/7/6/931233.png,0,0.9876962304115297,775,0,1491,618,716,618,applejack|fluttershy|mane six|pinkie pie|rainbow dash|rarity|twilight sparkle,vavacung
932133.png,https://derpicdn.net/img/view/2015/7/7/932133.png,0,0.999387502670288,376,1013,886,1523,510,510,pinkie pie|twilight sparkle,nekubi
932133.png,https://derpicdn.net/img/view/2015/7/7/932133.png,1,0.9985748529434204,0,24,320,426,320,402,pinkie pie|twilight sparkle,nekubi
933483.png,https://derpicdn.net/img/view/2015/7/9/933483.png,0,0.9095906019210817,0,179,754,1000,754,821,trixie|twilight sparkle,ushiro no kukan
934256.jpg,https://derpicdn.net/img/view/2015/7/10/934256.jpg,0,0.9438259601593018,452,778,860,1186,408,408,princess cadance|princess celestia|princess luna|twilight sparkle,shimizu
934256.jpg,https://derpicdn.net/img/view/2015/7/10/934256.jpg,1,0.9430870413780212,499,384,859,744,360,360,princess cadance|princess celestia|princess luna|twilight sparkle,shimizu
934538.png,https://derpicdn.net/img/view/2015/7/11/934538.png,0,0.994246542453766,947,4,1280,342,333,338,applejack|fluttershy|mane six|pinkie pie|rainbow dash|rarity|twilight sparkle,dshou
934751.png,https://derpicdn.net/img/view/2015/7/11/934751.png,1,0.9941357970237732,0,2713,295,3105,295,392,applejack|big macintosh|discord|fluttershy|mane six|pinkie pie|princess cadance|princess celestia|princess luna|queen chrysalis|rainbow dash|rarity|shining armor|spike|sunset shimmer|trixie|twilight sparkle,braeburned edits|lopoddity|silfoe|mittsies|mn27|badumsquish|ta-na|phurie edits|willisrisque|gatodelfuturo|mrw32|erockertorres|johnjoseco|maren|cherryviolets|b-epon|illuminatiums|slypon|somepony|bakki|jcosneverexisted|phurie|pikkinon|slowcoloringfag|sion-ara|mleonheart|rip|ponchuzn|jinzhan|gsphere|crookedtrees|ambris
934751.png,https://derpicdn.net/img/view/2015/7/11/934751.png,2,0.99034583568573,475,1267,783,1575,308,308,applejack|big macintosh|discord|fluttershy|mane six|pinkie pie|princess cadance|princess celestia|princess luna|queen chrysalis|rainbow dash|rarity|shining armor|spike|sunset shimmer|trixie|twilight sparkle,braeburned edits|lopoddity|silfoe|mittsies|mn27|badumsquish|ta-na|phurie edits|willisrisque|gatodelfuturo|mrw32|erockertorres|johnjoseco|maren|cherryviolets|b-epon|illuminatiums|slypon|somepony|bakki|jcosneverexisted|phurie|pikkinon|slowcoloringfag|sion-ara|mleonheart|rip|ponchuzn|jinzhan|gsphere|crookedtrees|ambris
935410.png,https://derpicdn.net/img/view/2015/7/12/935410.png,0,0.9784836173057556,850,89,2014,1253,1164,1164,rainbow dash|twilight sparkle,captainpudgemuffin
935851.png,https://derpicdn.net/img/view/2015/7/12/935851.png,1,0.9296507239341736,0,42,310,354,310,312,pinkie pie|rarity|shining armor|twilight sparkle,dvixie
935856.png,https://derpicdn.net/img/view/2015/7/12/935856.png,0,0.9886612296104432,989,0,1631,594,642,594,applejack|fluttershy|mane six|pinkie pie|rainbow dash|rarity|shining armor|sunset shimmer|twilight sparkle,dvixie
935856.png,https://derpicdn.net/img/view/2015/7/12/935856.png,2,0.9603624939918518,112,0,640,451,528,451,applejack|fluttershy|mane six|pinkie pie|rainbow dash|rarity|shining armor|sunset shimmer|twilight sparkle,dvixie
937836.png,https://derpicdn.net/img/view/2015/7/16/937836.png,1,0.9883537292480468,261,121,719,579,458,458,applejack|fluttershy|mane six|pinkie pie|rainbow dash|rarity|twilight sparkle,dream--chan
938935.png,https://derpicdn.net/img/view/2015/7/17/938935.png,0,0.9770190119743348,1459,526,1811,878,352,352,fluttershy|rainbow dash|shining armor|twilight sparkle,assasinmonkey
938935.png,https://derpicdn.net/img/view/2015/7/17/938935.png,2,0.9140533804893494,1336,282,1700,646,364,364,fluttershy|rainbow dash|shining armor|twilight sparkle,assasinmonkey
939354.jpg,https://derpicdn.net/img/view/2015/7/18/939354.jpg,0,0.9662023782730104,65,14,1175,1124,1110,1110,sunset shimmer|twilight sparkle,thearcano13
939418.png,https://derpicdn.net/img/view/2015/7/18/939418.png,0,0.9849482774734496,896,344,1650,1098,754,754,rainbow dash|twilight sparkle,captainpudgemuffin
941104.png,https://derpicdn.net/img/view/2015/7/21/941104.png,0,0.9988604784011841,388,404,734,750,346,346,applejack|fluttershy|mane six|pinkie pie|rainbow dash|rarity|twilight sparkle,bobdude0
941104.png,https://derpicdn.net/img/view/2015/7/21/941104.png,1,0.9979909658432008,430,19,746,335,316,316,applejack|fluttershy|mane six|pinkie pie|rainbow dash|rarity|twilight sparkle,bobdude0
941104.png,https://derpicdn.net/img/view/2015/7/21/941104.png,2,0.9966863989830016,306,820,570,1084,264,264,applejack|fluttershy|mane six|pinkie pie|rainbow dash|rarity|twilight sparkle,bobdude0
941104.png,https://derpicdn.net/img/view/2015/7/21/941104.png,3,0.994543194770813,675,800,933,1058,258,258,applejack|fluttershy|mane six|pinkie pie|rainbow dash|rarity|twilight sparkle,bobdude0
941104.png,https://derpicdn.net/img/view/2015/7/21/941104.png,4,0.9828763604164124,95,304,423,632,328,328,applejack|fluttershy|mane six|pinkie pie|rainbow dash|rarity|twilight sparkle,bobdude0
941104.png,https://derpicdn.net/img/view/2015/7/21/941104.png,5,0.9470730423927308,789,357,1075,643,286,286,applejack|fluttershy|mane six|pinkie pie|rainbow dash|rarity|twilight sparkle,bobdude0
941179.jpg,https://derpicdn.net/img/view/2015/7/21/941179.jpg,1,0.9845757484436036,2952,337,3586,971,634,634,applejack|fluttershy|twilight sparkle,tyelle
941287.png,https://derpicdn.net/img/view/2015/7/21/941287.png,0,0.9593015909194946,181,167,421,407,240,240,princess luna|twilight sparkle,turtlefarminguy
941375.png,https://derpicdn.net/img/view/2015/7/22/941375.png,0,0.9758235216140748,492,271,910,689,418,418,princess celestia|twilight sparkle,akeahi
941375.png,https://derpicdn.net/img/view/2015/7/22/941375.png,1,0.9394512176513672,111,31,565,485,454,454,princess celestia|twilight sparkle,akeahi
942733.png,https://derpicdn.net/img/view/2015/7/24/942733.png,0,0.9497619867324828,161,151,327,317,166,166,princess luna|twilight sparkle,lulubell
943159.png,https://derpicdn.net/img/view/2015/7/24/943159.png,0,0.9954172968864441,0,100,408,584,408,484,applejack|fluttershy|mane six|pinkie pie|rainbow dash|rarity|twilight sparkle,pepooni
943159.png,https://derpicdn.net/img/view/2015/7/24/943159.png,2,0.9719895720481871,274,124,704,554,430,430,applejack|fluttershy|mane six|pinkie pie|rainbow dash|rarity|twilight sparkle,pepooni
944396.png,https://derpicdn.net/img/view/2015/7/26/944396.png,0,0.9964558482170104,675,33,1247,605,572,572,princess celestia|sweetie belle|twilight sparkle,viwrastupr|bobdude0
945916.png,https://derpicdn.net/img/view/2015/7/28/945916.png,0,0.9977144002914428,300,15,576,291,276,276,applejack|fluttershy|mane six|pinkie pie|rainbow dash|rarity|twilight sparkle,probablyfakeblonde
947336.png,https://derpicdn.net/img/view/2015/7/30/947336.png,0,0.9987090229988098,548,35,1088,575,540,540,rainbow dash|twilight sparkle,futaku
947751.png,https://derpicdn.net/img/view/2015/7/31/947751.png,0,0.9994603991508484,521,0,927,401,406,401,princess celestia|twilight sparkle,slugbox
947751.png,https://derpicdn.net/img/view/2015/7/31/947751.png,1,0.9562707543373108,189,0,621,391,432,391,princess celestia|twilight sparkle,slugbox
948587.png,https://derpicdn.net/img/view/2015/8/2/948587.png,0,0.983617663383484,46,0,500,442,454,442,princess luna|twilight sparkle,lulubell
948997.png,https://derpicdn.net/img/view/2015/8/2/948997.png,0,0.9956691861152648,910,0,1556,577,646,577,spike|twilight sparkle,hobbsmeerkat
948997.png,https://derpicdn.net/img/view/2015/8/2/948997.png,1,0.9905115962028505,562,209,858,505,296,296,spike|twilight sparkle,hobbsmeerkat
949663.png,https://derpicdn.net/img/view/2015/8/3/949663.png,1,0.9756850600242616,286,0,612,317,326,317,applejack|fluttershy|mane six|pinkie pie|rainbow dash|rarity|sunset shimmer|trixie|twilight sparkle,the-butch-x
949663.png,https://derpicdn.net/img/view/2015/8/3/949663.png,2,0.9622980356216432,595,52,795,252,200,200,applejack|fluttershy|mane six|pinkie pie|rainbow dash|rarity|sunset shimmer|trixie|twilight sparkle,the-butch-x
949663.png,https://derpicdn.net/img/view/2015/8/3/949663.png,3,0.9421324729919434,1168,56,1356,244,188,188,applejack|fluttershy|mane six|pinkie pie|rainbow dash|rarity|sunset shimmer|trixie|twilight sparkle,the-butch-x
949663.png,https://derpicdn.net/img/view/2015/8/3/949663.png,5,0.9225867986679076,360,447,514,601,154,154,applejack|fluttershy|mane six|pinkie pie|rainbow dash|rarity|sunset shimmer|trixie|twilight sparkle,the-butch-x
950572.jpg,https://derpicdn.net/img/view/2015/8/4/950572.jpg,0,0.9924032688140868,374,126,852,604,478,478,rainbow dash|twilight sparkle,pshyzomancer
951896.png,https://derpicdn.net/img/view/2015/8/6/951896.png,0,0.9837582111358644,806,0,2438,1591,1632,1591,trixie|twilight sparkle,alexiy777
952212.jpg,https://derpicdn.net/img/view/2015/8/6/952212.jpg,0,0.9840893745422364,39,1640,693,2294,654,654,fluttershy|twilight sparkle,nikoh
952212.jpg,https://derpicdn.net/img/view/2015/8/6/952212.jpg,1,0.9790591597557068,932,0,2236,1161,1304,1161,fluttershy|twilight sparkle,nikoh
952716.png,https://derpicdn.net/img/view/2015/8/7/952716.png,0,0.964514434337616,125,3318,1709,4902,1584,1584,applejack|discord|fluttershy|mane six|pinkie pie|rainbow dash|rarity|twilight sparkle,mickeymonster|kired25
953824.png,https://derpicdn.net/img/view/2015/8/8/953824.png,0,0.9727928042411804,102,165,864,927,762,762,applejack|fluttershy|pinkie pie|rainbow dash|rarity|starlight glimmer|twilight sparkle,ketticat55
954464.png,https://derpicdn.net/img/view/2015/8/9/954464.png,0,0.9901301860809326,698,77,1472,851,774,774,pinkie pie|twilight sparkle,chromaskunk|bantha
954665.png,https://derpicdn.net/img/view/2015/8/10/954665.png,0,0.9950814843177797,409,65,623,279,214,214,rainbow dash|twilight sparkle,fuzzy_bites
954665.png,https://derpicdn.net/img/view/2015/8/10/954665.png,1,0.9755027890205384,39,49,285,295,246,246,rainbow dash|twilight sparkle,fuzzy_bites
956135.jpg,https://derpicdn.net/img/view/2015/8/12/956135.jpg,1,0.9922404885292052,378,439,634,695,256,256,applejack|fluttershy|mane six|pinkie pie|rainbow dash|rarity|trixie|twilight sparkle,shepherd0821
956159.png,https://derpicdn.net/img/view/2015/8/12/956159.png,1,0.9828274846076964,51,1136,1125,2210,1074,1074,applejack|fluttershy|mane six|pinkie pie|rainbow dash|rarity|twilight sparkle,mricantdraw
956268.png,https://derpicdn.net/img/view/2015/8/12/956268.png,0,0.9844837784767152,1849,602,2729,1482,880,880,princess celestia|twilight sparkle,askbubblelee
956268.png,https://derpicdn.net/img/view/2015/8/12/956268.png,1,0.9510759711265564,232,0,1560,1292,1328,1292,princess celestia|twilight sparkle,askbubblelee
956465.png,https://derpicdn.net/img/view/2015/8/12/956465.png,0,0.9818071722984314,1415,773,2195,1553,780,780,applejack|fluttershy|mane six|pinkie pie|rainbow dash|rarity|spike|twilight sparkle,drawntildawn
957262.png,https://derpicdn.net/img/view/2015/8/13/957262.png,0,0.9620361328125,1312,164,2882,1734,1570,1570,starlight glimmer|twilight sparkle,ponyecho
957263.png,https://derpicdn.net/img/view/2015/8/13/957263.png,0,0.9988645315170288,716,27,2338,1649,1622,1622,starlight glimmer|twilight sparkle,ponyecho
958165.jpg,https://derpicdn.net/img/view/2015/8/15/958165.jpg,0,0.9611145257949828,1605,483,2397,1275,792,792,applejack|fluttershy|mane six|pinkie pie|rainbow dash|rarity|twilight sparkle,greyscaleart
959871.png,https://derpicdn.net/img/view/2015/8/17/959871.png,0,0.9085686206817628,1065,0,1359,245,294,245,applejack|fluttershy|mane six|pinkie pie|princess celestia|rainbow dash|rarity|twilight sparkle,takua770|90sigma|moongazeponies|teentrunks4|ocarina0ftimelord|stabzor|illumnious|antylavx
961672.png,https://derpicdn.net/img/view/2015/8/20/961672.png,0,0.9998338222503662,630,205,1226,801,596,596,trixie|twilight sparkle,audrarius
962405.png,https://derpicdn.net/img/view/2015/8/21/962405.png,0,0.9469841718673706,468,0,626,158,158,158,applejack|twilight sparkle,jowybean
964429.png,https://derpicdn.net/img/view/2015/8/23/964429.png,0,0.9995444416999816,358,23,660,325,302,302,applejack|fluttershy|mane six|pinkie pie|rainbow dash|rarity|twilight sparkle,doekitty
964429.png,https://derpicdn.net/img/view/2015/8/23/964429.png,1,0.9985623359680176,736,162,980,406,244,244,applejack|fluttershy|mane six|pinkie pie|rainbow dash|rarity|twilight sparkle,doekitty
964429.png,https://derpicdn.net/img/view/2015/8/23/964429.png,2,0.9945968985557556,359,569,643,853,284,284,applejack|fluttershy|mane six|pinkie pie|rainbow dash|rarity|twilight sparkle,doekitty
964429.png,https://derpicdn.net/img/view/2015/8/23/964429.png,3,0.9843100905418396,96,596,356,856,260,260,applejack|fluttershy|mane six|pinkie pie|rainbow dash|rarity|twilight sparkle,doekitty
964751.png,https://derpicdn.net/img/view/2015/8/24/964751.png,0,0.9530388712882996,259,319,685,745,426,426,princess cadance|princess celestia|princess luna|twilight sparkle,discosweetruletik
965.png,https://derpicdn.net/img/view/2012/1/20/965.png,0,0.9872466921806335,427,0,675,234,248,234,applejack|fluttershy|mane six|pinkie pie|rainbow dash|rarity|twilight sparkle,brianblackberry
965.png,https://derpicdn.net/img/view/2012/1/20/965.png,2,0.926499366760254,407,287,673,553,266,266,applejack|fluttershy|mane six|pinkie pie|rainbow dash|rarity|twilight sparkle,brianblackberry
967920.png,https://derpicdn.net/img/view/2015/8/29/967920.png,0,0.902825653553009,145,136,421,412,276,276,applejack|fluttershy|mane six|pinkie pie|rainbow dash|rarity|spike|trixie|twilight sparkle,droll3
968692.png,https://derpicdn.net/img/view/2015/8/30/968692.png,0,0.9947784543037416,830,74,1652,896,822,822,sunset shimmer|twilight sparkle,xebck
968692.png,https://derpicdn.net/img/view/2015/8/30/968692.png,1,0.9894726276397704,2896,140,3500,750,604,610,sunset shimmer|twilight sparkle,xebck
968692.png,https://derpicdn.net/img/view/2015/8/30/968692.png,2,0.9563308358192444,209,1050,963,1804,754,754,sunset shimmer|twilight sparkle,xebck
968830.png,https://derpicdn.net/img/view/2015/8/30/968830.png,0,0.9977813959121704,705,323,1303,921,598,598,applejack|trixie|twilight sparkle,audrarius
969368.png,https://derpicdn.net/img/view/2015/8/30/969368.png,0,0.9324509501457214,233,7,500,285,267,278,sunset shimmer|twilight sparkle,rwl
970103.png,https://derpicdn.net/img/view/2015/8/31/970103.png,0,0.9763765931129456,225,57,705,537,480,480,trixie|twilight sparkle,senseidezzy
970854.png,https://derpicdn.net/img/view/2015/9/1/970854.png,0,0.9529923796653748,72,365,404,697,332,332,princess luna|twilight sparkle,theparagon
973062.png,https://derpicdn.net/img/view/2015/9/5/973062.png,0,0.9643369317054749,301,70,829,598,528,528,princess celestia|spike|twilight sparkle,dsana
974118.png,https://derpicdn.net/img/view/2015/9/6/974118.png,2,0.9057844281196594,336,11,658,333,322,322,apple bloom|applejack|fluttershy|mane six|pinkie pie|rainbow dash|rarity|sweetie belle|twilight sparkle,aruurara
975296.png,https://derpicdn.net/img/view/2015/9/8/975296.png,0,0.9993034601211548,399,0,889,478,490,478,applejack|discord|fluttershy|mane six|pinkie pie|rainbow dash|rarity|twilight sparkle,meekcheep
975296.png,https://derpicdn.net/img/view/2015/9/8/975296.png,1,0.9939898848533628,495,455,915,875,420,420,applejack|discord|fluttershy|mane six|pinkie pie|rainbow dash|rarity|twilight sparkle,meekcheep
975302.jpg,https://derpicdn.net/img/view/2015/9/8/975302.jpg,0,0.9687252044677734,192,0,776,573,584,573,trixie|twilight sparkle,rainiitan
97532.png,https://derpicdn.net/img/view/2012/9/13/97532.png,0,0.9848263263702391,393,0,589,176,196,176,applejack|fluttershy|mane six|pinkie pie|rainbow dash|rarity|trixie|twilight sparkle,berrypawnch
97532.png,https://derpicdn.net/img/view/2012/9/13/97532.png,1,0.9215980172157288,101,556,295,750,194,194,applejack|fluttershy|mane six|pinkie pie|rainbow dash|rarity|trixie|twilight sparkle,berrypawnch
975771.png,https://derpicdn.net/img/view/2015/9/9/975771.png,1,0.9990623593330384,743,74,1101,432,358,358,princess cadance|rarity|twilight sparkle,danmakuman|ponyguy67
976315.jpg,https://derpicdn.net/img/view/2015/9/9/976315.jpg,0,0.9963228702545166,605,352,771,518,166,166,apple bloom|applejack|big macintosh|cutie mark crusaders|discord|fluttershy|mane six|pinkie pie|princess cadance|princess celestia|princess luna|queen chrysalis|rainbow dash|rarity|scootaloo|shining armor|sunset shimmer|sweetie belle|trixie|twilight sparkle,mmishee
976315.jpg,https://derpicdn.net/img/view/2015/9/9/976315.jpg,1,0.9865128397941588,245,25,411,191,166,166,apple bloom|applejack|big macintosh|cutie mark crusaders|discord|fluttershy|mane six|pinkie pie|princess cadance|princess celestia|princess luna|queen chrysalis|rainbow dash|rarity|scootaloo|shining armor|sunset shimmer|sweetie belle|trixie|twilight sparkle,mmishee
976315.jpg,https://derpicdn.net/img/view/2015/9/9/976315.jpg,2,0.978877604007721,244,634,428,818,184,184,apple bloom|applejack|big macintosh|cutie mark crusaders|discord|fluttershy|mane six|pinkie pie|princess cadance|princess celestia|princess luna|queen chrysalis|rainbow dash|rarity|scootaloo|shining armor|sunset shimmer|sweetie belle|trixie|twilight sparkle,mmishee
976315.jpg,https://derpicdn.net/img/view/2015/9/9/976315.jpg,3,0.9747018218040466,26,12,224,210,198,198,apple bloom|applejack|big macintosh|cutie mark crusaders|discord|fluttershy|mane six|pinkie pie|princess cadance|princess celestia|princess luna|queen chrysalis|rainbow dash|rarity|scootaloo|shining armor|sunset shimmer|sweetie belle|trixie|twilight sparkle,mmishee
976315.jpg,https://derpicdn.net/img/view/2015/9/9/976315.jpg,4,0.96716970205307,780,924,974,1118,194,194,apple bloom|applejack|big macintosh|cutie mark crusaders|discord|fluttershy|mane six|pinkie pie|princess cadance|princess celestia|princess luna|queen chrysalis|rainbow dash|rarity|scootaloo|shining armor|sunset shimmer|sweetie belle|trixie|twilight sparkle,mmishee
976315.jpg,https://derpicdn.net/img/view/2015/9/9/976315.jpg,5,0.9304340481758118,754,335,912,493,158,158,apple bloom|applejack|big macintosh|cutie mark crusaders|discord|fluttershy|mane six|pinkie pie|princess cadance|princess celestia|princess luna|queen chrysalis|rainbow dash|rarity|scootaloo|shining armor|sunset shimmer|sweetie belle|trixie|twilight sparkle,mmishee
977013.png,https://derpicdn.net/img/view/2015/9/11/977013.png,0,0.9998492002487184,23,117,1333,1427,1310,1310,rainbow dash|twilight sparkle,hobbes-maxwell
977013.png,https://derpicdn.net/img/view/2015/9/11/977013.png,1,0.9994160532951356,1275,35,2727,1487,1452,1452,rainbow dash|twilight sparkle,hobbes-maxwell
977222.png,https://derpicdn.net/img/view/2015/9/11/977222.png,0,0.9591792225837708,85,44,313,272,228,228,applejack|fluttershy|mane six|pinkie pie|princess cadance|rainbow dash|rarity|shining armor|spike|twilight sparkle,dm29
978866.png,https://derpicdn.net/img/view/2015/9/13/978866.png,0,0.9887076020240784,469,1753,811,2095,342,342,apple bloom|applejack|babs seed|big macintosh|cutie mark crusaders|fluttershy|granny smith|mane six|pinkie pie|princess cadance|princess celestia|princess luna|rainbow dash|rarity|scootaloo|shining armor|sweetie belle|twilight sparkle,aquagalaxy
982422.png,https://derpicdn.net/img/view/2015/9/18/982422.png,0,0.943873405456543,188,467,388,667,200,200,pinkie pie|rarity|trixie|twilight sparkle,skyeypony
982422.png,https://derpicdn.net/img/view/2015/9/18/982422.png,1,0.920243501663208,386,453,590,657,204,204,pinkie pie|rarity|trixie|twilight sparkle,skyeypony
984671.png,https://derpicdn.net/img/view/2015/9/21/984671.png,0,0.9722009897232056,400,40,1104,744,704,704,princess cadance|twilight sparkle,fluffyxai
985319.png,https://derpicdn.net/img/view/2015/9/22/985319.png,1,0.9443835616111756,180,98,884,802,704,704,applejack|fluttershy|mane six|pinkie pie|rainbow dash|rarity|spike|sunset shimmer|twilight sparkle,deannart
985679.png,https://derpicdn.net/img/view/2015/9/22/985679.png,0,0.9717090725898744,43,445,771,1173,728,728,sunset shimmer|twilight sparkle,thegreatrouge
988552.png,https://derpicdn.net/img/view/2015/9/26/988552.png,0,0.9985174536705016,1861,145,3043,1327,1182,1182,princess celestia|twilight sparkle,bri-sta|wodahseht
988709.png,https://derpicdn.net/img/view/2015/9/27/988709.png,0,0.9566951990127563,181,350,293,462,112,112,applejack|fluttershy|pinkie pie|rainbow dash|rarity|sunset shimmer|twilight sparkle,
988749.jpg,https://derpicdn.net/img/view/2015/9/27/988749.jpg,0,0.9740557670593262,1224,62,1790,628,566,566,princess cadance|princess celestia|princess luna|twilight sparkle,silfoe
988749.jpg,https://derpicdn.net/img/view/2015/9/27/988749.jpg,1,0.9471670389175416,798,528,1484,1214,686,686,princess cadance|princess celestia|princess luna|twilight sparkle,silfoe
991700.png,https://derpicdn.net/img/view/2015/9/30/991700.png,0,0.9990639686584472,51,0,595,541,544,541,spike|twilight sparkle,arnachy
993206.png,https://derpicdn.net/img/view/2015/10/3/993206.png,0,0.9862461686134338,534,364,722,552,188,188,applejack|twilight sparkle,jowybean
993764.png,https://derpicdn.net/img/view/2015/10/3/993764.png,0,0.9997279047966005,976,284,1264,572,288,288,apple bloom|big macintosh|cutie mark crusaders|fluttershy|rainbow dash|scootaloo|shining armor|sweetie belle|twilight sparkle,dm29
993851.png,https://derpicdn.net/img/view/2015/10/3/993851.png,0,0.9717515110969543,95,490,353,748,258,258,starlight glimmer|sunset shimmer|twilight sparkle,breezyblueyt
996706.png,https://derpicdn.net/img/view/2015/10/7/996706.png,0,0.9200498461723328,472,2460,1026,3014,554,554,pinkie pie|rainbow dash|twilight sparkle,jittery-the-dragon
997021.png,https://derpicdn.net/img/view/2015/10/8/997021.png,0,0.9955552816390992,881,462,1963,1544,1082,1082,spike|twilight sparkle,skybounddeos|wodahseht
997021.png,https://derpicdn.net/img/view/2015/10/8/997021.png,1,0.9897216558456421,1947,132,2655,840,708,708,spike|twilight sparkle,skybounddeos|wodahseht
997408.png,https://derpicdn.net/img/view/2015/10/8/997408.png,0,0.9521727561950684,346,157,954,765,608,608,applejack|fluttershy|mane six|pinkie pie|princess cadance|princess celestia|princess luna|rainbow dash|rarity|shining armor|twilight sparkle,underpable|lunicmlp
998070.png,https://derpicdn.net/img/view/2015/10/9/998070.png,0,0.9667671322822572,253,83,565,395,312,312,applejack|twilight sparkle,jowybean
998070.png,https://derpicdn.net/img/view/2015/10/9/998070.png,1,0.955021321773529,504,88,846,430,342,342,applejack|twilight sparkle,jowybean
998608.png,https://derpicdn.net/img/view/2015/10/10/998608.png,0,0.9992274045944214,675,63,955,343,280,280,applejack|fluttershy|mane six|pinkie pie|rainbow dash|rarity|twilight sparkle,ushiro no kukan
998608.png,https://derpicdn.net/img/view/2015/10/10/998608.png,2,0.981367290019989,692,399,1000,727,308,328,applejack|fluttershy|mane six|pinkie pie|rainbow dash|rarity|twilight sparkle,ushiro no kukan
998608.png,https://derpicdn.net/img/view/2015/10/10/998608.png,3,0.9643104076385498,365,358,659,652,294,294,applejack|fluttershy|mane six|pinkie pie|rainbow dash|rarity|twilight sparkle,ushiro no kukan
998687.png,https://derpicdn.net/img/view/2015/10/10/998687.png,0,0.99973064661026,700,141,1072,513,372,372,applejack|fluttershy|mane six|pinkie pie|rainbow dash|rarity|twilight sparkle,sion-ara
998687.png,https://derpicdn.net/img/view/2015/10/10/998687.png,1,0.9867523312568665,308,510,574,776,266,266,applejack|fluttershy|mane six|pinkie pie|rainbow dash|rarity|twilight sparkle,sion-ara
998687.png,https://derpicdn.net/img/view/2015/10/10/998687.png,2,0.9827253222465516,863,490,1209,836,346,346,applejack|fluttershy|mane six|pinkie pie|rainbow dash|rarity|twilight sparkle,sion-ara
998687.png,https://derpicdn.net/img/view/2015/10/10/998687.png,3,0.964203715324402,570,442,864,736,294,294,applejack|fluttershy|mane six|pinkie pie|rainbow dash|rarity|twilight sparkle,sion-ara
998687.png,https://derpicdn.net/img/view/2015/10/10/998687.png,4,0.915438950061798,671,634,975,938,304,304,applejack|fluttershy|mane six|pinkie pie|rainbow dash|rarity|twilight sparkle,sion-ara
999533.png,https://derpicdn.net/img/view/2015/10/11/999533.png,0,0.9736105799674988,527,21,1803,1297,1276,1276,apple bloom|cutie mark crusaders|diamond tiara|scootaloo|silver spoon|sweetie belle|twilight sparkle,noben
1002218.png,https://derpicdn.net/img/view/2015/10/14/1002218.png,1,0.9909443855285645,511,725,779,993,268,268,applejack|fluttershy|mane six|pinkie pie|rainbow dash|rarity|twilight sparkle,king-kakapo
1002478.png,https://derpicdn.net/img/view/2015/10/15/1002478.png,0,0.9931923151016236,623,75,869,321,246,246,apple bloom|big macintosh|shining armor|twilight sparkle,dm29
1004751.png,https://derpicdn.net/img/view/2015/10/18/1004751.png,0,0.9445391893386841,639,107,1311,779,672,672,princess cadance|shining armor|twilight sparkle,
1005598.png,https://derpicdn.net/img/view/2015/10/19/1005598.png,0,0.9279836416244508,139,0,383,243,244,243,rainbow dash|twilight sparkle,kona1025
1005994.png,https://derpicdn.net/img/view/2015/10/19/1005994.png,0,0.9990552663803101,1609,864,2137,1392,528,528,apple bloom|applejack|cutie mark crusaders|diamond tiara|fluttershy|mane six|pinkie pie|rainbow dash|rarity|scootaloo|silver spoon|spike|sweetie belle|twilight sparkle,capt-nemo
1005994.png,https://derpicdn.net/img/view/2015/10/19/1005994.png,1,0.9676707983016968,2113,1086,2553,1526,440,440,apple bloom|applejack|cutie mark crusaders|diamond tiara|fluttershy|mane six|pinkie pie|rainbow dash|rarity|scootaloo|silver spoon|spike|sweetie belle|twilight sparkle,capt-nemo
10064.jpg,https://derpicdn.net/img/view/2012/6/19/10064.jpg,0,0.9298702478408812,315,1160,757,1602,442,442,applejack|twilight sparkle,another-story-2tell
1006615.jpg,https://derpicdn.net/img/view/2015/10/20/1006615.jpg,0,0.9904467463493348,365,713,949,1297,584,584,princess cadance|shining armor|twilight sparkle,
1009571.png,https://derpicdn.net/img/view/2015/10/25/1009571.png,0,0.9871386289596558,244,553,522,831,278,278,applejack|fluttershy|mane six|pinkie pie|rainbow dash|rarity|twilight sparkle,jessesmash32
1009571.png,https://derpicdn.net/img/view/2015/10/25/1009571.png,1,0.9831547141075134,603,186,897,480,294,294,applejack|fluttershy|mane six|pinkie pie|rainbow dash|rarity|twilight sparkle,jessesmash32
1009571.png,https://derpicdn.net/img/view/2015/10/25/1009571.png,2,0.9656093120574952,618,499,984,865,366,366,applejack|fluttershy|mane six|pinkie pie|rainbow dash|rarity|twilight sparkle,jessesmash32
1009795.jpg,https://derpicdn.net/img/view/2015/10/25/1009795.jpg,0,0.995732307434082,332,410,693,796,361,386,applejack|fluttershy|mane six|pinkie pie|rainbow dash|rarity|spike|twilight sparkle,andypriceart
1011339.png,https://derpicdn.net/img/view/2015/10/28/1011339.png,0,0.9588255286216736,571,62,863,354,292,292,princess cadance|princess celestia|princess luna|twilight sparkle,9seconds
1012809.png,https://derpicdn.net/img/view/2015/10/30/1012809.png,0,0.9578658938407898,137,426,371,660,234,234,applejack|discord|fluttershy|mane six|pinkie pie|rainbow dash|rarity|spike|twilight sparkle,inuhoshi-to-darkpen
1013021.png,https://derpicdn.net/img/view/2015/10/31/1013021.png,1,0.9985655546188354,274,354,584,664,310,310,applejack|fluttershy|mane six|pinkie pie|rainbow dash|rarity|twilight sparkle,mkogwheel
1013021.png,https://derpicdn.net/img/view/2015/10/31/1013021.png,2,0.965963900089264,493,351,845,703,352,352,applejack|fluttershy|mane six|pinkie pie|rainbow dash|rarity|twilight sparkle,mkogwheel
1013021.png,https://derpicdn.net/img/view/2015/10/31/1013021.png,3,0.951766073703766,669,63,1017,411,348,348,applejack|fluttershy|mane six|pinkie pie|rainbow dash|rarity|twilight sparkle,mkogwheel
1013021.png,https://derpicdn.net/img/view/2015/10/31/1013021.png,4,0.9497883319854736,77,440,363,726,286,286,applejack|fluttershy|mane six|pinkie pie|rainbow dash|rarity|twilight sparkle,mkogwheel
1013408.png,https://derpicdn.net/img/view/2015/10/31/1013408.png,0,0.9584043025970459,678,592,1125,1114,447,522,applejack|fluttershy|mane six|pinkie pie|rainbow dash|rarity|twilight sparkle,esuka
1014171.png,https://derpicdn.net/img/view/2015/11/1/1014171.png,0,0.9674879908561708,3231,325,5779,2873,2548,2548,princess cadance|princess celestia|princess luna|twilight sparkle,osipush
1014685.png,https://derpicdn.net/img/view/2015/11/2/1014685.png,0,0.988052248954773,2144,309,4458,2623,2314,2314,pinkie pie|twilight sparkle,darkflame75
1015496.png,https://derpicdn.net/img/view/2015/11/3/1015496.png,0,0.9834544062614441,353,268,741,656,388,388,applejack|fluttershy|mane six|pinkie pie|rainbow dash|rarity|twilight sparkle,sourcherry
1015879.png,https://derpicdn.net/img/view/2015/11/4/1015879.png,0,0.9934045672416688,88,55,628,595,540,540,sunset shimmer|twilight sparkle,puffpink
1017797.jpg,https://derpicdn.net/img/view/2015/11/7/1017797.jpg,0,0.999657154083252,1402,385,2000,1011,598,626,starlight glimmer|trixie|twilight sparkle,cihiiro
1017797.jpg,https://derpicdn.net/img/view/2015/11/7/1017797.jpg,1,0.9966740608215332,0,329,682,1017,682,688,starlight glimmer|trixie|twilight sparkle,cihiiro
1018118.png,https://derpicdn.net/img/view/2015/11/7/1018118.png,0,0.9105754494667052,954,8,1804,858,850,850,discord|twilight sparkle,
1022015.png,https://derpicdn.net/img/view/2015/11/13/1022015.png,0,0.9990682601928712,2050,1880,3112,2942,1062,1062,applejack|pinkie pie|rainbow dash|rarity|soarin'|starlight glimmer|trixie|twilight sparkle,rarityforever
1022015.png,https://derpicdn.net/img/view/2015/11/13/1022015.png,1,0.9961506128311156,242,95,1392,1245,1150,1150,applejack|pinkie pie|rainbow dash|rarity|soarin'|starlight glimmer|trixie|twilight sparkle,rarityforever
1022015.png,https://derpicdn.net/img/view/2015/11/13/1022015.png,2,0.9947100877761841,3539,0,4741,1192,1202,1192,applejack|pinkie pie|rainbow dash|rarity|soarin'|starlight glimmer|trixie|twilight sparkle,rarityforever
1022835.png,https://derpicdn.net/img/view/2015/11/14/1022835.png,0,0.9910468459129332,903,780,1369,1246,466,466,fluttershy|twilight sparkle,esuka
1023058.png,https://derpicdn.net/img/view/2015/11/15/1023058.png,0,0.9177934527397156,4862,1099,6024,2261,1162,1162,fluttershy|twilight sparkle,bluethunder66
1023088.png,https://derpicdn.net/img/view/2015/11/15/1023088.png,0,0.9966970086097716,580,313,992,725,412,412,fluttershy|twilight sparkle,
1023088.png,https://derpicdn.net/img/view/2015/11/15/1023088.png,1,0.9645491242408752,1666,1456,1970,1760,304,304,fluttershy|twilight sparkle,
1023088.png,https://derpicdn.net/img/view/2015/11/15/1023088.png,2,0.9528767466545104,1293,385,1713,805,420,420,fluttershy|twilight sparkle,
1023597.png,https://derpicdn.net/img/view/2015/11/15/1023597.png,1,0.9903561472892758,682,71,994,383,312,312,applejack|discord|fluttershy|pinkie pie|rainbow dash|rarity|spike|twilight sparkle,salvicorn
1023597.png,https://derpicdn.net/img/view/2015/11/15/1023597.png,2,0.9791538715362548,0,477,354,837,354,360,applejack|discord|fluttershy|pinkie pie|rainbow dash|rarity|spike|twilight sparkle,salvicorn
1023597.png,https://derpicdn.net/img/view/2015/11/15/1023597.png,3,0.9522251486778259,46,0,570,524,524,524,applejack|discord|fluttershy|pinkie pie|rainbow dash|rarity|spike|twilight sparkle,salvicorn
1025892.png,https://derpicdn.net/img/view/2015/11/19/1025892.png,0,0.9600568413734436,894,583,1978,1667,1084,1084,rainbow dash|twilight sparkle,jp
1027551.png,https://derpicdn.net/img/view/2015/11/22/1027551.png,0,0.951945424079895,5,23,815,833,810,810,starlight glimmer|twilight sparkle,bojo
1027936.png,https://derpicdn.net/img/view/2015/11/22/1027936.png,2,0.948861837387085,691,485,973,767,282,282,applejack|discord|fluttershy|mane six|pinkie pie|rainbow dash|rarity|soarin'|spike|twilight sparkle,bluesidearts
1029483.png,https://derpicdn.net/img/view/2015/11/24/1029483.png,0,0.9378508925437928,146,789,726,1369,580,580,trixie|twilight sparkle,pilla
1030967.png,https://derpicdn.net/img/view/2015/11/27/1030967.png,0,0.9901821613311768,0,226,508,886,508,660,applejack|fluttershy|mane six|pinkie pie|rainbow dash|rarity|twilight sparkle,lumineko
1030967.png,https://derpicdn.net/img/view/2015/11/27/1030967.png,1,0.9372135996818542,390,275,898,783,508,508,applejack|fluttershy|mane six|pinkie pie|rainbow dash|rarity|twilight sparkle,lumineko
1033415.png,https://derpicdn.net/img/view/2015/11/29/1033415.png,0,0.9980418682098388,4795,710,6665,2580,1870,1870,applejack|fluttershy|mane six|pinkie pie|rainbow dash|rarity|starlight glimmer|twilight sparkle,emera33
1033415.png,https://derpicdn.net/img/view/2015/11/29/1033415.png,1,0.9947544932365416,1612,2360,3344,4092,1732,1732,applejack|fluttershy|mane six|pinkie pie|rainbow dash|rarity|starlight glimmer|twilight sparkle,emera33
1033415.png,https://derpicdn.net/img/view/2015/11/29/1033415.png,2,0.9591913819313048,4538,2514,6040,4016,1502,1502,applejack|fluttershy|mane six|pinkie pie|rainbow dash|rarity|starlight glimmer|twilight sparkle,emera33
1033415.png,https://derpicdn.net/img/view/2015/11/29/1033415.png,3,0.9036716222763062,1559,0,3407,1800,1848,1800,applejack|fluttershy|mane six|pinkie pie|rainbow dash|rarity|starlight glimmer|twilight sparkle,emera33
1033434.png,https://derpicdn.net/img/view/2015/11/29/1033434.png,0,0.9889395833015442,1193,225,1665,697,472,472,starlight glimmer|twilight sparkle,mlp-firefox5013
1033768.jpg,https://derpicdn.net/img/view/2015/11/30/1033768.jpg,1,0.9898751974105836,0,592,397,1018,397,426,applejack|discord|fluttershy|mane six|pinkie pie|queen chrysalis|rainbow dash|rarity|spike|trixie|twilight sparkle,andypriceart|vest
1033768.jpg,https://derpicdn.net/img/view/2015/11/30/1033768.jpg,2,0.9661310315132141,946,856,1368,1278,422,422,applejack|discord|fluttershy|mane six|pinkie pie|queen chrysalis|rainbow dash|rarity|spike|trixie|twilight sparkle,andypriceart|vest
1033768.jpg,https://derpicdn.net/img/view/2015/11/30/1033768.jpg,3,0.9481618404388428,129,15,573,459,444,444,applejack|discord|fluttershy|mane six|pinkie pie|queen chrysalis|rainbow dash|rarity|spike|trixie|twilight sparkle,andypriceart|vest
1033770.jpg,https://derpicdn.net/img/view/2015/11/30/1033770.jpg,1,0.9966378808021544,37,1350,427,1740,390,390,applejack|discord|fluttershy|mane six|pinkie pie|queen chrysalis|rainbow dash|rarity|spike|starlight glimmer|twilight sparkle,novaspark|andypriceart
1033770.jpg,https://derpicdn.net/img/view/2015/11/30/1033770.jpg,2,0.9426777362823486,567,153,971,557,404,404,applejack|discord|fluttershy|mane six|pinkie pie|queen chrysalis|rainbow dash|rarity|spike|starlight glimmer|twilight sparkle,novaspark|andypriceart
1033770.jpg,https://derpicdn.net/img/view/2015/11/30/1033770.jpg,3,0.9250631928443908,979,626,1327,974,348,348,applejack|discord|fluttershy|mane six|pinkie pie|queen chrysalis|rainbow dash|rarity|spike|starlight glimmer|twilight sparkle,novaspark|andypriceart
1033898.png,https://derpicdn.net/img/view/2015/11/30/1033898.png,0,0.9553577303886414,1597,0,1920,395,323,395,discord|princess celestia|queen chrysalis|rainbow dash|spike|starlight glimmer|twilight sparkle,jbond
1034005.jpg,https://derpicdn.net/img/view/2015/11/30/1034005.jpg,0,0.9700063467025756,62,0,328,265,266,265,shining armor|twilight sparkle,azurepicker
1034019.jpg,https://derpicdn.net/img/view/2015/11/30/1034019.jpg,0,0.994441032409668,473,396,923,846,450,450,applejack|fluttershy|mane six|pinkie pie|rainbow dash|rarity|spike|twilight sparkle,sugarcubecake
1034190.png,https://derpicdn.net/img/view/2015/12/1/1034190.png,0,0.9722866415977478,0,2965,1783,4933,1783,1968,applejack|fluttershy|mane six|pinkie pie|rainbow dash|rarity|spike|starlight glimmer|twilight sparkle,soren-the-owl
1034405.png,https://derpicdn.net/img/view/2015/12/1/1034405.png,0,0.9955152273178101,0,0,475,445,475,445,fluttershy|twilight sparkle,dm29
1034605.png,https://derpicdn.net/img/view/2015/12/1/1034605.png,0,0.9973184466362,2502,175,3576,1249,1074,1074,princess cadance|princess celestia|princess luna|twilight sparkle,megarainbowdash2000
1034737.png,https://derpicdn.net/img/view/2015/12/1/1034737.png,0,0.9883463382720948,143,93,797,747,654,654,starlight glimmer|twilight sparkle,lytschi
1035875.png,https://derpicdn.net/img/view/2015/12/3/1035875.png,0,0.9979034662246704,1229,133,1561,465,332,332,rainbow dash|twilight sparkle,loukaina
1035875.png,https://derpicdn.net/img/view/2015/12/3/1035875.png,1,0.9943848252296448,557,15,1157,615,600,600,rainbow dash|twilight sparkle,loukaina
1036677.png,https://derpicdn.net/img/view/2015/12/4/1036677.png,0,0.9281412363052368,332,311,590,569,258,258,applejack|princess celestia|twilight sparkle,jowybean
1038457.png,https://derpicdn.net/img/view/2015/12/6/1038457.png,0,0.9408925771713256,3363,657,4317,1611,954,954,applejack|fluttershy|mane six|pinkie pie|rainbow dash|rarity|sunset shimmer|twilight sparkle,drawntildawn
1038501.png,https://derpicdn.net/img/view/2015/12/6/1038501.png,0,0.9672130346298218,424,49,672,297,248,248,starlight glimmer|twilight sparkle,naminzo
1038501.png,https://derpicdn.net/img/view/2015/12/6/1038501.png,1,0.9487048387527466,249,89,447,287,198,198,starlight glimmer|twilight sparkle,naminzo
1039775.png,https://derpicdn.net/img/view/2015/12/8/1039775.png,0,0.9772025942802428,1347,33,2249,935,902,902,applejack|fluttershy|mane six|pinkie pie|rainbow dash|rarity|starlight glimmer|twilight sparkle,vanillaghosties
1039807.png,https://derpicdn.net/img/view/2015/12/8/1039807.png,0,0.9935432672500608,487,0,2337,1776,1850,1776,sunset shimmer|twilight sparkle,mixiepie
1039807.png,https://derpicdn.net/img/view/2015/12/8/1039807.png,1,0.9838507175445556,2472,50,4144,1722,1672,1672,sunset shimmer|twilight sparkle,mixiepie
1040385.png,https://derpicdn.net/img/view/2015/12/9/1040385.png,0,0.9996077418327332,433,314,803,684,370,370,trixie|twilight sparkle,cherivinca
1040385.png,https://derpicdn.net/img/view/2015/12/9/1040385.png,1,0.978788197040558,224,334,546,656,322,322,trixie|twilight sparkle,cherivinca
104079.jpg,https://derpicdn.net/img/view/2012/9/22/104079.jpg,0,0.994152307510376,893,90,1855,1052,962,962,pinkie pie|twilight sparkle,mysticalpha
1041045.png,https://derpicdn.net/img/view/2015/12/10/1041045.png,0,0.964318573474884,383,277,905,799,522,522,applejack|fluttershy|mane six|pinkie pie|rainbow dash|rarity|twilight sparkle,lumineko
1041045.png,https://derpicdn.net/img/view/2015/12/10/1041045.png,1,0.948268711566925,0,299,417,777,417,478,applejack|fluttershy|mane six|pinkie pie|rainbow dash|rarity|twilight sparkle,lumineko
1041219.png,https://derpicdn.net/img/view/2015/12/10/1041219.png,0,0.9970806837081908,390,0,976,578,586,578,applejack|pinkie pie|twilight sparkle,tunairs
1041963.jpg,https://derpicdn.net/img/view/2015/12/11/1041963.jpg,0,0.9996883869171144,1134,545,2482,1893,1348,1348,applejack|fluttershy|pinkie pie|princess luna|rainbow dash|spitfire|trixie|twilight sparkle,captainhoers
1043435.png,https://derpicdn.net/img/view/2015/12/13/1043435.png,0,0.9903595447540284,1721,1190,2375,1844,654,654,applejack|fluttershy|mane six|pinkie pie|rainbow dash|rarity|twilight sparkle,alexdealey
1043435.png,https://derpicdn.net/img/view/2015/12/13/1043435.png,1,0.9887088537216188,694,1266,1190,1762,496,496,applejack|fluttershy|mane six|pinkie pie|rainbow dash|rarity|twilight sparkle,alexdealey
1043435.png,https://derpicdn.net/img/view/2015/12/13/1043435.png,2,0.9841982126235962,2349,1334,2819,1804,470,470,applejack|fluttershy|mane six|pinkie pie|rainbow dash|rarity|twilight sparkle,alexdealey
1043435.png,https://derpicdn.net/img/view/2015/12/13/1043435.png,3,0.9368609189987184,3135,1327,3663,1855,528,528,applejack|fluttershy|mane six|pinkie pie|rainbow dash|rarity|twilight sparkle,alexdealey
1043522.png,https://derpicdn.net/img/view/2015/12/13/1043522.png,0,0.9765356779098512,129,116,1024,1060,895,944,queen chrysalis|twilight sparkle,blah23z
1043635.png,https://derpicdn.net/img/view/2015/12/13/1043635.png,0,0.9917595982551576,282,188,478,384,196,196,starlight glimmer|sunset shimmer|trixie|twilight sparkle,moony-art
1043635.png,https://derpicdn.net/img/view/2015/12/13/1043635.png,1,0.9607389569282532,487,156,757,426,270,270,starlight glimmer|sunset shimmer|trixie|twilight sparkle,moony-art
1043647.png,https://derpicdn.net/img/view/2015/12/13/1043647.png,0,0.9951146841049194,295,218,643,566,348,348,fluttershy|rainbow dash|twilight sparkle,lightningflame
1043647.png,https://derpicdn.net/img/view/2015/12/13/1043647.png,1,0.9884727597236632,13,237,333,557,320,320,fluttershy|rainbow dash|twilight sparkle,lightningflame
1044782.png,https://derpicdn.net/img/view/2015/12/15/1044782.png,0,0.9993731379508972,2121,683,3083,1645,962,962,starlight glimmer|twilight sparkle,nutkicker12
1045190.png,https://derpicdn.net/img/view/2015/12/15/1045190.png,0,0.982765018939972,475,137,1151,813,676,676,starlight glimmer|twilight sparkle,dr-whiskey
1045690.png,https://derpicdn.net/img/view/2015/12/16/1045690.png,0,0.9859800338745116,142,51,446,355,304,304,rainbow dash|spike|twilight sparkle,suenden-hund
1045690.png,https://derpicdn.net/img/view/2015/12/16/1045690.png,1,0.9858401417732242,492,0,842,342,350,342,rainbow dash|spike|twilight sparkle,suenden-hund
1046266.jpg,https://derpicdn.net/img/view/2015/12/17/1046266.jpg,1,0.9235031604766846,1170,856,1596,1282,426,426,trixie|twilight sparkle,vadkaart
1046365.png,https://derpicdn.net/img/view/2015/12/17/1046365.png,1,0.9607285857200624,48,182,450,584,402,402,princess luna|twilight sparkle,dfectivedvice|jubileeglider
1048771.png,https://derpicdn.net/img/view/2015/12/20/1048771.png,0,0.979405403137207,57,5,359,307,302,302,princess luna|twilight sparkle,goat train
1049578.jpg,https://derpicdn.net/img/view/2015/12/21/1049578.jpg,0,0.9822736978530884,1365,0,2173,636,808,636,rainbow dash|twilight sparkle,cosmonaut
1049584.jpg,https://derpicdn.net/img/view/2015/12/21/1049584.jpg,0,0.9995384812355042,1713,0,2900,966,1187,966,rainbow dash|twilight sparkle,cosmonaut
1049749.png,https://derpicdn.net/img/view/2015/12/21/1049749.png,0,0.9840994477272034,291,728,491,928,200,200,applejack|fluttershy|mane six|pinkie pie|rainbow dash|rarity|twilight sparkle,christadoodles
1051126.png,https://derpicdn.net/img/view/2015/12/23/1051126.png,0,0.9954899549484252,287,167,529,409,242,242,applejack|fluttershy|mane six|pinkie pie|rainbow dash|rarity|starlight glimmer|sunset shimmer|twilight sparkle,riouku
1051126.png,https://derpicdn.net/img/view/2015/12/23/1051126.png,1,0.9643747210502625,534,467,806,739,272,272,applejack|fluttershy|mane six|pinkie pie|rainbow dash|rarity|starlight glimmer|sunset shimmer|twilight sparkle,riouku
1051981.png,https://derpicdn.net/img/view/2015/12/24/1051981.png,0,0.9811621904373168,467,238,743,514,276,276,sunset shimmer|twilight sparkle,xwreathofroses
1052060.png,https://derpicdn.net/img/view/2015/12/24/1052060.png,0,0.9907020926475524,93,282,293,482,200,200,apple bloom|applejack|big macintosh|granny smith|shining armor|spike|twilight sparkle,jowybean
1052060.png,https://derpicdn.net/img/view/2015/12/24/1052060.png,1,0.9898512959480286,386,393,552,559,166,166,apple bloom|applejack|big macintosh|granny smith|shining armor|spike|twilight sparkle,jowybean
1052060.png,https://derpicdn.net/img/view/2015/12/24/1052060.png,2,0.9528531432151794,32,189,186,343,154,154,apple bloom|applejack|big macintosh|granny smith|shining armor|spike|twilight sparkle,jowybean
1052060.png,https://derpicdn.net/img/view/2015/12/24/1052060.png,3,0.9499046802520752,408,203,550,345,142,142,apple bloom|applejack|big macintosh|granny smith|shining armor|spike|twilight sparkle,jowybean
1052060.png,https://derpicdn.net/img/view/2015/12/24/1052060.png,4,0.9366812705993652,470,541,638,709,168,168,apple bloom|applejack|big macintosh|granny smith|shining armor|spike|twilight sparkle,jowybean
1052060.png,https://derpicdn.net/img/view/2015/12/24/1052060.png,5,0.930014193058014,527,275,713,461,186,186,apple bloom|applejack|big macintosh|granny smith|shining armor|spike|twilight sparkle,jowybean
1052173.png,https://derpicdn.net/img/view/2015/12/25/1052173.png,0,0.9658188223838806,52,0,564,479,512,479,applejack|fluttershy|mane six|pinkie pie|princess cadance|rainbow dash|rarity|shining armor|spike|twilight sparkle,dm29
1054604.png,https://derpicdn.net/img/view/2015/12/28/1054604.png,0,0.9748238921165466,1670,406,1914,650,244,244,applejack|fluttershy|mane six|pinkie pie|rainbow dash|rarity|twilight sparkle,ryuu
1054890.png,https://derpicdn.net/img/view/2015/12/29/1054890.png,0,0.9976962208747864,2089,0,4171,2073,2082,2073,applejack|fluttershy|mane six|pinkie pie|rainbow dash|rarity|spike|starlight glimmer|twilight sparkle,meganlovesangrybirds
1054890.png,https://derpicdn.net/img/view/2015/12/29/1054890.png,1,0.9503101110458374,4801,1585,6699,3483,1898,1898,applejack|fluttershy|mane six|pinkie pie|rainbow dash|rarity|spike|starlight glimmer|twilight sparkle,meganlovesangrybirds
1055170.png,https://derpicdn.net/img/view/2015/12/29/1055170.png,0,0.9893299341201782,738,0,1202,373,464,373,applejack|fluttershy|mane six|pinkie pie|rainbow dash|rarity|twilight sparkle,aidapone
1055331.png,https://derpicdn.net/img/view/2015/12/29/1055331.png,1,0.9492146968841552,2376,493,2730,847,354,354,princess cadance|princess celestia|princess luna|twilight sparkle,xsizorback
1055876.png,https://derpicdn.net/img/view/2015/12/30/1055876.png,0,0.9886701107025146,424,171,1772,1519,1348,1348,trixie|twilight sparkle,nightmaremoons
1055876.png,https://derpicdn.net/img/view/2015/12/30/1055876.png,1,0.9206072092056274,2601,1322,3673,2394,1072,1072,trixie|twilight sparkle,nightmaremoons
1056698.png,https://derpicdn.net/img/view/2015/12/31/1056698.png,0,0.9483556151390076,83,272,799,988,716,716,applejack|fluttershy|mane six|pinkie pie|rainbow dash|rarity|spike|sunset shimmer|twilight sparkle,majkashinoda626
1056698.png,https://derpicdn.net/img/view/2015/12/31/1056698.png,1,0.9126343727111816,1730,149,2166,585,436,436,applejack|fluttershy|mane six|pinkie pie|rainbow dash|rarity|spike|sunset shimmer|twilight sparkle,majkashinoda626
1057249.png,https://derpicdn.net/img/view/2016/1/1/1057249.png,0,0.9484555721282959,481,0,869,334,388,334,applejack|twilight sparkle,jowybean
1057572.png,https://derpicdn.net/img/view/2016/1/1/1057572.png,0,0.9254378676414492,198,443,380,625,182,182,princess cadance|princess celestia|princess luna|twilight sparkle,deusexequus
1057572.png,https://derpicdn.net/img/view/2016/1/1/1057572.png,1,0.9246099591255188,562,493,778,709,216,216,princess cadance|princess celestia|princess luna|twilight sparkle,deusexequus
1057772.png,https://derpicdn.net/img/view/2016/1/2/1057772.png,0,0.9925923347473145,953,462,1157,666,204,204,princess celestia|twilight sparkle,silviawinter
1057979.png,https://derpicdn.net/img/view/2016/1/2/1057979.png,0,0.9735641479492188,536,234,874,572,338,338,princess celestia|twilight sparkle,deusexequus
1058802.png,https://derpicdn.net/img/view/2016/1/3/1058802.png,0,0.9982813596725464,12,6,334,328,322,322,princess celestia|twilight sparkle,kkitsu
1058802.png,https://derpicdn.net/img/view/2016/1/3/1058802.png,1,0.9154693484306335,289,0,663,331,374,331,princess celestia|twilight sparkle,kkitsu
1060344.png,https://derpicdn.net/img/view/2016/1/5/1060344.png,0,0.9951004981994628,115,614,449,948,334,334,applejack|fluttershy|mane six|pinkie pie|rainbow dash|rarity|twilight sparkle,hungrysohma
1060344.png,https://derpicdn.net/img/view/2016/1/5/1060344.png,1,0.9861478209495544,1151,606,1469,924,318,318,applejack|fluttershy|mane six|pinkie pie|rainbow dash|rarity|twilight sparkle,hungrysohma
1060344.png,https://derpicdn.net/img/view/2016/1/5/1060344.png,2,0.981659770011902,24,18,392,386,368,368,applejack|fluttershy|mane six|pinkie pie|rainbow dash|rarity|twilight sparkle,hungrysohma
1060344.png,https://derpicdn.net/img/view/2016/1/5/1060344.png,3,0.9557896852493286,696,103,1004,411,308,308,applejack|fluttershy|mane six|pinkie pie|rainbow dash|rarity|twilight sparkle,hungrysohma
1066338.png,https://derpicdn.net/img/view/2016/1/14/1066338.png,0,0.9788108468055724,15,168,287,440,272,272,spike|twilight sparkle,invisibleone11
1067391.png,https://derpicdn.net/img/view/2016/1/16/1067391.png,0,0.9998310804367064,1734,372,2524,1162,790,790,princess celestia|twilight sparkle,lordstormcaller
1067391.png,https://derpicdn.net/img/view/2016/1/16/1067391.png,1,0.9997126460075378,573,232,1409,1068,836,836,princess celestia|twilight sparkle,lordstormcaller
1067406.png,https://derpicdn.net/img/view/2016/1/16/1067406.png,0,0.9855377674102784,547,61,833,347,286,286,applejack|twilight sparkle,jowybean
1068289.png,https://derpicdn.net/img/view/2016/1/17/1068289.png,0,0.9822468161582948,617,338,993,714,376,376,princess celestia|princess luna|twilight sparkle,hinoraito
1071535.jpg,https://derpicdn.net/img/view/2016/1/22/1071535.jpg,0,0.9870738387107848,996,761,1840,1605,844,844,pinkie pie|twilight sparkle,dilarus
1072270.png,https://derpicdn.net/img/view/2016/1/23/1072270.png,0,0.9899037480354308,740,766,1040,1086,300,320,starlight glimmer|twilight sparkle,hoyeechun
1075662.png,https://derpicdn.net/img/view/2016/1/28/1075662.png,0,0.9951979517936708,1262,2218,2272,3228,1010,1010,discord|twilight sparkle,otakuap
1076296.png,https://derpicdn.net/img/view/2016/1/30/1076296.png,0,0.9724700450897216,269,3,625,359,356,356,applejack|fluttershy|mane six|pinkie pie|rainbow dash|rarity|twilight sparkle,sharmie
1076296.png,https://derpicdn.net/img/view/2016/1/30/1076296.png,1,0.965470552444458,176,546,488,858,312,312,applejack|fluttershy|mane six|pinkie pie|rainbow dash|rarity|twilight sparkle,sharmie
1076296.png,https://derpicdn.net/img/view/2016/1/30/1076296.png,2,0.941472053527832,321,975,597,1251,276,276,applejack|fluttershy|mane six|pinkie pie|rainbow dash|rarity|twilight sparkle,sharmie
1078189.png,https://derpicdn.net/img/view/2016/2/1/1078189.png,0,0.9607517123222352,2741,0,3573,715,832,715,starlight glimmer|sunset shimmer|trixie|twilight sparkle,sketchmcreations
1078189.png,https://derpicdn.net/img/view/2016/2/1/1078189.png,1,0.9031343460083008,460,878,1302,1720,842,842,starlight glimmer|sunset shimmer|trixie|twilight sparkle,sketchmcreations
1079303.png,https://derpicdn.net/img/view/2016/2/3/1079303.png,0,0.9047468304634094,327,317,543,533,216,216,applejack|fluttershy|mane six|pinkie pie|rainbow dash|rarity|spike|starlight glimmer|sunset shimmer|twilight sparkle,lemonheart
1081198.png,https://derpicdn.net/img/view/2016/2/5/1081198.png,0,0.95717191696167,0,16,839,864,839,848,pinkie pie|rainbow dash|twilight sparkle,ponythroat
1082051.png,https://derpicdn.net/img/view/2016/2/7/1082051.png,0,0.999446988105774,1090,793,1782,1485,692,692,applejack|fluttershy|mane six|pinkie pie|rainbow dash|rarity|twilight sparkle,flufflelord
1082051.png,https://derpicdn.net/img/view/2016/2/7/1082051.png,1,0.9878548979759216,1684,851,2298,1465,614,614,applejack|fluttershy|mane six|pinkie pie|rainbow dash|rarity|twilight sparkle,flufflelord
1082051.png,https://derpicdn.net/img/view/2016/2/7/1082051.png,2,0.9854000210762024,558,956,1376,1774,818,818,applejack|fluttershy|mane six|pinkie pie|rainbow dash|rarity|twilight sparkle,flufflelord
1082666.png,https://derpicdn.net/img/view/2016/2/7/1082666.png,0,0.999350607395172,562,285,1812,1535,1250,1250,princess cadance|princess flurry heart|twilight sparkle,kas92
1082666.png,https://derpicdn.net/img/view/2016/2/7/1082666.png,1,0.9736256599426272,1978,669,2884,1575,906,906,princess cadance|princess flurry heart|twilight sparkle,kas92
1082666.png,https://derpicdn.net/img/view/2016/2/7/1082666.png,2,0.9485772252082824,1962,29,2750,817,788,788,princess cadance|princess flurry heart|twilight sparkle,kas92
1084133.png,https://derpicdn.net/img/view/2016/2/9/1084133.png,0,0.949284553527832,61,0,439,366,378,366,spike|twilight sparkle,jamescorck
1084394.png,https://derpicdn.net/img/view/2016/2/10/1084394.png,0,0.9858606457710266,383,64,500,198,117,134,apple bloom|twilight sparkle,lumineko
1084394.png,https://derpicdn.net/img/view/2016/2/10/1084394.png,1,0.9742606282234192,0,76,134,212,134,136,apple bloom|twilight sparkle,lumineko
1084736.png,https://derpicdn.net/img/view/2016/2/10/1084736.png,0,0.9172977209091188,319,234,1413,1328,1094,1094,rarity|sunset shimmer|trixie|twilight sparkle,3d4d
1085425.png,https://derpicdn.net/img/view/2016/2/11/1085425.png,0,0.9905154705047609,1311,376,2843,1908,1532,1532,pinkie pie|twilight sparkle,thegreatrouge
1085844.jpg,https://derpicdn.net/img/view/2016/2/12/1085844.jpg,0,0.967942237854004,165,54,289,178,124,124,starlight glimmer|sunset shimmer|trixie|twilight sparkle,squipycheetah
1087048.jpg,https://derpicdn.net/img/view/2016/2/13/1087048.jpg,0,0.9974095821380616,6,88,270,352,264,264,princess celestia|twilight sparkle,mad'n evil
1092285.png,https://derpicdn.net/img/view/2016/2/20/1092285.png,0,0.9922340512275696,35,1234,587,1786,552,552,applejack|fluttershy|mane six|pinkie pie|rainbow dash|rarity|starlight glimmer|sunset shimmer|twilight sparkle,majkashinoda626
1092285.png,https://derpicdn.net/img/view/2016/2/20/1092285.png,1,0.9892302155494692,1171,73,1623,525,452,452,applejack|fluttershy|mane six|pinkie pie|rainbow dash|rarity|starlight glimmer|sunset shimmer|twilight sparkle,majkashinoda626
1092285.png,https://derpicdn.net/img/view/2016/2/20/1092285.png,2,0.9791353344917296,355,668,789,1102,434,434,applejack|fluttershy|mane six|pinkie pie|rainbow dash|rarity|starlight glimmer|sunset shimmer|twilight sparkle,majkashinoda626
1092285.png,https://derpicdn.net/img/view/2016/2/20/1092285.png,3,0.916427493095398,98,56,580,538,482,482,applejack|fluttershy|mane six|pinkie pie|rainbow dash|rarity|starlight glimmer|sunset shimmer|twilight sparkle,majkashinoda626
1096486.png,https://derpicdn.net/img/view/2016/2/25/1096486.png,1,0.9335003495216372,2126,970,2540,1384,414,414,apple bloom|applejack|big macintosh|fluttershy|granny smith|mane six|pinkie pie|princess celestia|princess luna|rainbow dash|rarity|scootaloo|spike|sweetie belle|trixie|twilight sparkle,blueshift
1096486.png,https://derpicdn.net/img/view/2016/2/25/1096486.png,2,0.9291081428527832,0,72,281,392,281,320,apple bloom|applejack|big macintosh|fluttershy|granny smith|mane six|pinkie pie|princess celestia|princess luna|rainbow dash|rarity|scootaloo|spike|sweetie belle|trixie|twilight sparkle,blueshift
1096486.png,https://derpicdn.net/img/view/2016/2/25/1096486.png,3,0.928563952445984,179,970,553,1344,374,374,apple bloom|applejack|big macintosh|fluttershy|granny smith|mane six|pinkie pie|princess celestia|princess luna|rainbow dash|rarity|scootaloo|spike|sweetie belle|trixie|twilight sparkle,blueshift
1097194.png,https://derpicdn.net/img/view/2016/2/26/1097194.png,0,0.9947754144668579,546,70,966,494,420,424,applejack|twilight sparkle,jowybean
1097756.png,https://derpicdn.net/img/view/2016/2/27/1097756.png,0,0.9937345385551452,24,129,672,777,648,648,sunset shimmer|twilight sparkle,ponyecho
1097851.png,https://derpicdn.net/img/view/2016/2/27/1097851.png,1,0.9126449227333068,610,405,2080,1875,1470,1470,rainbow dash|twilight sparkle,everlastingderp
1099261.png,https://derpicdn.net/img/view/2016/2/29/1099261.png,1,0.9925357699394226,9,418,319,728,310,310,applejack|big macintosh|braeburn|discord|fluttershy|mane six|pinkie pie|princess celestia|princess luna|queen chrysalis|rainbow dash|rarity|soarin'|spike|starlight glimmer|sunset shimmer|sweetie belle|trixie|twilight sparkle,starshinebeast|braeburned|hikariviny|goat train|sirsoarin|ushiro no kukan|evehly|craftedfun3|dilemmas4u|paradigmpizza|the weaver|majkashinoda626|calicopikachu|b-epon|speccysy|ende26|howxu|momo|ninjaham|si1vr|burnedpigeon|katiramoon|nolycs|freedomthai|mn27|navitaserussirus|kevinsano|crade
1099261.png,https://derpicdn.net/img/view/2016/2/29/1099261.png,2,0.9722673296928406,51,2867,371,3187,320,320,applejack|big macintosh|braeburn|discord|fluttershy|mane six|pinkie pie|princess celestia|princess luna|queen chrysalis|rainbow dash|rarity|soarin'|spike|starlight glimmer|sunset shimmer|sweetie belle|trixie|twilight sparkle,starshinebeast|braeburned|hikariviny|goat train|sirsoarin|ushiro no kukan|evehly|craftedfun3|dilemmas4u|paradigmpizza|the weaver|majkashinoda626|calicopikachu|b-epon|speccysy|ende26|howxu|momo|ninjaham|si1vr|burnedpigeon|katiramoon|nolycs|freedomthai|mn27|navitaserussirus|kevinsano|crade
1099261.png,https://derpicdn.net/img/view/2016/2/29/1099261.png,3,0.9708447456359864,1262,2792,1600,3150,338,358,applejack|big macintosh|braeburn|discord|fluttershy|mane six|pinkie pie|princess celestia|princess luna|queen chrysalis|rainbow dash|rarity|soarin'|spike|starlight glimmer|sunset shimmer|sweetie belle|trixie|twilight sparkle,starshinebeast|braeburned|hikariviny|goat train|sirsoarin|ushiro no kukan|evehly|craftedfun3|dilemmas4u|paradigmpizza|the weaver|majkashinoda626|calicopikachu|b-epon|speccysy|ende26|howxu|momo|ninjaham|si1vr|burnedpigeon|katiramoon|nolycs|freedomthai|mn27|navitaserussirus|kevinsano|crade
1099261.png,https://derpicdn.net/img/view/2016/2/29/1099261.png,5,0.927293598651886,439,1489,933,1983,494,494,applejack|big macintosh|braeburn|discord|fluttershy|mane six|pinkie pie|princess celestia|princess luna|queen chrysalis|rainbow dash|rarity|soarin'|spike|starlight glimmer|sunset shimmer|sweetie belle|trixie|twilight sparkle,starshinebeast|braeburned|hikariviny|goat train|sirsoarin|ushiro no kukan|evehly|craftedfun3|dilemmas4u|paradigmpizza|the weaver|majkashinoda626|calicopikachu|b-epon|speccysy|ende26|howxu|momo|ninjaham|si1vr|burnedpigeon|katiramoon|nolycs|freedomthai|mn27|navitaserussirus|kevinsano|crade
1100029.png,https://derpicdn.net/img/view/2016/3/1/1100029.png,0,0.9948341250419616,398,552,896,1050,498,498,applejack|fluttershy|mane six|pinkie pie|rainbow dash|rarity|twilight sparkle,ruffu
1100613.png,https://derpicdn.net/img/view/2016/3/2/1100613.png,0,0.9968766570091248,409,0,689,273,280,273,fluttershy|rainbow dash|twilight sparkle,flutterthrash
1100613.png,https://derpicdn.net/img/view/2016/3/2/1100613.png,1,0.9963706135749816,520,402,752,634,232,232,fluttershy|rainbow dash|twilight sparkle,flutterthrash
1102547.png,https://derpicdn.net/img/view/2016/3/5/1102547.png,0,0.9935637712478638,1137,606,1447,920,310,314,spike|twilight sparkle,pencils
1103216.jpg,https://derpicdn.net/img/view/2016/3/6/1103216.jpg,1,0.9622921943664552,1296,31,1952,687,656,656,rarity|twilight sparkle,unousaya
1109161.png,https://derpicdn.net/img/view/2016/3/15/1109161.png,0,0.9899406433105468,57,276,385,604,328,328,sunset shimmer|trixie|twilight sparkle,lotte
1109161.png,https://derpicdn.net/img/view/2016/3/15/1109161.png,2,0.9619458913803101,827,0,1085,256,258,256,sunset shimmer|trixie|twilight sparkle,lotte
1109161.png,https://derpicdn.net/img/view/2016/3/15/1109161.png,3,0.9432674050331116,202,1779,506,2083,304,304,sunset shimmer|trixie|twilight sparkle,lotte
1109548.png,https://derpicdn.net/img/view/2016/3/15/1109548.png,0,0.9996168613433838,109,250,555,696,446,446,applejack|fluttershy|mane six|pinkie pie|rainbow dash|rarity|twilight sparkle,silentwulv
1109548.png,https://derpicdn.net/img/view/2016/3/15/1109548.png,2,0.9844986200332642,1189,326,1477,614,288,288,applejack|fluttershy|mane six|pinkie pie|rainbow dash|rarity|twilight sparkle,silentwulv
1109548.png,https://derpicdn.net/img/view/2016/3/15/1109548.png,3,0.9818091988563538,458,472,776,790,318,318,applejack|fluttershy|mane six|pinkie pie|rainbow dash|rarity|twilight sparkle,silentwulv
1109548.png,https://derpicdn.net/img/view/2016/3/15/1109548.png,4,0.971629798412323,775,338,1035,598,260,260,applejack|fluttershy|mane six|pinkie pie|rainbow dash|rarity|twilight sparkle,silentwulv
1110064.png,https://derpicdn.net/img/view/2016/3/16/1110064.png,0,0.9870632290840148,502,800,1128,1426,626,626,starlight glimmer|sunset shimmer|trixie|twilight sparkle,cloud-dash
1110354.png,https://derpicdn.net/img/view/2016/3/16/1110354.png,0,0.9821568131446838,0,0,446,440,446,440,sunset shimmer|twilight sparkle,sapphireuniverse
1110700.jpg,https://derpicdn.net/img/view/2016/3/17/1110700.jpg,0,0.9551666378974916,118,127,384,393,266,266,spike|starlight glimmer|twilight sparkle,average-00
1110700.jpg,https://derpicdn.net/img/view/2016/3/17/1110700.jpg,1,0.9325179457664492,372,105,636,369,264,264,spike|starlight glimmer|twilight sparkle,average-00
1110925.png,https://derpicdn.net/img/view/2016/3/17/1110925.png,0,0.996212124824524,93,6,405,318,312,312,sunset shimmer|twilight sparkle,phyllismi
1110925.png,https://derpicdn.net/img/view/2016/3/17/1110925.png,1,0.971638023853302,358,66,586,294,228,228,sunset shimmer|twilight sparkle,phyllismi
1111190.png,https://derpicdn.net/img/view/2016/3/17/1111190.png,0,0.9242907762527466,671,0,1085,367,414,367,rainbow dash|twilight sparkle,kairaanix
11123.png,https://derpicdn.net/img/view/2012/6/20/11123.png,0,0.997890293598175,128,0,476,279,348,279,fluttershy|trixie|twilight sparkle,0r0ch1
1112542.png,https://derpicdn.net/img/view/2016/3/19/1112542.png,0,0.9970846772193908,397,7,887,497,490,490,spike|twilight sparkle,dsana
1113217.png,https://derpicdn.net/img/view/2016/3/20/1113217.png,0,0.9801239967346193,312,31,1022,741,710,710,starlight glimmer|sunset shimmer|trixie|twilight sparkle,squipycheetah
1113217.png,https://derpicdn.net/img/view/2016/3/20/1113217.png,1,0.9717744588851928,2946,15,3712,781,766,766,starlight glimmer|sunset shimmer|trixie|twilight sparkle,squipycheetah
1113311.png,https://derpicdn.net/img/view/2016/3/20/1113311.png,0,0.9939863681793212,396,0,938,527,542,527,rainbow dash|twilight sparkle,kallarmo
1113425.png,https://derpicdn.net/img/view/2016/3/21/1113425.png,0,0.9972988367080688,817,1066,1533,1782,716,716,applejack|fluttershy|mane six|pinkie pie|rainbow dash|rarity|starlight glimmer|sunset shimmer|twilight sparkle,phoenixgoldensilver
1113425.png,https://derpicdn.net/img/view/2016/3/21/1113425.png,1,0.9954009056091307,1123,2062,1941,2880,818,818,applejack|fluttershy|mane six|pinkie pie|rainbow dash|rarity|starlight glimmer|sunset shimmer|twilight sparkle,phoenixgoldensilver
1113425.png,https://derpicdn.net/img/view/2016/3/21/1113425.png,2,0.978923797607422,578,1900,1196,2518,618,618,applejack|fluttershy|mane six|pinkie pie|rainbow dash|rarity|starlight glimmer|sunset shimmer|twilight sparkle,phoenixgoldensilver
1113425.png,https://derpicdn.net/img/view/2016/3/21/1113425.png,3,0.9708315134048462,1368,1100,2052,1784,684,684,applejack|fluttershy|mane six|pinkie pie|rainbow dash|rarity|starlight glimmer|sunset shimmer|twilight sparkle,phoenixgoldensilver
1113425.png,https://derpicdn.net/img/view/2016/3/21/1113425.png,4,0.9670977592468262,1438,0,2864,1365,1426,1365,applejack|fluttershy|mane six|pinkie pie|rainbow dash|rarity|starlight glimmer|sunset shimmer|twilight sparkle,phoenixgoldensilver
1113425.png,https://derpicdn.net/img/view/2016/3/21/1113425.png,5,0.9111618995666504,1827,1858,2481,2512,654,654,applejack|fluttershy|mane six|pinkie pie|rainbow dash|rarity|starlight glimmer|sunset shimmer|twilight sparkle,phoenixgoldensilver
1114470.png,https://derpicdn.net/img/view/2016/3/22/1114470.png,0,0.9839672446250916,1068,516,1436,884,368,368,princess cadance|princess celestia|princess luna|twilight sparkle,bluesidearts
1116166.jpg,https://derpicdn.net/img/view/2016/3/25/1116166.jpg,0,0.9945883750915528,496,47,860,411,364,364,rarity|twilight sparkle,quakehoof
1117268.png,https://derpicdn.net/img/view/2016/3/26/1117268.png,0,0.9932861924171448,457,153,1125,821,668,668,princess cadance|princess celestia|princess luna|twilight sparkle,88ms-allie88|seleniium
1117268.png,https://derpicdn.net/img/view/2016/3/26/1117268.png,1,0.9885294437408448,1824,346,2432,954,608,608,princess cadance|princess celestia|princess luna|twilight sparkle,88ms-allie88|seleniium
111730.jpg,https://derpicdn.net/img/view/2012/10/2/111730.jpg,1,0.9771159887313844,980,153,1322,495,342,342,princess cadance|shining armor|spike|twilight sparkle,harwick
1119388.png,https://derpicdn.net/img/view/2016/3/29/1119388.png,0,0.9985508918762208,118,0,706,510,588,510,starlight glimmer|twilight sparkle,wonkysole
1119388.png,https://derpicdn.net/img/view/2016/3/29/1119388.png,1,0.966330111026764,538,36,1178,676,640,640,starlight glimmer|twilight sparkle,wonkysole
1126741.png,https://derpicdn.net/img/view/2016/4/7/1126741.png,0,0.937979817390442,649,380,1071,802,422,422,princess cadance|princess celestia|princess flurry heart|princess luna|starlight glimmer|twilight sparkle,theroyalprincesses
1126741.png,https://derpicdn.net/img/view/2016/4/7/1126741.png,1,0.9271873831748962,57,498,421,862,364,364,princess cadance|princess celestia|princess flurry heart|princess luna|starlight glimmer|twilight sparkle,theroyalprincesses
1127491.png,https://derpicdn.net/img/view/2016/4/8/1127491.png,0,0.9957122206687928,143,0,785,642,642,642,applejack|twilight sparkle,supermare
1128926.png,https://derpicdn.net/img/view/2016/4/10/1128926.png,0,0.9868359565734864,1940,778,2438,1276,498,498,applejack|fluttershy|mane six|pinkie pie|rainbow dash|rarity|starlight glimmer|twilight sparkle,kuzumori
1128926.png,https://derpicdn.net/img/view/2016/4/10/1128926.png,1,0.916737973690033,998,104,1384,490,386,386,applejack|fluttershy|mane six|pinkie pie|rainbow dash|rarity|starlight glimmer|twilight sparkle,kuzumori
113028.jpg,https://derpicdn.net/img/view/2012/10/4/113028.jpg,0,0.99563068151474,159,145,445,431,286,286,spike|twilight sparkle,ss2sonic
1132871.png,https://derpicdn.net/img/view/2016/4/16/1132871.png,0,0.9990791082382202,416,857,894,1335,478,478,starlight glimmer|sunset shimmer|twilight sparkle,flavinbagel
1132871.png,https://derpicdn.net/img/view/2016/4/16/1132871.png,1,0.9988306164741516,259,490,693,924,434,434,starlight glimmer|sunset shimmer|twilight sparkle,flavinbagel
1132871.png,https://derpicdn.net/img/view/2016/4/16/1132871.png,2,0.9745346307754515,71,62,403,394,332,332,starlight glimmer|sunset shimmer|twilight sparkle,flavinbagel
1133960.png,https://derpicdn.net/img/view/2016/4/17/1133960.png,0,0.9944148659706116,377,315,1173,1111,796,796,rarity|twilight sparkle,aleximusprime
1134291.png,https://derpicdn.net/img/view/2016/4/17/1134291.png,0,0.9951672554016112,5682,0,7816,2061,2134,2061,applejack|fluttershy|pinkie pie|rainbow dash|twilight sparkle,kiowa213
1134291.png,https://derpicdn.net/img/view/2016/4/17/1134291.png,1,0.9891899228096008,2976,175,5954,3153,2978,2978,applejack|fluttershy|pinkie pie|rainbow dash|twilight sparkle,kiowa213
1136013.png,https://derpicdn.net/img/view/2016/4/19/1136013.png,1,0.904168963432312,375,381,585,591,210,210,rarity|spike|twilight sparkle,vergolophus
1137803.png,https://derpicdn.net/img/view/2016/4/22/1137803.png,0,0.9049131870269777,676,0,1906,1064,1230,1064,starlight glimmer|twilight sparkle,
1138652.png,https://derpicdn.net/img/view/2016/4/23/1138652.png,1,0.9267440438270568,1629,436,2817,1624,1188,1188,pinkie pie|twilight sparkle,mrw32
1139398.jpg,https://derpicdn.net/img/view/2016/4/25/1139398.jpg,0,0.9710500240325928,650,0,1252,575,602,575,princess luna|twilight sparkle,magnaluna
1140978.png,https://derpicdn.net/img/view/2016/4/27/1140978.png,0,0.9946605563163756,3140,2751,3589,3221,449,470,rainbow dash|twilight sparkle,captainpudgemuffin
1140978.png,https://derpicdn.net/img/view/2016/4/27/1140978.png,1,0.9244386553764344,3172,1087,3589,1549,417,462,rainbow dash|twilight sparkle,captainpudgemuffin
1143321.jpg,https://derpicdn.net/img/view/2016/4/30/1143321.jpg,0,0.9268367886543274,541,34,847,340,306,306,princess celestia|twilight sparkle,
1143572.png,https://derpicdn.net/img/view/2016/5/1/1143572.png,0,0.955901026725769,24,0,710,613,686,613,trixie|twilight sparkle,lumelya
1144732.jpg,https://derpicdn.net/img/view/2016/5/2/1144732.jpg,0,0.9531844854354858,633,0,845,209,212,209,starlight glimmer|twilight sparkle,ereb-tauramandil
1145668.png,https://derpicdn.net/img/view/2016/5/3/1145668.png,0,0.9959224462509156,122,141,544,563,422,422,spike|twilight sparkle,caycowa
1147147.png,https://derpicdn.net/img/view/2016/5/5/1147147.png,0,0.9991655945777892,1416,0,2450,843,1034,843,starlight glimmer|twilight sparkle,floots
1148882.jpg,https://derpicdn.net/img/view/2016/5/7/1148882.jpg,0,0.9983131289482116,1092,394,1280,594,188,200,applejack|fluttershy|pinkie pie|princess luna|rainbow dash|rarity|spike|starlight glimmer|twilight sparkle,silfoe|powercat
1148882.jpg,https://derpicdn.net/img/view/2016/5/7/1148882.jpg,1,0.996206521987915,899,376,1111,588,212,212,applejack|fluttershy|pinkie pie|princess luna|rainbow dash|rarity|spike|starlight glimmer|twilight sparkle,silfoe|powercat
1150365.png,https://derpicdn.net/img/view/2016/5/9/1150365.png,0,0.9868298768997192,2595,431,4617,2453,2022,2022,rainbow dash|twilight sparkle,pucksterv
1150365.png,https://derpicdn.net/img/view/2016/5/9/1150365.png,1,0.9376829862594604,486,216,2482,2212,1996,1996,rainbow dash|twilight sparkle,pucksterv
1151018.jpg,https://derpicdn.net/img/view/2016/5/10/1151018.jpg,0,0.9981462955474854,396,243,588,435,192,192,fluttershy|twilight sparkle,
1151018.jpg,https://derpicdn.net/img/view/2016/5/10/1151018.jpg,1,0.9893432855606079,0,38,191,240,191,202,fluttershy|twilight sparkle,
1151265.jpg,https://derpicdn.net/img/view/2016/5/11/1151265.jpg,0,0.998535692691803,343,927,583,1167,240,240,applejack|fluttershy|mane six|pinkie pie|princess cadance|princess celestia|princess luna|rainbow dash|rarity|spitfire|sunset shimmer|trixie|twilight sparkle,skoon|strangerdanger|bakasan|pusspuss|b-epon|matimus91|atane27|sweetfilthyfun|omi|scramjet747|sugarlesspaints|shydale|qweeli|formalgentleman|ponegranate|cold-blooded-twilight|tres-apples|kevinsano|fearingfun|appelknekten|camychan|ratofdrawn|shinodage|mdgusty|bantha|skuttz|pony-butt-express|futaku|burgerkiss|caboni32|ambris|hiroshi-tea|rainbowscreen|silverfox057|northernsprint
1151265.jpg,https://derpicdn.net/img/view/2016/5/11/1151265.jpg,1,0.9982605576515198,156,907,406,1157,250,250,applejack|fluttershy|mane six|pinkie pie|princess cadance|princess celestia|princess luna|rainbow dash|rarity|spitfire|sunset shimmer|trixie|twilight sparkle,skoon|strangerdanger|bakasan|pusspuss|b-epon|matimus91|atane27|sweetfilthyfun|omi|scramjet747|sugarlesspaints|shydale|qweeli|formalgentleman|ponegranate|cold-blooded-twilight|tres-apples|kevinsano|fearingfun|appelknekten|camychan|ratofdrawn|shinodage|mdgusty|bantha|skuttz|pony-butt-express|futaku|burgerkiss|caboni32|ambris|hiroshi-tea|rainbowscreen|silverfox057|northernsprint
1151265.jpg,https://derpicdn.net/img/view/2016/5/11/1151265.jpg,2,0.9980529546737672,703,686,937,920,234,234,applejack|fluttershy|mane six|pinkie pie|princess cadance|princess celestia|princess luna|rainbow dash|rarity|spitfire|sunset shimmer|trixie|twilight sparkle,skoon|strangerdanger|bakasan|pusspuss|b-epon|matimus91|atane27|sweetfilthyfun|omi|scramjet747|sugarlesspaints|shydale|qweeli|formalgentleman|ponegranate|cold-blooded-twilight|tres-apples|kevinsano|fearingfun|appelknekten|camychan|ratofdrawn|shinodage|mdgusty|bantha|skuttz|pony-butt-express|futaku|burgerkiss|caboni32|ambris|hiroshi-tea|rainbowscreen|silverfox057|northernsprint
1151265.jpg,https://derpicdn.net/img/view/2016/5/11/1151265.jpg,3,0.9966859221458436,692,437,924,669,232,232,applejack|fluttershy|mane six|pinkie pie|princess cadance|princess celestia|princess luna|rainbow dash|rarity|spitfire|sunset shimmer|trixie|twilight sparkle,skoon|strangerdanger|bakasan|pusspuss|b-epon|matimus91|atane27|sweetfilthyfun|omi|scramjet747|sugarlesspaints|shydale|qweeli|formalgentleman|ponegranate|cold-blooded-twilight|tres-apples|kevinsano|fearingfun|appelknekten|camychan|ratofdrawn|shinodage|mdgusty|bantha|skuttz|pony-butt-express|futaku|burgerkiss|caboni32|ambris|hiroshi-tea|rainbowscreen|silverfox057|northernsprint
1151265.jpg,https://derpicdn.net/img/view/2016/5/11/1151265.jpg,4,0.9960910081863404,0,952,220,1176,220,224,applejack|fluttershy|mane six|pinkie pie|princess cadance|princess celestia|princess luna|rainbow dash|rarity|spitfire|sunset shimmer|trixie|twilight sparkle,skoon|strangerdanger|bakasan|pusspuss|b-epon|matimus91|atane27|sweetfilthyfun|omi|scramjet747|sugarlesspaints|shydale|qweeli|formalgentleman|ponegranate|cold-blooded-twilight|tres-apples|kevinsano|fearingfun|appelknekten|camychan|ratofdrawn|shinodage|mdgusty|bantha|skuttz|pony-butt-express|futaku|burgerkiss|caboni32|ambris|hiroshi-tea|rainbowscreen|silverfox057|northernsprint
1151265.jpg,https://derpicdn.net/img/view/2016/5/11/1151265.jpg,5,0.9957005977630616,876,913,1112,1149,236,236,applejack|fluttershy|mane six|pinkie pie|princess cadance|princess celestia|princess luna|rainbow dash|rarity|spitfire|sunset shimmer|trixie|twilight sparkle,skoon|strangerdanger|bakasan|pusspuss|b-epon|matimus91|atane27|sweetfilthyfun|omi|scramjet747|sugarlesspaints|shydale|qweeli|formalgentleman|ponegranate|cold-blooded-twilight|tres-apples|kevinsano|fearingfun|appelknekten|camychan|ratofdrawn|shinodage|mdgusty|bantha|skuttz|pony-butt-express|futaku|burgerkiss|caboni32|ambris|hiroshi-tea|rainbowscreen|silverfox057|northernsprint
1151265.jpg,https://derpicdn.net/img/view/2016/5/11/1151265.jpg,6,0.9954915642738342,163,707,379,923,216,216,applejack|fluttershy|mane six|pinkie pie|princess cadance|princess celestia|princess luna|rainbow dash|rarity|spitfire|sunset shimmer|trixie|twilight sparkle,skoon|strangerdanger|bakasan|pusspuss|b-epon|matimus91|atane27|sweetfilthyfun|omi|scramjet747|sugarlesspaints|shydale|qweeli|formalgentleman|ponegranate|cold-blooded-twilight|tres-apples|kevinsano|fearingfun|appelknekten|camychan|ratofdrawn|shinodage|mdgusty|bantha|skuttz|pony-butt-express|futaku|burgerkiss|caboni32|ambris|hiroshi-tea|rainbowscreen|silverfox057|northernsprint
1151265.jpg,https://derpicdn.net/img/view/2016/5/11/1151265.jpg,7,0.9943474531173706,523,1155,749,1381,226,226,applejack|fluttershy|mane six|pinkie pie|princess cadance|princess celestia|princess luna|rainbow dash|rarity|spitfire|sunset shimmer|trixie|twilight sparkle,skoon|strangerdanger|bakasan|pusspuss|b-epon|matimus91|atane27|sweetfilthyfun|omi|scramjet747|sugarlesspaints|shydale|qweeli|formalgentleman|ponegranate|cold-blooded-twilight|tres-apples|kevinsano|fearingfun|appelknekten|camychan|ratofdrawn|shinodage|mdgusty|bantha|skuttz|pony-butt-express|futaku|burgerkiss|caboni32|ambris|hiroshi-tea|rainbowscreen|silverfox057|northernsprint
1151265.jpg,https://derpicdn.net/img/view/2016/5/11/1151265.jpg,8,0.991031289100647,0,445,232,687,232,242,applejack|fluttershy|mane six|pinkie pie|princess cadance|princess celestia|princess luna|rainbow dash|rarity|spitfire|sunset shimmer|trixie|twilight sparkle,skoon|strangerdanger|bakasan|pusspuss|b-epon|matimus91|atane27|sweetfilthyfun|omi|scramjet747|sugarlesspaints|shydale|qweeli|formalgentleman|ponegranate|cold-blooded-twilight|tres-apples|kevinsano|fearingfun|appelknekten|camychan|ratofdrawn|shinodage|mdgusty|bantha|skuttz|pony-butt-express|futaku|burgerkiss|caboni32|ambris|hiroshi-tea|rainbowscreen|silverfox057|northernsprint
1151265.jpg,https://derpicdn.net/img/view/2016/5/11/1151265.jpg,9,0.9901084303855896,339,1164,575,1400,236,236,applejack|fluttershy|mane six|pinkie pie|princess cadance|princess celestia|princess luna|rainbow dash|rarity|spitfire|sunset shimmer|trixie|twilight sparkle,skoon|strangerdanger|bakasan|pusspuss|b-epon|matimus91|atane27|sweetfilthyfun|omi|scramjet747|sugarlesspaints|shydale|qweeli|formalgentleman|ponegranate|cold-blooded-twilight|tres-apples|kevinsano|fearingfun|appelknekten|camychan|ratofdrawn|shinodage|mdgusty|bantha|skuttz|pony-butt-express|futaku|burgerkiss|caboni32|ambris|hiroshi-tea|rainbowscreen|silverfox057|northernsprint
1151265.jpg,https://derpicdn.net/img/view/2016/5/11/1151265.jpg,11,0.9868882894515992,1046,949,1242,1145,196,196,applejack|fluttershy|mane six|pinkie pie|princess cadance|princess celestia|princess luna|rainbow dash|rarity|spitfire|sunset shimmer|trixie|twilight sparkle,skoon|strangerdanger|bakasan|pusspuss|b-epon|matimus91|atane27|sweetfilthyfun|omi|scramjet747|sugarlesspaints|shydale|qweeli|formalgentleman|ponegranate|cold-blooded-twilight|tres-apples|kevinsano|fearingfun|appelknekten|camychan|ratofdrawn|shinodage|mdgusty|bantha|skuttz|pony-butt-express|futaku|burgerkiss|caboni32|ambris|hiroshi-tea|rainbowscreen|silverfox057|northernsprint
1151265.jpg,https://derpicdn.net/img/view/2016/5/11/1151265.jpg,13,0.978167712688446,522,705,748,931,226,226,applejack|fluttershy|mane six|pinkie pie|princess cadance|princess celestia|princess luna|rainbow dash|rarity|spitfire|sunset shimmer|trixie|twilight sparkle,skoon|strangerdanger|bakasan|pusspuss|b-epon|matimus91|atane27|sweetfilthyfun|omi|scramjet747|sugarlesspaints|shydale|qweeli|formalgentleman|ponegranate|cold-blooded-twilight|tres-apples|kevinsano|fearingfun|appelknekten|camychan|ratofdrawn|shinodage|mdgusty|bantha|skuttz|pony-butt-express|futaku|burgerkiss|caboni32|ambris|hiroshi-tea|rainbowscreen|silverfox057|northernsprint
1151265.jpg,https://derpicdn.net/img/view/2016/5/11/1151265.jpg,14,0.9711531400680542,1055,714,1259,918,204,204,applejack|fluttershy|mane six|pinkie pie|princess cadance|princess celestia|princess luna|rainbow dash|rarity|spitfire|sunset shimmer|trixie|twilight sparkle,skoon|strangerdanger|bakasan|pusspuss|b-epon|matimus91|atane27|sweetfilthyfun|omi|scramjet747|sugarlesspaints|shydale|qweeli|formalgentleman|ponegranate|cold-blooded-twilight|tres-apples|kevinsano|fearingfun|appelknekten|camychan|ratofdrawn|shinodage|mdgusty|bantha|skuttz|pony-butt-express|futaku|burgerkiss|caboni32|ambris|hiroshi-tea|rainbowscreen|silverfox057|northernsprint
1151265.jpg,https://derpicdn.net/img/view/2016/5/11/1151265.jpg,15,0.9690209031105042,496,429,772,705,276,276,applejack|fluttershy|mane six|pinkie pie|princess cadance|princess celestia|princess luna|rainbow dash|rarity|spitfire|sunset shimmer|trixie|twilight sparkle,skoon|strangerdanger|bakasan|pusspuss|b-epon|matimus91|atane27|sweetfilthyfun|omi|scramjet747|sugarlesspaints|shydale|qweeli|formalgentleman|ponegranate|cold-blooded-twilight|tres-apples|kevinsano|fearingfun|appelknekten|camychan|ratofdrawn|shinodage|mdgusty|bantha|skuttz|pony-butt-express|futaku|burgerkiss|caboni32|ambris|hiroshi-tea|rainbowscreen|silverfox057|northernsprint
1151265.jpg,https://derpicdn.net/img/view/2016/5/11/1151265.jpg,16,0.9588093757629396,1056,1157,1280,1383,224,226,applejack|fluttershy|mane six|pinkie pie|princess cadance|princess celestia|princess luna|rainbow dash|rarity|spitfire|sunset shimmer|trixie|twilight sparkle,skoon|strangerdanger|bakasan|pusspuss|b-epon|matimus91|atane27|sweetfilthyfun|omi|scramjet747|sugarlesspaints|shydale|qweeli|formalgentleman|ponegranate|cold-blooded-twilight|tres-apples|kevinsano|fearingfun|appelknekten|camychan|ratofdrawn|shinodage|mdgusty|bantha|skuttz|pony-butt-express|futaku|burgerkiss|caboni32|ambris|hiroshi-tea|rainbowscreen|silverfox057|northernsprint
1151265.jpg,https://derpicdn.net/img/view/2016/5/11/1151265.jpg,17,0.9569845795631408,543,1411,745,1613,202,202,applejack|fluttershy|mane six|pinkie pie|princess cadance|princess celestia|princess luna|rainbow dash|rarity|spitfire|sunset shimmer|trixie|twilight sparkle,skoon|strangerdanger|bakasan|pusspuss|b-epon|matimus91|atane27|sweetfilthyfun|omi|scramjet747|sugarlesspaints|shydale|qweeli|formalgentleman|ponegranate|cold-blooded-twilight|tres-apples|kevinsano|fearingfun|appelknekten|camychan|ratofdrawn|shinodage|mdgusty|bantha|skuttz|pony-butt-express|futaku|burgerkiss|caboni32|ambris|hiroshi-tea|rainbowscreen|silverfox057|northernsprint
1151265.jpg,https://derpicdn.net/img/view/2016/5/11/1151265.jpg,18,0.9490671753883362,717,1408,899,1590,182,182,applejack|fluttershy|mane six|pinkie pie|princess cadance|princess celestia|princess luna|rainbow dash|rarity|spitfire|sunset shimmer|trixie|twilight sparkle,skoon|strangerdanger|bakasan|pusspuss|b-epon|matimus91|atane27|sweetfilthyfun|omi|scramjet747|sugarlesspaints|shydale|qweeli|formalgentleman|ponegranate|cold-blooded-twilight|tres-apples|kevinsano|fearingfun|appelknekten|camychan|ratofdrawn|shinodage|mdgusty|bantha|skuttz|pony-butt-express|futaku|burgerkiss|caboni32|ambris|hiroshi-tea|rainbowscreen|silverfox057|northernsprint
1151265.jpg,https://derpicdn.net/img/view/2016/5/11/1151265.jpg,20,0.9361695051193236,718,1184,916,1382,198,198,applejack|fluttershy|mane six|pinkie pie|princess cadance|princess celestia|princess luna|rainbow dash|rarity|spitfire|sunset shimmer|trixie|twilight sparkle,skoon|strangerdanger|bakasan|pusspuss|b-epon|matimus91|atane27|sweetfilthyfun|omi|scramjet747|sugarlesspaints|shydale|qweeli|formalgentleman|ponegranate|cold-blooded-twilight|tres-apples|kevinsano|fearingfun|appelknekten|camychan|ratofdrawn|shinodage|mdgusty|bantha|skuttz|pony-butt-express|futaku|burgerkiss|caboni32|ambris|hiroshi-tea|rainbowscreen|silverfox057|northernsprint
1151265.jpg,https://derpicdn.net/img/view/2016/5/11/1151265.jpg,21,0.9110048413276672,1047,1401,1280,1643,233,242,applejack|fluttershy|mane six|pinkie pie|princess cadance|princess celestia|princess luna|rainbow dash|rarity|spitfire|sunset shimmer|trixie|twilight sparkle,skoon|strangerdanger|bakasan|pusspuss|b-epon|matimus91|atane27|sweetfilthyfun|omi|scramjet747|sugarlesspaints|shydale|qweeli|formalgentleman|ponegranate|cold-blooded-twilight|tres-apples|kevinsano|fearingfun|appelknekten|camychan|ratofdrawn|shinodage|mdgusty|bantha|skuttz|pony-butt-express|futaku|burgerkiss|caboni32|ambris|hiroshi-tea|rainbowscreen|silverfox057|northernsprint
1152839.png,https://derpicdn.net/img/view/2016/5/13/1152839.png,0,0.9867528080940248,1330,428,1614,712,284,284,applejack|fluttershy|mane six|pinkie pie|rainbow dash|rarity|spike|twilight sparkle,dm29
1152839.png,https://derpicdn.net/img/view/2016/5/13/1152839.png,1,0.9362476468086244,1086,385,1408,707,322,322,applejack|fluttershy|mane six|pinkie pie|rainbow dash|rarity|spike|twilight sparkle,dm29
1153124.png,https://derpicdn.net/img/view/2016/5/13/1153124.png,0,0.9497835040092468,867,1013,1719,1865,852,852,rarity|twilight sparkle,ogaraorcynder
1155569.jpg,https://derpicdn.net/img/view/2016/5/16/1155569.jpg,0,0.949303150177002,70,226,272,428,202,202,princess cadance|princess celestia|princess luna|twilight sparkle,doodlepaintdraws
1157368.png,https://derpicdn.net/img/view/2016/5/19/1157368.png,0,0.9575890898704528,261,679,615,1033,354,354,starlight glimmer|sunset shimmer|trixie|twilight sparkle,
1157949.png,https://derpicdn.net/img/view/2016/5/19/1157949.png,0,0.9028043150901794,0,0,341,380,341,380,fluttershy|pinkie pie|rainbow dash|spike|twilight sparkle,tsitra360
1160427.jpg,https://derpicdn.net/img/view/2016/5/22/1160427.jpg,0,0.99457448720932,1841,625,2243,1027,402,402,applejack|fluttershy|mane six|pinkie pie|rainbow dash|rarity|twilight sparkle,ccc
1160427.jpg,https://derpicdn.net/img/view/2016/5/22/1160427.jpg,1,0.9928971529006958,2357,153,2923,719,566,566,applejack|fluttershy|mane six|pinkie pie|rainbow dash|rarity|twilight sparkle,ccc
1160427.jpg,https://derpicdn.net/img/view/2016/5/22/1160427.jpg,2,0.9468466639518738,1251,0,1803,533,552,533,applejack|fluttershy|mane six|pinkie pie|rainbow dash|rarity|twilight sparkle,ccc
1160427.jpg,https://derpicdn.net/img/view/2016/5/22/1160427.jpg,3,0.920945405960083,115,347,661,893,546,546,applejack|fluttershy|mane six|pinkie pie|rainbow dash|rarity|twilight sparkle,ccc
1163636.jpg,https://derpicdn.net/img/view/2016/5/26/1163636.jpg,0,0.9984118938446044,489,275,2127,1913,1638,1638,sunset shimmer|twilight sparkle,silfoe
1165835.png,https://derpicdn.net/img/view/2016/5/29/1165835.png,0,0.9956341981887816,484,16,980,512,496,496,spike|twilight sparkle,sharkie-19|sharkie19
1167008.png,https://derpicdn.net/img/view/2016/5/31/1167008.png,0,0.9957882761955258,436,456,724,744,288,288,starlight glimmer|trixie|twilight sparkle,artiecanvas
1167652.png,https://derpicdn.net/img/view/2016/6/1/1167652.png,0,0.9948127269744872,603,14,1029,440,426,426,fluttershy|twilight sparkle,pabbley
1167655.png,https://derpicdn.net/img/view/2016/6/1/1167655.png,0,0.9973925948143004,228,9,624,405,396,396,fluttershy|twilight sparkle,pabbley
1169554.png,https://derpicdn.net/img/view/2016/6/4/1169554.png,0,0.9776925444602966,80,105,864,889,784,784,applejack|fluttershy|mane six|pinkie pie|rainbow dash|rarity|twilight sparkle,helloiamyourfriend
1169812.jpg,https://derpicdn.net/img/view/2016/6/4/1169812.jpg,0,0.98256915807724,61,718,275,932,214,214,applejack|pinkie pie|princess luna|starlight glimmer|twilight sparkle,hairyfood
1171564.png,https://derpicdn.net/img/view/2016/6/6/1171564.png,0,0.9805299639701844,388,0,856,433,468,433,fluttershy|twilight sparkle,spectralunicorn
1175668.png,https://derpicdn.net/img/view/2016/6/11/1175668.png,0,0.9862616062164308,1559,0,1831,266,272,266,applejack|fluttershy|pinkie pie|rainbow dash|rarity|starlight glimmer|sunset shimmer|twilight sparkle,zharkaer
1175668.png,https://derpicdn.net/img/view/2016/6/11/1175668.png,1,0.9093679189682008,967,0,1333,354,366,354,applejack|fluttershy|pinkie pie|rainbow dash|rarity|starlight glimmer|sunset shimmer|twilight sparkle,zharkaer
1175668.png,https://derpicdn.net/img/view/2016/6/11/1175668.png,2,0.9001625776290894,1181,503,1601,923,420,420,applejack|fluttershy|pinkie pie|rainbow dash|rarity|starlight glimmer|sunset shimmer|twilight sparkle,zharkaer
1177265.png,https://derpicdn.net/img/view/2016/6/13/1177265.png,0,0.9924752116203308,313,93,753,533,440,440,pinkie pie|twilight sparkle,luzleimoon
1179651.png,https://derpicdn.net/img/view/2016/6/16/1179651.png,0,0.9845801591873168,1410,8,2048,646,638,638,rainbow dash|spike|twilight sparkle,kingtoby19
1179651.png,https://derpicdn.net/img/view/2016/6/16/1179651.png,1,0.9464406967163086,1015,49,1511,545,496,496,rainbow dash|spike|twilight sparkle,kingtoby19
1180354.png,https://derpicdn.net/img/view/2016/6/17/1180354.png,0,0.99791818857193,297,41,775,519,478,478,applejack|fluttershy|mane six|pinkie pie|rainbow dash|rarity|twilight sparkle,heir-of-rick
1182286.png,https://derpicdn.net/img/view/2016/6/19/1182286.png,1,0.9815029501914978,712,0,1148,388,436,388,discord|twilight sparkle,heilos
1182286.png,https://derpicdn.net/img/view/2016/6/19/1182286.png,2,0.9699286222457886,33,361,339,667,306,306,discord|twilight sparkle,heilos
1182616.png,https://derpicdn.net/img/view/2016/6/20/1182616.png,0,0.9911144375801086,1151,18,2449,1316,1298,1298,rainbow dash|twilight sparkle,zogzor
1184904.png,https://derpicdn.net/img/view/2016/6/23/1184904.png,0,0.988315761089325,309,0,731,372,422,372,shining armor|twilight sparkle,dm29
1185330.png,https://derpicdn.net/img/view/2016/6/23/1185330.png,1,0.9115661382675172,66,628,608,1170,542,542,applejack|fluttershy|mane six|pinkie pie|rainbow dash|rarity|spike|twilight sparkle,kyle23emma
1186276.png,https://derpicdn.net/img/view/2016/6/25/1186276.png,0,0.9735566973686218,958,64,1353,484,395,420,pinkie pie|twilight sparkle,sourspot
1187184.png,https://derpicdn.net/img/view/2016/6/26/1187184.png,0,0.9978736042976379,69,627,535,1093,466,466,applejack|fluttershy|lightning dust|mane six|pinkie pie|princess cadance|rainbow dash|rarity|shining armor|trixie|twilight sparkle,commissarbu
1187184.png,https://derpicdn.net/img/view/2016/6/26/1187184.png,4,0.9792726039886476,388,190,744,546,356,356,applejack|fluttershy|lightning dust|mane six|pinkie pie|princess cadance|rainbow dash|rarity|shining armor|trixie|twilight sparkle,commissarbu
1187184.png,https://derpicdn.net/img/view/2016/6/26/1187184.png,5,0.945487380027771,730,274,1006,550,276,276,applejack|fluttershy|lightning dust|mane six|pinkie pie|princess cadance|rainbow dash|rarity|shining armor|trixie|twilight sparkle,commissarbu
1189816.png,https://derpicdn.net/img/view/2016/6/30/1189816.png,0,0.9899432063102722,1013,436,1300,736,287,300,applejack|fluttershy|mane six|pinkie pie|rainbow dash|rarity|twilight sparkle,ultrard
1189816.png,https://derpicdn.net/img/view/2016/6/30/1189816.png,1,0.9820639491081238,43,0,417,344,374,344,applejack|fluttershy|mane six|pinkie pie|rainbow dash|rarity|twilight sparkle,ultrard
1189816.png,https://derpicdn.net/img/view/2016/6/30/1189816.png,3,0.92829430103302,267,266,593,592,326,326,applejack|fluttershy|mane six|pinkie pie|rainbow dash|rarity|twilight sparkle,ultrard
1189816.png,https://derpicdn.net/img/view/2016/6/30/1189816.png,4,0.9018848538398744,757,251,1059,553,302,302,applejack|fluttershy|mane six|pinkie pie|rainbow dash|rarity|twilight sparkle,ultrard
1190103.png,https://derpicdn.net/img/view/2016/6/30/1190103.png,0,0.9855296611785888,1633,57,2287,711,654,654,applejack|fluttershy|pinkie pie|rainbow dash|rarity|spike|starlight glimmer|twilight sparkle,qtmarx|cheezedoodle96|xebck|luckreza8|zutheskunk edits
1190103.png,https://derpicdn.net/img/view/2016/6/30/1190103.png,1,0.9126121997833252,378,845,970,1437,592,592,applejack|fluttershy|pinkie pie|rainbow dash|rarity|spike|starlight glimmer|twilight sparkle,qtmarx|cheezedoodle96|xebck|luckreza8|zutheskunk edits
1190491.png,https://derpicdn.net/img/view/2016/6/30/1190491.png,0,0.94839209318161,2088,181,4306,2399,2218,2218,trixie|twilight sparkle,mizuki56
1190555.png,https://derpicdn.net/img/view/2016/7/1/1190555.png,0,0.9988784193992616,75,131,463,519,388,388,sunset shimmer|twilight sparkle,kourabiedes
1190810.png,https://derpicdn.net/img/view/2016/7/1/1190810.png,2,0.9731802344322203,622,949,838,1165,216,216,applejack|diamond tiara|discord|fluttershy|mane six|pinkie pie|rainbow dash|rarity|silver spoon|trixie|twilight sparkle,bluesidearts
1190810.png,https://derpicdn.net/img/view/2016/7/1/1190810.png,3,0.9607457518577576,197,471,455,729,258,258,applejack|diamond tiara|discord|fluttershy|mane six|pinkie pie|rainbow dash|rarity|silver spoon|trixie|twilight sparkle,bluesidearts
1190810.png,https://derpicdn.net/img/view/2016/7/1/1190810.png,4,0.9510185122489928,677,1403,1007,1733,330,330,applejack|diamond tiara|discord|fluttershy|mane six|pinkie pie|rainbow dash|rarity|silver spoon|trixie|twilight sparkle,bluesidearts
1192014.png,https://derpicdn.net/img/view/2016/7/2/1192014.png,0,0.9661282300949096,315,659,1309,1653,994,994,applejack|fluttershy|mane six|pinkie pie|princess celestia|rainbow dash|rarity|spike|twilight sparkle,ravenevert
1192014.png,https://derpicdn.net/img/view/2016/7/2/1192014.png,1,0.9549005031585692,1990,921,3058,1989,1068,1068,applejack|fluttershy|mane six|pinkie pie|princess celestia|rainbow dash|rarity|spike|twilight sparkle,ravenevert
1192120.png,https://derpicdn.net/img/view/2016/7/3/1192120.png,0,0.9189507961273192,0,0,1812,1385,1812,1385,trixie|twilight sparkle,mizuki56
1194546.png,https://derpicdn.net/img/view/2016/7/6/1194546.png,0,0.948573648929596,249,872,549,1172,300,300,applejack|discord|fluttershy|mane six|pinkie pie|rainbow dash|rarity|spike|sunset shimmer|twilight sparkle,iduchan
1195676.png,https://derpicdn.net/img/view/2016/7/7/1195676.png,1,0.96372652053833,2088,975,2572,1459,484,484,sunset shimmer|twilight sparkle,gaelledragons
1199.jpg,https://derpicdn.net/img/view/2012/1/22/1199.jpg,0,0.9400460124015808,166,97,404,335,238,238,princess luna|twilight sparkle,br0ny
119972.jpg,https://derpicdn.net/img/view/2012/10/11/119972.jpg,0,0.9723799228668212,3849,1706,4781,2638,932,932,apple bloom|applejack|discord|fluttershy|pinkie pie|princess celestia|princess luna|rainbow dash|rarity|trixie|twilight sparkle,alexmakovsky
1199743.png,https://derpicdn.net/img/view/2016/7/13/1199743.png,0,0.9901010394096376,1498,1255,2120,1877,622,622,applejack|discord|fluttershy|mane six|pinkie pie|princess cadance|princess celestia|princess luna|queen chrysalis|rainbow dash|rarity|spike|sunset shimmer|twilight sparkle,niegelvonwolf
1199743.png,https://derpicdn.net/img/view/2016/7/13/1199743.png,1,0.9447194933891296,2015,1359,2459,1803,444,444,applejack|discord|fluttershy|mane six|pinkie pie|princess cadance|princess celestia|princess luna|queen chrysalis|rainbow dash|rarity|spike|sunset shimmer|twilight sparkle,niegelvonwolf
1199743.png,https://derpicdn.net/img/view/2016/7/13/1199743.png,2,0.9273569583892822,663,1106,1143,1586,480,480,applejack|discord|fluttershy|mane six|pinkie pie|princess cadance|princess celestia|princess luna|queen chrysalis|rainbow dash|rarity|spike|sunset shimmer|twilight sparkle,niegelvonwolf
1199773.png,https://derpicdn.net/img/view/2016/7/13/1199773.png,0,0.9567076563835144,410,102,786,478,376,376,rarity|twilight sparkle,silent-shadow-wolf
1199773.png,https://derpicdn.net/img/view/2016/7/13/1199773.png,1,0.9433560371398926,139,31,503,395,364,364,rarity|twilight sparkle,silent-shadow-wolf
1200677.png,https://derpicdn.net/img/view/2016/7/14/1200677.png,0,0.9149770736694336,51,118,1200,1272,1149,1154,rainbow dash|twilight sparkle,theroyalprincesses
1204598.png,https://derpicdn.net/img/view/2016/7/19/1204598.png,0,0.920330822467804,811,698,2247,2134,1436,1436,starlight glimmer|sunset shimmer|trixie|twilight sparkle,osipush
1205290.png,https://derpicdn.net/img/view/2016/7/20/1205290.png,0,0.9693252444267272,247,136,487,376,240,240,fluttershy|twilight sparkle,loceri
12057.png,https://derpicdn.net/img/view/2012/6/20/12057.png,0,0.9937365055084229,391,38,653,300,262,262,pinkie pie|spike|twilight sparkle,speccysy
12057.png,https://derpicdn.net/img/view/2012/6/20/12057.png,1,0.9903349876403807,0,52,244,310,244,258,pinkie pie|spike|twilight sparkle,speccysy
1206847.png,https://derpicdn.net/img/view/2016/7/22/1206847.png,0,0.9996976852416992,403,1,651,249,248,248,applejack|fluttershy|mane six|pinkie pie|rainbow dash|rarity|spike|twilight sparkle,pony-berserker
1206847.png,https://derpicdn.net/img/view/2016/7/22/1206847.png,1,0.9993292093276978,293,378,551,636,258,258,applejack|fluttershy|mane six|pinkie pie|rainbow dash|rarity|spike|twilight sparkle,pony-berserker
1206847.png,https://derpicdn.net/img/view/2016/7/22/1206847.png,2,0.9971120357513428,692,0,974,276,282,276,applejack|fluttershy|mane six|pinkie pie|rainbow dash|rarity|spike|twilight sparkle,pony-berserker
1206847.png,https://derpicdn.net/img/view/2016/7/22/1206847.png,3,0.9962354898452759,769,410,1023,664,254,254,applejack|fluttershy|mane six|pinkie pie|rainbow dash|rarity|spike|twilight sparkle,pony-berserker
1206847.png,https://derpicdn.net/img/view/2016/7/22/1206847.png,4,0.9910693168640136,82,0,354,262,272,262,applejack|fluttershy|mane six|pinkie pie|rainbow dash|rarity|spike|twilight sparkle,pony-berserker
1206847.png,https://derpicdn.net/img/view/2016/7/22/1206847.png,5,0.976267397403717,48,378,314,644,266,266,applejack|fluttershy|mane six|pinkie pie|rainbow dash|rarity|spike|twilight sparkle,pony-berserker
1207007.png,https://derpicdn.net/img/view/2016/7/22/1207007.png,0,0.9987241625785828,0,0,1246,1172,1246,1172,applejack|fluttershy|mane six|pinkie pie|rainbow dash|rarity|twilight sparkle,lrusu
1209593.png,https://derpicdn.net/img/view/2016/7/26/1209593.png,0,0.9169961810112,256,0,1012,698,756,698,princess celestia|twilight sparkle,jykinturah
1209609.png,https://derpicdn.net/img/view/2016/7/26/1209609.png,0,0.9836130738258362,42,0,424,357,382,357,sunset shimmer|twilight sparkle,phyllismi
1210272.png,https://derpicdn.net/img/view/2016/7/27/1210272.png,0,0.9982814192771912,0,931,626,1567,626,636,applejack|fluttershy|mane six|pinkie pie|rainbow dash|rarity|twilight sparkle,animechristy
1210272.png,https://derpicdn.net/img/view/2016/7/27/1210272.png,1,0.9737568497657776,2705,838,3351,1484,646,646,applejack|fluttershy|mane six|pinkie pie|rainbow dash|rarity|twilight sparkle,animechristy
1211022.png,https://derpicdn.net/img/view/2016/7/28/1211022.png,0,0.996322751045227,39,0,1403,1302,1364,1302,princess cadance|princess celestia|princess luna|twilight sparkle,segraece
1211022.png,https://derpicdn.net/img/view/2016/7/28/1211022.png,1,0.9839152097702026,1387,0,2861,1397,1474,1397,princess cadance|princess celestia|princess luna|twilight sparkle,segraece
1211314.png,https://derpicdn.net/img/view/2016/7/28/1211314.png,0,0.9754771590232848,1144,253,2328,1437,1184,1184,rainbow dash|twilight sparkle,nightmaremoons
1218000.png,https://derpicdn.net/img/view/2016/8/5/1218000.png,1,0.9905080199241638,921,189,1121,389,200,200,applejack|fluttershy|mane six|pinkie pie|rainbow dash|rarity|spike|starlight glimmer|twilight sparkle,shutterflyeqd
1218000.png,https://derpicdn.net/img/view/2016/8/5/1218000.png,2,0.9055704474449158,11,323,165,477,154,154,applejack|fluttershy|mane six|pinkie pie|rainbow dash|rarity|spike|starlight glimmer|twilight sparkle,shutterflyeqd
1219456.png,https://derpicdn.net/img/view/2016/8/7/1219456.png,0,0.9963498711586,333,4843,1371,5881,1038,1038,applejack|fluttershy|mane six|pinkie pie|rainbow dash|rarity|twilight sparkle,stinkehund
1219456.png,https://derpicdn.net/img/view/2016/8/7/1219456.png,1,0.9491219520568848,378,7,1186,815,808,808,applejack|fluttershy|mane six|pinkie pie|rainbow dash|rarity|twilight sparkle,stinkehund
1219456.png,https://derpicdn.net/img/view/2016/8/7/1219456.png,2,0.9119364619255066,462,1702,1730,2970,1268,1268,applejack|fluttershy|mane six|pinkie pie|rainbow dash|rarity|twilight sparkle,stinkehund
1219573.png,https://derpicdn.net/img/view/2016/8/7/1219573.png,1,0.9951385259628296,607,0,923,294,316,294,applejack|fluttershy|mane six|pinkie pie|rainbow dash|rarity|twilight sparkle,flash equestria photography
1219573.png,https://derpicdn.net/img/view/2016/8/7/1219573.png,2,0.986911952495575,16,0,348,311,332,311,applejack|fluttershy|mane six|pinkie pie|rainbow dash|rarity|twilight sparkle,flash equestria photography
1223989.png,https://derpicdn.net/img/view/2016/8/13/1223989.png,0,0.9951927661895752,0,0,1783,1616,1783,1616,spike|twilight sparkle,porygon2z
1225904.png,https://derpicdn.net/img/view/2016/8/15/1225904.png,0,0.9764112234115601,0,1191,328,1599,328,408,spike|twilight sparkle,theroyalprincesses
1226001.png,https://derpicdn.net/img/view/2016/8/15/1226001.png,0,0.9979172348976136,1626,285,2576,1235,950,950,apple bloom|applejack|twilight sparkle,shutterflyeqd
1226001.png,https://derpicdn.net/img/view/2016/8/15/1226001.png,1,0.9099495410919192,402,757,1142,1497,740,740,apple bloom|applejack|twilight sparkle,shutterflyeqd
12261.jpg,https://derpicdn.net/img/view/2012/6/20/12261.jpg,0,0.9819843769073486,230,40,816,626,586,586,princess celestia|twilight sparkle,kp-shadowsquirrel
1228108.png,https://derpicdn.net/img/view/2016/8/18/1228108.png,0,0.9855998754501344,2401,1340,3861,2800,1460,1460,applejack|fluttershy|mane six|pinkie pie|rainbow dash|rarity|twilight sparkle,ashee
1228108.png,https://derpicdn.net/img/view/2016/8/18/1228108.png,1,0.9740155339241028,132,0,1700,1378,1568,1378,applejack|fluttershy|mane six|pinkie pie|rainbow dash|rarity|twilight sparkle,ashee
1228108.png,https://derpicdn.net/img/view/2016/8/18/1228108.png,2,0.9688112735748292,1592,1617,2662,2687,1070,1070,applejack|fluttershy|mane six|pinkie pie|rainbow dash|rarity|twilight sparkle,ashee
1228108.png,https://derpicdn.net/img/view/2016/8/18/1228108.png,4,0.9284583926200868,1592,237,2886,1531,1294,1294,applejack|fluttershy|mane six|pinkie pie|rainbow dash|rarity|twilight sparkle,ashee
1228143.png,https://derpicdn.net/img/view/2016/8/18/1228143.png,0,0.9972074031829834,991,1,1350,367,359,366,shining armor|twilight sparkle,patty-plmh
1228143.png,https://derpicdn.net/img/view/2016/8/18/1228143.png,1,0.9887059926986694,58,110,366,418,308,308,shining armor|twilight sparkle,patty-plmh
1228143.png,https://derpicdn.net/img/view/2016/8/18/1228143.png,2,0.9289870858192444,376,54,686,364,310,310,shining armor|twilight sparkle,patty-plmh
1228163.png,https://derpicdn.net/img/view/2016/8/18/1228163.png,0,0.9987577199935912,533,0,1017,450,484,450,applejack|twilight sparkle,rwl
1228163.png,https://derpicdn.net/img/view/2016/8/18/1228163.png,1,0.960289180278778,281,232,619,570,338,338,applejack|twilight sparkle,rwl
12292.jpg,https://derpicdn.net/img/view/2012/6/20/12292.jpg,0,0.9985170960426332,336,100,640,404,304,304,princess celestia|spike|twilight sparkle,kp-shadowsquirrel
1230956.png,https://derpicdn.net/img/view/2016/8/22/1230956.png,0,0.9975183606147766,1978,514,2510,1046,532,532,starlight glimmer|sunset shimmer|twilight sparkle,kianamai
1230956.png,https://derpicdn.net/img/view/2016/8/22/1230956.png,1,0.9970738291740416,113,443,745,1075,632,632,starlight glimmer|sunset shimmer|twilight sparkle,kianamai
1230956.png,https://derpicdn.net/img/view/2016/8/22/1230956.png,2,0.9962165355682372,1500,2202,2122,2824,622,622,starlight glimmer|sunset shimmer|twilight sparkle,kianamai
1230956.png,https://derpicdn.net/img/view/2016/8/22/1230956.png,3,0.9863578677177428,68,1679,626,2237,558,558,starlight glimmer|sunset shimmer|twilight sparkle,kianamai
1230956.png,https://derpicdn.net/img/view/2016/8/22/1230956.png,4,0.9734792709350586,1453,942,2049,1538,596,596,starlight glimmer|sunset shimmer|twilight sparkle,kianamai
1233016.png,https://derpicdn.net/img/view/2016/8/24/1233016.png,0,0.9745294451713562,539,191,881,533,342,342,fluttershy|pinkie pie|queen chrysalis|rarity|twilight sparkle,sambragg
1239211.png,https://derpicdn.net/img/view/2016/9/1/1239211.png,0,0.9594241380691528,608,0,1116,395,508,395,sunset shimmer|twilight sparkle,gbrushandpaint
1239375.png,https://derpicdn.net/img/view/2016/9/1/1239375.png,0,0.9808421134948728,546,1472,1068,1994,522,522,applejack|fluttershy|mane six|pinkie pie|rainbow dash|rarity|twilight sparkle,light262
1239375.png,https://derpicdn.net/img/view/2016/9/1/1239375.png,1,0.9787584543228148,0,1666,467,2150,467,484,applejack|fluttershy|mane six|pinkie pie|rainbow dash|rarity|twilight sparkle,light262
1240350.png,https://derpicdn.net/img/view/2016/9/3/1240350.png,0,0.9811729192733764,797,24,1197,424,400,400,applejack|fluttershy|mane six|pinkie pie|rainbow dash|rarity|twilight sparkle,turtlefarminguy
1240350.png,https://derpicdn.net/img/view/2016/9/3/1240350.png,1,0.9689953923225404,183,1043,667,1527,484,484,applejack|fluttershy|mane six|pinkie pie|rainbow dash|rarity|twilight sparkle,turtlefarminguy
1240350.png,https://derpicdn.net/img/view/2016/9/3/1240350.png,2,0.962131917476654,454,672,842,1060,388,388,applejack|fluttershy|mane six|pinkie pie|rainbow dash|rarity|twilight sparkle,turtlefarminguy
1240350.png,https://derpicdn.net/img/view/2016/9/3/1240350.png,3,0.933387279510498,766,619,1148,1001,382,382,applejack|fluttershy|mane six|pinkie pie|rainbow dash|rarity|twilight sparkle,turtlefarminguy
1240350.png,https://derpicdn.net/img/view/2016/9/3/1240350.png,4,0.9320038557052612,31,544,585,1098,554,554,applejack|fluttershy|mane six|pinkie pie|rainbow dash|rarity|twilight sparkle,turtlefarminguy
1241546.png,https://derpicdn.net/img/view/2016/9/4/1241546.png,0,0.9580461382865906,65,107,451,493,386,386,fluttershy|rainbow dash|twilight sparkle,karzahnii
1241547.png,https://derpicdn.net/img/view/2016/9/4/1241547.png,0,0.97672700881958,859,27,2000,1201,1141,1174,rarity|starlight glimmer|twilight sparkle,ruushiicz
1242510.png,https://derpicdn.net/img/view/2016/9/5/1242510.png,0,0.9996910095214844,149,0,1099,807,950,807,applejack|fluttershy|mane six|pinkie pie|rainbow dash|rarity|twilight sparkle,figgot
1242510.png,https://derpicdn.net/img/view/2016/9/5/1242510.png,1,0.9996320009231568,2408,0,3396,902,988,902,applejack|fluttershy|mane six|pinkie pie|rainbow dash|rarity|twilight sparkle,figgot
1242510.png,https://derpicdn.net/img/view/2016/9/5/1242510.png,2,0.999117076396942,1476,0,2548,932,1072,932,applejack|fluttershy|mane six|pinkie pie|rainbow dash|rarity|twilight sparkle,figgot
1242510.png,https://derpicdn.net/img/view/2016/9/5/1242510.png,3,0.9976200461387634,1128,1049,2176,2097,1048,1048,applejack|fluttershy|mane six|pinkie pie|rainbow dash|rarity|twilight sparkle,figgot
1242510.png,https://derpicdn.net/img/view/2016/9/5/1242510.png,4,0.997448980808258,0,1154,946,2114,946,960,applejack|fluttershy|mane six|pinkie pie|rainbow dash|rarity|twilight sparkle,figgot
1243.png,https://derpicdn.net/img/view/2012/1/22/1243.png,0,0.9836449027061462,624,53,834,263,210,210,applejack|fluttershy|mane six|pinkie pie|rainbow dash|rarity|trixie|twilight sparkle,shutterflye
1243.png,https://derpicdn.net/img/view/2012/1/22/1243.png,1,0.9781068563461304,797,33,1016,257,219,224,applejack|fluttershy|mane six|pinkie pie|rainbow dash|rarity|trixie|twilight sparkle,shutterflye
1243.png,https://derpicdn.net/img/view/2012/1/22/1243.png,2,0.9581962823867798,393,304,647,558,254,254,applejack|fluttershy|mane six|pinkie pie|rainbow dash|rarity|trixie|twilight sparkle,shutterflye
1243.png,https://derpicdn.net/img/view/2012/1/22/1243.png,3,0.9516690373420716,28,233,186,391,158,158,applejack|fluttershy|mane six|pinkie pie|rainbow dash|rarity|trixie|twilight sparkle,shutterflye
1243412.png,https://derpicdn.net/img/view/2016/9/6/1243412.png,0,0.9676111936569214,898,0,2218,1314,1320,1314,spike|twilight sparkle,shutterflyeqd
1244106.png,https://derpicdn.net/img/view/2016/9/7/1244106.png,0,0.9975509643554688,0,0,913,808,913,808,princess celestia|twilight sparkle,stillwaterspony
1247246.png,https://derpicdn.net/img/view/2016/9/11/1247246.png,0,0.9816993474960328,317,0,625,288,308,288,starlight glimmer|sunset shimmer|twilight sparkle,dedonnerwolke
1248082.png,https://derpicdn.net/img/view/2016/9/13/1248082.png,0,0.9923654198646544,2069,441,3361,1733,1292,1292,applejack|fluttershy|mane six|pinkie pie|rainbow dash|rarity|twilight sparkle,drawponies
1248082.png,https://derpicdn.net/img/view/2016/9/13/1248082.png,1,0.9855274558067322,1208,363,2336,1491,1128,1128,applejack|fluttershy|mane six|pinkie pie|rainbow dash|rarity|twilight sparkle,drawponies
1248082.png,https://derpicdn.net/img/view/2016/9/13/1248082.png,2,0.9021632075309752,2933,698,3945,1710,1012,1012,applejack|fluttershy|mane six|pinkie pie|rainbow dash|rarity|twilight sparkle,drawponies
1250373.png,https://derpicdn.net/img/view/2016/9/16/1250373.png,0,0.9949390292167664,422,72,912,562,490,490,fluttershy|twilight sparkle,thattagen
125074.jpg,https://derpicdn.net/img/view/2012/10/17/125074.jpg,0,0.9534688591957092,75,19,281,225,206,206,spike|twilight sparkle,shepherd0821
1256248.png,https://derpicdn.net/img/view/2016/9/23/1256248.png,0,0.9395551085472108,206,20,668,482,462,462,discord|twilight sparkle,vavacung
1258.png,https://derpicdn.net/img/view/2012/1/22/1258.png,0,0.985509753227234,48,155,294,401,246,246,apple bloom|applejack|big macintosh|cutie mark crusaders|fluttershy|mane six|pinkie pie|rainbow dash|rarity|scootaloo|spike|sweetie belle|twilight sparkle,shutterflye
1261254.png,https://derpicdn.net/img/view/2016/9/29/1261254.png,0,0.9524226784706116,3269,679,4647,2057,1378,1378,starlight glimmer|sunset shimmer|twilight sparkle,missydakota
1261254.png,https://derpicdn.net/img/view/2016/9/29/1261254.png,1,0.9077792763710022,855,730,2045,1920,1190,1190,starlight glimmer|sunset shimmer|twilight sparkle,missydakota
12630.jpg,https://derpicdn.net/img/view/2012/6/20/12630.jpg,0,0.9715315699577332,345,119,609,383,264,264,princess celestia|twilight sparkle,longinius
12630.jpg,https://derpicdn.net/img/view/2012/6/20/12630.jpg,1,0.9465618133544922,514,307,784,577,270,270,princess celestia|twilight sparkle,longinius
1263304.png,https://derpicdn.net/img/view/2016/10/2/1263304.png,1,0.9273610115051272,867,180,1280,642,413,462,princess cadance|princess celestia|princess luna|twilight sparkle,ggalleonalliance|theroyalprincesses
1263406.png,https://derpicdn.net/img/view/2016/10/2/1263406.png,1,0.9906214475631714,388,62,634,308,246,246,starlight glimmer|sunset shimmer|twilight sparkle,proppane
1263406.png,https://derpicdn.net/img/view/2016/10/2/1263406.png,2,0.9867109060287476,639,80,877,318,238,238,starlight glimmer|sunset shimmer|twilight sparkle,proppane
1263698.png,https://derpicdn.net/img/view/2016/10/2/1263698.png,0,0.9690774083137512,15,8,983,976,968,968,rainbow dash|twilight sparkle,shutterflyeqd
12640.jpg,https://derpicdn.net/img/view/2012/6/20/12640.jpg,0,0.9312346577644348,1932,5626,2484,6178,552,552,apple bloom|applejack|cutie mark crusaders|discord|fluttershy|mane six|pinkie pie|princess celestia|princess luna|rainbow dash|rarity|scootaloo|soarin'|spike|sweetie belle|trixie|twilight sparkle,alexmakovsky
12640.jpg,https://derpicdn.net/img/view/2012/6/20/12640.jpg,1,0.9234625101089478,2382,6071,2818,6507,436,436,apple bloom|applejack|cutie mark crusaders|discord|fluttershy|mane six|pinkie pie|princess celestia|princess luna|rainbow dash|rarity|scootaloo|soarin'|spike|sweetie belle|trixie|twilight sparkle,alexmakovsky
1264144.png,https://derpicdn.net/img/view/2016/10/3/1264144.png,0,0.9884353876113892,250,0,566,280,316,280,princess celestia|twilight sparkle,moyamoya kuroi
1264565.png,https://derpicdn.net/img/view/2016/10/4/1264565.png,0,0.9882055521011353,533,0,951,399,418,399,pinkie pie|twilight sparkle,clouddg
1264697.png,https://derpicdn.net/img/view/2016/10/4/1264697.png,0,0.9432787895202636,543,0,957,366,414,366,spike|twilight sparkle,dm29
1265900.png,https://derpicdn.net/img/view/2016/10/6/1265900.png,0,0.9952932596206664,4,0,374,359,370,359,fluttershy|rainbow dash|rarity|twilight sparkle,pabbley
1265900.png,https://derpicdn.net/img/view/2016/10/6/1265900.png,1,0.9631143808364868,726,73,1062,409,336,336,fluttershy|rainbow dash|rarity|twilight sparkle,pabbley
1266.jpg,https://derpicdn.net/img/view/2012/1/22/1266.jpg,0,0.9950485825538636,646,536,854,774,208,238,apple bloom|applejack|cutie mark crusaders|fluttershy|mane six|pinkie pie|rainbow dash|rarity|scootaloo|sweetie belle|twilight sparkle,shutterflye
1266.jpg,https://derpicdn.net/img/view/2012/1/22/1266.jpg,1,0.9554325938224792,119,432,419,732,300,300,apple bloom|applejack|cutie mark crusaders|fluttershy|mane six|pinkie pie|rainbow dash|rarity|scootaloo|sweetie belle|twilight sparkle,shutterflye
1269433.png,https://derpicdn.net/img/view/2016/10/10/1269433.png,0,0.9678939580917358,2606,655,3170,1219,564,564,apple bloom|applejack|cutie mark crusaders|fluttershy|mane six|pinkie pie|rainbow dash|rarity|scootaloo|spike|starlight glimmer|sweetie belle|twilight sparkle,shutterflyeqd
1270716.png,https://derpicdn.net/img/view/2016/10/11/1270716.png,0,0.9962770938873292,206,63,492,349,286,286,applejack|fluttershy|mane six|pinkie pie|rainbow dash|rarity|spike|starlight glimmer|twilight sparkle,renokim
1270716.png,https://derpicdn.net/img/view/2016/10/11/1270716.png,1,0.9592255353927612,0,230,325,594,325,364,applejack|fluttershy|mane six|pinkie pie|rainbow dash|rarity|spike|starlight glimmer|twilight sparkle,renokim
1270716.png,https://derpicdn.net/img/view/2016/10/11/1270716.png,2,0.9564769268035888,742,273,1044,575,302,302,applejack|fluttershy|mane six|pinkie pie|rainbow dash|rarity|spike|starlight glimmer|twilight sparkle,renokim
1270716.png,https://derpicdn.net/img/view/2016/10/11/1270716.png,3,0.9435853958129884,422,594,806,978,384,384,applejack|fluttershy|mane six|pinkie pie|rainbow dash|rarity|spike|starlight glimmer|twilight sparkle,renokim
1270896.png,https://derpicdn.net/img/view/2016/10/11/1270896.png,0,0.9821277260780334,136,0,507,371,371,371,apple bloom|applejack|fluttershy|twilight sparkle,
1273924.png,https://derpicdn.net/img/view/2016/10/15/1273924.png,0,0.9773179292678832,925,81,1895,1051,970,970,starlight glimmer|twilight sparkle,dybekscoots
1274795.png,https://derpicdn.net/img/view/2016/10/16/1274795.png,0,0.9994184374809264,16,0,638,544,622,544,rainbow dash|twilight sparkle,iloontjexrootser
1275900.png,https://derpicdn.net/img/view/2016/10/18/1275900.png,0,0.9924696683883668,557,74,967,484,410,410,starlight glimmer|trixie|twilight sparkle,akainu_pony
12768.png,https://derpicdn.net/img/view/2012/6/20/12768.png,0,0.976639688014984,1116,1440,1672,1996,556,556,applejack|fluttershy|mane six|pinkie pie|princess celestia|princess luna|rainbow dash|rarity|spike|twilight sparkle,valcron
12768.png,https://derpicdn.net/img/view/2012/6/20/12768.png,1,0.9624390006065368,1194,833,1792,1431,598,598,applejack|fluttershy|mane six|pinkie pie|princess celestia|princess luna|rainbow dash|rarity|spike|twilight sparkle,valcron
1278803.png,https://derpicdn.net/img/view/2016/10/22/1278803.png,0,0.9591203927993774,594,150,1252,808,658,658,sunset shimmer|twilight sparkle,haden-2375
1280231.png,https://derpicdn.net/img/view/2016/10/24/1280231.png,1,0.9049679040908812,101,169,523,591,422,422,applejack|pinkie pie|princess cadance|princess celestia|princess flurry heart|princess luna|rainbow dash|rarity|shining armor|starlight glimmer|twilight sparkle,
1281606.png,https://derpicdn.net/img/view/2016/10/26/1281606.png,0,0.9954276084899902,455,0,1305,828,850,828,rainbow dash|twilight sparkle,pedrohander
1283388.png,https://derpicdn.net/img/view/2016/10/28/1283388.png,0,0.9956849217414856,1918,28,2636,746,718,718,fluttershy|twilight sparkle,wolfy-pony
1283388.png,https://derpicdn.net/img/view/2016/10/28/1283388.png,1,0.9864803552627563,1028,107,1654,733,626,626,fluttershy|twilight sparkle,wolfy-pony
1285595.png,https://derpicdn.net/img/view/2016/10/31/1285595.png,0,0.9898746013641356,699,0,1457,743,758,743,applejack|fluttershy|mane six|pinkie pie|rainbow dash|rarity|twilight sparkle,siggie740
1285595.png,https://derpicdn.net/img/view/2016/10/31/1285595.png,1,0.91859233379364,0,35,753,811,753,776,applejack|fluttershy|mane six|pinkie pie|rainbow dash|rarity|twilight sparkle,siggie740
1287986.png,https://derpicdn.net/img/view/2016/11/3/1287986.png,0,0.9981586337089542,323,719,597,993,274,274,princess celestia|spike|twilight sparkle,dsana
1287986.png,https://derpicdn.net/img/view/2016/11/3/1287986.png,1,0.9967504143714904,913,729,1187,1003,274,274,princess celestia|spike|twilight sparkle,dsana
1289588.png,https://derpicdn.net/img/view/2016/11/5/1289588.png,0,0.9976323246955872,289,0,747,394,458,394,applejack|fluttershy|mane six|pinkie pie|rainbow dash|rarity|spike|twilight sparkle,tsukuda
1289588.png,https://derpicdn.net/img/view/2016/11/5/1289588.png,1,0.986653745174408,118,215,426,523,308,308,applejack|fluttershy|mane six|pinkie pie|rainbow dash|rarity|spike|twilight sparkle,tsukuda
1289588.png,https://derpicdn.net/img/view/2016/11/5/1289588.png,2,0.9361549019813538,737,43,1163,469,426,426,applejack|fluttershy|mane six|pinkie pie|rainbow dash|rarity|spike|twilight sparkle,tsukuda
1290034.png,https://derpicdn.net/img/view/2016/11/6/1290034.png,0,0.926103413105011,38,0,688,416,650,416,starlight glimmer|trixie|twilight sparkle,bow2yourwaifu
12917.png,https://derpicdn.net/img/view/2012/6/20/12917.png,0,0.9919676780700684,1530,513,1920,921,390,408,applejack|fluttershy|mane six|pinkie pie|princess celestia|princess luna|rainbow dash|rarity|spike|twilight sparkle,madmax
1293645.png,https://derpicdn.net/img/view/2016/11/12/1293645.png,0,0.9926661849021912,0,123,631,795,631,672,princess celestia|sunset shimmer|twilight sparkle,curiouskeys
129467.jpg,https://derpicdn.net/img/view/2012/10/22/129467.jpg,0,0.9905777573585508,0,0,332,319,332,319,big macintosh|shining armor|twilight sparkle,redhotkick
129467.jpg,https://derpicdn.net/img/view/2012/10/22/129467.jpg,1,0.9737473130226136,207,59,500,369,293,310,big macintosh|shining armor|twilight sparkle,redhotkick
1295776.png,https://derpicdn.net/img/view/2016/11/14/1295776.png,0,0.9867097735404968,0,73,481,585,481,512,pinkie pie|twilight sparkle,nudeknightart
1297326.png,https://derpicdn.net/img/view/2016/11/16/1297326.png,0,0.9695670604705808,57,546,285,774,228,228,applejack|discord|fluttershy|mane six|pinkie pie|princess cadance|princess celestia|princess flurry heart|princess luna|rainbow dash|rarity|shining armor|spike|starlight glimmer|trixie|twilight sparkle,
1298736.png,https://derpicdn.net/img/view/2016/11/19/1298736.png,0,0.996576726436615,445,121,779,455,334,334,fluttershy|twilight sparkle,redpandacase
1298736.png,https://derpicdn.net/img/view/2016/11/19/1298736.png,1,0.9845625758171082,616,521,934,839,318,318,fluttershy|twilight sparkle,redpandacase
1300138.png,https://derpicdn.net/img/view/2016/11/21/1300138.png,0,0.9647634625434875,219,34,424,326,205,292,fluttershy|pinkie pie|twilight sparkle,pencils
1301126.png,https://derpicdn.net/img/view/2016/11/22/1301126.png,0,0.9935091137886048,0,219,986,1205,986,986,starlight glimmer|twilight sparkle,oinktweetstudios
1301126.png,https://derpicdn.net/img/view/2016/11/22/1301126.png,1,0.9673495888710022,1350,374,2292,1316,942,942,starlight glimmer|twilight sparkle,oinktweetstudios
1301243.png,https://derpicdn.net/img/view/2016/11/22/1301243.png,0,0.9916894435882568,102,165,328,391,226,226,princess celestia|princess luna|queen chrysalis|sunset shimmer|twilight sparkle,bakki
1301243.png,https://derpicdn.net/img/view/2016/11/22/1301243.png,1,0.9896107316017152,269,135,453,319,184,184,princess celestia|princess luna|queen chrysalis|sunset shimmer|twilight sparkle,bakki
1302644.png,https://derpicdn.net/img/view/2016/11/24/1302644.png,0,0.9477000832557678,2515,1562,3247,2294,732,732,applejack|discord|fluttershy|mane six|pinkie pie|rainbow dash|rarity|spike|starlight glimmer|sunset shimmer|twilight sparkle,oinktweetstudios
1303853.png,https://derpicdn.net/img/view/2016/11/26/1303853.png,1,0.9538307189941406,215,11,806,671,591,660,applejack|twilight sparkle,jowybean
1303979.png,https://derpicdn.net/img/view/2016/11/26/1303979.png,0,0.9962383508682252,968,227,1472,731,504,504,rarity|twilight sparkle,ogaraorcynder
1303979.png,https://derpicdn.net/img/view/2016/11/26/1303979.png,1,0.9848624467849731,377,277,875,775,498,498,rarity|twilight sparkle,ogaraorcynder
1304810.png,https://derpicdn.net/img/view/2016/11/27/1304810.png,0,0.939262628555298,114,233,1408,1527,1294,1294,rainbow dash|twilight sparkle,ashtoneer
1307356.png,https://derpicdn.net/img/view/2016/12/1/1307356.png,0,0.9996953010559082,496,235,844,583,348,348,trixie|twilight sparkle,nudeknightart
1308380.png,https://derpicdn.net/img/view/2016/12/2/1308380.png,0,0.9957649111747742,42,102,474,534,432,432,sunset shimmer|twilight sparkle,little-tweenframes
1308380.png,https://derpicdn.net/img/view/2016/12/2/1308380.png,1,0.9940449595451356,520,294,986,760,466,466,sunset shimmer|twilight sparkle,little-tweenframes
1309514.png,https://derpicdn.net/img/view/2016/12/4/1309514.png,0,0.9820102453231812,332,331,582,581,250,250,applejack|fluttershy|mane six|pinkie pie|rainbow dash|rarity|twilight sparkle,osawari64
1309514.png,https://derpicdn.net/img/view/2016/12/4/1309514.png,1,0.9810761213302612,348,0,632,266,284,266,applejack|fluttershy|mane six|pinkie pie|rainbow dash|rarity|twilight sparkle,osawari64
1309514.png,https://derpicdn.net/img/view/2016/12/4/1309514.png,2,0.912501871585846,48,357,258,567,210,210,applejack|fluttershy|mane six|pinkie pie|rainbow dash|rarity|twilight sparkle,osawari64
1309852.png,https://derpicdn.net/img/view/2016/12/4/1309852.png,0,0.9618833065032959,58,44,470,456,412,412,shining armor|twilight sparkle,novaintellus
1309852.png,https://derpicdn.net/img/view/2016/12/4/1309852.png,1,0.9419015645980836,306,6,624,324,318,318,shining armor|twilight sparkle,novaintellus
1312801.png,https://derpicdn.net/img/view/2016/12/8/1312801.png,0,0.9722585678100586,0,0,1909,1982,1909,1982,sunset shimmer|twilight sparkle,gaelledragons
1315564.png,https://derpicdn.net/img/view/2016/12/12/1315564.png,0,0.9376795291900636,222,0,1148,840,926,840,rainbow dash|twilight sparkle,zogzor
1321981.png,https://derpicdn.net/img/view/2016/12/21/1321981.png,0,0.9510130882263184,331,480,731,880,400,400,apple bloom|applejack|big macintosh|fluttershy|granny smith|mane six|pinkie pie|rainbow dash|rarity|spike|twilight sparkle,pixelkitties
1321981.png,https://derpicdn.net/img/view/2016/12/21/1321981.png,1,0.9503241181373596,322,0,640,259,318,259,apple bloom|applejack|big macintosh|fluttershy|granny smith|mane six|pinkie pie|rainbow dash|rarity|spike|twilight sparkle,pixelkitties
1322060.png,https://derpicdn.net/img/view/2016/12/21/1322060.png,0,0.9932043552398682,119,103,561,545,442,442,sunset shimmer|twilight sparkle,little-tweenframes
1322060.png,https://derpicdn.net/img/view/2016/12/21/1322060.png,1,0.9819091558456421,644,134,1068,558,424,424,sunset shimmer|twilight sparkle,little-tweenframes
1322618.png,https://derpicdn.net/img/view/2016/12/22/1322618.png,0,0.9983143210411072,556,400,1110,954,554,554,applejack|fluttershy|mane six|pinkie pie|rainbow dash|rarity|spike|starlight glimmer|twilight sparkle,cloureed
1322618.png,https://derpicdn.net/img/view/2016/12/22/1322618.png,2,0.9895604848861694,1086,357,1664,935,578,578,applejack|fluttershy|mane six|pinkie pie|rainbow dash|rarity|spike|starlight glimmer|twilight sparkle,cloureed
1322618.png,https://derpicdn.net/img/view/2016/12/22/1322618.png,4,0.9661877155303956,1707,1173,2107,1573,400,400,applejack|fluttershy|mane six|pinkie pie|rainbow dash|rarity|spike|starlight glimmer|twilight sparkle,cloureed
1322751.png,https://derpicdn.net/img/view/2016/12/22/1322751.png,0,0.9260845184326172,69,0,841,626,772,626,sunset shimmer|twilight sparkle,little-tweenframes
1323980.png,https://derpicdn.net/img/view/2016/12/24/1323980.png,1,0.9076233506202698,663,383,933,653,270,270,princess cadance|princess flurry heart|rainbow dash|shining armor|spike|twilight sparkle,tim-kangaroo
1324324.png,https://derpicdn.net/img/view/2016/12/24/1324324.png,0,0.9886702895164492,67,1476,717,2126,650,650,princess cadance|princess celestia|princess flurry heart|princess luna|shining armor|twilight sparkle,pridark
1324324.png,https://derpicdn.net/img/view/2016/12/24/1324324.png,1,0.9761550426483154,1991,1742,2619,2370,628,628,princess cadance|princess celestia|princess flurry heart|princess luna|shining armor|twilight sparkle,pridark
1327471.png,https://derpicdn.net/img/view/2016/12/29/1327471.png,0,0.9859479069709778,621,123,1001,503,380,380,fluttershy|pinkie pie|rainbow dash|twilight sparkle,omegaozone
1327471.png,https://derpicdn.net/img/view/2016/12/29/1327471.png,1,0.9817762970924376,967,183,1219,435,252,252,fluttershy|pinkie pie|rainbow dash|twilight sparkle,omegaozone
1327471.png,https://derpicdn.net/img/view/2016/12/29/1327471.png,2,0.9788256287574768,62,188,312,438,250,250,fluttershy|pinkie pie|rainbow dash|twilight sparkle,omegaozone
1329302.png,https://derpicdn.net/img/view/2016/12/31/1329302.png,0,0.9961732625961304,5204,749,6120,1665,916,916,applejack|fluttershy|mane six|pinkie pie|rainbow dash|rarity|spike|starlight glimmer|twilight sparkle,asika-aida
1331210.png,https://derpicdn.net/img/view/2017/1/3/1331210.png,0,0.9983518123626708,659,186,959,486,300,300,princess cadance|princess flurry heart|shining armor|twilight sparkle,dm29
1336567.png,https://derpicdn.net/img/view/2017/1/10/1336567.png,0,0.9984667897224426,417,0,961,536,544,536,sunset shimmer|twilight sparkle,polkadot-creeper
1337194.png,https://derpicdn.net/img/view/2017/1/11/1337194.png,0,0.9938666224479676,1006,442,1890,1326,884,884,discord|twilight sparkle,underpable
1338478.png,https://derpicdn.net/img/view/2017/1/13/1338478.png,0,0.97754967212677,206,88,602,484,396,396,princess cadance|princess celestia|twilight sparkle,dm29
1338478.png,https://derpicdn.net/img/view/2017/1/13/1338478.png,1,0.9588979482650756,510,187,870,547,360,360,princess cadance|princess celestia|twilight sparkle,dm29
13390.jpg,https://derpicdn.net/img/view/2012/6/21/13390.jpg,0,0.9463606476783752,362,361,734,733,372,372,applejack|fluttershy|mane six|pinkie pie|rainbow dash|rarity|spike|twilight sparkle,porkcow
1341834.png,https://derpicdn.net/img/view/2017/1/18/1341834.png,0,0.9927152395248412,824,193,1356,725,532,532,pinkie pie|twilight sparkle,heir-of-rick
1347715.png,https://derpicdn.net/img/view/2017/1/25/1347715.png,0,0.994554042816162,829,200,1343,714,514,514,pinkie pie|twilight sparkle,heir-of-rick
1347715.png,https://derpicdn.net/img/view/2017/1/25/1347715.png,1,0.9210090637207032,179,121,681,623,502,502,pinkie pie|twilight sparkle,heir-of-rick
134809.jpg,https://derpicdn.net/img/view/2012/10/28/134809.jpg,0,0.9997405409812928,2196,238,3150,1192,954,954,princess cadance|shining armor|twilight sparkle,holivi
134809.jpg,https://derpicdn.net/img/view/2012/10/28/134809.jpg,1,0.9911007881164552,1116,792,1756,1432,640,640,princess cadance|shining armor|twilight sparkle,holivi
134809.jpg,https://derpicdn.net/img/view/2012/10/28/134809.jpg,2,0.956985354423523,666,586,1296,1216,630,630,princess cadance|shining armor|twilight sparkle,holivi
1348298.png,https://derpicdn.net/img/view/2017/1/26/1348298.png,0,0.9931946396827698,58,136,510,588,452,452,starlight glimmer|trixie|twilight sparkle,duop-qoub|post-it
1348298.png,https://derpicdn.net/img/view/2017/1/26/1348298.png,1,0.983176052570343,363,509,891,1037,528,528,starlight glimmer|trixie|twilight sparkle,duop-qoub|post-it
1350116.png,https://derpicdn.net/img/view/2017/1/29/1350116.png,0,0.9997230172157288,491,234,843,586,352,352,trixie|twilight sparkle,nudeknightart
1350293.png,https://derpicdn.net/img/view/2017/1/29/1350293.png,0,0.9958739876747132,975,913,1683,1621,708,708,applejack|fluttershy|mane six|pinkie pie|rainbow dash|rarity|starlight glimmer|twilight sparkle,doekitty
1350293.png,https://derpicdn.net/img/view/2017/1/29/1350293.png,1,0.9956873655319214,83,1443,741,2101,658,658,applejack|fluttershy|mane six|pinkie pie|rainbow dash|rarity|starlight glimmer|twilight sparkle,doekitty
1350293.png,https://derpicdn.net/img/view/2017/1/29/1350293.png,3,0.9912489652633668,1388,0,1920,519,532,519,applejack|fluttershy|mane six|pinkie pie|rainbow dash|rarity|starlight glimmer|twilight sparkle,doekitty
1350293.png,https://derpicdn.net/img/view/2017/1/29/1350293.png,4,0.9887936115264891,928,2042,1584,2698,656,656,applejack|fluttershy|mane six|pinkie pie|rainbow dash|rarity|starlight glimmer|twilight sparkle,doekitty
1350293.png,https://derpicdn.net/img/view/2017/1/29/1350293.png,5,0.9848889708518982,258,0,1016,757,758,757,applejack|fluttershy|mane six|pinkie pie|rainbow dash|rarity|starlight glimmer|twilight sparkle,doekitty
1351501.png,https://derpicdn.net/img/view/2017/1/30/1351501.png,1,0.9119388461112976,549,42,759,252,210,210,rainbow dash|twilight sparkle,gorecatqueen
1359410.png,https://derpicdn.net/img/view/2017/2/10/1359410.png,1,0.9983539581298828,0,1082,305,1398,305,316,applejack|fluttershy|mane six|pinkie pie|rainbow dash|rarity|spike|twilight sparkle,vavacung
1359410.png,https://derpicdn.net/img/view/2017/2/10/1359410.png,2,0.9974124431610109,1190,570,1500,906,310,336,applejack|fluttershy|mane six|pinkie pie|rainbow dash|rarity|spike|twilight sparkle,vavacung
1359410.png,https://derpicdn.net/img/view/2017/2/10/1359410.png,3,0.9961224794387816,215,609,503,897,288,288,applejack|fluttershy|mane six|pinkie pie|rainbow dash|rarity|spike|twilight sparkle,vavacung
1359410.png,https://derpicdn.net/img/view/2017/2/10/1359410.png,4,0.9933058619499208,31,600,321,890,290,290,applejack|fluttershy|mane six|pinkie pie|rainbow dash|rarity|spike|twilight sparkle,vavacung
1359410.png,https://derpicdn.net/img/view/2017/2/10/1359410.png,5,0.9870675802230836,453,1520,829,1896,376,376,applejack|fluttershy|mane six|pinkie pie|rainbow dash|rarity|spike|twilight sparkle,vavacung
1359410.png,https://derpicdn.net/img/view/2017/2/10/1359410.png,6,0.9797050356864928,1017,9,1417,409,400,400,applejack|fluttershy|mane six|pinkie pie|rainbow dash|rarity|spike|twilight sparkle,vavacung
136208.png,https://derpicdn.net/img/view/2012/10/30/136208.png,0,0.9014976620674132,8,0,256,235,248,235,spike|twilight sparkle,jiayi
1362751.png,https://derpicdn.net/img/view/2017/2/14/1362751.png,0,0.9953718781471252,1905,1619,2263,1977,358,358,applejack|fluttershy|mane six|pinkie pie|rainbow dash|rarity|starlight glimmer|sunset shimmer|trixie|twilight sparkle,phyllismi
1362751.png,https://derpicdn.net/img/view/2017/2/14/1362751.png,1,0.9930648207664492,23,34,473,484,450,450,applejack|fluttershy|mane six|pinkie pie|rainbow dash|rarity|starlight glimmer|sunset shimmer|trixie|twilight sparkle,phyllismi
1362751.png,https://derpicdn.net/img/view/2017/2/14/1362751.png,2,0.9913372993469238,1596,792,2010,1206,414,414,applejack|fluttershy|mane six|pinkie pie|rainbow dash|rarity|starlight glimmer|sunset shimmer|trixie|twilight sparkle,phyllismi
1362751.png,https://derpicdn.net/img/view/2017/2/14/1362751.png,3,0.989328920841217,25,846,427,1248,402,402,applejack|fluttershy|mane six|pinkie pie|rainbow dash|rarity|starlight glimmer|sunset shimmer|trixie|twilight sparkle,phyllismi
1362751.png,https://derpicdn.net/img/view/2017/2/14/1362751.png,4,0.9763206243515016,286,1625,668,2007,382,382,applejack|fluttershy|mane six|pinkie pie|rainbow dash|rarity|starlight glimmer|sunset shimmer|trixie|twilight sparkle,phyllismi
1362751.png,https://derpicdn.net/img/view/2017/2/14/1362751.png,5,0.9760966897010804,875,38,1375,538,500,500,applejack|fluttershy|mane six|pinkie pie|rainbow dash|rarity|starlight glimmer|sunset shimmer|trixie|twilight sparkle,phyllismi
1362751.png,https://derpicdn.net/img/view/2017/2/14/1362751.png,6,0.973807692527771,1133,829,1523,1219,390,390,applejack|fluttershy|mane six|pinkie pie|rainbow dash|rarity|starlight glimmer|sunset shimmer|trixie|twilight sparkle,phyllismi
1362751.png,https://derpicdn.net/img/view/2017/2/14/1362751.png,7,0.9728814959526062,1892,107,2324,539,432,432,applejack|fluttershy|mane six|pinkie pie|rainbow dash|rarity|starlight glimmer|sunset shimmer|trixie|twilight sparkle,phyllismi
1364048.png,https://derpicdn.net/img/view/2017/2/15/1364048.png,0,0.9958176016807556,445,0,1551,963,1106,963,sweetie belle|twilight sparkle,marsminer
1364074.png,https://derpicdn.net/img/view/2017/2/15/1364074.png,0,0.9920650720596312,411,0,1053,546,642,546,spike|twilight sparkle,tsitra360
1365301.png,https://derpicdn.net/img/view/2017/2/17/1365301.png,1,0.9606157541275024,3485,2206,4303,3024,818,818,applejack|fluttershy|mane six|pinkie pie|rainbow dash|rarity|starlight glimmer|sunset shimmer|twilight sparkle,limedazzle
1367476.png,https://derpicdn.net/img/view/2017/2/19/1367476.png,0,0.9651479721069336,125,31,1341,1247,1216,1216,starlight glimmer|twilight sparkle,shogundun|bloodatius
1369124.png,https://derpicdn.net/img/view/2017/2/21/1369124.png,2,0.9219383597373962,172,333,470,631,298,298,princess celestia|sunset shimmer|twilight sparkle,little-tweenframes
1371071.png,https://derpicdn.net/img/view/2017/2/23/1371071.png,1,0.9435253143310548,467,76,611,220,144,144,applejack|fluttershy|mane six|pinkie pie|rainbow dash|rarity|twilight sparkle,flash equestria photography
1371627.png,https://derpicdn.net/img/view/2017/2/24/1371627.png,0,0.9962950348854064,1572,136,2046,610,474,474,princess cadance|twilight sparkle,amarynceus
1371627.png,https://derpicdn.net/img/view/2017/2/24/1371627.png,1,0.9927040338516236,1121,16,1671,566,550,550,princess cadance|twilight sparkle,amarynceus
1373238.png,https://derpicdn.net/img/view/2017/2/25/1373238.png,0,0.991944432258606,119,0,615,475,496,475,shining armor|twilight sparkle,wubcakeva
1376410.png,https://derpicdn.net/img/view/2017/3/1/1376410.png,0,0.9957404136657716,1054,0,1275,248,221,248,applejack|fluttershy|mane six|pinkie pie|rainbow dash|rarity|shining armor|spike|twilight sparkle,equestria-prevails|jay fosgitt
1376410.png,https://derpicdn.net/img/view/2017/3/1/1376410.png,1,0.9786248207092284,16,284,228,496,212,212,applejack|fluttershy|mane six|pinkie pie|rainbow dash|rarity|shining armor|spike|twilight sparkle,equestria-prevails|jay fosgitt
1376410.png,https://derpicdn.net/img/view/2017/3/1/1376410.png,3,0.9723794460296632,818,543,1072,797,254,254,applejack|fluttershy|mane six|pinkie pie|rainbow dash|rarity|shining armor|spike|twilight sparkle,equestria-prevails|jay fosgitt
1376410.png,https://derpicdn.net/img/view/2017/3/1/1376410.png,4,0.9674111604690552,565,108,837,380,272,272,applejack|fluttershy|mane six|pinkie pie|rainbow dash|rarity|shining armor|spike|twilight sparkle,equestria-prevails|jay fosgitt
1376410.png,https://derpicdn.net/img/view/2017/3/1/1376410.png,5,0.9522813558578492,194,215,472,493,278,278,applejack|fluttershy|mane six|pinkie pie|rainbow dash|rarity|shining armor|spike|twilight sparkle,equestria-prevails|jay fosgitt
1379855.png,https://derpicdn.net/img/view/2017/3/5/1379855.png,0,0.9756248593330384,534,224,1218,908,684,684,princess celestia|spike|twilight sparkle,ragurimo
1379855.png,https://derpicdn.net/img/view/2017/3/5/1379855.png,1,0.9009358882904052,1520,1216,1924,1620,404,404,princess celestia|spike|twilight sparkle,ragurimo
1380839.png,https://derpicdn.net/img/view/2017/3/6/1380839.png,0,0.9961156249046326,643,1050,1031,1438,388,388,applejack|fluttershy|mane six|pinkie pie|rainbow dash|rarity|spike|twilight sparkle,vavacung
1380839.png,https://derpicdn.net/img/view/2017/3/6/1380839.png,1,0.9932016730308532,1028,0,1448,401,420,401,applejack|fluttershy|mane six|pinkie pie|rainbow dash|rarity|spike|twilight sparkle,vavacung
1380839.png,https://derpicdn.net/img/view/2017/3/6/1380839.png,2,0.9764697551727296,964,981,1330,1347,366,366,applejack|fluttershy|mane six|pinkie pie|rainbow dash|rarity|spike|twilight sparkle,vavacung
1380839.png,https://derpicdn.net/img/view/2017/3/6/1380839.png,3,0.969214916229248,205,66,561,422,356,356,applejack|fluttershy|mane six|pinkie pie|rainbow dash|rarity|spike|twilight sparkle,vavacung
1380839.png,https://derpicdn.net/img/view/2017/3/6/1380839.png,4,0.9647543430328368,0,78,335,424,335,346,applejack|fluttershy|mane six|pinkie pie|rainbow dash|rarity|spike|twilight sparkle,vavacung
1389755.png,https://derpicdn.net/img/view/2017/3/17/1389755.png,1,0.9914591312408448,546,243,780,477,234,234,applejack|fluttershy|mane six|pinkie pie|rainbow dash|rarity|twilight sparkle,
1390966.png,https://derpicdn.net/img/view/2017/3/19/1390966.png,0,0.9975979924201964,129,0,429,296,300,296,princess luna|twilight sparkle,lulubell
1391850.png,https://derpicdn.net/img/view/2017/3/20/1391850.png,0,0.9899305701255798,88,271,852,1035,764,764,starlight glimmer|twilight sparkle,shutterflyeqd
1392258.png,https://derpicdn.net/img/view/2017/3/20/1392258.png,1,0.9144666194915771,194,4,448,258,254,254,applejack|fluttershy|mane six|pinkie pie|rainbow dash|rarity|twilight sparkle,vdru7
1393284.png,https://derpicdn.net/img/view/2017/3/21/1393284.png,0,0.9810547232627868,214,33,675,495,461,462,trixie|twilight sparkle,hardbrony
1396665.png,https://derpicdn.net/img/view/2017/3/26/1396665.png,1,0.9695408940315248,616,25,1096,505,480,480,spike|twilight sparkle,starchasesketches
1397279.png,https://derpicdn.net/img/view/2017/3/26/1397279.png,0,0.9830381274223328,0,173,343,529,343,356,princess luna|twilight sparkle,lulubell
1400618.png,https://derpicdn.net/img/view/2017/3/31/1400618.png,0,0.9954401254653932,376,191,602,417,226,226,applejack|fluttershy|mane six|pinkie pie|rainbow dash|rarity|starlight glimmer|twilight sparkle,dm29
1401158.png,https://derpicdn.net/img/view/2017/4/1/1401158.png,0,0.9745804071426392,415,243,631,459,216,216,applejack|spike|twilight sparkle,dm29
1405863.png,https://derpicdn.net/img/view/2017/4/7/1405863.png,0,0.9878313541412354,3,106,739,842,736,736,apple bloom|cutie mark crusaders|scootaloo|sweetie belle|twilight sparkle,vanillaghosties
1405863.png,https://derpicdn.net/img/view/2017/4/7/1405863.png,1,0.9682685136795044,1093,659,1387,953,294,294,apple bloom|cutie mark crusaders|scootaloo|sweetie belle|twilight sparkle,vanillaghosties
1407928.png,https://derpicdn.net/img/view/2017/4/9/1407928.png,0,0.9976086616516112,425,0,667,237,242,237,trixie|twilight sparkle,professordoctorc
1409973.png,https://derpicdn.net/img/view/2017/4/12/1409973.png,1,0.9681589603424072,512,159,780,427,268,268,applejack|fluttershy|mane six|pinkie pie|rainbow dash|rarity|scootaloo|twilight sparkle,midnightpremiere
1409973.png,https://derpicdn.net/img/view/2017/4/12/1409973.png,2,0.962181270122528,240,0,504,226,264,226,applejack|fluttershy|mane six|pinkie pie|rainbow dash|rarity|scootaloo|twilight sparkle,midnightpremiere
1415555.png,https://derpicdn.net/img/view/2017/4/18/1415555.png,0,0.9993306994438172,341,217,745,621,404,404,trixie|twilight sparkle,alasou
1415555.png,https://derpicdn.net/img/view/2017/4/18/1415555.png,1,0.995823860168457,680,273,938,531,258,258,trixie|twilight sparkle,alasou
1416337.png,https://derpicdn.net/img/view/2017/4/19/1416337.png,0,0.9952176213264464,1900,828,2776,1704,876,876,princess celestia|twilight sparkle,lrusu
1416886.png,https://derpicdn.net/img/view/2017/4/20/1416886.png,0,0.957616686820984,524,228,826,530,302,302,princess luna|sunset shimmer|twilight sparkle,little-tweenframes
1417400.png,https://derpicdn.net/img/view/2017/4/21/1417400.png,0,0.9974349737167358,629,0,1511,790,882,790,trixie|twilight sparkle,paskanaakka
1417536.png,https://derpicdn.net/img/view/2017/4/21/1417536.png,0,0.9964144229888916,1066,224,1528,686,462,462,princess celestia|twilight sparkle,geomancing
1417536.png,https://derpicdn.net/img/view/2017/4/21/1417536.png,1,0.97585791349411,10,0,742,607,732,607,princess celestia|twilight sparkle,geomancing
1418097.png,https://derpicdn.net/img/view/2017/4/22/1418097.png,0,0.9877232909202576,398,39,916,557,518,518,applejack|fluttershy|mane six|pinkie pie|rainbow dash|rarity|twilight sparkle,sonikku001
1418487.png,https://derpicdn.net/img/view/2017/4/22/1418487.png,2,0.9932417273521424,649,608,1117,1076,468,468,applejack|fluttershy|mane six|pinkie pie|rainbow dash|rarity|starlight glimmer|trixie|twilight sparkle,kemofoo
1418487.png,https://derpicdn.net/img/view/2017/4/22/1418487.png,3,0.992288053035736,0,667,593,1295,593,628,applejack|fluttershy|mane six|pinkie pie|rainbow dash|rarity|starlight glimmer|trixie|twilight sparkle,kemofoo
1418614.png,https://derpicdn.net/img/view/2017/4/22/1418614.png,0,0.9775429368019104,237,1,1099,863,862,862,princess flurry heart|twilight sparkle,sakuracheetah
1418614.png,https://derpicdn.net/img/view/2017/4/22/1418614.png,1,0.9143739938735962,129,633,515,1019,386,386,princess flurry heart|twilight sparkle,sakuracheetah
1419159.png,https://derpicdn.net/img/view/2017/4/23/1419159.png,0,0.9920451641082764,568,666,806,904,238,238,applejack|fluttershy|mane six|pinkie pie|rainbow dash|rarity|starlight glimmer|sunset shimmer|trixie|twilight sparkle,starshame
1419159.png,https://derpicdn.net/img/view/2017/4/23/1419159.png,1,0.9909165501594543,604,113,838,347,234,234,applejack|fluttershy|mane six|pinkie pie|rainbow dash|rarity|starlight glimmer|sunset shimmer|trixie|twilight sparkle,starshame
1419159.png,https://derpicdn.net/img/view/2017/4/23/1419159.png,2,0.984408676624298,347,423,557,633,210,210,applejack|fluttershy|mane six|pinkie pie|rainbow dash|rarity|starlight glimmer|sunset shimmer|trixie|twilight sparkle,starshame
1419159.png,https://derpicdn.net/img/view/2017/4/23/1419159.png,4,0.9679326415061952,114,75,408,369,294,294,applejack|fluttershy|mane six|pinkie pie|rainbow dash|rarity|starlight glimmer|sunset shimmer|trixie|twilight sparkle,starshame
1420377.png,https://derpicdn.net/img/view/2017/4/24/1420377.png,0,0.9892147183418274,288,62,884,658,596,596,princess flurry heart|twilight sparkle,dusthiel
1420556.png,https://derpicdn.net/img/view/2017/4/24/1420556.png,0,0.9879418611526488,483,60,1200,800,717,740,rarity|twilight sparkle,acesrockz
1420556.png,https://derpicdn.net/img/view/2017/4/24/1420556.png,1,0.974336326122284,0,48,740,822,740,774,rarity|twilight sparkle,acesrockz
1420699.png,https://derpicdn.net/img/view/2017/4/24/1420699.png,0,0.9756346344947816,3323,329,6657,3663,3334,3334,princess flurry heart|twilight sparkle,shutterflyeqd
1422391.png,https://derpicdn.net/img/view/2017/4/26/1422391.png,0,0.9975584149360656,493,524,911,942,418,418,starlight glimmer|twilight sparkle,cofotory
1422391.png,https://derpicdn.net/img/view/2017/4/26/1422391.png,1,0.9895721077919006,157,179,575,597,418,418,starlight glimmer|twilight sparkle,cofotory
1423332.png,https://derpicdn.net/img/view/2017/4/28/1423332.png,0,0.9601139426231384,173,0,561,372,388,372,princess flurry heart|twilight sparkle,inuhoshi-to-darkpen
1423927.png,https://derpicdn.net/img/view/2017/4/28/1423927.png,0,0.9139551520347596,870,1087,1138,1355,268,268,apple bloom|applejack|big macintosh|fluttershy|granny smith|pinkie pie|queen chrysalis|rainbow dash|rarity|scootaloo|spike|starlight glimmer|sweetie belle|twilight sparkle,
1424469.png,https://derpicdn.net/img/view/2017/4/29/1424469.png,0,0.9371760487556458,162,2834,406,3078,244,244,applejack|discord|fluttershy|pinkie pie|rainbow dash|rarity|trixie|twilight sparkle,lopoddity
1426176.png,https://derpicdn.net/img/view/2017/5/1/1426176.png,0,0.9968050718307496,560,708,1066,1214,506,506,spike|twilight sparkle,qzygugu
1427972.png,https://derpicdn.net/img/view/2017/5/3/1427972.png,0,0.9879776835441588,139,70,525,456,386,386,princess flurry heart|twilight sparkle,imaplatypus
1428059.png,https://derpicdn.net/img/view/2017/5/4/1428059.png,0,0.9893536567687988,180,96,680,596,500,500,princess flurry heart|twilight sparkle,imaplatypus
1428730.png,https://derpicdn.net/img/view/2017/5/4/1428730.png,0,0.9964750409126282,175,81,689,595,514,514,princess flurry heart|twilight sparkle,imaplatypus
1431875.png,https://derpicdn.net/img/view/2017/5/8/1431875.png,0,0.9100965261459352,347,120,617,390,270,270,sunset shimmer|twilight sparkle,jase1505
1432905.png,https://derpicdn.net/img/view/2017/5/9/1432905.png,0,0.9815707206726074,1400,0,2484,1022,1084,1022,apple bloom|twilight sparkle,shutterflyeqd
1434557.png,https://derpicdn.net/img/view/2017/5/12/1434557.png,0,0.9541253447532654,943,428,1195,680,252,252,spike|twilight sparkle,dm29
1434607.png,https://derpicdn.net/img/view/2017/5/12/1434607.png,0,0.9984341263771056,2389,402,3797,1810,1408,1408,princess cadance|princess celestia|princess flurry heart|princess luna|twilight sparkle,darkest-lunar-flower
1434607.png,https://derpicdn.net/img/view/2017/5/12/1434607.png,1,0.9923593997955322,50,1305,1220,2475,1170,1170,princess cadance|princess celestia|princess flurry heart|princess luna|twilight sparkle,darkest-lunar-flower
1437936.png,https://derpicdn.net/img/view/2017/5/16/1437936.png,0,0.991986870765686,984,81,1386,483,402,402,spike|twilight sparkle,dsana
1437936.png,https://derpicdn.net/img/view/2017/5/16/1437936.png,1,0.9833288788795472,89,6,743,660,654,654,spike|twilight sparkle,dsana
1437936.png,https://derpicdn.net/img/view/2017/5/16/1437936.png,2,0.9810792207717896,760,294,1098,632,338,338,spike|twilight sparkle,dsana
1440887.png,https://derpicdn.net/img/view/2017/5/20/1440887.png,0,0.9208050966262816,528,180,1198,850,670,670,spike|twilight sparkle,phyllismi
1441248.png,https://derpicdn.net/img/view/2017/5/20/1441248.png,0,0.9753830432891846,473,451,781,759,308,308,pinkie pie|twilight sparkle,athan
1441248.png,https://derpicdn.net/img/view/2017/5/20/1441248.png,1,0.960379421710968,43,48,365,370,322,322,pinkie pie|twilight sparkle,athan
1441715.png,https://derpicdn.net/img/view/2017/5/20/1441715.png,0,0.9488379955291748,324,0,1824,1090,1500,1090,starlight glimmer|twilight sparkle,
1441918.png,https://derpicdn.net/img/view/2017/5/21/1441918.png,0,0.9537815451622008,119,0,500,404,381,404,starlight glimmer|twilight sparkle,
1446284.png,https://derpicdn.net/img/view/2017/5/26/1446284.png,0,0.9994091987609864,554,469,866,781,312,312,discord|princess celestia|rainbow dash|soarin'|sunset shimmer|twilight sparkle,hikariviny
1446284.png,https://derpicdn.net/img/view/2017/5/26/1446284.png,1,0.997195601463318,833,511,1123,801,290,290,discord|princess celestia|rainbow dash|soarin'|sunset shimmer|twilight sparkle,hikariviny
1446981.png,https://derpicdn.net/img/view/2017/5/27/1446981.png,0,0.9961900115013124,42,530,570,1058,528,528,rainbow dash|twilight sparkle,
144817.png,https://derpicdn.net/img/view/2012/11/7/144817.png,1,0.939606785774231,372,224,670,522,298,298,applejack|trixie|twilight sparkle,pixelkitties
1449307.png,https://derpicdn.net/img/view/2017/5/29/1449307.png,0,0.9998440742492676,2003,260,3021,1278,1018,1018,pinkie pie|twilight sparkle,lupiarts
1449809.png,https://derpicdn.net/img/view/2017/5/30/1449809.png,0,0.9884691834449768,2,0,572,524,570,524,applejack|fluttershy|mane six|pinkie pie|rainbow dash|rarity|twilight sparkle,
1452162.png,https://derpicdn.net/img/view/2017/6/2/1452162.png,0,0.9940589666366576,668,8,1000,356,332,348,sunset shimmer|twilight sparkle,little-tweenframes
1453331.png,https://derpicdn.net/img/view/2017/6/3/1453331.png,0,0.9997648596763612,1326,35,2124,833,798,798,princess flurry heart|twilight sparkle,percy-mcmurphy
1453331.png,https://derpicdn.net/img/view/2017/6/3/1453331.png,1,0.9964442849159241,586,329,1224,967,638,638,princess flurry heart|twilight sparkle,percy-mcmurphy
1453854.png,https://derpicdn.net/img/view/2017/6/4/1453854.png,0,0.9993521571159364,506,140,796,430,290,290,princess cadance|princess flurry heart|shining armor|spike|twilight sparkle,phyllismi
1453854.png,https://derpicdn.net/img/view/2017/6/4/1453854.png,1,0.996966540813446,835,106,1099,370,264,264,princess cadance|princess flurry heart|shining armor|spike|twilight sparkle,phyllismi
1453854.png,https://derpicdn.net/img/view/2017/6/4/1453854.png,2,0.9723111987113952,303,82,607,386,304,304,princess cadance|princess flurry heart|shining armor|spike|twilight sparkle,phyllismi
1455914.png,https://derpicdn.net/img/view/2017/6/7/1455914.png,0,0.9968083500862122,2150,707,2876,1433,726,726,princess luna|rainbow dash|twilight sparkle,helmie-d
1455914.png,https://derpicdn.net/img/view/2017/6/7/1455914.png,1,0.9956181049346924,1577,519,2355,1297,778,778,princess luna|rainbow dash|twilight sparkle,helmie-d
1456084.png,https://derpicdn.net/img/view/2017/6/7/1456084.png,0,0.9985882639884948,166,609,562,1005,396,396,spike|sunset shimmer|twilight sparkle,little-tweenframes
1456084.png,https://derpicdn.net/img/view/2017/6/7/1456084.png,1,0.9957454204559326,539,968,807,1236,268,268,spike|sunset shimmer|twilight sparkle,little-tweenframes
1456084.png,https://derpicdn.net/img/view/2017/6/7/1456084.png,2,0.939275324344635,782,632,1160,1010,378,378,spike|sunset shimmer|twilight sparkle,little-tweenframes
1459645.png,https://derpicdn.net/img/view/2017/6/11/1459645.png,0,0.9993168115615844,45,385,761,1101,716,716,applejack|fluttershy|mane six|pinkie pie|princess celestia|princess luna|rainbow dash|rarity|spike|twilight sparkle,docwario
1459645.png,https://derpicdn.net/img/view/2017/6/11/1459645.png,1,0.999110758304596,1478,1094,2194,1810,716,716,applejack|fluttershy|mane six|pinkie pie|princess celestia|princess luna|rainbow dash|rarity|spike|twilight sparkle,docwario
1459645.png,https://derpicdn.net/img/view/2017/6/11/1459645.png,2,0.9967999458312988,680,277,1588,1185,908,908,applejack|fluttershy|mane six|pinkie pie|princess celestia|princess luna|rainbow dash|rarity|spike|twilight sparkle,docwario
1459645.png,https://derpicdn.net/img/view/2017/6/11/1459645.png,3,0.9952245354652404,51,1113,743,1805,692,692,applejack|fluttershy|mane six|pinkie pie|princess celestia|princess luna|rainbow dash|rarity|spike|twilight sparkle,docwario
1459645.png,https://derpicdn.net/img/view/2017/6/11/1459645.png,4,0.990462601184845,24,1874,684,2534,660,660,applejack|fluttershy|mane six|pinkie pie|princess celestia|princess luna|rainbow dash|rarity|spike|twilight sparkle,docwario
1459645.png,https://derpicdn.net/img/view/2017/6/11/1459645.png,5,0.9866747260093688,1493,433,2201,1141,708,708,applejack|fluttershy|mane six|pinkie pie|princess celestia|princess luna|rainbow dash|rarity|spike|twilight sparkle,docwario
1459645.png,https://derpicdn.net/img/view/2017/6/11/1459645.png,6,0.98395174741745,1440,1737,2250,2619,810,882,applejack|fluttershy|mane six|pinkie pie|princess celestia|princess luna|rainbow dash|rarity|spike|twilight sparkle,docwario
1459645.png,https://derpicdn.net/img/view/2017/6/11/1459645.png,7,0.9789889454841614,715,1090,1507,1882,792,792,applejack|fluttershy|mane six|pinkie pie|princess celestia|princess luna|rainbow dash|rarity|spike|twilight sparkle,docwario
1460436.png,https://derpicdn.net/img/view/2017/6/13/1460436.png,0,0.938582479953766,62,0,844,756,782,756,applejack|fluttershy|mane six|pinkie pie|rainbow dash|rarity|twilight sparkle,latecustomer
1461224.png,https://derpicdn.net/img/view/2017/6/13/1461224.png,1,0.9837610125541688,27,0,501,397,474,397,sunset shimmer|twilight sparkle,tambelon
1463888.png,https://derpicdn.net/img/view/2017/6/17/1463888.png,0,0.99921452999115,970,1221,1264,1515,294,294,applejack|fluttershy|mane six|pinkie pie|rainbow dash|rarity|starlight glimmer|twilight sparkle,phoenixperegrine
1463888.png,https://derpicdn.net/img/view/2017/6/17/1463888.png,2,0.9217965602874756,240,80,646,486,406,406,applejack|fluttershy|mane six|pinkie pie|rainbow dash|rarity|starlight glimmer|twilight sparkle,phoenixperegrine
1463888.png,https://derpicdn.net/img/view/2017/6/17/1463888.png,3,0.9217268824577332,464,721,834,1091,370,370,applejack|fluttershy|mane six|pinkie pie|rainbow dash|rarity|starlight glimmer|twilight sparkle,phoenixperegrine
1463920.png,https://derpicdn.net/img/view/2017/6/17/1463920.png,0,0.9994173049926758,256,202,484,430,228,228,applejack|fluttershy|mane six|pinkie pie|rainbow dash|rarity|spike|twilight sparkle,docwario
1463920.png,https://derpicdn.net/img/view/2017/6/17/1463920.png,1,0.965719997882843,342,415,566,639,224,224,applejack|fluttershy|mane six|pinkie pie|rainbow dash|rarity|spike|twilight sparkle,docwario
1464100.png,https://derpicdn.net/img/view/2017/6/17/1464100.png,0,0.9963808655738832,301,36,489,224,188,188,applejack|fluttershy|mane six|pinkie pie|rainbow dash|rarity|starlight glimmer|twilight sparkle,fatcakes
1464100.png,https://derpicdn.net/img/view/2017/6/17/1464100.png,1,0.9819873571395874,459,368,633,542,174,174,applejack|fluttershy|mane six|pinkie pie|rainbow dash|rarity|starlight glimmer|twilight sparkle,fatcakes
1464100.png,https://derpicdn.net/img/view/2017/6/17/1464100.png,2,0.9815704822540284,129,187,307,365,178,178,applejack|fluttershy|mane six|pinkie pie|rainbow dash|rarity|starlight glimmer|twilight sparkle,fatcakes
1464100.png,https://derpicdn.net/img/view/2017/6/17/1464100.png,3,0.915895700454712,319,467,483,631,164,164,applejack|fluttershy|mane six|pinkie pie|rainbow dash|rarity|starlight glimmer|twilight sparkle,fatcakes
1464845.png,https://derpicdn.net/img/view/2017/6/18/1464845.png,0,0.9886813759803772,114,0,500,370,386,370,sunset shimmer|twilight sparkle,little-tweenframes
1465258.png,https://derpicdn.net/img/view/2017/6/18/1465258.png,0,0.9805063009262084,392,0,764,363,372,363,rainbow dash|twilight sparkle,empyu
1470395.png,https://derpicdn.net/img/view/2017/6/24/1470395.png,0,0.9598915576934814,3331,252,4079,1000,748,748,applejack|fluttershy|mane six|pinkie pie|rainbow dash|rarity|twilight sparkle,siggie740
1472092.png,https://derpicdn.net/img/view/2017/6/26/1472092.png,0,0.9745291471481324,21,73,445,497,424,424,big macintosh|sunset shimmer|twilight sparkle,little-tweenframes
1472789.png,https://derpicdn.net/img/view/2017/6/27/1472789.png,0,0.9877641797065736,3378,307,4978,1907,1600,1600,starlight glimmer|trixie|twilight sparkle,chub-wub
1472789.png,https://derpicdn.net/img/view/2017/6/27/1472789.png,1,0.9120726585388184,0,398,1504,1932,1504,1534,starlight glimmer|trixie|twilight sparkle,chub-wub
1474005.png,https://derpicdn.net/img/view/2017/6/29/1474005.png,0,0.9987474083900452,772,0,1426,616,654,616,rainbow dash|twilight sparkle,mykegreywolf
1476598.png,https://derpicdn.net/img/view/2017/7/2/1476598.png,0,0.9980957508087158,347,128,621,402,274,274,fluttershy|twilight sparkle,radiantrealm
1477175.png,https://derpicdn.net/img/view/2017/7/2/1477175.png,0,0.9676014184951782,877,204,1289,616,412,412,rarity|starlight glimmer|trixie|twilight sparkle,guzzlord
1479641.png,https://derpicdn.net/img/view/2017/7/6/1479641.png,0,0.985687255859375,1638,595,2606,1563,968,968,rarity|twilight sparkle,lilfunkman
147973.png,https://derpicdn.net/img/view/2012/11/10/147973.png,0,0.9382374882698059,244,337,382,475,138,138,applejack|rarity|twilight sparkle,egophiliac
1481572.png,https://derpicdn.net/img/view/2017/7/8/1481572.png,0,0.9982565641403198,286,23,438,175,152,152,trixie|twilight sparkle,joey darkmeat
1481572.png,https://derpicdn.net/img/view/2017/7/8/1481572.png,1,0.9866071343421936,72,0,304,203,232,203,trixie|twilight sparkle,joey darkmeat
1481573.png,https://derpicdn.net/img/view/2017/7/8/1481573.png,0,0.9861719012260436,0,0,393,245,393,245,trixie|twilight sparkle,joey darkmeat
1481574.png,https://derpicdn.net/img/view/2017/7/8/1481574.png,0,0.9653486609458924,150,0,566,274,416,274,trixie|twilight sparkle,joey darkmeat
1488492.png,https://derpicdn.net/img/view/2017/7/17/1488492.png,0,0.9987356662750244,317,0,483,159,166,159,applejack|fluttershy|pinkie pie|rainbow dash|rarity|starlight glimmer|twilight sparkle,dshou
1488492.png,https://derpicdn.net/img/view/2017/7/17/1488492.png,1,0.9958155155181884,12,45,172,205,160,160,applejack|fluttershy|pinkie pie|rainbow dash|rarity|starlight glimmer|twilight sparkle,dshou
1488492.png,https://derpicdn.net/img/view/2017/7/17/1488492.png,2,0.9599292874336244,404,114,558,268,154,154,applejack|fluttershy|pinkie pie|rainbow dash|rarity|starlight glimmer|twilight sparkle,dshou
1488492.png,https://derpicdn.net/img/view/2017/7/17/1488492.png,3,0.9457203149795532,42,209,174,341,132,132,applejack|fluttershy|pinkie pie|rainbow dash|rarity|starlight glimmer|twilight sparkle,dshou
1489649.png,https://derpicdn.net/img/view/2017/7/19/1489649.png,0,0.9958701133728028,61,0,361,296,300,296,rainbow dash|twilight sparkle,reddemolps
1489649.png,https://derpicdn.net/img/view/2017/7/19/1489649.png,1,0.9831396341323853,362,0,634,262,272,262,rainbow dash|twilight sparkle,reddemolps
1490097.png,https://derpicdn.net/img/view/2017/7/19/1490097.png,0,0.9862030148506165,90,0,388,277,298,277,pinkie pie|twilight sparkle,jase1505
1493865.png,https://derpicdn.net/img/view/2017/7/24/1493865.png,0,0.9990416169166564,543,1384,879,1720,336,336,applejack|fluttershy|pinkie pie|princess celestia|princess luna|rainbow dash|rarity|sunset shimmer|twilight sparkle,jase1505
1493865.png,https://derpicdn.net/img/view/2017/7/24/1493865.png,1,0.9981693029403688,1233,72,1567,406,334,334,applejack|fluttershy|pinkie pie|princess celestia|princess luna|rainbow dash|rarity|sunset shimmer|twilight sparkle,jase1505
1493865.png,https://derpicdn.net/img/view/2017/7/24/1493865.png,3,0.9901626110076904,732,0,1076,313,344,313,applejack|fluttershy|pinkie pie|princess celestia|princess luna|rainbow dash|rarity|sunset shimmer|twilight sparkle,jase1505
1493865.png,https://derpicdn.net/img/view/2017/7/24/1493865.png,4,0.988888144493103,0,721,326,1047,326,326,applejack|fluttershy|pinkie pie|princess celestia|princess luna|rainbow dash|rarity|sunset shimmer|twilight sparkle,jase1505
1493865.png,https://derpicdn.net/img/view/2017/7/24/1493865.png,5,0.9870876669883728,1313,1458,1649,1794,336,336,applejack|fluttershy|pinkie pie|princess celestia|princess luna|rainbow dash|rarity|sunset shimmer|twilight sparkle,jase1505
1493865.png,https://derpicdn.net/img/view/2017/7/24/1493865.png,6,0.9573062062263488,21,1593,307,1879,286,286,applejack|fluttershy|pinkie pie|princess celestia|princess luna|rainbow dash|rarity|sunset shimmer|twilight sparkle,jase1505
1493865.png,https://derpicdn.net/img/view/2017/7/24/1493865.png,7,0.9476192593574524,492,676,814,998,322,322,applejack|fluttershy|pinkie pie|princess celestia|princess luna|rainbow dash|rarity|sunset shimmer|twilight sparkle,jase1505
1493865.png,https://derpicdn.net/img/view/2017/7/24/1493865.png,8,0.9468648433685304,1361,604,1739,982,378,378,applejack|fluttershy|pinkie pie|princess celestia|princess luna|rainbow dash|rarity|sunset shimmer|twilight sparkle,jase1505
1496848.png,https://derpicdn.net/img/view/2017/7/28/1496848.png,0,0.9998687505722046,313,65,831,583,518,518,princess flurry heart|shining armor|twilight sparkle,mailner
1496848.png,https://derpicdn.net/img/view/2017/7/28/1496848.png,1,0.9916751384735109,817,88,1359,630,542,542,princess flurry heart|shining armor|twilight sparkle,mailner
1496848.png,https://derpicdn.net/img/view/2017/7/28/1496848.png,2,0.9914445877075196,822,870,1258,1306,436,436,princess flurry heart|shining armor|twilight sparkle,mailner
1501833.png,https://derpicdn.net/img/view/2017/8/3/1501833.png,0,0.9784455895423888,964,458,1416,910,452,452,trixie|twilight sparkle,deltauraart
1503703.png,https://derpicdn.net/img/view/2017/8/5/1503703.png,0,0.9680811762809752,56,0,680,591,624,591,pinkie pie|princess celestia|twilight sparkle,wenni|coatieyay|anearbyanimal|whisperfoot|yoditax|zajice|neighday|whydomenhavenipples|codras|replica
1504748.png,https://derpicdn.net/img/view/2017/8/7/1504748.png,0,0.9953969717025756,678,129,910,361,232,232,starlight glimmer|sunset shimmer|twilight sparkle,dstears
1504748.png,https://derpicdn.net/img/view/2017/8/7/1504748.png,1,0.9513047933578492,189,132,603,546,414,414,starlight glimmer|sunset shimmer|twilight sparkle,dstears
1509510.png,https://derpicdn.net/img/view/2017/8/13/1509510.png,0,0.9994969367980956,0,29,742,791,742,762,rarity|twilight sparkle,deltauraart
1509510.png,https://derpicdn.net/img/view/2017/8/13/1509510.png,1,0.9960266947746276,919,0,1777,847,858,847,rarity|twilight sparkle,deltauraart
1513859.png,https://derpicdn.net/img/view/2017/8/18/1513859.png,0,0.9763085842132568,1508,185,1732,409,224,224,applejack|fluttershy|mane six|pinkie pie|rainbow dash|rarity|twilight sparkle,jowybean
1516386.png,https://derpicdn.net/img/view/2017/8/21/1516386.png,0,0.9963945746421814,221,0,755,553,534,553,starlight glimmer|twilight sparkle,
1517095.png,https://derpicdn.net/img/view/2017/8/22/1517095.png,0,0.9949934482574464,233,0,541,276,308,276,applejack|fluttershy|mane six|pinkie pie|rainbow dash|rarity|twilight sparkle,egophiliac
1517095.png,https://derpicdn.net/img/view/2017/8/22/1517095.png,1,0.9859203696250916,5,231,289,515,284,284,applejack|fluttershy|mane six|pinkie pie|rainbow dash|rarity|twilight sparkle,egophiliac
1517095.png,https://derpicdn.net/img/view/2017/8/22/1517095.png,2,0.9434192180633544,764,247,978,461,214,214,applejack|fluttershy|mane six|pinkie pie|rainbow dash|rarity|twilight sparkle,egophiliac
1517807.png,https://derpicdn.net/img/view/2017/8/23/1517807.png,0,0.9916825890541076,997,356,1319,678,322,322,applejack|fluttershy|mane six|pinkie pie|rainbow dash|rarity|twilight sparkle,egophiliac
1517807.png,https://derpicdn.net/img/view/2017/8/23/1517807.png,1,0.9665131568908693,851,389,1069,607,218,218,applejack|fluttershy|mane six|pinkie pie|rainbow dash|rarity|twilight sparkle,egophiliac
1517807.png,https://derpicdn.net/img/view/2017/8/23/1517807.png,3,0.9246193170547484,35,383,349,697,314,314,applejack|fluttershy|mane six|pinkie pie|rainbow dash|rarity|twilight sparkle,egophiliac
1517888.png,https://derpicdn.net/img/view/2017/8/23/1517888.png,0,0.9900421500205994,0,11,535,631,535,620,starlight glimmer|twilight sparkle,clouddg
1517894.png,https://derpicdn.net/img/view/2017/8/23/1517894.png,0,0.9797489643096924,305,207,713,586,408,379,applejack|fluttershy|mane six|pinkie pie|rainbow dash|rarity|twilight sparkle,sion-ara
15183.png,https://derpicdn.net/img/view/2012/6/22/15183.png,0,0.9930048584938048,903,586,1227,910,324,324,applejack|fluttershy|mane six|pinkie pie|rainbow dash|rarity|twilight sparkle,karzahnii
15183.png,https://derpicdn.net/img/view/2012/6/22/15183.png,1,0.9411842823028564,1201,493,1600,953,399,460,applejack|fluttershy|mane six|pinkie pie|rainbow dash|rarity|twilight sparkle,karzahnii
15183.png,https://derpicdn.net/img/view/2012/6/22/15183.png,2,0.9127333760261536,0,473,561,1143,561,670,applejack|fluttershy|mane six|pinkie pie|rainbow dash|rarity|twilight sparkle,karzahnii
1518763.png,https://derpicdn.net/img/view/2017/8/24/1518763.png,0,0.9961650967597958,353,50,2203,1900,1850,1850,rainbow dash|twilight sparkle,twidasher
1518764.png,https://derpicdn.net/img/view/2017/8/24/1518764.png,0,0.9992835521697998,520,129,1934,1543,1414,1414,rainbow dash|twilight sparkle,twidasher
1519416.png,https://derpicdn.net/img/view/2017/8/25/1519416.png,0,0.999881625175476,900,0,1368,379,468,379,applejack|fluttershy|mane six|pinkie pie|rainbow dash|rarity|twilight sparkle,luminousdazzle
1519416.png,https://derpicdn.net/img/view/2017/8/25/1519416.png,1,0.995348870754242,960,288,1466,794,506,506,applejack|fluttershy|mane six|pinkie pie|rainbow dash|rarity|twilight sparkle,luminousdazzle
1519915.png,https://derpicdn.net/img/view/2017/8/26/1519915.png,0,0.9382969737052916,385,148,689,452,304,304,rainbow dash|twilight sparkle,spyro4287|grumblepluck|doctor-derpy|illuminatiums
1519952.png,https://derpicdn.net/img/view/2017/8/26/1519952.png,0,0.997972011566162,26,375,250,599,224,224,applejack|fluttershy|mane six|pinkie pie|rainbow dash|rarity|twilight sparkle,w00tnewt
1519952.png,https://derpicdn.net/img/view/2017/8/26/1519952.png,1,0.990559995174408,184,2,428,246,244,244,applejack|fluttershy|mane six|pinkie pie|rainbow dash|rarity|twilight sparkle,w00tnewt
1519952.png,https://derpicdn.net/img/view/2017/8/26/1519952.png,3,0.9706434607505798,533,394,737,598,204,204,applejack|fluttershy|mane six|pinkie pie|rainbow dash|rarity|twilight sparkle,w00tnewt
1519952.png,https://derpicdn.net/img/view/2017/8/26/1519952.png,4,0.9697865843772888,563,17,759,213,196,196,applejack|fluttershy|mane six|pinkie pie|rainbow dash|rarity|twilight sparkle,w00tnewt
1519952.png,https://derpicdn.net/img/view/2017/8/26/1519952.png,5,0.9523881077766418,827,421,1003,597,176,176,applejack|fluttershy|mane six|pinkie pie|rainbow dash|rarity|twilight sparkle,w00tnewt
1522676.png,https://derpicdn.net/img/view/2017/8/29/1522676.png,0,0.998515248298645,269,62,1021,814,752,752,applejack|twilight sparkle,curiouskeys
1523398.png,https://derpicdn.net/img/view/2017/8/30/1523398.png,0,0.9945140480995178,430,81,1524,1175,1094,1094,rainbow dash|twilight sparkle,twidasher
1523550.png,https://derpicdn.net/img/view/2017/8/30/1523550.png,0,0.9898398518562316,668,2302,1200,2834,532,532,applejack|fluttershy|rainbow dash|rarity|sunset shimmer|twilight sparkle,phyllismi
1523550.png,https://derpicdn.net/img/view/2017/8/30/1523550.png,1,0.9897595643997192,655,91,1201,637,546,546,applejack|fluttershy|rainbow dash|rarity|sunset shimmer|twilight sparkle,phyllismi
1523550.png,https://derpicdn.net/img/view/2017/8/30/1523550.png,3,0.9536136388778688,1040,1886,1890,2736,850,850,applejack|fluttershy|rainbow dash|rarity|sunset shimmer|twilight sparkle,phyllismi
1524283.png,https://derpicdn.net/img/view/2017/8/31/1524283.png,0,0.9953541159629822,167,142,625,600,458,458,sunset shimmer|twilight sparkle,little-tweenframes
1524483.png,https://derpicdn.net/img/view/2017/8/31/1524483.png,0,0.9969091415405272,1533,1590,2480,2600,947,1010,princess cadance|princess celestia|princess luna|rainbow dash|scootaloo|shining armor|spike|twilight sparkle,twidasher
1524483.png,https://derpicdn.net/img/view/2017/8/31/1524483.png,1,0.9931632876396179,1141,928,1877,1664,736,736,princess cadance|princess celestia|princess luna|rainbow dash|scootaloo|shining armor|spike|twilight sparkle,twidasher
1524483.png,https://derpicdn.net/img/view/2017/8/31/1524483.png,2,0.979848325252533,1455,575,2480,1761,1025,1186,princess cadance|princess celestia|princess luna|rainbow dash|scootaloo|shining armor|spike|twilight sparkle,twidasher
1524483.png,https://derpicdn.net/img/view/2017/8/31/1524483.png,3,0.9724329710006714,426,2893,1064,3507,638,614,princess cadance|princess celestia|princess luna|rainbow dash|scootaloo|shining armor|spike|twilight sparkle,twidasher
1524483.png,https://derpicdn.net/img/view/2017/8/31/1524483.png,4,0.971355438232422,417,2260,1237,3080,820,820,princess cadance|princess celestia|princess luna|rainbow dash|scootaloo|shining armor|spike|twilight sparkle,twidasher
1524483.png,https://derpicdn.net/img/view/2017/8/31/1524483.png,6,0.9370830655097958,236,20,1182,966,946,946,princess cadance|princess celestia|princess luna|rainbow dash|scootaloo|shining armor|spike|twilight sparkle,twidasher
1525178.png,https://derpicdn.net/img/view/2017/9/1/1525178.png,0,0.9959166049957277,419,8,1187,776,768,768,rainbow dash|twilight sparkle,twidasher
1525178.png,https://derpicdn.net/img/view/2017/9/1/1525178.png,1,0.9533461332321168,1240,0,2134,879,894,879,rainbow dash|twilight sparkle,twidasher
1525426.png,https://derpicdn.net/img/view/2017/9/1/1525426.png,0,0.9939262866973876,1624,193,3058,1627,1434,1434,rarity|twilight sparkle,shellshoker
1525488.png,https://derpicdn.net/img/view/2017/9/2/1525488.png,0,0.9437167048454284,1869,2578,2749,3458,880,880,discord|rarity|twilight sparkle,lilfunkman
1531896.png,https://derpicdn.net/img/view/2017/9/10/1531896.png,0,0.9245897531509399,94,229,770,905,676,676,sunset shimmer|twilight sparkle,docwario
1532858.png,https://derpicdn.net/img/view/2017/9/11/1532858.png,0,0.9968117475509644,1199,636,1491,928,292,292,applejack|fluttershy|mane six|pinkie pie|rainbow dash|rarity|twilight sparkle,brendahickey
1532858.png,https://derpicdn.net/img/view/2017/9/11/1532858.png,1,0.987446129322052,1209,2,1495,298,286,296,applejack|fluttershy|mane six|pinkie pie|rainbow dash|rarity|twilight sparkle,brendahickey
1532858.png,https://derpicdn.net/img/view/2017/9/11/1532858.png,2,0.9559345841407776,0,597,295,939,295,342,applejack|fluttershy|mane six|pinkie pie|rainbow dash|rarity|twilight sparkle,brendahickey
1532927.png,https://derpicdn.net/img/view/2017/9/11/1532927.png,0,0.9635317325592041,107,162,729,784,622,622,sunset shimmer|twilight sparkle,little-tweenframes
1536567.png,https://derpicdn.net/img/view/2017/9/16/1536567.png,0,0.9491837620735168,269,30,551,312,282,282,sunset shimmer|twilight sparkle,little-tweenframes
1538695.png,https://derpicdn.net/img/view/2017/9/18/1538695.png,1,0.9425536990165708,0,588,2035,2836,2035,2248,princess celestia|twilight sparkle,pastel-pony-princess
1541077.png,https://derpicdn.net/img/view/2017/9/21/1541077.png,0,0.9559197425842284,167,0,1241,974,1074,974,fluttershy|twilight sparkle,fensu-san
15427.png,https://derpicdn.net/img/view/2012/6/22/15427.png,0,0.9880200028419496,894,40,1314,460,420,420,rainbow dash|twilight sparkle,skipsy
1547670.png,https://derpicdn.net/img/view/2017/9/29/1547670.png,0,0.9951472282409668,1679,1657,2127,2105,448,448,discord|princess luna|starlight glimmer|sunset shimmer|trixie|twilight sparkle,sapphirescarletta
1547670.png,https://derpicdn.net/img/view/2017/9/29/1547670.png,1,0.9949948191642758,1754,1104,2320,1670,566,566,discord|princess luna|starlight glimmer|sunset shimmer|trixie|twilight sparkle,sapphirescarletta
1547670.png,https://derpicdn.net/img/view/2017/9/29/1547670.png,2,0.9949153661727904,375,2335,947,2907,572,572,discord|princess luna|starlight glimmer|sunset shimmer|trixie|twilight sparkle,sapphirescarletta
1547670.png,https://derpicdn.net/img/view/2017/9/29/1547670.png,3,0.9899977445602416,1157,2294,1781,2918,624,624,discord|princess luna|starlight glimmer|sunset shimmer|trixie|twilight sparkle,sapphirescarletta
1547670.png,https://derpicdn.net/img/view/2017/9/29/1547670.png,4,0.9888811707496644,2003,2382,2521,2900,518,518,discord|princess luna|starlight glimmer|sunset shimmer|trixie|twilight sparkle,sapphirescarletta
1547670.png,https://derpicdn.net/img/view/2017/9/29/1547670.png,5,0.984139621257782,984,483,1702,1201,718,718,discord|princess luna|starlight glimmer|sunset shimmer|trixie|twilight sparkle,sapphirescarletta
1547670.png,https://derpicdn.net/img/view/2017/9/29/1547670.png,6,0.9574483036994934,1677,2335,2151,2809,474,474,discord|princess luna|starlight glimmer|sunset shimmer|trixie|twilight sparkle,sapphirescarletta
1547670.png,https://derpicdn.net/img/view/2017/9/29/1547670.png,7,0.9574266076087952,2058,1642,2536,2120,478,478,discord|princess luna|starlight glimmer|sunset shimmer|trixie|twilight sparkle,sapphirescarletta
1547670.png,https://derpicdn.net/img/view/2017/9/29/1547670.png,8,0.9523679614067078,1224,1729,1732,2237,508,508,discord|princess luna|starlight glimmer|sunset shimmer|trixie|twilight sparkle,sapphirescarletta
1547670.png,https://derpicdn.net/img/view/2017/9/29/1547670.png,9,0.9370272755622864,411,511,1017,1117,606,606,discord|princess luna|starlight glimmer|sunset shimmer|trixie|twilight sparkle,sapphirescarletta
1547670.png,https://derpicdn.net/img/view/2017/9/29/1547670.png,10,0.9271106719970704,608,1521,1096,2009,488,488,discord|princess luna|starlight glimmer|sunset shimmer|trixie|twilight sparkle,sapphirescarletta
1548066.png,https://derpicdn.net/img/view/2017/9/30/1548066.png,0,0.9979216456413268,98,0,1094,945,996,945,rarity|twilight sparkle,lilfunkman
1548066.png,https://derpicdn.net/img/view/2017/9/30/1548066.png,1,0.9270817637443542,894,0,1930,1025,1036,1025,rarity|twilight sparkle,lilfunkman
1549766.png,https://derpicdn.net/img/view/2017/10/1/1549766.png,0,0.9876513481140136,0,216,461,708,461,492,princess cadance|princess celestia|princess flurry heart|princess luna|twilight sparkle,purediamond360
1549766.png,https://derpicdn.net/img/view/2017/10/1/1549766.png,1,0.9833382368087769,494,114,1024,644,530,530,princess cadance|princess celestia|princess flurry heart|princess luna|twilight sparkle,purediamond360
1549766.png,https://derpicdn.net/img/view/2017/10/1/1549766.png,2,0.9585591554641724,1646,248,2072,674,426,426,princess cadance|princess celestia|princess flurry heart|princess luna|twilight sparkle,purediamond360
1550853.png,https://derpicdn.net/img/view/2017/10/3/1550853.png,0,0.9941856861114502,310,44,1028,762,718,718,rarity|twilight sparkle,
1551975.png,https://derpicdn.net/img/view/2017/10/4/1551975.png,0,0.9819455742836,495,279,1053,837,558,558,rarity|twilight sparkle,lilfunkman
1552615.png,https://derpicdn.net/img/view/2017/10/5/1552615.png,0,0.9994946718215942,0,35,685,731,685,696,spike|twilight sparkle,hardbrony
1552615.png,https://derpicdn.net/img/view/2017/10/5/1552615.png,1,0.968882977962494,645,95,1125,575,480,480,spike|twilight sparkle,hardbrony
1552646.png,https://derpicdn.net/img/view/2017/10/5/1552646.png,0,0.9933379292488098,704,0,1590,833,886,833,starlight glimmer|twilight sparkle,
1552646.png,https://derpicdn.net/img/view/2017/10/5/1552646.png,1,0.9048100113868712,617,1099,1411,1893,794,794,starlight glimmer|twilight sparkle,
1553435.png,https://derpicdn.net/img/view/2017/10/6/1553435.png,1,0.9314508438110352,0,426,1296,1918,1296,1492,rainbow dash|twilight sparkle,twidasher
1553555.png,https://derpicdn.net/img/view/2017/10/6/1553555.png,0,0.9961348176002502,732,0,1194,416,462,416,applejack|fluttershy|mane six|pinkie pie|rainbow dash|rarity|spike|twilight sparkle,saxopi
1553555.png,https://derpicdn.net/img/view/2017/10/6/1553555.png,1,0.9713349342346193,393,0,861,439,468,439,applejack|fluttershy|mane six|pinkie pie|rainbow dash|rarity|spike|twilight sparkle,saxopi
1553555.png,https://derpicdn.net/img/view/2017/10/6/1553555.png,4,0.9114685654640198,861,314,1397,850,536,536,applejack|fluttershy|mane six|pinkie pie|rainbow dash|rarity|spike|twilight sparkle,saxopi
1555386.png,https://derpicdn.net/img/view/2017/10/8/1555386.png,0,0.9171578884124756,1632,362,1920,656,288,294,applejack|fluttershy|mane six|pinkie pie|rainbow dash|rarity|twilight sparkle,30clock
1557541.png,https://derpicdn.net/img/view/2017/10/10/1557541.png,0,0.9703465104103088,1878,1049,2562,1733,684,684,applejack|fluttershy|mane six|pinkie pie|rainbow dash|rarity|spike|sunset shimmer|twilight sparkle,dsp2003
1557541.png,https://derpicdn.net/img/view/2017/10/10/1557541.png,2,0.9149134159088136,1154,0,1988,748,834,748,applejack|fluttershy|mane six|pinkie pie|rainbow dash|rarity|spike|sunset shimmer|twilight sparkle,dsp2003
1557699.png,https://derpicdn.net/img/view/2017/10/10/1557699.png,2,0.9496152997016908,830,1780,1284,2234,454,454,applejack|fluttershy|mane six|pinkie pie|rainbow dash|rarity|spike|starlight glimmer|sunset shimmer|trixie|twilight sparkle,heir-of-rick
1557699.png,https://derpicdn.net/img/view/2017/10/10/1557699.png,3,0.9195696115493774,102,875,688,1461,586,586,applejack|fluttershy|mane six|pinkie pie|rainbow dash|rarity|spike|starlight glimmer|sunset shimmer|trixie|twilight sparkle,heir-of-rick
1557809.png,https://derpicdn.net/img/view/2017/10/10/1557809.png,0,0.9989989399909972,961,0,1471,487,510,487,applejack|fluttershy|mane six|pinkie pie|rainbow dash|rarity|twilight sparkle,/d/non
1557809.png,https://derpicdn.net/img/view/2017/10/10/1557809.png,2,0.99344140291214,1843,94,2343,594,500,500,applejack|fluttershy|mane six|pinkie pie|rainbow dash|rarity|twilight sparkle,/d/non
1557809.png,https://derpicdn.net/img/view/2017/10/10/1557809.png,3,0.9607037901878356,1056,527,1904,1346,848,819,applejack|fluttershy|mane six|pinkie pie|rainbow dash|rarity|twilight sparkle,/d/non
1557856.png,https://derpicdn.net/img/view/2017/10/11/1557856.png,0,0.9861364364624025,990,462,1880,1352,890,890,applejack|pinkie pie|rainbow dash|rarity|twilight sparkle,micky-ann
1557856.png,https://derpicdn.net/img/view/2017/10/11/1557856.png,2,0.9691654443740844,2179,0,3089,772,910,772,applejack|pinkie pie|rainbow dash|rarity|twilight sparkle,micky-ann
1560506.png,https://derpicdn.net/img/view/2017/10/14/1560506.png,0,0.9977332949638368,656,593,1098,1035,442,442,apple bloom|applejack|cutie mark crusaders|discord|fluttershy|mane six|pinkie pie|princess cadance|princess celestia|princess luna|rainbow dash|rarity|scootaloo|spike|starlight glimmer|sunset shimmer|sweetie belle|trixie|twilight sparkle,zharkaer
1560566.png,https://derpicdn.net/img/view/2017/10/14/1560566.png,0,0.947609543800354,224,157,500,433,276,276,applejack|fluttershy|mane six|pinkie pie|princess celestia|princess luna|rainbow dash|rarity|scootaloo|starlight glimmer|twilight sparkle,caroo
1560933.png,https://derpicdn.net/img/view/2017/10/14/1560933.png,0,0.9919453263282776,113,1,613,501,500,500,applejack|fluttershy|mane six|pinkie pie|rainbow dash|rarity|twilight sparkle,windymils
1564717.png,https://derpicdn.net/img/view/2017/10/18/1564717.png,0,0.9989232420921326,287,65,531,309,244,244,applejack|fluttershy|mane six|pinkie pie|rainbow dash|rarity|twilight sparkle,chibi-jen-hen
1564717.png,https://derpicdn.net/img/view/2017/10/18/1564717.png,1,0.9957855343818665,632,55,922,345,290,290,applejack|fluttershy|mane six|pinkie pie|rainbow dash|rarity|twilight sparkle,chibi-jen-hen
1564717.png,https://derpicdn.net/img/view/2017/10/18/1564717.png,2,0.9691435098648072,0,44,219,300,219,256,applejack|fluttershy|mane six|pinkie pie|rainbow dash|rarity|twilight sparkle,chibi-jen-hen
156475.png,https://derpicdn.net/img/view/2012/11/18/156475.png,0,0.9920737147331238,337,0,707,358,370,358,big macintosh|twilight sparkle,kittehkatbar
1565606.png,https://derpicdn.net/img/view/2017/10/20/1565606.png,0,0.969647228717804,675,0,1800,1198,1125,1198,princess cadance|twilight sparkle,loyaldis
1567274.png,https://derpicdn.net/img/view/2017/10/22/1567274.png,0,0.9993462562561036,662,19,1292,649,630,630,trixie|twilight sparkle,deltauraart
1567274.png,https://derpicdn.net/img/view/2017/10/22/1567274.png,1,0.9040196537971495,0,0,709,750,709,750,trixie|twilight sparkle,deltauraart
1567793.png,https://derpicdn.net/img/view/2017/10/22/1567793.png,0,0.9946203231811525,247,0,947,700,700,700,spike|twilight sparkle,j24262756
1569640.png,https://derpicdn.net/img/view/2017/10/25/1569640.png,0,0.9969619512557985,757,94,1433,770,676,676,rarity|twilight sparkle,lilfunkman
1573096.png,https://derpicdn.net/img/view/2017/10/29/1573096.png,0,0.975825846195221,2482,635,3614,1767,1132,1132,starlight glimmer|twilight sparkle,goatcanon
1575089.png,https://derpicdn.net/img/view/2017/11/1/1575089.png,0,0.976783573627472,7,9,399,401,392,392,princess luna|twilight sparkle,lulubell
1575316.png,https://derpicdn.net/img/view/2017/11/1/1575316.png,0,0.9966076016426086,344,202,666,524,322,322,princess celestia|twilight sparkle,jykinturah
1576311.png,https://derpicdn.net/img/view/2017/11/2/1576311.png,0,0.9926739931106568,289,0,657,344,368,344,starlight glimmer|twilight sparkle,skyeypony
1578504.png,https://derpicdn.net/img/view/2017/11/5/1578504.png,0,0.9600151181221008,444,0,2336,1835,1892,1835,princess celestia|twilight sparkle,greyscaleart
1581540.png,https://derpicdn.net/img/view/2017/11/8/1581540.png,0,0.9959065914154052,1755,1987,2287,2519,532,532,sunset shimmer|twilight sparkle,triplestitch|h0mi3
15848.png,https://derpicdn.net/img/view/2012/6/22/15848.png,0,0.9910101294517516,264,417,664,817,400,400,princess cadance|shining armor|twilight sparkle,black-namer
1585791.png,https://derpicdn.net/img/view/2017/11/14/1585791.png,0,0.9780627489089966,620,315,1212,907,592,592,rainbow dash|twilight sparkle,lupeylycan
1587929.png,https://derpicdn.net/img/view/2017/11/16/1587929.png,0,0.9899559617042542,1347,50,2119,822,772,772,fluttershy|twilight sparkle,bloodatius
1587929.png,https://derpicdn.net/img/view/2017/11/16/1587929.png,1,0.9795156121253968,244,62,1026,844,782,782,fluttershy|twilight sparkle,bloodatius
1587963.png,https://derpicdn.net/img/view/2017/11/17/1587963.png,0,0.9836017489433287,1995,9,2931,945,936,936,applejack|fluttershy|rarity|twilight sparkle,heir-of-rick
1588317.png,https://derpicdn.net/img/view/2017/11/17/1588317.png,0,0.977582573890686,263,119,651,507,388,388,sunset shimmer|twilight sparkle,little-tweenframes
1588744.png,https://derpicdn.net/img/view/2017/11/18/1588744.png,0,0.9447295665740968,1672,170,3606,2104,1934,1934,rainbow dash|twilight sparkle,digiqrow
1590599.png,https://derpicdn.net/img/view/2017/11/20/1590599.png,0,0.9504581093788148,867,1013,1719,1865,852,852,rarity|twilight sparkle,ogaraorcynder
1593166.png,https://derpicdn.net/img/view/2017/11/24/1593166.png,0,0.9961651563644408,0,308,652,1074,652,766,spike|starlight glimmer|twilight sparkle,oinktweetstudios
1593166.png,https://derpicdn.net/img/view/2017/11/24/1593166.png,1,0.9669085741043092,602,680,1452,1530,850,850,spike|starlight glimmer|twilight sparkle,oinktweetstudios
1596956.png,https://derpicdn.net/img/view/2017/11/29/1596956.png,0,0.9448673725128174,5899,1900,6899,2900,1000,1000,fluttershy|twilight sparkle,rainbownspeedash
1598430.png,https://derpicdn.net/img/view/2017/12/1/1598430.png,0,0.99711412191391,1059,303,1525,769,466,466,rarity|twilight sparkle,discorded|lilfunkman
1598430.png,https://derpicdn.net/img/view/2017/12/1/1598430.png,1,0.9927924871444702,77,212,819,954,742,742,rarity|twilight sparkle,discorded|lilfunkman
1599418.png,https://derpicdn.net/img/view/2017/12/3/1599418.png,0,0.9646857976913452,0,0,574,575,574,575,princess cadance|twilight sparkle,rossignolet
1602816.png,https://derpicdn.net/img/view/2017/12/7/1602816.png,0,0.9150585532188416,270,8,1044,782,774,774,fluttershy|twilight sparkle,inuyuru
1603043.png,https://derpicdn.net/img/view/2017/12/8/1603043.png,0,0.9331084489822388,89,218,449,578,360,360,discord|princess cadance|twilight sparkle,ponythroat
1603391.png,https://derpicdn.net/img/view/2017/12/8/1603391.png,0,0.99565452337265,106,535,400,829,294,294,applejack|fluttershy|mane six|pinkie pie|rainbow dash|rarity|twilight sparkle,kumikoponylk
1603391.png,https://derpicdn.net/img/view/2017/12/8/1603391.png,1,0.993210792541504,71,90,385,404,314,314,applejack|fluttershy|mane six|pinkie pie|rainbow dash|rarity|twilight sparkle,kumikoponylk
1603549.png,https://derpicdn.net/img/view/2017/12/9/1603549.png,0,0.9367588758468628,237,8,1000,794,763,786,pinkie pie|twilight sparkle,vale-bandicoot96
1606283.png,https://derpicdn.net/img/view/2017/12/12/1606283.png,0,0.9710562229156494,173,707,627,1161,454,454,applejack|fluttershy|mane six|pinkie pie|rainbow dash|rarity|spike|starlight glimmer|twilight sparkle,cloureed
1606283.png,https://derpicdn.net/img/view/2017/12/12/1606283.png,2,0.9117295145988464,526,732,852,1058,326,326,applejack|fluttershy|mane six|pinkie pie|rainbow dash|rarity|spike|starlight glimmer|twilight sparkle,cloureed
1607670.png,https://derpicdn.net/img/view/2017/12/14/1607670.png,0,0.9985228180885316,565,411,1589,1435,1024,1024,spike|twilight sparkle,nutty-stardragon
1607670.png,https://derpicdn.net/img/view/2017/12/14/1607670.png,1,0.9973856806755066,0,47,949,1083,949,1036,spike|twilight sparkle,nutty-stardragon
1607794.png,https://derpicdn.net/img/view/2017/12/14/1607794.png,0,0.9418635964393616,279,238,675,634,396,396,sunset shimmer|twilight sparkle,little-tweenframes|jase1505
1609789.png,https://derpicdn.net/img/view/2017/12/17/1609789.png,0,0.9982964396476746,1077,1071,1431,1425,354,354,rainbow dash|twilight sparkle,saphi-boo
1609789.png,https://derpicdn.net/img/view/2017/12/17/1609789.png,1,0.99033784866333,0,60,342,422,342,362,rainbow dash|twilight sparkle,saphi-boo
1609789.png,https://derpicdn.net/img/view/2017/12/17/1609789.png,3,0.9445757865905762,763,1047,1109,1393,346,346,rainbow dash|twilight sparkle,saphi-boo
1611039.png,https://derpicdn.net/img/view/2017/12/19/1611039.png,2,0.9679508209228516,266,354,1002,1090,736,736,rarity|twilight sparkle,lilfunkman
1611198.png,https://derpicdn.net/img/view/2017/12/19/1611198.png,0,0.963567852973938,560,0,1304,566,744,566,applejack|fluttershy|mane six|pinkie pie|rainbow dash|rarity|twilight sparkle,screwingwithsfm
1611427.png,https://derpicdn.net/img/view/2017/12/19/1611427.png,0,0.9942564964294434,2420,451,3418,1449,998,998,rarity|twilight sparkle,mellowhen|neongothic
1611711.png,https://derpicdn.net/img/view/2017/12/20/1611711.png,0,0.9897581934928894,172,0,602,409,430,409,princess celestia|twilight sparkle,pencils
1612245.png,https://derpicdn.net/img/view/2017/12/20/1612245.png,0,0.980874001979828,346,775,684,1113,338,338,starlight glimmer|sunset shimmer|twilight sparkle,heir-of-rick
1612543.png,https://derpicdn.net/img/view/2017/12/21/1612543.png,0,0.929051399230957,121,0,613,432,492,432,princess celestia|twilight sparkle,pencils
1613023.png,https://derpicdn.net/img/view/2017/12/22/1613023.png,0,0.9562938213348388,933,93,1759,919,826,826,rarity|twilight sparkle,lilfunkman
1613023.png,https://derpicdn.net/img/view/2017/12/22/1613023.png,1,0.9188324213027954,576,52,1192,668,616,616,rarity|twilight sparkle,lilfunkman
1616174.png,https://derpicdn.net/img/view/2017/12/25/1616174.png,0,0.993354558944702,1098,1663,1560,2125,462,462,fluttershy|rainbow dash|twilight sparkle,serafelis
1616321.png,https://derpicdn.net/img/view/2017/12/26/1616321.png,0,0.9236266613006592,1617,2964,3000,4384,1383,1420,princess celestia|soarin'|sweetie belle|twilight sparkle,heyerika
1616929.png,https://derpicdn.net/img/view/2017/12/26/1616929.png,0,0.9751198887825012,1453,0,4583,2584,3130,2584,rainbow dash|twilight sparkle,xpesifeindx
1616951.png,https://derpicdn.net/img/view/2017/12/26/1616951.png,0,0.9899697303771972,2617,2303,4581,4267,1964,1964,sunset shimmer|twilight sparkle,docwario
1616951.png,https://derpicdn.net/img/view/2017/12/26/1616951.png,1,0.9812332391738892,4519,1342,6839,3662,2320,2320,sunset shimmer|twilight sparkle,docwario
1616963.png,https://derpicdn.net/img/view/2017/12/26/1616963.png,0,0.9660113453865052,30,51,988,1009,958,958,starlight glimmer|twilight sparkle,rawrienstein
1620922.png,https://derpicdn.net/img/view/2017/12/31/1620922.png,0,0.9117591977119446,792,1104,1602,1914,810,810,princess luna|twilight sparkle,pumpkabooo
1620999.png,https://derpicdn.net/img/view/2017/12/31/1620999.png,0,0.9996781349182128,146,836,718,1408,572,572,princess luna|twilight sparkle,antelon
1621034.png,https://derpicdn.net/img/view/2017/12/31/1621034.png,0,0.950056254863739,1416,563,1750,897,334,334,applejack|fluttershy|mane six|pinkie pie|rainbow dash|rarity|spike|starlight glimmer|twilight sparkle,shad0w-galaxy
1621034.png,https://derpicdn.net/img/view/2017/12/31/1621034.png,1,0.9414440393447876,793,707,1009,923,216,216,applejack|fluttershy|mane six|pinkie pie|rainbow dash|rarity|spike|starlight glimmer|twilight sparkle,shad0w-galaxy
1621190.png,https://derpicdn.net/img/view/2018/1/1/1621190.png,0,0.9913814663887024,428,0,652,214,224,214,princess celestia|twilight sparkle,crecious
1621470.png,https://derpicdn.net/img/view/2018/1/1/1621470.png,1,0.9248877763748168,651,2,1121,472,470,470,starlight glimmer|sunset shimmer|twilight sparkle,saturdaymorningproj
1621581.png,https://derpicdn.net/img/view/2018/1/1/1621581.png,0,0.9911647439002992,817,247,1393,823,576,576,applejack|fluttershy|mane six|pinkie pie|rainbow dash|rarity|twilight sparkle,howxu
1621581.png,https://derpicdn.net/img/view/2018/1/1/1621581.png,1,0.9148217439651488,1673,398,2015,740,342,342,applejack|fluttershy|mane six|pinkie pie|rainbow dash|rarity|twilight sparkle,howxu
1622016.png,https://derpicdn.net/img/view/2018/1/2/1622016.png,0,0.9941255450248718,1372,1858,2368,2854,996,996,applejack|fluttershy|pinkie pie|rainbow dash|rarity|twilight sparkle,theshadowstone
1622016.png,https://derpicdn.net/img/view/2018/1/2/1622016.png,1,0.9834522604942322,453,558,1557,1662,1104,1104,applejack|fluttershy|pinkie pie|rainbow dash|rarity|twilight sparkle,theshadowstone
1622016.png,https://derpicdn.net/img/view/2018/1/2/1622016.png,2,0.9829972386360168,2235,1703,3303,2771,1068,1068,applejack|fluttershy|pinkie pie|rainbow dash|rarity|twilight sparkle,theshadowstone
1622016.png,https://derpicdn.net/img/view/2018/1/2/1622016.png,3,0.9633725881576538,2564,378,3856,1802,1292,1424,applejack|fluttershy|pinkie pie|rainbow dash|rarity|twilight sparkle,theshadowstone
1622016.png,https://derpicdn.net/img/view/2018/1/2/1622016.png,4,0.9596731662750244,1417,82,2383,1048,966,966,applejack|fluttershy|pinkie pie|rainbow dash|rarity|twilight sparkle,theshadowstone
1622503.png,https://derpicdn.net/img/view/2018/1/2/1622503.png,0,0.9894483685493468,120,62,610,552,490,490,rainbow dash|twilight sparkle,xenon
1622503.png,https://derpicdn.net/img/view/2018/1/2/1622503.png,1,0.9667295813560486,40,1187,492,1639,452,452,rainbow dash|twilight sparkle,xenon
1622508.png,https://derpicdn.net/img/view/2018/1/2/1622508.png,0,0.9962811470031738,855,388,1235,768,380,380,applejack|fluttershy|mane six|pinkie pie|rainbow dash|rarity|twilight sparkle,xenon
1622508.png,https://derpicdn.net/img/view/2018/1/2/1622508.png,1,0.9893519878387452,20,23,264,267,244,244,applejack|fluttershy|mane six|pinkie pie|rainbow dash|rarity|twilight sparkle,xenon
1622508.png,https://derpicdn.net/img/view/2018/1/2/1622508.png,2,0.9444519877433776,904,0,1216,265,312,265,applejack|fluttershy|mane six|pinkie pie|rainbow dash|rarity|twilight sparkle,xenon
1622509.png,https://derpicdn.net/img/view/2018/1/2/1622509.png,0,0.9941164255142212,502,12,730,240,228,228,starlight glimmer|sunset shimmer|twilight sparkle,xenon
1623935.png,https://derpicdn.net/img/view/2018/1/4/1623935.png,0,0.9964409470558168,234,286,436,488,202,202,applejack|fluttershy|mane six|pinkie pie|rainbow dash|rarity|twilight sparkle,dinkelion
1623935.png,https://derpicdn.net/img/view/2018/1/4/1623935.png,1,0.9641464352607728,0,152,219,380,219,228,applejack|fluttershy|mane six|pinkie pie|rainbow dash|rarity|twilight sparkle,dinkelion
1623935.png,https://derpicdn.net/img/view/2018/1/4/1623935.png,2,0.9522140026092528,234,4,432,202,198,198,applejack|fluttershy|mane six|pinkie pie|rainbow dash|rarity|twilight sparkle,dinkelion
1626920.png,https://derpicdn.net/img/view/2018/1/8/1626920.png,0,0.9711039066314696,6,69,450,513,444,444,spike|twilight sparkle,emositecc
1630177.png,https://derpicdn.net/img/view/2018/1/12/1630177.png,0,0.9886456727981568,192,90,548,446,356,356,spike|twilight sparkle,emositecc
1630802.png,https://derpicdn.net/img/view/2018/1/13/1630802.png,0,0.983972668647766,1682,360,3938,2616,2256,2256,pinkie pie|twilight sparkle,jhayarr23
1631528.png,https://derpicdn.net/img/view/2018/1/13/1631528.png,0,0.9864883422851562,1203,310,1569,676,366,366,applejack|fluttershy|mane six|pinkie pie|rainbow dash|rarity|twilight sparkle,sillyrapids
1631528.png,https://derpicdn.net/img/view/2018/1/13/1631528.png,1,0.9781588315963744,17,551,275,809,258,258,applejack|fluttershy|mane six|pinkie pie|rainbow dash|rarity|twilight sparkle,sillyrapids
1632385.png,https://derpicdn.net/img/view/2018/1/14/1632385.png,0,0.9939005374908448,786,168,1110,492,324,324,fluttershy|princess cadance|rainbow dash|rarity|shining armor|sunset shimmer|trixie|twilight sparkle,kkmrarar
1632385.png,https://derpicdn.net/img/view/2018/1/14/1632385.png,2,0.9556863903999328,958,1304,1178,1524,220,220,fluttershy|princess cadance|rainbow dash|rarity|shining armor|sunset shimmer|trixie|twilight sparkle,kkmrarar
1632385.png,https://derpicdn.net/img/view/2018/1/14/1632385.png,3,0.9335282444953918,1497,1294,1777,1574,280,280,fluttershy|princess cadance|rainbow dash|rarity|shining armor|sunset shimmer|trixie|twilight sparkle,kkmrarar
1632385.png,https://derpicdn.net/img/view/2018/1/14/1632385.png,4,0.9025431275367736,1604,63,1892,351,288,288,fluttershy|princess cadance|rainbow dash|rarity|shining armor|sunset shimmer|trixie|twilight sparkle,kkmrarar
1635030.png,https://derpicdn.net/img/view/2018/1/18/1635030.png,0,0.9977396130561828,192,1003,1112,1923,920,920,starlight glimmer|twilight sparkle,
1635030.png,https://derpicdn.net/img/view/2018/1/18/1635030.png,1,0.9930325150489808,805,0,1777,950,972,950,starlight glimmer|twilight sparkle,
1635280.png,https://derpicdn.net/img/view/2018/1/18/1635280.png,0,0.9936069846153259,804,0,1774,850,970,850,starlight glimmer|twilight sparkle,maren
1635280.png,https://derpicdn.net/img/view/2018/1/18/1635280.png,1,0.9322397708892822,58,117,996,1055,938,938,starlight glimmer|twilight sparkle,maren
1637583.png,https://derpicdn.net/img/view/2018/1/21/1637583.png,0,0.9931175112724304,69,146,355,432,286,286,rainbow dash|twilight sparkle,1trick
1637583.png,https://derpicdn.net/img/view/2018/1/21/1637583.png,1,0.959527552127838,401,18,699,316,298,298,rainbow dash|twilight sparkle,1trick
1638069.png,https://derpicdn.net/img/view/2018/1/22/1638069.png,0,0.9814403653144836,824,559,1728,1463,904,904,princess celestia|twilight sparkle,firimil
1639454.png,https://derpicdn.net/img/view/2018/1/24/1639454.png,0,0.9866150617599488,248,190,498,440,250,250,applejack|fluttershy|mane six|pinkie pie|rainbow dash|rarity|twilight sparkle,taaffeiite
1639454.png,https://derpicdn.net/img/view/2018/1/24/1639454.png,1,0.9809696674346924,14,221,278,485,264,264,applejack|fluttershy|mane six|pinkie pie|rainbow dash|rarity|twilight sparkle,taaffeiite
1641483.png,https://derpicdn.net/img/view/2018/1/26/1641483.png,0,0.9917044043540956,54,0,372,315,318,315,pinkie pie|rainbow dash|twilight sparkle,
1641625.png,https://derpicdn.net/img/view/2018/1/26/1641625.png,0,0.9629727602005004,1313,311,1581,579,268,268,applejack|fluttershy|mane six|pinkie pie|rainbow dash|rarity|spike|twilight sparkle,
1647077.png,https://derpicdn.net/img/view/2018/2/3/1647077.png,0,0.9715335369110109,584,6,958,380,374,374,applejack|twilight sparkle,inuhoshi-to-darkpen
1647301.png,https://derpicdn.net/img/view/2018/2/3/1647301.png,0,0.9940528869628906,2441,63,4559,2181,2118,2118,pinkie pie|twilight sparkle,pabbley
1649315.png,https://derpicdn.net/img/view/2018/2/5/1649315.png,0,0.9967201352119446,292,0,1694,1093,1402,1093,rainbow dash|twilight sparkle,itsalwayspony
1649408.png,https://derpicdn.net/img/view/2018/2/6/1649408.png,0,0.9516132473945618,56,152,478,574,422,422,rainbow dash|twilight sparkle,emositecc
1649408.png,https://derpicdn.net/img/view/2018/2/6/1649408.png,1,0.9301075935363772,319,38,800,538,481,500,rainbow dash|twilight sparkle,emositecc
1651731.png,https://derpicdn.net/img/view/2018/2/9/1651731.png,0,0.9988977909088136,315,0,785,429,470,429,princess cadance|princess flurry heart|spike|twilight sparkle,emositecc
1651801.png,https://derpicdn.net/img/view/2018/2/9/1651801.png,0,0.9634526371955872,173,357,343,527,170,170,applejack|fluttershy|mane six|pinkie pie|rainbow dash|rarity|twilight sparkle,creeate97
1651801.png,https://derpicdn.net/img/view/2018/2/9/1651801.png,1,0.928061068058014,339,217,523,401,184,184,applejack|fluttershy|mane six|pinkie pie|rainbow dash|rarity|twilight sparkle,creeate97
1651812.png,https://derpicdn.net/img/view/2018/2/9/1651812.png,0,0.9786428809165956,197,0,1920,804,1723,804,princess celestia|twilight sparkle,
1653626.png,https://derpicdn.net/img/view/2018/2/11/1653626.png,0,0.9324573278427124,1166,76,1746,656,580,580,princess celestia|twilight sparkle,onewithspitfire
1654824.png,https://derpicdn.net/img/view/2018/2/13/1654824.png,0,0.9671011567115784,1473,312,1661,500,188,188,applejack|fluttershy|mane six|pinkie pie|rainbow dash|rarity|spike|twilight sparkle,
1655700.png,https://derpicdn.net/img/view/2018/2/14/1655700.png,0,0.9867551922798156,347,0,800,450,453,450,sunset shimmer|twilight sparkle,saturdaymorningproj
1655700.png,https://derpicdn.net/img/view/2018/2/14/1655700.png,1,0.9423072934150696,0,0,472,480,472,480,sunset shimmer|twilight sparkle,saturdaymorningproj
1660295.png,https://derpicdn.net/img/view/2018/2/19/1660295.png,0,0.9930482506752014,1229,1959,2137,2867,908,908,rarity|twilight sparkle,lilfunkman
1660521.png,https://derpicdn.net/img/view/2018/2/19/1660521.png,0,0.985740840435028,189,440,811,1062,622,622,applejack|fluttershy|pinkie pie|princess celestia|rainbow dash|rarity|spike|sunset shimmer|trixie|twilight sparkle,liniitadash23
1660521.png,https://derpicdn.net/img/view/2018/2/19/1660521.png,2,0.9635318517684937,2167,210,2603,646,436,436,applejack|fluttershy|pinkie pie|princess celestia|rainbow dash|rarity|spike|sunset shimmer|trixie|twilight sparkle,liniitadash23
1660521.png,https://derpicdn.net/img/view/2018/2/19/1660521.png,3,0.949733316898346,2496,266,2842,612,346,346,applejack|fluttershy|pinkie pie|princess celestia|rainbow dash|rarity|spike|sunset shimmer|trixie|twilight sparkle,liniitadash23
1660757.png,https://derpicdn.net/img/view/2018/2/19/1660757.png,0,0.9650146365165708,1082,0,4386,3192,3304,3192,sunset shimmer|twilight sparkle,shutterflyeqd
1661590.png,https://derpicdn.net/img/view/2018/2/20/1661590.png,0,0.9593302011489868,901,2472,1261,2832,360,360,applejack|fluttershy|mane six|pinkie pie|rainbow dash|rarity|twilight sparkle,
1661922.png,https://derpicdn.net/img/view/2018/2/21/1661922.png,0,0.9973708391189576,2234,0,5534,3132,3300,3132,rarity|twilight sparkle,lilfunkman
1661922.png,https://derpicdn.net/img/view/2018/2/21/1661922.png,1,0.9733590483665466,341,508,2645,2812,2304,2304,rarity|twilight sparkle,lilfunkman
1663284.png,https://derpicdn.net/img/view/2018/2/23/1663284.png,1,0.9862223863601683,243,0,1193,935,950,935,starlight glimmer|twilight sparkle,seamaggie
1663858.png,https://derpicdn.net/img/view/2018/2/23/1663858.png,1,0.9973862171173096,411,0,797,345,386,345,sunset shimmer|twilight sparkle,sannykat
1665585.png,https://derpicdn.net/img/view/2018/2/25/1665585.png,0,0.9826664328575134,274,469,544,739,270,270,applejack|fluttershy|mane six|pinkie pie|rainbow dash|rarity|twilight sparkle,nanook123
1665585.png,https://derpicdn.net/img/view/2018/2/25/1665585.png,2,0.9572028517723083,0,400,201,620,201,220,applejack|fluttershy|mane six|pinkie pie|rainbow dash|rarity|twilight sparkle,nanook123
1669187.png,https://derpicdn.net/img/view/2018/3/1/1669187.png,1,0.9790402054786682,584,209,772,397,188,188,applejack|fluttershy|mane six|pinkie pie|rainbow dash|rarity|twilight sparkle,miamaha
16725.png,https://derpicdn.net/img/view/2012/6/23/16725.png,0,0.9959140419960022,877,52,1127,302,250,250,applejack|pinkie pie|rainbow dash|twilight sparkle,rikose
16725.png,https://derpicdn.net/img/view/2012/6/23/16725.png,1,0.9921687245368958,1142,117,1380,355,238,238,applejack|pinkie pie|rainbow dash|twilight sparkle,rikose
16725.png,https://derpicdn.net/img/view/2012/6/23/16725.png,2,0.97908616065979,1012,493,1258,739,246,246,applejack|pinkie pie|rainbow dash|twilight sparkle,rikose
16725.png,https://derpicdn.net/img/view/2012/6/23/16725.png,3,0.974407970905304,452,0,654,184,202,184,applejack|pinkie pie|rainbow dash|twilight sparkle,rikose
16725.png,https://derpicdn.net/img/view/2012/6/23/16725.png,5,0.9278004169464112,544,940,794,1190,250,250,applejack|pinkie pie|rainbow dash|twilight sparkle,rikose
16725.png,https://derpicdn.net/img/view/2012/6/23/16725.png,6,0.9182027578353882,43,487,289,733,246,246,applejack|pinkie pie|rainbow dash|twilight sparkle,rikose
1672935.png,https://derpicdn.net/img/view/2018/3/6/1672935.png,1,0.963920533657074,132,115,280,263,148,148,applejack|fluttershy|pinkie pie|rainbow dash|rarity|twilight sparkle,caelynmlp
1675097.png,https://derpicdn.net/img/view/2018/3/9/1675097.png,0,0.9578563570976256,495,0,793,298,298,298,applejack|fluttershy|mane six|pinkie pie|rainbow dash|rarity|spike|twilight sparkle,dm29
1675460.png,https://derpicdn.net/img/view/2018/3/9/1675460.png,0,0.9982874989509584,754,1074,1620,1940,866,866,applejack|fluttershy|pinkie pie|rainbow dash|rarity|spike|sunset shimmer|trixie|twilight sparkle,badumsquish
1675460.png,https://derpicdn.net/img/view/2018/3/9/1675460.png,1,0.9223434925079346,2752,307,3462,1017,710,710,applejack|fluttershy|pinkie pie|rainbow dash|rarity|spike|sunset shimmer|trixie|twilight sparkle,badumsquish
1678687.png,https://derpicdn.net/img/view/2018/3/13/1678687.png,0,0.9015803337097168,0,28,260,298,260,270,sunset shimmer|twilight sparkle,verumtee|little-tweenframes
1679336.png,https://derpicdn.net/img/view/2018/3/13/1679336.png,2,0.9445793628692628,420,12,580,172,160,160,applejack|fluttershy|mane six|pinkie pie|princess celestia|princess luna|rainbow dash|rarity|spike|twilight sparkle,jiayi
1679336.png,https://derpicdn.net/img/view/2018/3/13/1679336.png,3,0.9274803996086121,106,309,298,501,192,192,applejack|fluttershy|mane six|pinkie pie|princess celestia|princess luna|rainbow dash|rarity|spike|twilight sparkle,jiayi
1679764.png,https://derpicdn.net/img/view/2018/3/14/1679764.png,0,0.9155392050743104,66,35,456,425,390,390,starlight glimmer|trixie|twilight sparkle,
1682920.png,https://derpicdn.net/img/view/2018/3/17/1682920.png,0,0.9988166689872742,354,6,732,384,378,378,starlight glimmer|twilight sparkle,mysticcoral
1682920.png,https://derpicdn.net/img/view/2018/3/17/1682920.png,1,0.9688709378242492,358,275,694,611,336,336,starlight glimmer|twilight sparkle,mysticcoral
1684351.png,https://derpicdn.net/img/view/2018/3/18/1684351.png,0,0.9992850422859192,22,14,406,398,384,384,princess celestia|twilight sparkle,spazzdhn
1686755.png,https://derpicdn.net/img/view/2018/3/21/1686755.png,0,0.9777384996414183,318,22,880,584,562,562,applejack|twilight sparkle,umejiru
1686756.png,https://derpicdn.net/img/view/2018/3/21/1686756.png,0,0.9799796342849731,309,12,889,592,580,580,applejack|twilight sparkle,umejiru
1688574.png,https://derpicdn.net/img/view/2018/3/24/1688574.png,1,0.9233217239379884,0,36,1100,1188,1100,1152,trixie|twilight sparkle,jimmyjamno1
1689739.png,https://derpicdn.net/img/view/2018/3/25/1689739.png,0,0.9924495220184326,281,73,775,567,494,494,starlight glimmer|twilight sparkle,
1692779.png,https://derpicdn.net/img/view/2018/3/28/1692779.png,0,0.97817724943161,390,0,826,360,436,360,applejack|twilight sparkle,royalagate|tsitra360
169376.png,https://derpicdn.net/img/view/2012/12/1/169376.png,0,0.9886162877082824,74,0,520,418,446,418,princess celestia|trixie|twilight sparkle,zelc-face
169376.png,https://derpicdn.net/img/view/2012/12/1/169376.png,1,0.9858306050300598,410,0,880,441,470,441,princess celestia|trixie|twilight sparkle,zelc-face
16957.png,https://derpicdn.net/img/view/2012/6/23/16957.png,0,0.9864954948425292,44,0,618,569,574,569,rainbow dash|twilight sparkle,microgrid
1696159.png,https://derpicdn.net/img/view/2018/4/1/1696159.png,0,0.9752880334854126,5990,3710,8192,6006,2202,2296,applejack|fluttershy|mane six|pinkie pie|rainbow dash|rarity|twilight sparkle,amarthgul
1697013.png,https://derpicdn.net/img/view/2018/4/2/1697013.png,0,0.9938035011291504,1068,455,1300,687,232,232,applejack|fluttershy|mane six|pinkie pie|princess celestia|rainbow dash|rarity|spike|twilight sparkle,
1697013.png,https://derpicdn.net/img/view/2018/4/2/1697013.png,1,0.9895759224891664,44,236,250,442,206,206,applejack|fluttershy|mane six|pinkie pie|princess celestia|rainbow dash|rarity|spike|twilight sparkle,
1697013.png,https://derpicdn.net/img/view/2018/4/2/1697013.png,3,0.902452290058136,56,413,312,669,256,256,applejack|fluttershy|mane six|pinkie pie|princess celestia|rainbow dash|rarity|spike|twilight sparkle,
1697135.png,https://derpicdn.net/img/view/2018/4/2/1697135.png,0,0.976018488407135,524,207,2188,1871,1664,1664,rainbow dash|twilight sparkle,twidasher
1698017.png,https://derpicdn.net/img/view/2018/4/3/1698017.png,0,0.9898645281791688,1227,2,2023,798,796,796,princess luna|twilight sparkle,bra1neater
1698835.png,https://derpicdn.net/img/view/2018/4/4/1698835.png,1,0.978757619857788,0,331,233,567,233,236,applejack|fluttershy|mane six|pinkie pie|rainbow dash|rarity|twilight sparkle,tsukusun
1698835.png,https://derpicdn.net/img/view/2018/4/4/1698835.png,2,0.9611448049545288,348,33,580,265,232,232,applejack|fluttershy|mane six|pinkie pie|rainbow dash|rarity|twilight sparkle,tsukusun
1698835.png,https://derpicdn.net/img/view/2018/4/4/1698835.png,3,0.9489010572433472,403,301,640,551,237,250,applejack|fluttershy|mane six|pinkie pie|rainbow dash|rarity|twilight sparkle,tsukusun
1699539.png,https://derpicdn.net/img/view/2018/4/5/1699539.png,0,0.9657980799674988,1288,0,2400,1087,1112,1087,applejack|fluttershy|pinkie pie|rainbow dash|twilight sparkle,beardeddoomguy|hooves-art
1700394.png,https://derpicdn.net/img/view/2018/4/6/1700394.png,0,0.9877859354019164,597,11,1095,509,498,498,spike|twilight sparkle,princesketchy|riukime
1700667.png,https://derpicdn.net/img/view/2018/4/6/1700667.png,0,0.967971920967102,575,494,1173,1092,598,598,applejack|fluttershy|mane six|pinkie pie|rainbow dash|rarity|twilight sparkle,limebreaker
1703477.png,https://derpicdn.net/img/view/2018/4/9/1703477.png,0,0.9703779220581056,0,1386,1692,3152,1692,1766,rainbow dash|twilight sparkle,twidasher
1704126.png,https://derpicdn.net/img/view/2018/4/10/1704126.png,0,0.9980862736701964,822,212,1362,752,540,540,rarity|twilight sparkle,lilfunkman
1704126.png,https://derpicdn.net/img/view/2018/4/10/1704126.png,1,0.9859899282455444,617,247,1051,681,434,434,rarity|twilight sparkle,lilfunkman
1707404.png,https://derpicdn.net/img/view/2018/4/14/1707404.png,0,0.9927095174789428,604,470,920,786,316,316,princess flurry heart|twilight sparkle,hagallaz
171358.jpg,https://derpicdn.net/img/view/2012/12/3/171358.jpg,0,0.9950902462005616,63,199,321,457,258,258,spike|trixie|twilight sparkle,ss2sonic
1715589.png,https://derpicdn.net/img/view/2018/4/23/1715589.png,0,0.9990744590759276,1033,1349,1650,1999,617,650,applejack|fluttershy|mane six|pinkie pie|rainbow dash|rarity|twilight sparkle,serenity
1715589.png,https://derpicdn.net/img/view/2018/4/23/1715589.png,1,0.9970638751983644,0,352,559,998,559,646,applejack|fluttershy|mane six|pinkie pie|rainbow dash|rarity|twilight sparkle,serenity
1715589.png,https://derpicdn.net/img/view/2018/4/23/1715589.png,2,0.9761297106742859,993,0,1579,470,586,470,applejack|fluttershy|mane six|pinkie pie|rainbow dash|rarity|twilight sparkle,serenity
1715589.png,https://derpicdn.net/img/view/2018/4/23/1715589.png,3,0.9535154700279236,185,1216,739,1770,554,554,applejack|fluttershy|mane six|pinkie pie|rainbow dash|rarity|twilight sparkle,serenity
1715707.png,https://derpicdn.net/img/view/2018/4/24/1715707.png,0,0.9992462992668152,1588,2751,3180,4343,1592,1592,applejack|twilight sparkle,drawbauchery
1715707.png,https://derpicdn.net/img/view/2018/4/24/1715707.png,1,0.9752331972122192,3553,1485,5091,3023,1538,1538,applejack|twilight sparkle,drawbauchery
1716224.png,https://derpicdn.net/img/view/2018/4/24/1716224.png,0,0.9567019939422609,1031,120,1971,1060,940,940,rainbow dash|twilight sparkle,twidasher
1716224.png,https://derpicdn.net/img/view/2018/4/24/1716224.png,1,0.9272712469100952,34,176,1178,1320,1144,1144,rainbow dash|twilight sparkle,twidasher
1716526.png,https://derpicdn.net/img/view/2018/4/25/1716526.png,0,0.9991058707237244,996,459,1704,1167,708,708,rainbow dash|twilight sparkle,solareflares
1716526.png,https://derpicdn.net/img/view/2018/4/25/1716526.png,1,0.9952654838562012,427,0,1077,612,650,612,rainbow dash|twilight sparkle,solareflares
1716832.png,https://derpicdn.net/img/view/2018/4/25/1716832.png,0,0.9199022650718688,750,28,2418,1696,1668,1668,rainbow dash|twilight sparkle,twidasher
1716893.png,https://derpicdn.net/img/view/2018/4/25/1716893.png,0,0.9065641760826112,1128,0,3522,2269,2394,2269,princess celestia|twilight sparkle,darkest-lunar-flower
171789.png,https://derpicdn.net/img/view/2012/12/3/171789.png,0,0.9293612241744996,3714,223,4310,819,596,596,trixie|twilight sparkle,yanoda
1718012.png,https://derpicdn.net/img/view/2018/4/27/1718012.png,0,0.9103120565414428,172,918,800,1546,628,628,princess cadance|princess celestia|princess luna|twilight sparkle,candasaurus
1719017.png,https://derpicdn.net/img/view/2018/4/28/1719017.png,0,0.9974732398986816,473,665,775,967,302,302,applejack|fluttershy|mane six|pinkie pie|rainbow dash|rarity|twilight sparkle,xxmelody-scribblexx
1719017.png,https://derpicdn.net/img/view/2018/4/28/1719017.png,1,0.9897812604904176,450,116,784,450,334,334,applejack|fluttershy|mane six|pinkie pie|rainbow dash|rarity|twilight sparkle,xxmelody-scribblexx
1719017.png,https://derpicdn.net/img/view/2018/4/28/1719017.png,2,0.9831053018569946,29,752,277,1000,248,248,applejack|fluttershy|mane six|pinkie pie|rainbow dash|rarity|twilight sparkle,xxmelody-scribblexx
1720476.png,https://derpicdn.net/img/view/2018/4/29/1720476.png,0,0.9968397617340088,275,225,453,403,178,178,starlight glimmer|sunset shimmer|twilight sparkle,alexbluebird
1720476.png,https://derpicdn.net/img/view/2018/4/29/1720476.png,1,0.9435732364654541,484,96,694,306,210,210,starlight glimmer|sunset shimmer|twilight sparkle,alexbluebird
1721629.png,https://derpicdn.net/img/view/2018/5/1/1721629.png,0,0.9861947298049928,2287,1590,2859,2162,572,572,applejack|fluttershy|mane six|pinkie pie|princess celestia|rainbow dash|rarity|shining armor|spike|twilight sparkle,saphi-boo
1722424.png,https://derpicdn.net/img/view/2018/5/2/1722424.png,0,0.9937527179718018,76,0,222,145,146,145,starlight glimmer|sunset shimmer|twilight sparkle,wilvarin-liadon
1723454.png,https://derpicdn.net/img/view/2018/5/3/1723454.png,0,0.9768285751342772,472,523,734,785,262,262,applejack|fluttershy|mane six|pinkie pie|rainbow dash|rarity|spike|twilight sparkle,
1723454.png,https://derpicdn.net/img/view/2018/5/3/1723454.png,1,0.9416908025741576,99,627,359,887,260,260,applejack|fluttershy|mane six|pinkie pie|rainbow dash|rarity|spike|twilight sparkle,
1723578.png,https://derpicdn.net/img/view/2018/5/4/1723578.png,0,0.9717414975166321,368,30,794,456,426,426,rainbow dash|twilight sparkle,afkcyrist
1725736.png,https://derpicdn.net/img/view/2018/5/6/1725736.png,0,0.9994327425956726,1217,806,1541,1130,324,324,applejack|fluttershy|mane six|pinkie pie|rainbow dash|rarity|twilight sparkle,scarlet-spectrum
1725736.png,https://derpicdn.net/img/view/2018/5/6/1725736.png,1,0.9987776279449464,1123,0,1511,371,388,371,applejack|fluttershy|mane six|pinkie pie|rainbow dash|rarity|twilight sparkle,scarlet-spectrum
1725736.png,https://derpicdn.net/img/view/2018/5/6/1725736.png,2,0.992508590221405,78,0,380,292,302,292,applejack|fluttershy|mane six|pinkie pie|rainbow dash|rarity|twilight sparkle,scarlet-spectrum
1725736.png,https://derpicdn.net/img/view/2018/5/6/1725736.png,3,0.988484263420105,719,0,1013,289,294,289,applejack|fluttershy|mane six|pinkie pie|rainbow dash|rarity|twilight sparkle,scarlet-spectrum
1725736.png,https://derpicdn.net/img/view/2018/5/6/1725736.png,5,0.953839123249054,139,806,465,1132,326,326,applejack|fluttershy|mane six|pinkie pie|rainbow dash|rarity|twilight sparkle,scarlet-spectrum
1731156.png,https://derpicdn.net/img/view/2018/5/12/1731156.png,0,0.9944481849670408,402,0,946,518,544,518,trixie|twilight sparkle,fiercedeitylynx
1731292.png,https://derpicdn.net/img/view/2018/5/12/1731292.png,0,0.995179295539856,985,0,2000,991,1015,991,sunset shimmer|twilight sparkle,jase1505
1731292.png,https://derpicdn.net/img/view/2018/5/12/1731292.png,1,0.9902466535568236,0,0,993,966,993,966,sunset shimmer|twilight sparkle,jase1505
1731818.png,https://derpicdn.net/img/view/2018/5/13/1731818.png,3,0.9150915741920472,135,4016,1239,5120,1104,1104,apple bloom|applejack|big macintosh|fluttershy|mane six|pinkie pie|rainbow dash|rarity|shining armor|sweetie belle|twilight sparkle,evilfrenzy
1732313.png,https://derpicdn.net/img/view/2018/5/14/1732313.png,0,0.996460497379303,220,0,614,388,394,388,spike|twilight sparkle,bunnynha
1735497.png,https://derpicdn.net/img/view/2018/5/18/1735497.png,0,0.9591285586357116,659,216,835,392,176,176,applejack|fluttershy|granny smith|pinkie pie|princess celestia|rainbow dash|scootaloo|spike|starlight glimmer|twilight sparkle,dm29
1738608.png,https://derpicdn.net/img/view/2018/5/22/1738608.png,0,0.972943902015686,1795,640,2601,1446,806,806,applejack|twilight sparkle,carnifex
173912.jpg,https://derpicdn.net/img/view/2012/12/6/173912.jpg,0,0.9942321181297302,587,333,725,471,138,138,trixie|twilight sparkle,vendaris
173912.jpg,https://derpicdn.net/img/view/2012/12/6/173912.jpg,1,0.9888097047805786,599,55,743,199,144,144,trixie|twilight sparkle,vendaris
1739418.png,https://derpicdn.net/img/view/2018/5/23/1739418.png,0,0.9955984354019164,881,0,1379,391,498,391,fluttershy|pinkie pie|rainbow dash|twilight sparkle,/d/non
1739573.png,https://derpicdn.net/img/view/2018/5/23/1739573.png,0,0.9425065517425536,293,63,927,697,634,634,spike|twilight sparkle,yam
174176.png,https://derpicdn.net/img/view/2012/12/6/174176.png,0,0.9948914647102356,2104,304,2776,976,672,672,fluttershy|pinkie pie|twilight sparkle,kas92
1742168.png,https://derpicdn.net/img/view/2018/5/26/1742168.png,0,0.9988308548927308,53,260,581,788,528,528,rarity|spike|twilight sparkle,saturdaymorningproj
1742168.png,https://derpicdn.net/img/view/2018/5/26/1742168.png,2,0.969542384147644,795,315,1335,855,540,540,rarity|spike|twilight sparkle,saturdaymorningproj
1742764.png,https://derpicdn.net/img/view/2018/5/27/1742764.png,0,0.958323061466217,49,0,577,505,528,505,princess celestia|princess luna|twilight sparkle,tohupo
1743243.png,https://derpicdn.net/img/view/2018/5/27/1743243.png,0,0.9809628129005432,5,0,897,833,892,833,queen chrysalis|twilight sparkle,skitter
1745446.png,https://derpicdn.net/img/view/2018/5/30/1745446.png,0,0.998286247253418,0,29,1054,1115,1054,1086,sunset shimmer|twilight sparkle,adostume
1746323.png,https://derpicdn.net/img/view/2018/5/31/1746323.png,0,0.9608623385429382,155,130,333,308,178,178,rarity|twilight sparkle,lilfunkman
1747961.png,https://derpicdn.net/img/view/2018/6/2/1747961.png,1,0.9442816376686096,844,463,1054,673,210,210,applejack|big macintosh|fluttershy|granny smith|pinkie pie|princess celestia|rainbow dash|scootaloo|spike|starlight glimmer|sweetie belle|twilight sparkle,dm29
1747961.png,https://derpicdn.net/img/view/2018/6/2/1747961.png,2,0.9260405898094176,332,0,588,232,256,232,applejack|big macintosh|fluttershy|granny smith|pinkie pie|princess celestia|rainbow dash|scootaloo|spike|starlight glimmer|sweetie belle|twilight sparkle,dm29
1748493.png,https://derpicdn.net/img/view/2018/6/3/1748493.png,0,0.9875096678733826,2202,941,2802,1541,600,600,princess cadance|princess celestia|princess luna|twilight sparkle,drawbauchery
1750304.png,https://derpicdn.net/img/view/2018/6/5/1750304.png,0,0.9230524897575378,140,26,592,478,452,452,spike|twilight sparkle,emositecc
1750542.png,https://derpicdn.net/img/view/2018/6/5/1750542.png,0,0.997757852077484,0,56,442,538,442,482,princess celestia|twilight sparkle,verawitch
1750782.png,https://derpicdn.net/img/view/2018/6/5/1750782.png,0,0.9973301291465759,357,634,689,966,332,332,spike|twilight sparkle,inuhoshi-to-darkpen
1751079.png,https://derpicdn.net/img/view/2018/6/6/1751079.png,0,0.9953823685646056,472,922,760,1210,288,288,applejack|big macintosh|fluttershy|mane six|pinkie pie|princess cadance|princess celestia|princess luna|rainbow dash|rarity|shining armor|spike|twilight sparkle,andypriceart
1751079.png,https://derpicdn.net/img/view/2018/6/6/1751079.png,5,0.9263864159584044,482,300,716,534,234,234,applejack|big macintosh|fluttershy|mane six|pinkie pie|princess cadance|princess celestia|princess luna|rainbow dash|rarity|shining armor|spike|twilight sparkle,andypriceart
1752430.png,https://derpicdn.net/img/view/2018/6/8/1752430.png,0,0.9968636035919192,374,380,622,628,248,248,discord|spike|twilight sparkle,heilos
1752430.png,https://derpicdn.net/img/view/2018/6/8/1752430.png,1,0.9808089733123779,188,325,422,559,234,234,discord|spike|twilight sparkle,heilos
1752430.png,https://derpicdn.net/img/view/2018/6/8/1752430.png,2,0.9605013132095336,712,461,916,665,204,204,discord|spike|twilight sparkle,heilos
1752430.png,https://derpicdn.net/img/view/2018/6/8/1752430.png,3,0.9507080316543579,2,419,186,603,184,184,discord|spike|twilight sparkle,heilos
1753617.png,https://derpicdn.net/img/view/2018/6/9/1753617.png,0,0.981063723564148,0,1427,428,1913,428,486,applejack|fluttershy|mane six|pinkie pie|queen chrysalis|rainbow dash|rarity|twilight sparkle,yewdee
1753617.png,https://derpicdn.net/img/view/2018/6/9/1753617.png,2,0.9424155950546264,4,0,1244,1145,1240,1145,applejack|fluttershy|mane six|pinkie pie|queen chrysalis|rainbow dash|rarity|twilight sparkle,yewdee
1753617.png,https://derpicdn.net/img/view/2018/6/9/1753617.png,3,0.9101213216781616,1165,1487,1677,1999,512,512,applejack|fluttershy|mane six|pinkie pie|queen chrysalis|rainbow dash|rarity|twilight sparkle,yewdee
1754978.png,https://derpicdn.net/img/view/2018/6/11/1754978.png,0,0.9995952248573304,2647,0,4309,1330,1662,1330,applejack|fluttershy|mane six|pinkie pie|rainbow dash|rarity|starlight glimmer|twilight sparkle,jhayarr23
1754978.png,https://derpicdn.net/img/view/2018/6/11/1754978.png,1,0.9920995831489564,1557,0,3153,1334,1596,1334,applejack|fluttershy|mane six|pinkie pie|rainbow dash|rarity|starlight glimmer|twilight sparkle,jhayarr23
1755709.png,https://derpicdn.net/img/view/2018/6/12/1755709.png,0,0.9907459616661072,2181,0,4401,2192,2220,2192,spike|twilight sparkle,auroriia
175652.png,https://derpicdn.net/img/view/2012/12/8/175652.png,0,0.999184548854828,1934,644,2400,1120,466,476,applejack|fluttershy|mane six|pinkie pie|rainbow dash|rarity|spike|twilight sparkle,elenaboosy
175652.png,https://derpicdn.net/img/view/2012/12/8/175652.png,2,0.9897204637527466,839,403,1413,977,574,574,applejack|fluttershy|mane six|pinkie pie|rainbow dash|rarity|spike|twilight sparkle,elenaboosy
1759366.png,https://derpicdn.net/img/view/2018/6/16/1759366.png,0,0.9881430864334106,176,60,840,724,664,664,rainbow dash|twilight sparkle,johnjudes
1759366.png,https://derpicdn.net/img/view/2018/6/16/1759366.png,1,0.9539652466773988,714,207,1354,847,640,640,rainbow dash|twilight sparkle,johnjudes
176052.png,https://derpicdn.net/img/view/2012/12/8/176052.png,0,0.990680694580078,84,82,404,402,320,320,pinkie pie|twilight sparkle,ende26
1763473.png,https://derpicdn.net/img/view/2018/6/22/1763473.png,0,0.9823884963989258,29,0,595,522,566,522,starlight glimmer|sunset shimmer|twilight sparkle,ch-chau|whiskyice|chautung
1763473.png,https://derpicdn.net/img/view/2018/6/22/1763473.png,2,0.922407567501068,843,0,1339,481,496,481,starlight glimmer|sunset shimmer|twilight sparkle,ch-chau|whiskyice|chautung
1763881.png,https://derpicdn.net/img/view/2018/6/23/1763881.png,0,0.9992484450340272,279,0,707,391,428,391,spike|twilight sparkle,theecchiqueen
1766351.png,https://derpicdn.net/img/view/2018/6/26/1766351.png,0,0.9863166809082032,20,92,352,424,332,332,fluttershy|starlight glimmer|sweetie belle|twilight sparkle,thegreatrouge
1766351.png,https://derpicdn.net/img/view/2018/6/26/1766351.png,1,0.9121270179748536,346,0,892,503,546,503,fluttershy|starlight glimmer|sweetie belle|twilight sparkle,thegreatrouge
1766398.png,https://derpicdn.net/img/view/2018/6/26/1766398.png,0,0.9993999004364014,2528,182,3212,866,684,684,princess celestia|princess luna|twilight sparkle,sintakhra
1766910.png,https://derpicdn.net/img/view/2018/6/27/1766910.png,0,0.9946930408477784,439,47,979,587,540,540,starlight glimmer|twilight sparkle,ashtoneer|heir-of-rick
1766910.png,https://derpicdn.net/img/view/2018/6/27/1766910.png,1,0.9892101287841796,204,711,924,1431,720,720,starlight glimmer|twilight sparkle,ashtoneer|heir-of-rick
1768430.png,https://derpicdn.net/img/view/2018/6/28/1768430.png,0,0.9670777916908264,990,0,2016,919,1026,919,princess celestia|twilight sparkle,waackery
1768732.png,https://derpicdn.net/img/view/2018/6/29/1768732.png,0,0.9028165340423584,350,0,626,246,276,246,apple bloom|applejack|big macintosh|cutie mark crusaders|fluttershy|granny smith|pinkie pie|princess celestia|rainbow dash|scootaloo|spike|starlight glimmer|sweetie belle|trixie|twilight sparkle,dm29
1769724.png,https://derpicdn.net/img/view/2018/6/30/1769724.png,0,0.9772522449493408,156,65,848,757,692,692,princess celestia|twilight sparkle,waackery
1769991.png,https://derpicdn.net/img/view/2018/6/30/1769991.png,0,0.9802464246749878,245,240,887,882,642,642,rarity|twilight sparkle,skitter
1770364.png,https://derpicdn.net/img/view/2018/7/1/1770364.png,0,0.9982408285140992,0,679,1420,2553,1420,1874,princess cadance|shining armor|twilight sparkle,silverhopexiii
1770364.png,https://derpicdn.net/img/view/2018/7/1/1770364.png,1,0.996670424938202,1643,982,2800,2482,1157,1500,princess cadance|shining armor|twilight sparkle,silverhopexiii
1770364.png,https://derpicdn.net/img/view/2018/7/1/1770364.png,2,0.990156590938568,820,2361,2040,3581,1220,1220,princess cadance|shining armor|twilight sparkle,silverhopexiii
1773880.png,https://derpicdn.net/img/view/2018/7/6/1773880.png,0,0.9947988390922546,1959,358,3729,2128,1770,1770,sunset shimmer|twilight sparkle,nichroniclesvsart
1775504.png,https://derpicdn.net/img/view/2018/7/8/1775504.png,0,0.9985368251800536,37,0,453,385,416,385,starlight glimmer|twilight sparkle,crownhound
1776720.png,https://derpicdn.net/img/view/2018/7/9/1776720.png,0,0.9814258217811584,1511,129,2551,1169,1040,1040,applejack|fluttershy|mane six|pinkie pie|rainbow dash|rarity|spike|twilight sparkle,lupiarts
1778066.png,https://derpicdn.net/img/view/2018/7/11/1778066.png,0,0.99455463886261,361,551,1251,1441,890,890,applejack|fluttershy|mane six|pinkie pie|rainbow dash|rarity|twilight sparkle,ciderpunk
1778404.png,https://derpicdn.net/img/view/2018/7/11/1778404.png,0,0.995113492012024,1510,101,1846,437,336,336,fluttershy|rarity|starlight glimmer|twilight sparkle,seishinann
17789.jpg,https://derpicdn.net/img/view/2012/6/23/17789.jpg,1,0.9812138676643372,330,13,634,317,304,304,applejack|fluttershy|mane six|pinkie pie|princess luna|rainbow dash|rarity|trixie|twilight sparkle,solar-slash
17789.jpg,https://derpicdn.net/img/view/2012/6/23/17789.jpg,3,0.9220159649848938,416,298,680,562,264,264,applejack|fluttershy|mane six|pinkie pie|princess luna|rainbow dash|rarity|trixie|twilight sparkle,solar-slash
1779343.png,https://derpicdn.net/img/view/2018/7/12/1779343.png,0,0.9950124621391296,1421,833,2269,1681,848,848,apple bloom|applejack|fluttershy|mane six|pinkie pie|rainbow dash|rarity|scootaloo|spike|starlight glimmer|sweetie belle|trixie|twilight sparkle,fluffyxai
1779343.png,https://derpicdn.net/img/view/2018/7/12/1779343.png,1,0.9779110550880432,2948,1029,3632,1713,684,684,apple bloom|applejack|fluttershy|mane six|pinkie pie|rainbow dash|rarity|scootaloo|spike|starlight glimmer|sweetie belle|trixie|twilight sparkle,fluffyxai
1781633.png,https://derpicdn.net/img/view/2018/7/15/1781633.png,1,0.9970375299453736,404,323,582,501,178,178,applejack|fluttershy|mane six|pinkie pie|rainbow dash|rarity|sunset shimmer|twilight sparkle,lucheek
1781633.png,https://derpicdn.net/img/view/2018/7/15/1781633.png,2,0.990629017353058,180,0,506,287,326,287,applejack|fluttershy|mane six|pinkie pie|rainbow dash|rarity|sunset shimmer|twilight sparkle,lucheek
1782124.png,https://derpicdn.net/img/view/2018/7/16/1782124.png,0,0.9727091789245604,289,64,563,338,274,274,princess luna|twilight sparkle,lulubell
1784127.png,https://derpicdn.net/img/view/2018/7/18/1784127.png,0,0.9976415038108826,512,159,1190,837,678,678,starlight glimmer|twilight sparkle,doekitty
1786557.png,https://derpicdn.net/img/view/2018/7/22/1786557.png,0,0.9991503953933716,1207,397,1847,1037,640,640,applejack|fluttershy|mane six|pinkie pie|rainbow dash|rarity|twilight sparkle,urbanqhoul
1786557.png,https://derpicdn.net/img/view/2018/7/22/1786557.png,1,0.9973248839378356,660,312,1364,1016,704,704,applejack|fluttershy|mane six|pinkie pie|rainbow dash|rarity|twilight sparkle,urbanqhoul
1789499.png,https://derpicdn.net/img/view/2018/7/25/1789499.png,0,0.9908095002174376,890,0,1818,848,928,848,princess cadance|princess luna|twilight sparkle,2snacks
1789499.png,https://derpicdn.net/img/view/2018/7/25/1789499.png,1,0.9880647063255308,70,88,618,636,548,548,princess cadance|princess luna|twilight sparkle,2snacks
1794065.png,https://derpicdn.net/img/view/2018/7/31/1794065.png,0,0.9910850524902344,110,0,440,330,330,330,sunset shimmer|twilight sparkle,dm29
1794866.png,https://derpicdn.net/img/view/2018/8/1/1794866.png,1,0.9076862931251526,523,314,825,616,302,302,applejack|fluttershy|mane six|pinkie pie|rainbow dash|rarity|twilight sparkle,olivecow
17970.png,https://derpicdn.net/img/view/2012/6/24/17970.png,0,0.9204534888267516,580,321,734,475,154,154,apple bloom|applejack|big macintosh|diamond tiara|fluttershy|pinkie pie|princess celestia|princess luna|rainbow dash|rarity|silver spoon|spike|twilight sparkle,emlan
17970.png,https://derpicdn.net/img/view/2012/6/24/17970.png,1,0.9108057022094728,529,601,683,755,154,154,apple bloom|applejack|big macintosh|diamond tiara|fluttershy|pinkie pie|princess celestia|princess luna|rainbow dash|rarity|silver spoon|spike|twilight sparkle,emlan
1799228.png,https://derpicdn.net/img/view/2018/8/6/1799228.png,0,0.999254047870636,0,6,253,264,253,258,applejack|fluttershy|mane six|pinkie pie|rainbow dash|rarity|twilight sparkle,pekou
1799228.png,https://derpicdn.net/img/view/2018/8/6/1799228.png,1,0.9990702867507936,324,348,638,662,314,314,applejack|fluttershy|mane six|pinkie pie|rainbow dash|rarity|twilight sparkle,pekou
1799228.png,https://derpicdn.net/img/view/2018/8/6/1799228.png,2,0.9987252950668336,584,325,922,663,338,338,applejack|fluttershy|mane six|pinkie pie|rainbow dash|rarity|twilight sparkle,pekou
1799228.png,https://derpicdn.net/img/view/2018/8/6/1799228.png,3,0.9983296394348145,320,0,648,301,328,301,applejack|fluttershy|mane six|pinkie pie|rainbow dash|rarity|twilight sparkle,pekou
1799228.png,https://derpicdn.net/img/view/2018/8/6/1799228.png,4,0.9907428622245787,611,0,919,288,308,288,applejack|fluttershy|mane six|pinkie pie|rainbow dash|rarity|twilight sparkle,pekou
1799228.png,https://derpicdn.net/img/view/2018/8/6/1799228.png,5,0.9395459294319152,43,375,331,663,288,288,applejack|fluttershy|mane six|pinkie pie|rainbow dash|rarity|twilight sparkle,pekou
1799573.png,https://derpicdn.net/img/view/2018/8/6/1799573.png,0,0.9861840009689332,171,0,1317,1122,1146,1122,sunset shimmer|twilight sparkle,duskie-06
1800025.png,https://derpicdn.net/img/view/2018/8/6/1800025.png,0,0.9858844876289368,1110,116,3002,2008,1892,1892,princess celestia|twilight sparkle,faline-art
1800025.png,https://derpicdn.net/img/view/2018/8/6/1800025.png,1,0.952711284160614,2759,1426,4131,2798,1372,1372,princess celestia|twilight sparkle,faline-art
1805819.png,https://derpicdn.net/img/view/2018/8/13/1805819.png,0,0.9446108937263488,319,0,1239,815,920,815,spike|twilight sparkle,hierozaki
1806537.png,https://derpicdn.net/img/view/2018/8/14/1806537.png,0,0.9969673752784728,414,186,858,630,444,444,starlight glimmer|trixie|twilight sparkle,tahublade7
1814215.png,https://derpicdn.net/img/view/2018/8/23/1814215.png,0,0.9581685066223145,3658,1170,4490,2002,832,832,applejack|fluttershy|mane six|pinkie pie|princess celestia|princess luna|rainbow dash|rarity|sunset shimmer|twilight sparkle,duskie-06
1814740.png,https://derpicdn.net/img/view/2018/8/24/1814740.png,0,0.9552130103111268,193,0,673,465,480,465,rainbow dash|twilight sparkle,astra
1815554.png,https://derpicdn.net/img/view/2018/8/25/1815554.png,0,0.9841096997261048,421,0,1280,768,859,768,princess luna|twilight sparkle,silfoe
1815554.png,https://derpicdn.net/img/view/2018/8/25/1815554.png,1,0.9687033295631408,28,254,608,834,580,580,princess luna|twilight sparkle,silfoe
1816597.png,https://derpicdn.net/img/view/2018/8/26/1816597.png,0,0.9987742304801941,1105,0,1799,653,694,653,applejack|fluttershy|pinkie pie|rainbow dash|rarity|twilight sparkle,lalakachu
1816597.png,https://derpicdn.net/img/view/2018/8/26/1816597.png,1,0.997863233089447,1753,462,2375,1084,622,622,applejack|fluttershy|pinkie pie|rainbow dash|rarity|twilight sparkle,lalakachu
1816597.png,https://derpicdn.net/img/view/2018/8/26/1816597.png,3,0.9800942540168762,843,790,1389,1336,546,546,applejack|fluttershy|pinkie pie|rainbow dash|rarity|twilight sparkle,lalakachu
1823503.png,https://derpicdn.net/img/view/2018/9/3/1823503.png,0,0.9993457794189452,649,58,1171,580,522,522,rainbow dash|twilight sparkle,kaatseye
1823937.png,https://derpicdn.net/img/view/2018/9/3/1823937.png,0,0.9994550347328186,1867,729,2905,1767,1038,1038,princess celestia|twilight sparkle,comfyplum
1831522.png,https://derpicdn.net/img/view/2018/9/13/1831522.png,0,0.9993365406990052,633,508,1401,1276,768,768,princess celestia|twilight sparkle,comfyplum
1831680.png,https://derpicdn.net/img/view/2018/9/13/1831680.png,0,0.91699880361557,1555,77,2263,785,708,708,applejack|fluttershy|mane six|pinkie pie|rainbow dash|rarity|twilight sparkle,phucknuckl
1831680.png,https://derpicdn.net/img/view/2018/9/13/1831680.png,1,0.9054033160209656,2871,2909,3597,3635,726,726,applejack|fluttershy|mane six|pinkie pie|rainbow dash|rarity|twilight sparkle,phucknuckl
18331.png,https://derpicdn.net/img/view/2012/6/24/18331.png,0,0.9611077308654784,157,201,435,479,278,278,applejack|fluttershy|mane six|pinkie pie|princess celestia|rainbow dash|rarity|twilight sparkle,tess|elslowmo
1833113.png,https://derpicdn.net/img/view/2018/9/15/1833113.png,1,0.9938479661941528,2553,86,3833,1366,1280,1280,applejack|discord|fluttershy|mane six|pinkie pie|rainbow dash|rarity|twilight sparkle,synnfultiger
1834310.png,https://derpicdn.net/img/view/2018/9/16/1834310.png,0,0.9919193387031556,407,126,983,702,576,576,spike|twilight sparkle,mik3thestrange
1840267.png,https://derpicdn.net/img/view/2018/9/24/1840267.png,0,0.9969373941421508,40,144,304,408,264,264,applejack|fluttershy|mane six|pinkie pie|rainbow dash|rarity|twilight sparkle,scarlet-spectrum
1840267.png,https://derpicdn.net/img/view/2018/9/24/1840267.png,1,0.996817946434021,265,0,581,249,316,249,applejack|fluttershy|mane six|pinkie pie|rainbow dash|rarity|twilight sparkle,scarlet-spectrum
1841793.png,https://derpicdn.net/img/view/2018/9/26/1841793.png,1,0.976192831993103,61,417,595,951,534,534,pinkie pie|twilight sparkle,chaosangeldesu
1843311.png,https://derpicdn.net/img/view/2018/9/28/1843311.png,0,0.9626927375793456,170,0,554,379,384,379,applejack|fluttershy|mane six|pinkie pie|rainbow dash|rarity|twilight sparkle,envygirl95
1846173.png,https://derpicdn.net/img/view/2018/10/2/1846173.png,0,0.9165371656417848,16,1093,384,1461,368,368,applejack|princess celestia|princess luna|twilight sparkle,28gooddays
1846690.png,https://derpicdn.net/img/view/2018/10/3/1846690.png,0,0.9990933537483216,220,98,414,292,194,194,applejack|fluttershy|mane six|pinkie pie|rainbow dash|rarity|spike|twilight sparkle,tonyfleecs
1846740.png,https://derpicdn.net/img/view/2018/10/3/1846740.png,0,0.9560688138008118,272,438,926,1092,654,654,princess celestia|twilight sparkle,tolpain
1846908.png,https://derpicdn.net/img/view/2018/10/3/1846908.png,1,0.9582623839378356,1343,50,1845,552,502,502,applejack|fluttershy|mane six|pinkie pie|rainbow dash|rarity|twilight sparkle,ciderpunk
1848347.png,https://derpicdn.net/img/view/2018/10/5/1848347.png,0,0.9733346700668336,534,660,806,932,272,272,applejack|fluttershy|mane six|pinkie pie|princess flurry heart|rainbow dash|rarity|spike|twilight sparkle,tonyfleecs
1848347.png,https://derpicdn.net/img/view/2018/10/5/1848347.png,1,0.9650290608406068,657,969,903,1215,246,246,applejack|fluttershy|mane six|pinkie pie|princess flurry heart|rainbow dash|rarity|spike|twilight sparkle,tonyfleecs
1848347.png,https://derpicdn.net/img/view/2018/10/5/1848347.png,2,0.9170088768005372,366,90,700,424,334,334,applejack|fluttershy|mane six|pinkie pie|princess flurry heart|rainbow dash|rarity|spike|twilight sparkle,tonyfleecs
1855962.png,https://derpicdn.net/img/view/2018/10/14/1855962.png,0,0.934717297554016,84,78,344,338,260,260,fluttershy|twilight sparkle,thegreatrouge
1856323.png,https://derpicdn.net/img/view/2018/10/14/1856323.png,0,0.999218225479126,1752,365,2770,1383,1018,1018,princess celestia|twilight sparkle,batonya12561
1856323.png,https://derpicdn.net/img/view/2018/10/14/1856323.png,1,0.9955885410308838,1329,936,2195,1802,866,866,princess celestia|twilight sparkle,batonya12561
185795.png,https://derpicdn.net/img/view/2012/12/17/185795.png,0,0.9934439659118652,1242,476,3222,2456,1980,1980,fluttershy|rainbow dash|twilight sparkle,swissleo
1863083.png,https://derpicdn.net/img/view/2018/10/22/1863083.png,0,0.9837819337844848,390,0,1942,1466,1552,1466,fluttershy|twilight sparkle,fensu-san
1869089.png,https://derpicdn.net/img/view/2018/10/29/1869089.png,1,0.918732523918152,856,278,1192,614,336,336,sunset shimmer|twilight sparkle,
1870040.png,https://derpicdn.net/img/view/2018/10/30/1870040.png,0,0.996176779270172,893,394,1409,910,516,516,sunset shimmer|twilight sparkle,
1878612.png,https://derpicdn.net/img/view/2018/11/9/1878612.png,0,0.9983452558517456,593,101,817,325,224,224,applejack|fluttershy|mane six|pinkie pie|rainbow dash|rarity|twilight sparkle,
1878834.png,https://derpicdn.net/img/view/2018/11/10/1878834.png,0,0.9931584596633912,1903,135,2461,693,558,558,fluttershy|rainbow dash|rarity|twilight sparkle,monmonstar|percytechnic|optimus97|redaceofspades|dracagon
1878834.png,https://derpicdn.net/img/view/2018/11/10/1878834.png,1,0.9437220692634584,20,240,676,896,656,656,fluttershy|rainbow dash|rarity|twilight sparkle,monmonstar|percytechnic|optimus97|redaceofspades|dracagon
1881555.png,https://derpicdn.net/img/view/2018/11/13/1881555.png,0,0.993614673614502,363,898,2035,2570,1672,1672,spike|twilight sparkle,shutterflyeqd
1886046.png,https://derpicdn.net/img/view/2018/11/19/1886046.png,0,0.9862962365150452,588,139,1246,797,658,658,sunset shimmer|twilight sparkle,ch-chau
1886513.png,https://derpicdn.net/img/view/2018/11/20/1886513.png,2,0.9874472618103028,770,402,984,616,214,214,applejack|fluttershy|mane six|pinkie pie|rainbow dash|rarity|spike|twilight sparkle,merry-carousel
1886513.png,https://derpicdn.net/img/view/2018/11/20/1886513.png,3,0.979220986366272,360,16,706,362,346,346,applejack|fluttershy|mane six|pinkie pie|rainbow dash|rarity|spike|twilight sparkle,merry-carousel
1886513.png,https://derpicdn.net/img/view/2018/11/20/1886513.png,4,0.9319207072257996,690,11,998,319,308,308,applejack|fluttershy|mane six|pinkie pie|rainbow dash|rarity|spike|twilight sparkle,merry-carousel
1890696.png,https://derpicdn.net/img/view/2018/11/25/1890696.png,0,0.9890881776809692,3122,1273,3718,1869,596,596,applejack|discord|fluttershy|mane six|pinkie pie|princess cadance|princess flurry heart|rainbow dash|rarity|shining armor|spike|starlight glimmer|trixie|twilight sparkle,oinktweetstudios
1890696.png,https://derpicdn.net/img/view/2018/11/25/1890696.png,1,0.984542727470398,0,1262,564,1870,564,608,applejack|discord|fluttershy|mane six|pinkie pie|princess cadance|princess flurry heart|rainbow dash|rarity|shining armor|spike|starlight glimmer|trixie|twilight sparkle,oinktweetstudios
1890696.png,https://derpicdn.net/img/view/2018/11/25/1890696.png,2,0.9815062880516052,1251,1076,1801,1626,550,550,applejack|discord|fluttershy|mane six|pinkie pie|princess cadance|princess flurry heart|rainbow dash|rarity|shining armor|spike|starlight glimmer|trixie|twilight sparkle,oinktweetstudios
1890696.png,https://derpicdn.net/img/view/2018/11/25/1890696.png,3,0.973340392112732,1986,414,2830,1258,844,844,applejack|discord|fluttershy|mane six|pinkie pie|princess cadance|princess flurry heart|rainbow dash|rarity|shining armor|spike|starlight glimmer|trixie|twilight sparkle,oinktweetstudios
1890696.png,https://derpicdn.net/img/view/2018/11/25/1890696.png,4,0.909388542175293,1620,988,2236,1604,616,616,applejack|discord|fluttershy|mane six|pinkie pie|princess cadance|princess flurry heart|rainbow dash|rarity|shining armor|spike|starlight glimmer|trixie|twilight sparkle,oinktweetstudios
1890749.png,https://derpicdn.net/img/view/2018/11/25/1890749.png,0,0.9517822265625,201,6,491,296,290,290,princess cadance|twilight sparkle,kkmrarar
1892657.png,https://derpicdn.net/img/view/2018/11/28/1892657.png,0,0.9971567392349244,1031,0,1445,399,414,399,applejack|fluttershy|mane six|pinkie pie|rainbow dash|rarity|spike|starlight glimmer|sunset shimmer|twilight sparkle,fuzon-s
1892657.png,https://derpicdn.net/img/view/2018/11/28/1892657.png,1,0.9949722290039062,1637,0,2261,498,624,498,applejack|fluttershy|mane six|pinkie pie|rainbow dash|rarity|spike|starlight glimmer|sunset shimmer|twilight sparkle,fuzon-s
1892657.png,https://derpicdn.net/img/view/2018/11/28/1892657.png,2,0.992609441280365,1523,373,1969,819,446,446,applejack|fluttershy|mane six|pinkie pie|rainbow dash|rarity|spike|starlight glimmer|sunset shimmer|twilight sparkle,fuzon-s
1892657.png,https://derpicdn.net/img/view/2018/11/28/1892657.png,3,0.9419769644737244,395,438,809,852,414,414,applejack|fluttershy|mane six|pinkie pie|rainbow dash|rarity|spike|starlight glimmer|sunset shimmer|twilight sparkle,fuzon-s
1892657.png,https://derpicdn.net/img/view/2018/11/28/1892657.png,4,0.9092066884040833,1213,377,1649,813,436,436,applejack|fluttershy|mane six|pinkie pie|rainbow dash|rarity|spike|starlight glimmer|sunset shimmer|twilight sparkle,fuzon-s
1896646.png,https://derpicdn.net/img/view/2018/12/2/1896646.png,0,0.9396146535873412,455,10,1085,640,630,630,starlight glimmer|twilight sparkle,fluttershy_z|wcctnoam
1898452.png,https://derpicdn.net/img/view/2018/12/4/1898452.png,0,0.9939614534378052,511,90,1121,700,610,610,fluttershy|rainbow dash|rarity|twilight sparkle,shad0w-galaxy
1899387.png,https://derpicdn.net/img/view/2018/12/5/1899387.png,0,0.9803875684738159,1939,1027,2952,2265,1013,1238,princess cadance|queen chrysalis|shining armor|twilight sparkle,yunlongchen
1906922.png,https://derpicdn.net/img/view/2018/12/13/1906922.png,0,0.9988591074943542,982,1676,1882,2576,900,900,discord|fluttershy|queen chrysalis|twilight sparkle,switchsugar
1906922.png,https://derpicdn.net/img/view/2018/12/13/1906922.png,1,0.9964857697486876,1778,357,2956,1535,1178,1178,discord|fluttershy|queen chrysalis|twilight sparkle,switchsugar
1906922.png,https://derpicdn.net/img/view/2018/12/13/1906922.png,2,0.9858611226081848,2533,1269,3427,2163,894,894,discord|fluttershy|queen chrysalis|twilight sparkle,switchsugar
1913328.png,https://derpicdn.net/img/view/2018/12/20/1913328.png,0,0.9820423722267152,500,0,1262,728,762,728,discord|spike|twilight sparkle,ss2sonic
1918772.png,https://derpicdn.net/img/view/2018/12/25/1918772.png,0,0.9853627681732178,1172,21,1790,639,618,618,sunset shimmer|twilight sparkle,marbola
1918772.png,https://derpicdn.net/img/view/2018/12/25/1918772.png,1,0.9153820872306824,619,86,1341,808,722,722,sunset shimmer|twilight sparkle,marbola
1919018.png,https://derpicdn.net/img/view/2018/12/26/1919018.png,0,0.992344081401825,3551,0,6025,2378,2474,2378,rainbow dash|twilight sparkle,lahirien
1919018.png,https://derpicdn.net/img/view/2018/12/26/1919018.png,1,0.9776877164840698,1444,114,3950,2620,2506,2506,rainbow dash|twilight sparkle,lahirien
1919022.png,https://derpicdn.net/img/view/2018/12/26/1919022.png,0,0.9043533802032472,1461,570,3045,2154,1584,1584,princess flurry heart|twilight sparkle,cuddlelamb
1920044.png,https://derpicdn.net/img/view/2018/12/27/1920044.png,0,0.9835420846939088,54,0,450,390,396,390,starlight glimmer|twilight sparkle,wanderingpegasus
1921971.png,https://derpicdn.net/img/view/2018/12/30/1921971.png,0,0.9903855323791504,458,487,760,789,302,302,applejack|fluttershy|mane six|pinkie pie|rainbow dash|rarity|twilight sparkle,kittywoofers
1921971.png,https://derpicdn.net/img/view/2018/12/30/1921971.png,1,0.9869387149810792,291,0,555,256,264,256,applejack|fluttershy|mane six|pinkie pie|rainbow dash|rarity|twilight sparkle,kittywoofers
1921971.png,https://derpicdn.net/img/view/2018/12/30/1921971.png,2,0.9848660230636596,61,0,303,210,242,210,applejack|fluttershy|mane six|pinkie pie|rainbow dash|rarity|twilight sparkle,kittywoofers
1921971.png,https://derpicdn.net/img/view/2018/12/30/1921971.png,3,0.9684983491897584,550,0,766,195,216,195,applejack|fluttershy|mane six|pinkie pie|rainbow dash|rarity|twilight sparkle,kittywoofers
1922909.png,https://derpicdn.net/img/view/2018/12/31/1922909.png,0,0.9825617671012878,78,97,366,385,288,288,rainbow dash|twilight sparkle,tylerdashart
1923404.png,https://derpicdn.net/img/view/2018/12/31/1923404.png,0,0.999541699886322,202,2357,936,3091,734,734,applejack|fluttershy|mane six|pinkie pie|rainbow dash|rarity|spike|twilight sparkle,mickeymonster
1923404.png,https://derpicdn.net/img/view/2018/12/31/1923404.png,1,0.9972851276397704,88,71,736,719,648,648,applejack|fluttershy|mane six|pinkie pie|rainbow dash|rarity|spike|twilight sparkle,mickeymonster
1923404.png,https://derpicdn.net/img/view/2018/12/31/1923404.png,2,0.9955992102622986,1009,798,1855,1644,846,846,applejack|fluttershy|mane six|pinkie pie|rainbow dash|rarity|spike|twilight sparkle,mickeymonster
1923404.png,https://derpicdn.net/img/view/2018/12/31/1923404.png,3,0.9949228763580322,33,654,1039,1660,1006,1006,applejack|fluttershy|mane six|pinkie pie|rainbow dash|rarity|spike|twilight sparkle,mickeymonster
1923404.png,https://derpicdn.net/img/view/2018/12/31/1923404.png,5,0.9868788123130798,1148,2537,1778,3167,630,630,applejack|fluttershy|mane six|pinkie pie|rainbow dash|rarity|spike|twilight sparkle,mickeymonster
1923423.png,https://derpicdn.net/img/view/2018/12/31/1923423.png,0,0.9973636865615844,0,1763,755,2537,755,774,apple bloom|applejack|cutie mark crusaders|fluttershy|mane six|pinkie pie|rainbow dash|rarity|scootaloo|spike|sweetie belle|twilight sparkle,jackiebloom
1923423.png,https://derpicdn.net/img/view/2018/12/31/1923423.png,3,0.9872514605522156,1446,47,2670,1271,1224,1224,apple bloom|applejack|cutie mark crusaders|fluttershy|mane six|pinkie pie|rainbow dash|rarity|scootaloo|spike|sweetie belle|twilight sparkle,jackiebloom
1923423.png,https://derpicdn.net/img/view/2018/12/31/1923423.png,5,0.9778926372528076,84,1067,822,1805,738,738,apple bloom|applejack|cutie mark crusaders|fluttershy|mane six|pinkie pie|rainbow dash|rarity|scootaloo|spike|sweetie belle|twilight sparkle,jackiebloom
1924643.png,https://derpicdn.net/img/view/2019/1/2/1924643.png,0,0.920796275138855,7,49,411,453,404,404,applejack|fluttershy|mane six|pinkie pie|rainbow dash|rarity|twilight sparkle,euphoriapony
1926213.png,https://derpicdn.net/img/view/2019/1/4/1926213.png,0,0.9908521771430968,97,60,561,524,464,464,applejack|fluttershy|mane six|pinkie pie|rainbow dash|rarity|twilight sparkle,mickeymonster
1926213.png,https://derpicdn.net/img/view/2019/1/4/1926213.png,1,0.9807397723197936,616,0,1214,571,598,571,applejack|fluttershy|mane six|pinkie pie|rainbow dash|rarity|twilight sparkle,mickeymonster
1926213.png,https://derpicdn.net/img/view/2019/1/4/1926213.png,2,0.942548394203186,671,679,1321,1329,650,650,applejack|fluttershy|mane six|pinkie pie|rainbow dash|rarity|twilight sparkle,mickeymonster
1927252.png,https://derpicdn.net/img/view/2019/1/5/1927252.png,0,0.9701879620552064,215,174,689,648,474,474,applejack|twilight sparkle,vavacung
1934538.png,https://derpicdn.net/img/view/2019/1/13/1934538.png,1,0.9848076105117798,61,13,307,259,246,246,applejack|rainbow dash|twilight sparkle,sepiakeys
1934804.png,https://derpicdn.net/img/view/2019/1/14/1934804.png,0,0.98760724067688,319,0,591,242,272,242,applejack|fluttershy|mane six|pinkie pie|rainbow dash|rarity|twilight sparkle,pyroprye
1937717.png,https://derpicdn.net/img/view/2019/1/17/1937717.png,0,0.9901223182678224,0,1937,1581,3523,1581,1586,rainbow dash|rarity|twilight sparkle,nightmaremoons
1938369.png,https://derpicdn.net/img/view/2019/1/18/1938369.png,0,0.997864305973053,1256,0,2246,958,990,958,applejack|twilight sparkle,airiniblock
1942124.png,https://derpicdn.net/img/view/2019/1/23/1942124.png,0,0.9158527255058287,116,10,342,236,226,226,applejack|fluttershy|mane six|pinkie pie|rainbow dash|rarity|twilight sparkle,saphi-boo
1942264.png,https://derpicdn.net/img/view/2019/1/23/1942264.png,0,0.9505674242973328,49,66,273,290,224,224,princess celestia|twilight sparkle,pencils
1943041.png,https://derpicdn.net/img/view/2019/1/24/1943041.png,0,0.9919942021369934,185,218,515,548,330,330,starlight glimmer|twilight sparkle,valemjj
1945149.png,https://derpicdn.net/img/view/2019/1/26/1945149.png,0,0.9513888955116272,5,0,711,604,706,604,spike|twilight sparkle,mamatwilightsparkle
1948774.png,https://derpicdn.net/img/view/2019/1/30/1948774.png,0,0.993447721004486,812,0,1902,985,1090,985,pinkie pie|twilight sparkle,taurson
1949420.png,https://derpicdn.net/img/view/2019/1/31/1949420.png,0,0.9742701649665833,46,351,556,861,510,510,sunset shimmer|twilight sparkle,dragbax
1953765.png,https://derpicdn.net/img/view/2019/2/4/1953765.png,0,0.9960318803787231,1482,378,1920,846,438,468,applejack|fluttershy|mane six|pinkie pie|rainbow dash|rarity|spike|starlight glimmer|twilight sparkle,kaliner123
1953765.png,https://derpicdn.net/img/view/2019/2/4/1953765.png,1,0.9929145574569702,241,0,895,501,654,501,applejack|fluttershy|mane six|pinkie pie|rainbow dash|rarity|spike|starlight glimmer|twilight sparkle,kaliner123
1953765.png,https://derpicdn.net/img/view/2019/2/4/1953765.png,2,0.9017537236213684,419,532,729,842,310,310,applejack|fluttershy|mane six|pinkie pie|rainbow dash|rarity|spike|starlight glimmer|twilight sparkle,kaliner123
1954961.png,https://derpicdn.net/img/view/2019/2/6/1954961.png,1,0.907235026359558,951,57,1343,449,392,392,discord|twilight sparkle,vincher
1955849.png,https://derpicdn.net/img/view/2019/2/7/1955849.png,0,0.9202032685279846,7,28,443,464,436,436,fluttershy|twilight sparkle,saphi-boo
1956404.png,https://derpicdn.net/img/view/2019/2/8/1956404.png,0,0.9991775751113892,1956,898,3000,1976,1044,1078,applejack|fluttershy|mane six|pinkie pie|rainbow dash|rarity|twilight sparkle,puetsua
1956404.png,https://derpicdn.net/img/view/2019/2/8/1956404.png,1,0.997475564479828,17,0,1003,972,986,972,applejack|fluttershy|mane six|pinkie pie|rainbow dash|rarity|twilight sparkle,puetsua
1956404.png,https://derpicdn.net/img/view/2019/2/8/1956404.png,2,0.9968273639678956,1964,0,2980,978,1016,978,applejack|fluttershy|mane six|pinkie pie|rainbow dash|rarity|twilight sparkle,puetsua
1956404.png,https://derpicdn.net/img/view/2019/2/8/1956404.png,3,0.9783711433410645,761,0,2169,1147,1408,1147,applejack|fluttershy|mane six|pinkie pie|rainbow dash|rarity|twilight sparkle,puetsua
1956440.png,https://derpicdn.net/img/view/2019/2/8/1956440.png,0,0.9494860768318176,430,381,976,927,546,546,sunset shimmer|twilight sparkle,
1956731.png,https://derpicdn.net/img/view/2019/2/8/1956731.png,0,0.9976953864097596,456,661,766,971,310,310,spike|twilight sparkle,howxu
1956731.png,https://derpicdn.net/img/view/2019/2/8/1956731.png,1,0.9952727556228638,669,676,1017,1024,348,348,spike|twilight sparkle,howxu
1956944.png,https://derpicdn.net/img/view/2019/2/8/1956944.png,0,0.9439395070075988,106,7,624,567,518,560,spike|twilight sparkle,dsana
1959371.png,https://derpicdn.net/img/view/2019/2/11/1959371.png,0,0.9669438004493712,1402,2143,1728,2469,326,326,princess celestia|princess luna|twilight sparkle,glitteronin
1962113.png,https://derpicdn.net/img/view/2019/2/14/1962113.png,0,0.9988139867782592,1276,268,2076,1068,800,800,princess luna|twilight sparkle,puetsua
1963582.png,https://derpicdn.net/img/view/2019/2/16/1963582.png,0,0.9978733062744141,1145,0,2911,1661,1766,1661,princess cadance|princess flurry heart|shining armor|twilight sparkle,greenbrothersart
1963582.png,https://derpicdn.net/img/view/2019/2/16/1963582.png,1,0.992331862449646,2530,0,4440,1654,1910,1654,princess cadance|princess flurry heart|shining armor|twilight sparkle,greenbrothersart
1965012.png,https://derpicdn.net/img/view/2019/2/18/1965012.png,1,0.9899432063102722,649,0,1245,586,596,586,princess cadance|princess celestia|princess luna|twilight sparkle,incubugs
1966342.png,https://derpicdn.net/img/view/2019/2/19/1966342.png,0,0.9913509488105774,418,764,1204,1550,786,786,fluttershy|twilight sparkle,calena
1966813.png,https://derpicdn.net/img/view/2019/2/20/1966813.png,0,0.978255331516266,2936,85,4986,2135,2050,2050,starlight glimmer|twilight sparkle,jhayarr23
1977089.png,https://derpicdn.net/img/view/2019/3/4/1977089.png,0,0.9840214252471924,752,0,2572,1719,1820,1719,sunset shimmer|twilight sparkle,labglab
1977089.png,https://derpicdn.net/img/view/2019/3/4/1977089.png,1,0.9708017706871032,2316,295,4060,2039,1744,1744,sunset shimmer|twilight sparkle,labglab
1984739.png,https://derpicdn.net/img/view/2019/3/13/1984739.png,0,0.9948230981826782,509,1044,935,1470,426,426,rainbow dash|twilight sparkle,tylerdashart
1984739.png,https://derpicdn.net/img/view/2019/3/13/1984739.png,1,0.9944936633110046,213,92,859,738,646,646,rainbow dash|twilight sparkle,tylerdashart
1985035.png,https://derpicdn.net/img/view/2019/3/14/1985035.png,0,0.9866752028465272,228,0,1208,890,980,890,rainbow dash|twilight sparkle,jup1t3r
1986670.png,https://derpicdn.net/img/view/2019/3/16/1986670.png,0,0.991472065448761,866,30,1422,586,556,556,sunset shimmer|twilight sparkle,miamaha
1989119.png,https://derpicdn.net/img/view/2019/3/18/1989119.png,1,0.9396350383758544,2611,683,4223,2295,1612,1612,applejack|fluttershy|mane six|pinkie pie|rainbow dash|rarity|twilight sparkle,jhayarr23
1989442.png,https://derpicdn.net/img/view/2019/3/18/1989442.png,0,0.9994019865989684,540,0,1278,728,738,728,spike|twilight sparkle,deraniel
1991621.png,https://derpicdn.net/img/view/2019/3/21/1991621.png,0,0.9985920190811156,13,910,327,1224,314,314,applejack|fluttershy|mane six|pinkie pie|princess flurry heart|rainbow dash|rarity|spike|twilight sparkle,aleximusprime
1993538.png,https://derpicdn.net/img/view/2019/3/24/1993538.png,0,0.9934321045875548,460,276,708,524,248,248,sunset shimmer|twilight sparkle,winter-scarf
1995340.png,https://derpicdn.net/img/view/2019/3/26/1995340.png,0,0.9929380416870116,204,83,1146,1025,942,942,pinkie pie|twilight sparkle,secretgoombaman12345
1999669.png,https://derpicdn.net/img/view/2019/4/1/1999669.png,0,0.996062159538269,562,163,870,471,308,308,spike|twilight sparkle,racingwolf
1999669.png,https://derpicdn.net/img/view/2019/4/1/1999669.png,1,0.9098560810089112,401,406,703,708,302,302,spike|twilight sparkle,racingwolf
1999974.png,https://derpicdn.net/img/view/2019/4/1/1999974.png,0,0.9954761862754822,82,41,774,733,692,692,rainbow dash|sunset shimmer|twilight sparkle,
2000027.png,https://derpicdn.net/img/view/2019/4/1/2000027.png,1,0.9908902049064636,368,338,712,682,344,344,applejack|fluttershy|pinkie pie|rainbow dash|rarity|sunset shimmer|twilight sparkle,
2000027.png,https://derpicdn.net/img/view/2019/4/1/2000027.png,2,0.9129038453102112,839,494,1027,682,188,188,applejack|fluttershy|pinkie pie|rainbow dash|rarity|sunset shimmer|twilight sparkle,
2000303.png,https://derpicdn.net/img/view/2019/4/1/2000303.png,0,0.9924243688583374,8035,2695,10175,4835,2140,2140,applejack|fluttershy|pinkie pie|rainbow dash|rarity|sunset shimmer|twilight sparkle,suramii
2004643.png,https://derpicdn.net/img/view/2019/4/6/2004643.png,0,0.9901040196418762,22,0,354,297,332,297,applejack|twilight sparkle,
2009338.png,https://derpicdn.net/img/view/2019/4/11/2009338.png,0,0.9994823932647704,61,0,523,452,462,452,applejack|twilight sparkle,cinnamonsparx
2010104.png,https://derpicdn.net/img/view/2019/4/12/2010104.png,0,0.9902373552322388,3064,3547,4356,4839,1292,1292,queen chrysalis|rainbow dash|twilight sparkle,theretroart88
2010104.png,https://derpicdn.net/img/view/2019/4/12/2010104.png,1,0.9864093661308287,1538,3500,2918,4880,1380,1380,queen chrysalis|rainbow dash|twilight sparkle,theretroart88
2010104.png,https://derpicdn.net/img/view/2019/4/12/2010104.png,2,0.9744551181793212,0,2721,1500,4569,1500,1848,queen chrysalis|rainbow dash|twilight sparkle,theretroart88
2011187.png,https://derpicdn.net/img/view/2019/4/13/2011187.png,0,0.9379954338073728,1293,0,2399,1085,1106,1085,applejack|fluttershy|mane six|pinkie pie|rainbow dash|rarity|twilight sparkle,beardeddoomguy|hooves-art
2014863.png,https://derpicdn.net/img/view/2019/4/17/2014863.png,0,0.9989697337150574,69,3,359,293,290,290,princess celestia|twilight sparkle,lulubell
2024520.png,https://derpicdn.net/img/view/2019/4/27/2024520.png,0,0.9977666735649108,58,514,406,862,348,348,princess celestia|princess luna|twilight sparkle,loveslove
2025691.png,https://derpicdn.net/img/view/2019/4/28/2025691.png,0,0.9936255216598512,850,0,2082,1177,1232,1177,applejack|fluttershy|mane six|pinkie pie|rainbow dash|rarity|spike|twilight sparkle,oinktweetstudios
2025691.png,https://derpicdn.net/img/view/2019/4/28/2025691.png,1,0.9786026477813721,1690,766,2468,1544,778,778,applejack|fluttershy|mane six|pinkie pie|rainbow dash|rarity|spike|twilight sparkle,oinktweetstudios
2026101.png,https://derpicdn.net/img/view/2019/4/29/2026101.png,0,0.9891578555107116,708,725,1328,1345,620,620,princess cadance|shining armor|spike|twilight sparkle,aleximusprime
2028069.png,https://derpicdn.net/img/view/2019/5/1/2028069.png,0,0.999496579170227,1388,236,2210,1058,822,822,pinkie pie|twilight sparkle,secretgoombaman12345
202872.png,https://derpicdn.net/img/view/2013/1/5/202872.png,0,0.9929526448249816,0,608,269,898,269,290,trixie|twilight sparkle,trollie trollenberg
202872.png,https://derpicdn.net/img/view/2013/1/5/202872.png,1,0.9910326600074768,256,0,758,456,502,456,trixie|twilight sparkle,trollie trollenberg
2031403.png,https://derpicdn.net/img/view/2019/5/5/2031403.png,0,0.9316535592079164,67,241,1071,1245,1004,1004,rarity|twilight sparkle,lilfunkman
2034450.png,https://derpicdn.net/img/view/2019/5/9/2034450.png,0,0.9056340456008912,314,0,1280,855,966,855,applejack|twilight sparkle,heir-of-rick
2047376.png,https://derpicdn.net/img/view/2019/5/24/2047376.png,0,0.9903355240821838,55,48,345,396,290,348,applejack|fluttershy|twilight sparkle,
2047376.png,https://derpicdn.net/img/view/2019/5/24/2047376.png,1,0.9411770105361938,0,0,318,374,318,374,applejack|fluttershy|twilight sparkle,
2054761.png,https://derpicdn.net/img/view/2019/6/1/2054761.png,0,0.9613744020462036,991,0,5337,3612,4346,3612,starlight glimmer|twilight sparkle,kids-in-the-corner|those kids in the corner
2057320.png,https://derpicdn.net/img/view/2019/6/4/2057320.png,0,0.9256850481033324,420,0,1336,843,916,843,princess celestia|twilight sparkle,lrusu
2058857.png,https://derpicdn.net/img/view/2019/6/6/2058857.png,0,0.9952822327613832,345,35,833,523,488,488,fluttershy|spike|twilight sparkle,racingwolf
2058857.png,https://derpicdn.net/img/view/2019/6/6/2058857.png,1,0.9438257813453674,54,213,434,593,380,380,fluttershy|spike|twilight sparkle,racingwolf
2061061.png,https://derpicdn.net/img/view/2019/6/9/2061061.png,1,0.9877130389213562,54,1131,880,1957,826,826,applejack|fluttershy|mane six|pinkie pie|rainbow dash|rarity|twilight sparkle,taaffeiite
2061575.png,https://derpicdn.net/img/view/2019/6/9/2061575.png,0,0.995212972164154,0,162,1057,1238,1057,1076,applejack|pinkie pie|twilight sparkle,shibaroll
2063885.png,https://derpicdn.net/img/view/2019/6/12/2063885.png,0,0.9630982875823976,203,0,1209,961,1006,961,princess celestia|princess luna|twilight sparkle,kateponylover
2066710.png,https://derpicdn.net/img/view/2019/6/16/2066710.png,0,0.9616184234619141,73,35,365,327,292,292,applejack|fluttershy|mane six|pinkie pie|rainbow dash|rarity|twilight sparkle,
2066716.png,https://derpicdn.net/img/view/2019/6/16/2066716.png,1,0.98507958650589,776,408,1398,1030,622,622,applejack|fluttershy|mane six|pinkie pie|rainbow dash|rarity|twilight sparkle,
2066716.png,https://derpicdn.net/img/view/2019/6/16/2066716.png,2,0.9399709105491638,773,38,1141,406,368,368,applejack|fluttershy|mane six|pinkie pie|rainbow dash|rarity|twilight sparkle,
2066937.png,https://derpicdn.net/img/view/2019/6/16/2066937.png,0,0.996468722820282,1095,0,1789,663,694,663,applejack|fluttershy|mane six|pinkie pie|rainbow dash|rarity|scootaloo|spike|starlight glimmer|sweetie belle|twilight sparkle,
2066937.png,https://derpicdn.net/img/view/2019/6/16/2066937.png,1,0.9103081226348876,114,0,1004,769,890,769,applejack|fluttershy|mane six|pinkie pie|rainbow dash|rarity|scootaloo|spike|starlight glimmer|sweetie belle|twilight sparkle,
2070572.png,https://derpicdn.net/img/view/2019/6/20/2070572.png,0,0.9333134293556212,1225,901,2047,1723,822,822,sunset shimmer|twilight sparkle,duskie-06
2072363.png,https://derpicdn.net/img/view/2019/6/22/2072363.png,0,0.9671456813812256,375,326,617,568,242,242,rainbow dash|twilight sparkle,afkcyrist
2075099.png,https://derpicdn.net/img/view/2019/6/25/2075099.png,0,0.987537145614624,398,0,1578,1130,1180,1130,starlight glimmer|twilight sparkle,artiks
2075601.png,https://derpicdn.net/img/view/2019/6/26/2075601.png,0,0.9958709478378296,1123,0,2523,1369,1400,1369,fluttershy|twilight sparkle,mediasmile666
2077292.png,https://derpicdn.net/img/view/2019/6/28/2077292.png,0,0.9933449625968932,0,0,564,570,564,570,fluttershy|twilight sparkle,provolonepone
2077292.png,https://derpicdn.net/img/view/2019/6/28/2077292.png,1,0.9212310314178468,121,0,761,580,640,580,fluttershy|twilight sparkle,provolonepone
2077710.png,https://derpicdn.net/img/view/2019/6/28/2077710.png,4,0.943457305431366,491,183,671,363,180,180,applejack|fluttershy|pinkie pie|rainbow dash|rarity|spike|sunset shimmer|twilight sparkle,
2078944.png,https://derpicdn.net/img/view/2019/6/30/2078944.png,0,0.9994269013404846,0,0,383,379,383,379,applejack|fluttershy|mane six|pinkie pie|rainbow dash|rarity|twilight sparkle,nana-yuka
2078944.png,https://derpicdn.net/img/view/2019/6/30/2078944.png,1,0.9981771111488342,334,453,736,855,402,402,applejack|fluttershy|mane six|pinkie pie|rainbow dash|rarity|twilight sparkle,nana-yuka
2078944.png,https://derpicdn.net/img/view/2019/6/30/2078944.png,2,0.998076558113098,672,0,1024,366,352,366,applejack|fluttershy|mane six|pinkie pie|rainbow dash|rarity|twilight sparkle,nana-yuka
2078944.png,https://derpicdn.net/img/view/2019/6/30/2078944.png,3,0.9877182245254515,0,478,334,846,334,368,applejack|fluttershy|mane six|pinkie pie|rainbow dash|rarity|twilight sparkle,nana-yuka
2081998.png,https://derpicdn.net/img/view/2019/7/3/2081998.png,0,0.9994080066680908,411,85,721,395,310,310,pinkie pie|sunset shimmer|twilight sparkle,pencils
2082917.png,https://derpicdn.net/img/view/2019/7/4/2082917.png,0,0.9974405169487,470,228,1302,1060,832,832,applejack|fluttershy|mane six|pinkie pie|rainbow dash|rarity|twilight sparkle,rivin177
2082917.png,https://derpicdn.net/img/view/2019/7/4/2082917.png,1,0.993162989616394,1581,244,2417,1080,836,836,applejack|fluttershy|mane six|pinkie pie|rainbow dash|rarity|twilight sparkle,rivin177
2082917.png,https://derpicdn.net/img/view/2019/7/4/2082917.png,2,0.9890300035476683,1070,259,1864,1053,794,794,applejack|fluttershy|mane six|pinkie pie|rainbow dash|rarity|twilight sparkle,rivin177
2082917.png,https://derpicdn.net/img/view/2019/7/4/2082917.png,4,0.9648038744926452,2631,140,3517,1026,886,886,applejack|fluttershy|mane six|pinkie pie|rainbow dash|rarity|twilight sparkle,rivin177
2093972.png,https://derpicdn.net/img/view/2019/7/17/2093972.png,0,0.9786683917045592,449,318,707,576,258,258,applejack|fluttershy|mane six|pinkie pie|rainbow dash|rarity|twilight sparkle,jargon scott
2093972.png,https://derpicdn.net/img/view/2019/7/17/2093972.png,1,0.9136255383491516,734,471,1028,765,294,294,applejack|fluttershy|mane six|pinkie pie|rainbow dash|rarity|twilight sparkle,jargon scott
2094937.png,https://derpicdn.net/img/view/2019/7/18/2094937.png,0,0.9980562329292296,334,278,946,890,612,612,princess celestia|princess luna|starlight glimmer|twilight sparkle,shad0w-galaxy
2094937.png,https://derpicdn.net/img/view/2019/7/18/2094937.png,2,0.9950847625732422,2024,484,2534,994,510,510,princess celestia|princess luna|starlight glimmer|twilight sparkle,shad0w-galaxy
2094937.png,https://derpicdn.net/img/view/2019/7/18/2094937.png,3,0.9858599305152892,1428,595,2198,1365,770,770,princess celestia|princess luna|starlight glimmer|twilight sparkle,shad0w-galaxy
2095089.png,https://derpicdn.net/img/view/2019/7/18/2095089.png,0,0.9727619886398317,488,40,754,306,266,266,apple bloom|applejack|cutie mark crusaders|fluttershy|pinkie pie|princess celestia|rainbow dash|rarity|scootaloo|starlight glimmer|sunset shimmer|sweetie belle|twilight sparkle,ambris
2095601.png,https://derpicdn.net/img/view/2019/7/19/2095601.png,0,0.9720098972320556,266,848,1418,2000,1152,1152,princess celestia|princess luna|twilight sparkle,loveslove
2104856.png,https://derpicdn.net/img/view/2019/7/30/2104856.png,1,0.9595319628715516,2490,22,3484,1016,994,994,applejack|fluttershy|mane six|pinkie pie|rainbow dash|rarity|starlight glimmer|twilight sparkle,fluffyxai
2104856.png,https://derpicdn.net/img/view/2019/7/30/2104856.png,2,0.9383065104484558,5950,1408,7264,2722,1314,1314,applejack|fluttershy|mane six|pinkie pie|rainbow dash|rarity|starlight glimmer|twilight sparkle,fluffyxai
2105770.png,https://derpicdn.net/img/view/2019/7/31/2105770.png,0,0.9830293655395508,691,312,1087,708,396,396,fluttershy|spike|trixie|twilight sparkle,gluemakers
2105770.png,https://derpicdn.net/img/view/2019/7/31/2105770.png,1,0.958952784538269,959,1,1161,203,202,202,fluttershy|spike|trixie|twilight sparkle,gluemakers
2110520.png,https://derpicdn.net/img/view/2019/8/6/2110520.png,0,0.9650208950042723,1170,0,1348,172,178,172,rainbow dash|starlight glimmer|sunset shimmer|twilight sparkle,xjenn9
2114030.png,https://derpicdn.net/img/view/2019/8/10/2114030.png,0,0.9702944159507751,4501,9,9684,5427,5183,5418,pinkie pie|twilight sparkle,mrkat7214
2115756.png,https://derpicdn.net/img/view/2019/8/12/2115756.png,0,0.9879465103149414,1436,1352,2504,2420,1068,1068,applejack|fluttershy|mane six|pinkie pie|rainbow dash|rarity|twilight sparkle,prismspark
2121514.png,https://derpicdn.net/img/view/2019/8/18/2121514.png,0,0.9962397813796996,1460,1061,1982,1583,522,522,apple bloom|applejack|big macintosh|cutie mark crusaders|fluttershy|mane six|pinkie pie|princess celestia|rainbow dash|rarity|scootaloo|spike|sweetie belle|trixie|twilight sparkle,arteses-canvas
2121514.png,https://derpicdn.net/img/view/2019/8/18/2121514.png,2,0.9440445303916932,285,417,839,971,554,554,apple bloom|applejack|big macintosh|cutie mark crusaders|fluttershy|mane six|pinkie pie|princess celestia|rainbow dash|rarity|scootaloo|spike|sweetie belle|trixie|twilight sparkle,arteses-canvas
2122752.png,https://derpicdn.net/img/view/2019/8/20/2122752.png,0,0.9410951733589172,1189,88,1961,860,772,772,princess celestia|twilight sparkle,majupaju
2123212.png,https://derpicdn.net/img/view/2019/8/20/2123212.png,0,0.9968940019607544,1481,0,2633,1026,1152,1026,rainbow dash|starlight glimmer|twilight sparkle,danli69
2126180.png,https://derpicdn.net/img/view/2019/8/24/2126180.png,0,0.9998158812522888,1582,1414,2476,2308,894,894,rarity|twilight sparkle,lilfunkman
2126180.png,https://derpicdn.net/img/view/2019/8/24/2126180.png,1,0.9996799230575562,546,144,1384,982,838,838,rarity|twilight sparkle,lilfunkman
2127287.png,https://derpicdn.net/img/view/2019/8/25/2127287.png,0,0.916165828704834,42,362,276,596,234,234,applejack|fluttershy|mane six|pinkie pie|rainbow dash|rarity|spike|twilight sparkle,
2129575.png,https://derpicdn.net/img/view/2019/8/28/2129575.png,1,0.9893433451652528,3110,423,3550,863,440,440,applejack|fluttershy|mane six|pinkie pie|rainbow dash|rarity|twilight sparkle,jo-vee-al
2129575.png,https://derpicdn.net/img/view/2019/8/28/2129575.png,2,0.9779514670372008,602,411,1036,845,434,434,applejack|fluttershy|mane six|pinkie pie|rainbow dash|rarity|twilight sparkle,jo-vee-al
2129575.png,https://derpicdn.net/img/view/2019/8/28/2129575.png,3,0.9394288063049316,0,287,701,997,701,710,applejack|fluttershy|mane six|pinkie pie|rainbow dash|rarity|twilight sparkle,jo-vee-al
2129997.png,https://derpicdn.net/img/view/2019/8/28/2129997.png,1,0.9724768996238708,1088,1310,2000,2302,912,992,spike|twilight sparkle,shad0w-galaxy
2130760.png,https://derpicdn.net/img/view/2019/8/29/2130760.png,0,0.982877552509308,459,0,665,201,206,201,applejack|fluttershy|mane six|pinkie pie|rainbow dash|rarity|spike|twilight sparkle,
2130760.png,https://derpicdn.net/img/view/2019/8/29/2130760.png,1,0.9603233933448792,316,1086,606,1376,290,290,applejack|fluttershy|mane six|pinkie pie|rainbow dash|rarity|spike|twilight sparkle,
2131535.png,https://derpicdn.net/img/view/2019/8/30/2131535.png,0,0.9992496371269226,1843,836,2333,1328,490,492,applejack|fluttershy|mane six|pinkie pie|rainbow dash|rarity|starlight glimmer|twilight sparkle,soulcentinel
2131535.png,https://derpicdn.net/img/view/2019/8/30/2131535.png,3,0.9649590253829956,1213,870,1681,1338,468,468,applejack|fluttershy|mane six|pinkie pie|rainbow dash|rarity|starlight glimmer|twilight sparkle,soulcentinel
2132008.png,https://derpicdn.net/img/view/2019/8/31/2132008.png,0,0.9874594211578368,102,3094,2270,5262,2168,2168,applejack|fluttershy|mane six|pinkie pie|rainbow dash|rarity|twilight sparkle,rosesweety
2132008.png,https://derpicdn.net/img/view/2019/8/31/2132008.png,1,0.9838348627090454,4707,135,7229,2657,2522,2522,applejack|fluttershy|mane six|pinkie pie|rainbow dash|rarity|twilight sparkle,rosesweety
2132008.png,https://derpicdn.net/img/view/2019/8/31/2132008.png,2,0.9620825052261353,2712,3193,4536,5017,1824,1824,applejack|fluttershy|mane six|pinkie pie|rainbow dash|rarity|twilight sparkle,rosesweety
2132022.png,https://derpicdn.net/img/view/2019/8/31/2132022.png,3,0.9762582778930664,1293,1265,1623,1595,330,330,apple bloom|applejack|diamond tiara|discord|fluttershy|mane six|pinkie pie|princess luna|queen chrysalis|rainbow dash|rarity|silver spoon|spike|sweetie belle|twilight sparkle,arteses-canvas
2132022.png,https://derpicdn.net/img/view/2019/8/31/2132022.png,4,0.9608147740364076,0,508,393,960,393,452,apple bloom|applejack|diamond tiara|discord|fluttershy|mane six|pinkie pie|princess luna|queen chrysalis|rainbow dash|rarity|silver spoon|spike|sweetie belle|twilight sparkle,arteses-canvas
2132144.png,https://derpicdn.net/img/view/2019/8/31/2132144.png,0,0.975986897945404,1258,217,1636,595,378,378,applejack|fluttershy|mane six|pinkie pie|rainbow dash|rarity|spike|twilight sparkle,
2132917.png,https://derpicdn.net/img/view/2019/8/31/2132917.png,0,0.954758882522583,325,0,679,338,354,338,spike|twilight sparkle,gifanon
2140880.png,https://derpicdn.net/img/view/2019/9/10/2140880.png,1,0.9175357222557068,141,0,465,259,324,259,princess cadance|princess celestia|princess flurry heart|princess luna|shining armor|starlight glimmer|sunset shimmer|trixie|twilight sparkle,
2142154.png,https://derpicdn.net/img/view/2019/9/12/2142154.png,1,0.995357871055603,904,374,1310,780,406,406,applejack|fluttershy|mane six|pinkie pie|rainbow dash|rarity|twilight sparkle,bitshift
2142362.png,https://derpicdn.net/img/view/2019/9/12/2142362.png,0,0.9552181959152222,99,0,1533,1307,1434,1307,spike|twilight sparkle,avrameow
2143164.png,https://derpicdn.net/img/view/2019/9/13/2143164.png,0,0.999032497406006,1755,0,2839,929,1084,929,applejack|fluttershy|mane six|pinkie pie|rainbow dash|rarity|twilight sparkle,coociecat
2143164.png,https://derpicdn.net/img/view/2019/9/13/2143164.png,1,0.9932178258895874,675,183,1601,1109,926,926,applejack|fluttershy|mane six|pinkie pie|rainbow dash|rarity|twilight sparkle,coociecat
2143164.png,https://derpicdn.net/img/view/2019/9/13/2143164.png,2,0.9865943789482116,1012,2192,1878,3058,866,866,applejack|fluttershy|mane six|pinkie pie|rainbow dash|rarity|twilight sparkle,coociecat
2143164.png,https://derpicdn.net/img/view/2019/9/13/2143164.png,3,0.9610236287117004,407,1531,1211,2335,804,804,applejack|fluttershy|mane six|pinkie pie|rainbow dash|rarity|twilight sparkle,coociecat
214451.png,https://derpicdn.net/img/view/2013/1/16/214451.png,0,0.9873467683792114,700,840,1074,1200,374,360,applejack|fluttershy|mane six|pinkie pie|rainbow dash|rarity|twilight sparkle,khorme
2145230.png,https://derpicdn.net/img/view/2019/9/15/2145230.png,0,0.97441565990448,0,0,629,625,629,625,rarity|twilight sparkle,
2148787.png,https://derpicdn.net/img/view/2019/9/20/2148787.png,0,0.99824458360672,987,0,3551,2332,2564,2332,shining armor|spike|twilight sparkle,tsitra360|09hankris
2148787.png,https://derpicdn.net/img/view/2019/9/20/2148787.png,1,0.9503113627433776,1680,2385,2198,2903,518,518,shining armor|spike|twilight sparkle,tsitra360|09hankris
2150351.png,https://derpicdn.net/img/view/2019/9/22/2150351.png,2,0.9230798482894896,1172,0,1892,713,720,713,applejack|fluttershy|mane six|pinkie pie|rainbow dash|rarity|twilight sparkle,kayotanv87
215283.png,https://derpicdn.net/img/view/2013/1/17/215283.png,0,0.9859790205955504,1080,242,1802,964,722,722,fluttershy|spike|twilight sparkle,
2158292.png,https://derpicdn.net/img/view/2019/10/2/2158292.png,0,0.966447651386261,633,809,1121,1297,488,488,rainbow dash|twilight sparkle,little-sketches
2158846.png,https://derpicdn.net/img/view/2019/10/3/2158846.png,0,0.9124422669410706,663,32,1313,682,650,650,applejack|discord|fluttershy|mane six|pinkie pie|princess celestia|princess luna|rainbow dash|rarity|spike|starlight glimmer|twilight sparkle,
2160499.png,https://derpicdn.net/img/view/2019/10/5/2160499.png,0,0.9741334319114684,2488,453,3000,965,512,512,pinkie pie|rainbow dash|twilight sparkle,blood-asp0123
2162884.png,https://derpicdn.net/img/view/2019/10/7/2162884.png,0,0.9983072280883788,101,356,1079,1334,978,978,applejack|fluttershy|mane six|pinkie pie|princess celestia|princess luna|rainbow dash|rarity|spike|starlight glimmer|trixie|twilight sparkle,jubyskylines
2162884.png,https://derpicdn.net/img/view/2019/10/7/2162884.png,2,0.9890061020851136,1209,974,2173,1938,964,964,applejack|fluttershy|mane six|pinkie pie|princess celestia|princess luna|rainbow dash|rarity|spike|starlight glimmer|trixie|twilight sparkle,jubyskylines
2162884.png,https://derpicdn.net/img/view/2019/10/7/2162884.png,3,0.9693025946617126,1231,269,2251,1289,1020,1020,applejack|fluttershy|mane six|pinkie pie|princess celestia|princess luna|rainbow dash|rarity|spike|starlight glimmer|trixie|twilight sparkle,jubyskylines
2162884.png,https://derpicdn.net/img/view/2019/10/7/2162884.png,4,0.9147576689720154,575,1152,1383,1960,808,808,applejack|fluttershy|mane six|pinkie pie|princess celestia|princess luna|rainbow dash|rarity|spike|starlight glimmer|trixie|twilight sparkle,jubyskylines
2165165.png,https://derpicdn.net/img/view/2019/10/10/2165165.png,0,0.9693437814712524,130,1564,720,2154,590,590,applejack|fluttershy|pinkie pie|princess celestia|princess luna|rainbow dash|rarity|spike|twilight sparkle,spellboundcanvas
2165165.png,https://derpicdn.net/img/view/2019/10/10/2165165.png,1,0.9589723348617554,144,2124,710,2690,566,566,applejack|fluttershy|pinkie pie|princess celestia|princess luna|rainbow dash|rarity|spike|twilight sparkle,spellboundcanvas
2165165.png,https://derpicdn.net/img/view/2019/10/10/2165165.png,2,0.9081312417984008,682,1239,1264,1821,582,582,applejack|fluttershy|pinkie pie|princess celestia|princess luna|rainbow dash|rarity|spike|twilight sparkle,spellboundcanvas
2166364.png,https://derpicdn.net/img/view/2019/10/12/2166364.png,0,0.9790804386138916,502,0,1174,562,672,562,apple bloom|applejack|cutie mark crusaders|fluttershy|mane six|pinkie pie|princess cadance|princess celestia|princess flurry heart|princess luna|rainbow dash|rarity|scootaloo|shining armor|spike|sweetie belle|twilight sparkle,sjart117
2166561.png,https://derpicdn.net/img/view/2019/10/12/2166561.png,0,0.9990087151527404,579,904,1045,1370,466,466,applejack|fluttershy|mane six|pinkie pie|rainbow dash|rarity|twilight sparkle,pearlescent
2166561.png,https://derpicdn.net/img/view/2019/10/12/2166561.png,1,0.9944460391998292,906,1325,1262,1681,356,356,applejack|fluttershy|mane six|pinkie pie|rainbow dash|rarity|twilight sparkle,pearlescent
2166561.png,https://derpicdn.net/img/view/2019/10/12/2166561.png,2,0.9943903088569641,580,536,976,932,396,396,applejack|fluttershy|mane six|pinkie pie|rainbow dash|rarity|twilight sparkle,pearlescent
2166561.png,https://derpicdn.net/img/view/2019/10/12/2166561.png,3,0.9790562391281128,1196,0,1642,436,446,436,applejack|fluttershy|mane six|pinkie pie|rainbow dash|rarity|twilight sparkle,pearlescent
2166561.png,https://derpicdn.net/img/view/2019/10/12/2166561.png,4,0.9367368221282959,885,358,1371,844,486,486,applejack|fluttershy|mane six|pinkie pie|rainbow dash|rarity|twilight sparkle,pearlescent
2166879.png,https://derpicdn.net/img/view/2019/10/13/2166879.png,0,0.9334017634391784,246,233,660,647,414,414,applejack|fluttershy|mane six|pinkie pie|rainbow dash|rarity|twilight sparkle,
2166879.png,https://derpicdn.net/img/view/2019/10/13/2166879.png,1,0.9301529526710508,484,532,810,858,326,326,applejack|fluttershy|mane six|pinkie pie|rainbow dash|rarity|twilight sparkle,
2167150.png,https://derpicdn.net/img/view/2019/10/13/2167150.png,0,0.9780291318893432,362,8,690,336,328,328,fluttershy|twilight sparkle,tracerpainter
2167187.png,https://derpicdn.net/img/view/2019/10/13/2167187.png,0,0.9968546628952026,933,105,1609,781,676,676,applejack|fluttershy|mane six|pinkie pie|rainbow dash|rarity|twilight sparkle,pixelgrip94
2167187.png,https://derpicdn.net/img/view/2019/10/13/2167187.png,1,0.9935664534568788,712,286,1124,698,412,412,applejack|fluttershy|mane six|pinkie pie|rainbow dash|rarity|twilight sparkle,pixelgrip94
2167222.png,https://derpicdn.net/img/view/2019/10/13/2167222.png,0,0.9524935483932496,1499,251,1951,703,452,452,princess celestia|twilight sparkle,theluckyangel
2167535.png,https://derpicdn.net/img/view/2019/10/13/2167535.png,0,0.9885799288749696,433,558,657,782,224,224,applejack|fluttershy|mane six|pinkie pie|rainbow dash|rarity|twilight sparkle,
2167535.png,https://derpicdn.net/img/view/2019/10/13/2167535.png,1,0.9573656916618348,700,277,952,529,252,252,applejack|fluttershy|mane six|pinkie pie|rainbow dash|rarity|twilight sparkle,
2168002.png,https://derpicdn.net/img/view/2019/10/13/2168002.png,0,0.965527594089508,2932,1489,3800,2234,868,745,applejack|fluttershy|mane six|pinkie pie|rainbow dash|rarity|twilight sparkle,nekosnicker
2168027.png,https://derpicdn.net/img/view/2019/10/13/2168027.png,0,0.9758697152137756,4074,126,4616,668,542,542,applejack|fluttershy|mane six|pinkie pie|rainbow dash|rarity|spike|twilight sparkle,linavillain
2168027.png,https://derpicdn.net/img/view/2019/10/13/2168027.png,1,0.9698355793952942,3448,1068,4280,1900,832,832,applejack|fluttershy|mane six|pinkie pie|rainbow dash|rarity|spike|twilight sparkle,linavillain
2168095.png,https://derpicdn.net/img/view/2019/10/13/2168095.png,1,0.9808765053749084,832,1609,1630,2407,798,798,applejack|fluttershy|mane six|pinkie pie|princess luna|queen chrysalis|rainbow dash|rarity|spike|sweetie belle|twilight sparkle,sonofaskywalker
2168095.png,https://derpicdn.net/img/view/2019/10/13/2168095.png,5,0.9193461537361144,1372,1698,2056,2382,684,684,applejack|fluttershy|mane six|pinkie pie|princess luna|queen chrysalis|rainbow dash|rarity|spike|sweetie belle|twilight sparkle,sonofaskywalker
2168108.png,https://derpicdn.net/img/view/2019/10/13/2168108.png,1,0.9856472611427308,972,0,2032,843,1060,843,applejack|fluttershy|mane six|pinkie pie|rainbow dash|rarity|twilight sparkle,owlpirate
2168139.png,https://derpicdn.net/img/view/2019/10/14/2168139.png,0,0.9881027340888976,1136,921,1800,1605,664,684,apple bloom|babs seed|big macintosh|discord|fluttershy|lightning dust|pinkie pie|princess cadance|rainbow dash|rarity|scootaloo|shining armor|spike|trixie|twilight sparkle,arteses-canvas
2168992.png,https://derpicdn.net/img/view/2019/10/14/2168992.png,0,0.9915959239006042,362,0,644,240,282,240,applejack|fluttershy|mane six|pinkie pie|rainbow dash|rarity|spike|twilight sparkle,therainbowtroll
2168992.png,https://derpicdn.net/img/view/2019/10/14/2168992.png,1,0.9809067845344543,587,239,777,429,190,190,applejack|fluttershy|mane six|pinkie pie|rainbow dash|rarity|spike|twilight sparkle,therainbowtroll
2169148.png,https://derpicdn.net/img/view/2019/10/15/2169148.png,0,0.9980574250221252,1197,257,1565,625,368,368,starlight glimmer|sunset shimmer|twilight sparkle,stellardusk|orin331|3d4d
2169385.png,https://derpicdn.net/img/view/2019/10/15/2169385.png,0,0.9809490442276,910,219,1110,419,200,200,applejack|fluttershy|mane six|pinkie pie|rainbow dash|rarity|spike|twilight sparkle,
2169385.png,https://derpicdn.net/img/view/2019/10/15/2169385.png,1,0.9710038900375366,370,247,610,487,240,240,applejack|fluttershy|mane six|pinkie pie|rainbow dash|rarity|spike|twilight sparkle,
2169843.png,https://derpicdn.net/img/view/2019/10/15/2169843.png,0,0.986002504825592,1313,786,1685,1158,372,372,applejack|fluttershy|mane six|pinkie pie|rainbow dash|rarity|twilight sparkle,avrameow
2170219.png,https://derpicdn.net/img/view/2019/10/16/2170219.png,0,0.9990670680999756,677,869,1339,1531,662,662,applejack|fluttershy|pinkie pie|rainbow dash|rarity|spike|twilight sparkle,robbiecave
2170219.png,https://derpicdn.net/img/view/2019/10/16/2170219.png,2,0.9938843846321106,1481,874,2109,1502,628,628,applejack|fluttershy|pinkie pie|rainbow dash|rarity|spike|twilight sparkle,robbiecave
2170219.png,https://derpicdn.net/img/view/2019/10/16/2170219.png,3,0.9910371899604796,1038,254,1852,1068,814,814,applejack|fluttershy|pinkie pie|rainbow dash|rarity|spike|twilight sparkle,robbiecave
2172070.png,https://derpicdn.net/img/view/2019/10/17/2172070.png,0,0.9982298612594604,1894,73,2552,731,658,658,applejack|fluttershy|mane six|pinkie pie|rainbow dash|rarity|twilight sparkle,softinen
2172070.png,https://derpicdn.net/img/view/2019/10/17/2172070.png,1,0.9894106984138488,2585,424,3261,1100,676,676,applejack|fluttershy|mane six|pinkie pie|rainbow dash|rarity|twilight sparkle,softinen
2172070.png,https://derpicdn.net/img/view/2019/10/17/2172070.png,2,0.9886807799339294,2618,1480,3212,2074,594,594,applejack|fluttershy|mane six|pinkie pie|rainbow dash|rarity|twilight sparkle,softinen
2172070.png,https://derpicdn.net/img/view/2019/10/17/2172070.png,3,0.959260106086731,347,1091,1069,1813,722,722,applejack|fluttershy|mane six|pinkie pie|rainbow dash|rarity|twilight sparkle,softinen
2172981.png,https://derpicdn.net/img/view/2019/10/18/2172981.png,0,0.9893880486488342,17,1038,989,2010,972,972,applejack|fluttershy|mane six|pinkie pie|rainbow dash|rarity|starlight glimmer|sunset shimmer|twilight sparkle,shininglovelystar
2172981.png,https://derpicdn.net/img/view/2019/10/18/2172981.png,1,0.9284732341766356,1945,1150,2877,2082,932,932,applejack|fluttershy|mane six|pinkie pie|rainbow dash|rarity|starlight glimmer|sunset shimmer|twilight sparkle,shininglovelystar
2172981.png,https://derpicdn.net/img/view/2019/10/18/2172981.png,2,0.9106149077415466,1372,1284,2250,2162,878,878,applejack|fluttershy|mane six|pinkie pie|rainbow dash|rarity|starlight glimmer|sunset shimmer|twilight sparkle,shininglovelystar
2173286.png,https://derpicdn.net/img/view/2019/10/19/2173286.png,0,0.9379213452339172,553,85,1155,687,602,602,applejack|fluttershy|mane six|pinkie pie|rainbow dash|rarity|twilight sparkle,redrose26
21739.jpg,https://derpicdn.net/img/view/2012/6/26/21739.jpg,0,0.9975080490112304,289,0,713,406,424,406,fluttershy|princess celestia|princess luna|twilight sparkle,negativefox
2174128.png,https://derpicdn.net/img/view/2019/10/20/2174128.png,0,0.994870126247406,536,531,818,813,282,282,applejack|fluttershy|mane six|pinkie pie|rainbow dash|rarity|spike|twilight sparkle,mn27
2174128.png,https://derpicdn.net/img/view/2019/10/20/2174128.png,1,0.9865242838859558,687,76,1029,418,342,342,applejack|fluttershy|mane six|pinkie pie|rainbow dash|rarity|spike|twilight sparkle,mn27
2174128.png,https://derpicdn.net/img/view/2019/10/20/2174128.png,2,0.983852744102478,359,102,707,450,348,348,applejack|fluttershy|mane six|pinkie pie|rainbow dash|rarity|spike|twilight sparkle,mn27
2174128.png,https://derpicdn.net/img/view/2019/10/20/2174128.png,3,0.9788886904716492,271,655,541,925,270,270,applejack|fluttershy|mane six|pinkie pie|rainbow dash|rarity|spike|twilight sparkle,mn27
2174128.png,https://derpicdn.net/img/view/2019/10/20/2174128.png,4,0.9534207582473756,671,849,975,1153,304,304,applejack|fluttershy|mane six|pinkie pie|rainbow dash|rarity|spike|twilight sparkle,mn27
2174128.png,https://derpicdn.net/img/view/2019/10/20/2174128.png,5,0.9414157867431641,766,599,1074,907,308,308,applejack|fluttershy|mane six|pinkie pie|rainbow dash|rarity|spike|twilight sparkle,mn27
2174883.png,https://derpicdn.net/img/view/2019/10/20/2174883.png,0,0.9816503524780272,1094,363,1690,959,596,596,applejack|fluttershy|mane six|pinkie pie|rainbow dash|rarity|twilight sparkle,rocket-lawnchair
2176355.png,https://derpicdn.net/img/view/2019/10/22/2176355.png,0,0.9228696227073668,193,0,625,428,432,428,rarity|twilight sparkle,
2176962.png,https://derpicdn.net/img/view/2019/10/23/2176962.png,1,0.925907015800476,56,300,276,520,220,220,applejack|fluttershy|mane six|pinkie pie|rainbow dash|rarity|twilight sparkle,the-park
2179437.png,https://derpicdn.net/img/view/2019/10/26/2179437.png,0,0.9967740774154664,837,355,1591,1109,754,754,rainbow dash|twilight sparkle,stuwor-art
2180814.png,https://derpicdn.net/img/view/2019/10/28/2180814.png,0,0.9718692898750304,1466,852,1906,1292,440,440,fluttershy|twilight sparkle,marbola
2181827.png,https://derpicdn.net/img/view/2019/10/29/2181827.png,0,0.9905900359153748,1473,858,1905,1290,432,432,fluttershy|twilight sparkle,marbola
2183727.png,https://derpicdn.net/img/view/2019/10/31/2183727.png,0,0.9988325834274292,1023,7,1653,637,630,630,princess cadance|princess celestia|princess flurry heart|princess luna|twilight sparkle,avrameow
2183727.png,https://derpicdn.net/img/view/2019/10/31/2183727.png,1,0.983481764793396,41,0,691,634,650,634,princess cadance|princess celestia|princess flurry heart|princess luna|twilight sparkle,avrameow
2184756.png,https://derpicdn.net/img/view/2019/11/1/2184756.png,0,0.971345603466034,1636,610,2082,1056,446,446,applejack|fluttershy|mane six|pinkie pie|rainbow dash|rarity|spike|twilight sparkle,livitoza
2185221.png,https://derpicdn.net/img/view/2019/11/2/2185221.png,1,0.9734427332878112,757,1136,1133,1512,376,376,applejack|fluttershy|mane six|pinkie pie|rainbow dash|rarity|spike|twilight sparkle,jinyaranda
2187583.png,https://derpicdn.net/img/view/2019/11/4/2187583.png,0,0.9892581701278688,2204,3,2606,405,402,402,applejack|fluttershy|mane six|pinkie pie|rainbow dash|rarity|spike|starlight glimmer|twilight sparkle,jhayarr23
2191183.png,https://derpicdn.net/img/view/2019/11/9/2191183.png,0,0.994263768196106,371,2,657,288,286,286,applejack|fluttershy|mane six|pinkie pie|rainbow dash|rarity|twilight sparkle,serafelis
2191183.png,https://derpicdn.net/img/view/2019/11/9/2191183.png,1,0.9711113572120668,402,294,702,594,300,300,applejack|fluttershy|mane six|pinkie pie|rainbow dash|rarity|twilight sparkle,serafelis
2191183.png,https://derpicdn.net/img/view/2019/11/9/2191183.png,3,0.9295653700828552,804,106,1118,420,314,314,applejack|fluttershy|mane six|pinkie pie|rainbow dash|rarity|twilight sparkle,serafelis
2191416.png,https://derpicdn.net/img/view/2019/11/9/2191416.png,0,0.9964773654937744,506,699,1732,1925,1226,1226,applejack|fluttershy|mane six|pinkie pie|rainbow dash|rarity|twilight sparkle,arcane-thunder
2191416.png,https://derpicdn.net/img/view/2019/11/9/2191416.png,1,0.9841980934143066,1435,439,2561,1565,1126,1126,applejack|fluttershy|mane six|pinkie pie|rainbow dash|rarity|twilight sparkle,arcane-thunder
2191416.png,https://derpicdn.net/img/view/2019/11/9/2191416.png,2,0.9502270817756652,1853,1201,2947,2295,1094,1094,applejack|fluttershy|mane six|pinkie pie|rainbow dash|rarity|twilight sparkle,arcane-thunder
219858.png,https://derpicdn.net/img/view/2013/1/21/219858.png,0,0.9873989820480348,532,155,692,315,160,160,applejack|big macintosh|fluttershy|lightning dust|pinkie pie|princess cadance|princess celestia|princess luna|queen chrysalis|rainbow dash|rarity|soarin'|spitfire|trixie|twilight sparkle,xxoomorathxx
219858.png,https://derpicdn.net/img/view/2013/1/21/219858.png,2,0.9036018252372742,596,451,730,585,134,134,applejack|big macintosh|fluttershy|lightning dust|pinkie pie|princess cadance|princess celestia|princess luna|queen chrysalis|rainbow dash|rarity|soarin'|spitfire|trixie|twilight sparkle,xxoomorathxx
2198707.png,https://derpicdn.net/img/view/2019/11/17/2198707.png,1,0.9928374290466307,888,1223,1720,2055,832,832,applejack|fluttershy|mane six|pinkie pie|rainbow dash|rarity|twilight sparkle,darklight1315
2198707.png,https://derpicdn.net/img/view/2019/11/17/2198707.png,2,0.9709953665733336,2168,1218,3000,2050,832,832,applejack|fluttershy|mane six|pinkie pie|rainbow dash|rarity|twilight sparkle,darklight1315
2198806.png,https://derpicdn.net/img/view/2019/11/17/2198806.png,0,0.9986713528633118,684,3,1956,1275,1272,1272,fluttershy|twilight sparkle,artiks
2203059.png,https://derpicdn.net/img/view/2019/11/22/2203059.png,0,0.9946197271347046,917,1432,2205,2720,1288,1288,applejack|fluttershy|mane six|pinkie pie|rainbow dash|rarity|twilight sparkle,flutterstormreturns
2203059.png,https://derpicdn.net/img/view/2019/11/22/2203059.png,1,0.9878292083740234,230,370,1566,1706,1336,1336,applejack|fluttershy|mane six|pinkie pie|rainbow dash|rarity|twilight sparkle,flutterstormreturns
2203059.png,https://derpicdn.net/img/view/2019/11/22/2203059.png,2,0.9046745300292968,1713,1516,3093,2896,1380,1380,applejack|fluttershy|mane six|pinkie pie|rainbow dash|rarity|twilight sparkle,flutterstormreturns
2203335.png,https://derpicdn.net/img/view/2019/11/23/2203335.png,0,0.9976847767829896,482,1191,898,1607,416,416,applejack|fluttershy|mane six|pinkie pie|rainbow dash|rarity|twilight sparkle,snowberry
2203335.png,https://derpicdn.net/img/view/2019/11/23/2203335.png,1,0.9941943287849426,838,0,1296,447,458,447,applejack|fluttershy|mane six|pinkie pie|rainbow dash|rarity|twilight sparkle,snowberry
2203335.png,https://derpicdn.net/img/view/2019/11/23/2203335.png,2,0.990184724330902,888,1138,1400,1650,512,512,applejack|fluttershy|mane six|pinkie pie|rainbow dash|rarity|twilight sparkle,snowberry
2203335.png,https://derpicdn.net/img/view/2019/11/23/2203335.png,3,0.989362359046936,236,0,718,449,482,449,applejack|fluttershy|mane six|pinkie pie|rainbow dash|rarity|twilight sparkle,snowberry
2203335.png,https://derpicdn.net/img/view/2019/11/23/2203335.png,4,0.9299466609954834,830,623,1240,1033,410,410,applejack|fluttershy|mane six|pinkie pie|rainbow dash|rarity|twilight sparkle,snowberry
2204559.png,https://derpicdn.net/img/view/2019/11/24/2204559.png,0,0.973958432674408,1051,213,2369,1531,1318,1318,princess luna|twilight sparkle,lakunae
2205935.png,https://derpicdn.net/img/view/2019/11/26/2205935.png,0,0.9919720888137816,233,0,887,625,654,625,rainbow dash|twilight sparkle,afkcyrist
2206812.png,https://derpicdn.net/img/view/2019/11/27/2206812.png,0,0.9740752577781676,1452,434,1752,734,300,300,apple bloom|applejack|big macintosh|cutie mark crusaders|fluttershy|granny smith|mane six|pinkie pie|princess cadance|princess celestia|princess flurry heart|princess luna|rainbow dash|rarity|scootaloo|shining armor|spike|spitfire|starlight glimmer|sunset shimmer|sweetie belle|trixie|twilight sparkle,phucknuckl
2206812.png,https://derpicdn.net/img/view/2019/11/27/2206812.png,2,0.9554951190948486,2176,434,2490,748,314,314,apple bloom|applejack|big macintosh|cutie mark crusaders|fluttershy|granny smith|mane six|pinkie pie|princess cadance|princess celestia|princess flurry heart|princess luna|rainbow dash|rarity|scootaloo|shining armor|spike|spitfire|starlight glimmer|sunset shimmer|sweetie belle|trixie|twilight sparkle,phucknuckl
2206812.png,https://derpicdn.net/img/view/2019/11/27/2206812.png,4,0.9457878470420836,1369,1698,1791,2120,422,422,apple bloom|applejack|big macintosh|cutie mark crusaders|fluttershy|granny smith|mane six|pinkie pie|princess cadance|princess celestia|princess flurry heart|princess luna|rainbow dash|rarity|scootaloo|shining armor|spike|spitfire|starlight glimmer|sunset shimmer|sweetie belle|trixie|twilight sparkle,phucknuckl
2206812.png,https://derpicdn.net/img/view/2019/11/27/2206812.png,5,0.9322514533996582,737,1746,1047,2056,310,310,apple bloom|applejack|big macintosh|cutie mark crusaders|fluttershy|granny smith|mane six|pinkie pie|princess cadance|princess celestia|princess flurry heart|princess luna|rainbow dash|rarity|scootaloo|shining armor|spike|spitfire|starlight glimmer|sunset shimmer|sweetie belle|trixie|twilight sparkle,phucknuckl
2211673.png,https://derpicdn.net/img/view/2019/12/3/2211673.png,0,0.9921191930770874,0,236,565,910,565,674,applejack|fluttershy|mane six|pinkie pie|rainbow dash|rarity|twilight sparkle,fadlihalimns
2220362.png,https://derpicdn.net/img/view/2019/12/14/2220362.png,0,0.949977457523346,1236,505,1478,747,242,242,applejack|fluttershy|mane six|pinkie pie|rainbow dash|rarity|spike|twilight sparkle,jamescorck
2220529.png,https://derpicdn.net/img/view/2019/12/14/2220529.png,1,0.9330182075500488,3077,578,4067,1568,990,990,applejack|fluttershy|mane six|pinkie pie|rainbow dash|rarity|spike|twilight sparkle,gor1ck
222264.png,https://derpicdn.net/img/view/2013/1/24/222264.png,0,0.992029309272766,39,19,673,653,634,634,trixie|twilight sparkle,dcencia
222264.png,https://derpicdn.net/img/view/2013/1/24/222264.png,1,0.9729101657867432,577,50,1171,644,594,594,trixie|twilight sparkle,dcencia
2223054.png,https://derpicdn.net/img/view/2019/12/17/2223054.png,0,0.9943976402282716,179,101,783,705,604,604,pinkie pie|twilight sparkle,mirtash|sonnatora
2223054.png,https://derpicdn.net/img/view/2019/12/17/2223054.png,1,0.9536316394805908,595,174,1119,698,524,524,pinkie pie|twilight sparkle,mirtash|sonnatora
2226015.png,https://derpicdn.net/img/view/2019/12/21/2226015.png,1,0.96149480342865,235,329,531,625,296,296,applejack|fluttershy|mane six|pinkie pie|rainbow dash|rarity|twilight sparkle,tarkron
2226409.png,https://derpicdn.net/img/view/2019/12/21/2226409.png,0,0.9722751975059508,181,893,1131,1843,950,950,applejack|fluttershy|mane six|pinkie pie|rainbow dash|rarity|twilight sparkle,kaleido-art
2226869.png,https://derpicdn.net/img/view/2019/12/22/2226869.png,0,0.9661865234375,84,76,1008,979,924,903,rarity|twilight sparkle,galacticflashd
2226905.png,https://derpicdn.net/img/view/2019/12/22/2226905.png,1,0.9834923148155212,414,614,600,814,186,200,princess celestia|princess luna|twilight sparkle,redruin01
2228386.jpg,https://derpicdn.net/img/view/2019/12/24/2228386.jpg,1,0.9934654831886292,1764,2224,2722,3182,958,958,apple bloom|applejack|cutie mark crusaders|fluttershy|mane six|pinkie pie|princess celestia|princess luna|rainbow dash|rarity|scootaloo|spike|starlight glimmer|sunset shimmer|sweetie belle|trixie|twilight sparkle,darksly
2228386.jpg,https://derpicdn.net/img/view/2019/12/24/2228386.jpg,3,0.9411847591400146,1324,2573,1958,3207,634,634,apple bloom|applejack|cutie mark crusaders|fluttershy|mane six|pinkie pie|princess celestia|princess luna|rainbow dash|rarity|scootaloo|spike|starlight glimmer|sunset shimmer|sweetie belle|trixie|twilight sparkle,darksly
2229509.jpg,https://derpicdn.net/img/view/2019/12/25/2229509.jpg,0,0.9866403937339784,376,1171,1312,2107,936,936,fluttershy|twilight sparkle,xjenn9
2229509.jpg,https://derpicdn.net/img/view/2019/12/25/2229509.jpg,1,0.9630159735679626,3096,986,3836,1726,740,740,fluttershy|twilight sparkle,xjenn9
2229812.png,https://derpicdn.net/img/view/2019/12/25/2229812.png,0,0.9795498847961426,539,0,1751,1159,1212,1159,princess luna|twilight sparkle,fensu-san
2230977.jpg,https://derpicdn.net/img/view/2019/12/27/2230977.jpg,0,0.9181962013244628,2893,2071,3979,3157,1086,1086,rarity|twilight sparkle,earthsong9405
2231738.jpg,https://derpicdn.net/img/view/2019/12/28/2231738.jpg,1,0.9163640737533568,244,23,524,303,280,280,princess cadance|princess celestia|princess luna|starlight glimmer|sunset shimmer|twilight sparkle,marybellamy
2232282.png,https://derpicdn.net/img/view/2019/12/28/2232282.png,0,0.9963324069976808,2,0,654,630,652,630,princess celestia|twilight sparkle,rainbowtashie
2233379.jpg,https://derpicdn.net/img/view/2019/12/29/2233379.jpg,3,0.9079355597496032,0,156,436,630,436,474,applejack|fluttershy|mane six|pinkie pie|princess celestia|princess luna|rainbow dash|rarity|twilight sparkle,yanamosuda|psaxophone|osawari64
2234627.jpg,https://derpicdn.net/img/view/2019/12/31/2234627.jpg,0,0.9977862238883972,351,0,783,432,432,432,applejack|fluttershy|mane six|pinkie pie|princess celestia|princess luna|rainbow dash|rarity|spike|twilight sparkle,ipun
2234627.jpg,https://derpicdn.net/img/view/2019/12/31/2234627.jpg,1,0.983229160308838,190,590,462,862,272,272,applejack|fluttershy|mane six|pinkie pie|princess celestia|princess luna|rainbow dash|rarity|spike|twilight sparkle,ipun
2234627.jpg,https://derpicdn.net/img/view/2019/12/31/2234627.jpg,2,0.9201377630233764,474,685,800,1017,326,332,applejack|fluttershy|mane six|pinkie pie|princess celestia|princess luna|rainbow dash|rarity|spike|twilight sparkle,ipun
223868.png,https://derpicdn.net/img/view/2013/1/26/223868.png,0,0.9926456212997437,1862,498,3072,1708,1210,1210,pinkie pie|twilight sparkle,buttercupsaiyan
2239914.png,https://derpicdn.net/img/view/2020/1/6/2239914.png,1,0.956810176372528,1096,517,1668,1089,572,572,rainbow dash|twilight sparkle,tinybenz
2239917.png,https://derpicdn.net/img/view/2020/1/6/2239917.png,0,0.9915992617607116,1761,504,2447,1190,686,686,rainbow dash|twilight sparkle,tinybenz
2240095.png,https://derpicdn.net/img/view/2020/1/6/2240095.png,0,0.9646462202072144,0,626,1806,2440,1806,1814,applejack|rainbow dash|twilight sparkle,wenni
2240149.jpg,https://derpicdn.net/img/view/2020/1/6/2240149.jpg,0,0.9370938539505004,371,20,1297,946,926,926,starlight glimmer|trixie|twilight sparkle,ljdamz1119
2240907.jpg,https://derpicdn.net/img/view/2020/1/7/2240907.jpg,3,0.9806786775588988,13,424,465,876,452,452,applejack|princess celestia|rainbow dash|rarity|twilight sparkle,anontheanon
2241821.png,https://derpicdn.net/img/view/2020/1/8/2241821.png,0,0.984650194644928,698,0,1350,564,652,564,rainbow dash|twilight sparkle,friendshipishorses
2241821.png,https://derpicdn.net/img/view/2020/1/8/2241821.png,1,0.972855806350708,25,0,557,518,532,518,rainbow dash|twilight sparkle,friendshipishorses
2243721.jpg,https://derpicdn.net/img/view/2020/1/10/2243721.jpg,0,0.9882147908210754,92,0,1280,1330,1188,1330,princess flurry heart|twilight sparkle,littleblackraencloud
2245480.png,https://derpicdn.net/img/view/2020/1/12/2245480.png,0,0.998267948627472,2124,762,2746,1384,622,622,fluttershy|pinkie pie|princess celestia|sunset shimmer|twilight sparkle,vanillaghosties
2245480.png,https://derpicdn.net/img/view/2020/1/12/2245480.png,2,0.9884061813354492,1263,1040,1873,1650,610,610,fluttershy|pinkie pie|princess celestia|sunset shimmer|twilight sparkle,vanillaghosties
2245480.png,https://derpicdn.net/img/view/2020/1/12/2245480.png,3,0.9657248854637146,702,0,1440,624,738,624,fluttershy|pinkie pie|princess celestia|sunset shimmer|twilight sparkle,vanillaghosties
2245480.png,https://derpicdn.net/img/view/2020/1/12/2245480.png,4,0.9530689716339112,648,667,1162,1181,514,514,fluttershy|pinkie pie|princess celestia|sunset shimmer|twilight sparkle,vanillaghosties
2246580.png,https://derpicdn.net/img/view/2020/1/13/2246580.png,0,0.9940661787986756,775,56,1637,918,862,862,applejack|fluttershy|mane six|pinkie pie|rainbow dash|rarity|twilight sparkle,mkogwheel
2246826.jpg,https://derpicdn.net/img/view/2020/1/14/2246826.jpg,0,0.995924174785614,138,633,530,1025,392,392,fluttershy|pinkie pie|rainbow dash|twilight sparkle,tsitra360
2246826.jpg,https://derpicdn.net/img/view/2020/1/14/2246826.jpg,1,0.9549875259399414,843,565,1113,835,270,270,fluttershy|pinkie pie|rainbow dash|twilight sparkle,tsitra360
2246991.jpg,https://derpicdn.net/img/view/2020/1/14/2246991.jpg,0,0.9299932718276978,1067,0,1815,680,748,680,spike|twilight sparkle,drtuo4
2247001.jpg,https://derpicdn.net/img/view/2020/1/14/2247001.jpg,0,0.980940580368042,530,390,744,604,214,214,apple bloom|applejack|cutie mark crusaders|fluttershy|mane six|pinkie pie|rainbow dash|rarity|scootaloo|spike|sweetie belle|twilight sparkle,drtuo4
2247001.jpg,https://derpicdn.net/img/view/2020/1/14/2247001.jpg,1,0.9247867465019226,743,482,937,676,194,194,apple bloom|applejack|cutie mark crusaders|fluttershy|mane six|pinkie pie|rainbow dash|rarity|scootaloo|spike|sweetie belle|twilight sparkle,drtuo4
224733.jpg,https://derpicdn.net/img/view/2013/1/26/224733.jpg,0,0.9191747307777404,2332,3809,4444,5921,2112,2112,applejack|fluttershy|mane six|pinkie pie|rainbow dash|rarity|twilight sparkle,haltie
2255752.png,https://derpicdn.net/img/view/2020/1/24/2255752.png,0,0.9711632132530212,654,31,1282,659,628,628,rainbow dash|twilight sparkle,little-sketches
2258977.jpg,https://derpicdn.net/img/view/2020/1/28/2258977.jpg,0,0.9165005087852478,237,423,465,651,228,228,princess celestia|twilight sparkle,earthsong9405
2261566.jpg,https://derpicdn.net/img/view/2020/1/31/2261566.jpg,0,0.9764648079872132,131,0,413,272,282,272,spike|twilight sparkle,earthsong9405
2261566.jpg,https://derpicdn.net/img/view/2020/1/31/2261566.jpg,1,0.9621506929397584,653,0,967,277,314,277,spike|twilight sparkle,earthsong9405
2262110.jpg,https://derpicdn.net/img/view/2020/1/31/2262110.jpg,0,0.9330493807792664,534,0,820,283,286,283,applejack|fluttershy|mane six|pinkie pie|rainbow dash|rarity|twilight sparkle,raikoh
2262110.jpg,https://derpicdn.net/img/view/2020/1/31/2262110.jpg,1,0.930294394493103,114,34,396,316,282,282,applejack|fluttershy|mane six|pinkie pie|rainbow dash|rarity|twilight sparkle,raikoh
2262110.jpg,https://derpicdn.net/img/view/2020/1/31/2262110.jpg,2,0.9186226725578308,735,278,979,522,244,244,applejack|fluttershy|mane six|pinkie pie|rainbow dash|rarity|twilight sparkle,raikoh
2262110.jpg,https://derpicdn.net/img/view/2020/1/31/2262110.jpg,3,0.9000244140625,968,263,1198,493,230,230,applejack|fluttershy|mane six|pinkie pie|rainbow dash|rarity|twilight sparkle,raikoh
2262215.png,https://derpicdn.net/img/view/2020/1/31/2262215.png,1,0.9577624797821044,452,0,1236,750,784,750,rainbow dash|twilight sparkle,little-sketches
2264128.png,https://derpicdn.net/img/view/2020/2/2/2264128.png,0,0.9584763646125792,1562,260,2472,1170,910,910,pinkie pie|twilight sparkle,alkit_is_not_me|alkit
2264708.png,https://derpicdn.net/img/view/2020/2/3/2264708.png,0,0.9693833589553832,0,790,198,990,198,200,spike|twilight sparkle,vavacung
2272832.png,https://derpicdn.net/img/view/2020/2/13/2272832.png,0,0.9849124550819396,2420,1514,3550,2644,1130,1130,princess celestia|twilight sparkle,badumsquish|felix-kot
2272832.png,https://derpicdn.net/img/view/2020/2/13/2272832.png,1,0.9397905468940736,1381,419,2849,1887,1468,1468,princess celestia|twilight sparkle,badumsquish|felix-kot
2273678.jpg,https://derpicdn.net/img/view/2020/2/14/2273678.jpg,0,0.9871093630790708,332,10,644,322,312,312,spike|twilight sparkle,kura
227394.png,https://derpicdn.net/img/view/2013/1/29/227394.png,1,0.9827414155006408,616,537,1014,935,398,398,applejack|fluttershy|mane six|pinkie pie|rainbow dash|rarity|twilight sparkle,brejburn
227394.png,https://derpicdn.net/img/view/2013/1/29/227394.png,3,0.9104043841362,320,0,832,501,512,501,applejack|fluttershy|mane six|pinkie pie|rainbow dash|rarity|twilight sparkle,brejburn
2276266.png,https://derpicdn.net/img/view/2020/2/16/2276266.png,1,0.996827244758606,1284,623,2000,1351,716,728,applejack|fluttershy|pinkie pie|rainbow dash|rarity|sunset shimmer|twilight sparkle,jamescorck
2277646.jpg,https://derpicdn.net/img/view/2020/2/18/2277646.jpg,0,0.9978075623512268,427,181,709,463,282,282,sunset shimmer|twilight sparkle,snowballflo|truebluflo
2277646.jpg,https://derpicdn.net/img/view/2020/2/18/2277646.jpg,1,0.9082627892494202,668,297,948,577,280,280,sunset shimmer|twilight sparkle,snowballflo|truebluflo
2280199.png,https://derpicdn.net/img/view/2020/2/21/2280199.png,0,0.9757736325263976,603,140,809,346,206,206,starlight glimmer|trixie|twilight sparkle,zwitterkitsune
2280355.jpg,https://derpicdn.net/img/view/2020/2/21/2280355.jpg,0,0.9949671626091005,713,0,1357,599,644,599,fluttershy|twilight sparkle,navokin
2280524.jpg,https://derpicdn.net/img/view/2020/2/22/2280524.jpg,0,0.9789811968803406,639,4820,1319,5500,680,680,applejack|fluttershy|mane six|pinkie pie|rainbow dash|rarity|twilight sparkle,chub-wub
2282063.jpg,https://derpicdn.net/img/view/2020/2/23/2282063.jpg,0,0.9896571636199952,1004,1184,2090,2270,1086,1086,rarity|twilight sparkle,earthsong9405
2282063.jpg,https://derpicdn.net/img/view/2020/2/23/2282063.jpg,1,0.9856358766555786,2434,686,3640,1892,1206,1206,rarity|twilight sparkle,earthsong9405
229.jpg,https://derpicdn.net/img/view/2012/1/15/229.jpg,0,0.9277058839797974,242,889,636,1283,394,394,apple bloom|applejack|fluttershy|mane six|pinkie pie|rainbow dash|rarity|spike|twilight sparkle,lavosvsbahamut
2290151.png,https://derpicdn.net/img/view/2020/3/4/2290151.png,0,0.9659155011177064,187,494,1499,1806,1312,1312,princess luna|twilight sparkle,darkest-lunar-flower
229058.png,https://derpicdn.net/img/view/2013/1/31/229058.png,0,0.9694995284080504,859,15,2181,1337,1322,1322,shining armor|twilight sparkle,
229173.jpg,https://derpicdn.net/img/view/2013/1/31/229173.jpg,0,0.9479564428329468,203,274,449,520,246,246,applejack|fluttershy|mane six|pinkie pie|rainbow dash|rarity|twilight sparkle,
2292280.jpg,https://derpicdn.net/img/view/2020/3/7/2292280.jpg,0,0.996391534805298,0,416,1311,1748,1311,1332,sunset shimmer|twilight sparkle,celestialoddity
229272.png,https://derpicdn.net/img/view/2013/1/31/229272.png,0,0.9147356152534484,289,68,745,524,456,456,shining armor|twilight sparkle,dm29
2294019.png,https://derpicdn.net/img/view/2020/3/10/2294019.png,0,0.9935338497161864,495,0,981,437,486,437,applejack|fluttershy|mane six|pinkie pie|rainbow dash|rarity|twilight sparkle,lilith1light
2295866.jpg,https://derpicdn.net/img/view/2020/3/12/2295866.jpg,0,0.9465773105621338,289,0,1191,800,902,800,starlight glimmer|twilight sparkle,citi
2297524.jpg,https://derpicdn.net/img/view/2020/3/14/2297524.jpg,0,0.9903600811958312,474,6,1104,636,630,630,sunset shimmer|twilight sparkle,5mmumm5
2297524.jpg,https://derpicdn.net/img/view/2020/3/14/2297524.jpg,1,0.9833273887634276,37,103,629,695,592,592,sunset shimmer|twilight sparkle,5mmumm5
2299272.png,https://derpicdn.net/img/view/2020/3/17/2299272.png,0,0.9902951717376708,434,0,3378,2681,2944,2681,spike|twilight sparkle,professionalpuppy
230039.png,https://derpicdn.net/img/view/2013/2/1/230039.png,0,0.9330568313598632,597,156,1021,580,424,424,applejack|fluttershy|mane six|pinkie pie|rainbow dash|rarity|spike|twilight sparkle,zat
2301989.png,https://derpicdn.net/img/view/2020/3/20/2301989.png,1,0.9951381087303162,706,297,1000,609,294,312,rarity|sweetie belle|twilight sparkle,manifest harmony
2301989.png,https://derpicdn.net/img/view/2020/3/20/2301989.png,2,0.9870119094848632,616,915,1000,1355,384,440,rarity|sweetie belle|twilight sparkle,manifest harmony
2301989.png,https://derpicdn.net/img/view/2020/3/20/2301989.png,4,0.9542428255081176,30,1033,390,1393,360,360,rarity|sweetie belle|twilight sparkle,manifest harmony
2302673.png,https://derpicdn.net/img/view/2020/3/21/2302673.png,0,0.9990879893302916,601,335,811,545,210,210,discord|twilight sparkle,vavacung
230331.jpg,https://derpicdn.net/img/view/2013/2/1/230331.jpg,1,0.9992407560348512,2513,970,2959,1416,446,446,applejack|fluttershy|mane six|pinkie pie|rainbow dash|rarity|twilight sparkle,moyamoya kuroi
230331.jpg,https://derpicdn.net/img/view/2013/2/1/230331.jpg,3,0.9968427419662476,1294,889,1860,1455,566,566,applejack|fluttershy|mane six|pinkie pie|rainbow dash|rarity|twilight sparkle,moyamoya kuroi
230331.jpg,https://derpicdn.net/img/view/2013/2/1/230331.jpg,4,0.9962846636772156,428,883,1010,1465,582,582,applejack|fluttershy|mane six|pinkie pie|rainbow dash|rarity|twilight sparkle,moyamoya kuroi
230331.jpg,https://derpicdn.net/img/view/2013/2/1/230331.jpg,5,0.9349889159202576,1992,0,2594,494,602,494,applejack|fluttershy|mane six|pinkie pie|rainbow dash|rarity|twilight sparkle,moyamoya kuroi
2304557.png,https://derpicdn.net/img/view/2020/3/23/2304557.png,0,0.995200514793396,261,327,401,467,140,140,applejack|fluttershy|pinkie pie|rainbow dash|twilight sparkle,kkmrarar
2307264.png,https://derpicdn.net/img/view/2020/3/27/2307264.png,0,0.9971968531608582,682,663,1200,1207,518,544,pinkie pie|rainbow dash|twilight sparkle,pia-sama
2313862.png,https://derpicdn.net/img/view/2020/4/4/2313862.png,0,0.9967800974845886,676,100,1656,1080,980,980,rarity|twilight sparkle,whiteraven
2316295.jpg,https://derpicdn.net/img/view/2020/4/7/2316295.jpg,0,0.9783276319503784,1070,794,1414,1138,344,344,applejack|fluttershy|mane six|pinkie pie|rainbow dash|rarity|twilight sparkle,emeraldgalaxy
231688.png,https://derpicdn.net/img/view/2013/2/2/231688.png,0,0.994048535823822,1004,45,1588,629,584,584,princess luna|twilight sparkle,fauxsquared
231688.png,https://derpicdn.net/img/view/2013/2/2/231688.png,1,0.9183919429779052,158,335,908,1085,750,750,princess luna|twilight sparkle,fauxsquared
2320923.png,https://derpicdn.net/img/view/2020/4/12/2320923.png,0,0.9258462190628052,114,0,516,352,402,352,fluttershy|twilight sparkle,nekoshiei
2321590.png,https://derpicdn.net/img/view/2020/4/13/2321590.png,0,0.9737427234649658,282,746,1396,1860,1114,1114,rarity|twilight sparkle,sadtrooper
2324974.jpg,https://derpicdn.net/img/view/2020/4/17/2324974.jpg,1,0.944668173789978,649,120,1119,590,470,470,pinkie pie|rarity|spike|twilight sparkle,traupa
2327509.jpg,https://derpicdn.net/img/view/2020/4/20/2327509.jpg,2,0.950441598892212,2010,260,2446,696,436,436,princess celestia|princess luna|starlight glimmer|twilight sparkle,nosch
2327988.jpg,https://derpicdn.net/img/view/2020/4/21/2327988.jpg,0,0.9844034910202026,366,7,732,373,366,366,spike|twilight sparkle,flamingbiscuit_
23284.jpg,https://derpicdn.net/img/view/2012/6/28/23284.jpg,0,0.957838535308838,3327,1645,3855,2173,528,528,applejack|discord|fluttershy|pinkie pie|princess luna|rainbow dash|rarity|soarin'|spike|spitfire|trixie|twilight sparkle,curiousglaistig
2329207.png,https://derpicdn.net/img/view/2020/4/23/2329207.png,0,0.998664140701294,57,1242,1163,2348,1106,1106,princess celestia|princess luna|twilight sparkle,darkest-lunar-flower
2329207.png,https://derpicdn.net/img/view/2020/4/23/2329207.png,1,0.9867805242538452,2393,212,3561,1380,1168,1168,princess celestia|princess luna|twilight sparkle,darkest-lunar-flower
2329207.png,https://derpicdn.net/img/view/2020/4/23/2329207.png,2,0.9819167852401732,1232,863,2410,2041,1178,1178,princess celestia|princess luna|twilight sparkle,darkest-lunar-flower
2330450.jpg,https://derpicdn.net/img/view/2020/4/24/2330450.jpg,0,0.9959861636161804,4571,528,7035,2992,2464,2464,applejack|fluttershy|rainbow dash|rarity|starlight glimmer|sunset shimmer|trixie|twilight sparkle,imafutureguitarhero
2330450.jpg,https://derpicdn.net/img/view/2020/4/24/2330450.jpg,1,0.9929039478302002,520,695,2846,3021,2326,2326,applejack|fluttershy|rainbow dash|rarity|starlight glimmer|sunset shimmer|trixie|twilight sparkle,imafutureguitarhero
2331572.jpg,https://derpicdn.net/img/view/2020/4/25/2331572.jpg,0,0.9388203024864196,706,670,962,926,256,256,applejack|fluttershy|rainbow dash|twilight sparkle,tinybenz
2331976.jpg,https://derpicdn.net/img/view/2020/4/26/2331976.jpg,1,0.959033727645874,1304,936,1866,1498,562,562,applejack|fluttershy|mane six|pinkie pie|rainbow dash|rarity|twilight sparkle,chapaghettii
2331976.jpg,https://derpicdn.net/img/view/2020/4/26/2331976.jpg,2,0.9576361179351808,100,967,562,1429,462,462,applejack|fluttershy|mane six|pinkie pie|rainbow dash|rarity|twilight sparkle,chapaghettii
2332694.jpg,https://derpicdn.net/img/view/2020/4/27/2332694.jpg,0,0.909809947013855,505,415,1419,1329,914,914,applejack|fluttershy|mane six|pinkie pie|rainbow dash|rarity|sunset shimmer|twilight sparkle,albertbm
2332748.jpg,https://derpicdn.net/img/view/2020/4/27/2332748.jpg,0,0.9897814393043518,312,448,1000,1136,688,688,starlight glimmer|sunset shimmer|trixie|twilight sparkle,saralien
2332748.jpg,https://derpicdn.net/img/view/2020/4/27/2332748.jpg,2,0.9712727069854736,1095,424,1809,1138,714,714,starlight glimmer|sunset shimmer|trixie|twilight sparkle,saralien
233307.png,https://derpicdn.net/img/view/2013/2/4/233307.png,0,0.9924654364585876,546,381,2506,2341,1960,1960,princess cadance|shining armor|twilight sparkle,beavernator|773her
233307.png,https://derpicdn.net/img/view/2013/2/4/233307.png,1,0.9607009291648864,2253,0,4093,1599,1840,1599,princess cadance|shining armor|twilight sparkle,beavernator|773her
233403.jpg,https://derpicdn.net/img/view/2013/2/4/233403.jpg,0,0.998521327972412,296,6,534,244,238,238,applejack|fluttershy|mane six|pinkie pie|rainbow dash|rarity|twilight sparkle,shepherd0821
233403.jpg,https://derpicdn.net/img/view/2013/2/4/233403.jpg,1,0.9936421513557434,193,297,475,579,282,282,applejack|fluttershy|mane six|pinkie pie|rainbow dash|rarity|twilight sparkle,shepherd0821
233403.jpg,https://derpicdn.net/img/view/2013/2/4/233403.jpg,2,0.9880093336105348,0,314,234,552,234,238,applejack|fluttershy|mane six|pinkie pie|rainbow dash|rarity|twilight sparkle,shepherd0821
233403.jpg,https://derpicdn.net/img/view/2013/2/4/233403.jpg,3,0.9815447330474854,457,25,695,263,238,238,applejack|fluttershy|mane six|pinkie pie|rainbow dash|rarity|twilight sparkle,shepherd0821
233403.jpg,https://derpicdn.net/img/view/2013/2/4/233403.jpg,4,0.9384223818778992,130,102,396,368,266,266,applejack|fluttershy|mane six|pinkie pie|rainbow dash|rarity|twilight sparkle,shepherd0821
2336601.jpg,https://derpicdn.net/img/view/2020/5/1/2336601.jpg,0,0.9951776266098022,1336,514,1726,920,390,406,applejack|fluttershy|mane six|pinkie pie|rainbow dash|rarity|twilight sparkle,doekis_|doekis
2336601.jpg,https://derpicdn.net/img/view/2020/5/1/2336601.jpg,1,0.9869365096092224,1122,584,1466,928,344,344,applejack|fluttershy|mane six|pinkie pie|rainbow dash|rarity|twilight sparkle,doekis_|doekis
2336601.jpg,https://derpicdn.net/img/view/2020/5/1/2336601.jpg,2,0.9819548726081848,361,41,627,307,266,266,applejack|fluttershy|mane six|pinkie pie|rainbow dash|rarity|twilight sparkle,doekis_|doekis
2336601.jpg,https://derpicdn.net/img/view/2020/5/1/2336601.jpg,4,0.9256026744842528,978,0,1354,372,376,372,applejack|fluttershy|mane six|pinkie pie|rainbow dash|rarity|twilight sparkle,doekis_|doekis
2336601.jpg,https://derpicdn.net/img/view/2020/5/1/2336601.jpg,5,0.9106301069259644,503,359,765,621,262,262,applejack|fluttershy|mane six|pinkie pie|rainbow dash|rarity|twilight sparkle,doekis_|doekis
2340514.jpg,https://derpicdn.net/img/view/2020/5/5/2340514.jpg,0,0.9983527064323424,826,174,1346,694,520,520,applejack|rarity|twilight sparkle,icychamber
2343278.jpg,https://derpicdn.net/img/view/2020/5/9/2343278.jpg,0,0.9905567169189452,51,0,461,383,410,383,applejack|big macintosh|princess celestia|rarity|starlight glimmer|twilight sparkle,colorfulcolor233
2343278.jpg,https://derpicdn.net/img/view/2020/5/9/2343278.jpg,2,0.9547373652458192,558,0,980,388,422,388,applejack|big macintosh|princess celestia|rarity|starlight glimmer|twilight sparkle,colorfulcolor233
2345966.png,https://derpicdn.net/img/view/2020/5/11/2345966.png,0,0.948040008544922,0,39,375,429,375,390,rainbow dash|twilight sparkle,honneymoonmlp
2349775.png,https://derpicdn.net/img/view/2020/5/16/2349775.png,0,0.998164176940918,456,170,676,390,220,220,pinkie pie|princess celestia|twilight sparkle,nekoshiei
2349775.png,https://derpicdn.net/img/view/2020/5/16/2349775.png,1,0.9980989694595336,684,534,1052,902,368,368,pinkie pie|princess celestia|twilight sparkle,nekoshiei
2349775.png,https://derpicdn.net/img/view/2020/5/16/2349775.png,2,0.9937936663627625,228,0,516,281,288,281,pinkie pie|princess celestia|twilight sparkle,nekoshiei
2349775.png,https://derpicdn.net/img/view/2020/5/16/2349775.png,3,0.937007486820221,228,663,570,1005,342,342,pinkie pie|princess celestia|twilight sparkle,nekoshiei
2350822.png,https://derpicdn.net/img/view/2020/5/17/2350822.png,0,0.9782786965370178,684,4266,1394,4976,710,710,applejack|discord|fluttershy|mane six|pinkie pie|rainbow dash|rarity|soarin'|sunset shimmer|twilight sparkle,snowballflo
2351013.jpg,https://derpicdn.net/img/view/2020/5/17/2351013.jpg,1,0.9782033562660216,771,358,1181,768,410,410,spike|starlight glimmer|sunset shimmer|twilight sparkle,isagat7|hierozaki
2351157.jpg,https://derpicdn.net/img/view/2020/5/17/2351157.jpg,0,0.9993124008178712,58,822,434,1198,376,376,applejack|fluttershy|pinkie pie|rainbow dash|twilight sparkle,klhpyro
2354076.jpg,https://derpicdn.net/img/view/2020/5/21/2354076.jpg,0,0.9780249595642092,17,0,649,478,632,478,rarity|twilight sparkle,seledka
2355706.jpg,https://derpicdn.net/img/view/2020/5/23/2355706.jpg,0,0.99729722738266,174,0,1662,1325,1488,1325,rainbow dash|twilight sparkle,liaaqila
2355706.jpg,https://derpicdn.net/img/view/2020/5/23/2355706.jpg,1,0.985581398010254,1708,252,2568,1112,860,860,rainbow dash|twilight sparkle,liaaqila
236.jpg,https://derpicdn.net/img/view/2012/1/15/236.jpg,0,0.9921857118606568,445,396,749,700,304,304,fluttershy|spike|twilight sparkle,lavosvsbahamut
23621.png,https://derpicdn.net/img/view/2012/6/28/23621.png,0,0.9571982622146606,753,12,1993,1252,1240,1240,rainbow dash|twilight sparkle,shakamu|paperlover
237886.jpg,https://derpicdn.net/img/view/2013/2/9/237886.jpg,0,0.997518002986908,241,46,423,228,182,182,fluttershy|pinkie pie|twilight sparkle,shepherd0821
237886.jpg,https://derpicdn.net/img/view/2013/2/9/237886.jpg,1,0.9850764870643616,12,52,190,230,178,178,fluttershy|pinkie pie|twilight sparkle,shepherd0821
240200.png,https://derpicdn.net/img/view/2013/2/11/240200.png,0,0.9990183711051941,89,734,405,1050,316,316,apple bloom|applejack|cutie mark crusaders|diamond tiara|discord|fluttershy|mane six|pinkie pie|princess cadance|princess celestia|princess luna|queen chrysalis|rainbow dash|rarity|scootaloo|shining armor|silver spoon|spike|sweetie belle|trixie|twilight sparkle,30clock
240200.png,https://derpicdn.net/img/view/2013/2/11/240200.png,1,0.9966229796409608,880,764,1262,1146,382,382,apple bloom|applejack|cutie mark crusaders|diamond tiara|discord|fluttershy|mane six|pinkie pie|princess cadance|princess celestia|princess luna|queen chrysalis|rainbow dash|rarity|scootaloo|shining armor|silver spoon|spike|sweetie belle|trixie|twilight sparkle,30clock
240200.png,https://derpicdn.net/img/view/2013/2/11/240200.png,2,0.9932161569595336,454,138,792,476,338,338,apple bloom|applejack|cutie mark crusaders|diamond tiara|discord|fluttershy|mane six|pinkie pie|princess cadance|princess celestia|princess luna|queen chrysalis|rainbow dash|rarity|scootaloo|shining armor|silver spoon|spike|sweetie belle|trixie|twilight sparkle,30clock
240200.png,https://derpicdn.net/img/view/2013/2/11/240200.png,3,0.9928743839263916,1011,392,1319,700,308,308,apple bloom|applejack|cutie mark crusaders|diamond tiara|discord|fluttershy|mane six|pinkie pie|princess cadance|princess celestia|princess luna|queen chrysalis|rainbow dash|rarity|scootaloo|shining armor|silver spoon|spike|sweetie belle|trixie|twilight sparkle,30clock
240200.png,https://derpicdn.net/img/view/2013/2/11/240200.png,4,0.9827856421470642,628,918,932,1222,304,304,apple bloom|applejack|cutie mark crusaders|diamond tiara|discord|fluttershy|mane six|pinkie pie|princess cadance|princess celestia|princess luna|queen chrysalis|rainbow dash|rarity|scootaloo|shining armor|silver spoon|spike|sweetie belle|trixie|twilight sparkle,30clock
240200.png,https://derpicdn.net/img/view/2013/2/11/240200.png,5,0.9600803256034852,60,1041,446,1427,386,386,apple bloom|applejack|cutie mark crusaders|diamond tiara|discord|fluttershy|mane six|pinkie pie|princess cadance|princess celestia|princess luna|queen chrysalis|rainbow dash|rarity|scootaloo|shining armor|silver spoon|spike|sweetie belle|trixie|twilight sparkle,30clock
240200.png,https://derpicdn.net/img/view/2013/2/11/240200.png,6,0.9029341340065002,484,423,848,787,364,364,apple bloom|applejack|cutie mark crusaders|diamond tiara|discord|fluttershy|mane six|pinkie pie|princess cadance|princess celestia|princess luna|queen chrysalis|rainbow dash|rarity|scootaloo|shining armor|silver spoon|spike|sweetie belle|trixie|twilight sparkle,30clock
242820.png,https://derpicdn.net/img/view/2013/2/14/242820.png,0,0.9994975328445436,1430,0,2416,941,986,941,princess celestia|twilight sparkle,bellacielo
242820.png,https://derpicdn.net/img/view/2013/2/14/242820.png,1,0.9990094900131226,697,606,1553,1462,856,856,princess celestia|twilight sparkle,bellacielo
247129.png,https://derpicdn.net/img/view/2013/2/17/247129.png,0,0.9990521073341372,716,163,1016,463,300,300,fluttershy|twilight sparkle,alasou
247129.png,https://derpicdn.net/img/view/2013/2/17/247129.png,1,0.9841116666793824,427,85,783,441,356,356,fluttershy|twilight sparkle,alasou
251299.png,https://derpicdn.net/img/view/2013/2/22/251299.png,0,0.9986979961395264,1630,103,2252,725,622,622,applejack|fluttershy|mane six|pinkie pie|princess celestia|rainbow dash|rarity|twilight sparkle,danfango
251456.png,https://derpicdn.net/img/view/2013/2/22/251456.png,0,0.997835636138916,247,339,483,575,236,236,princess celestia|twilight sparkle,caycowa
253613.png,https://derpicdn.net/img/view/2013/2/24/253613.png,0,0.9963150024414062,115,89,297,271,182,182,princess cadance|princess celestia|princess luna|twilight sparkle,probablyfakeblonde
253613.png,https://derpicdn.net/img/view/2013/2/24/253613.png,1,0.9464899301528932,366,81,484,199,118,118,princess cadance|princess celestia|princess luna|twilight sparkle,probablyfakeblonde
25382.png,https://derpicdn.net/img/view/2012/6/29/25382.png,0,0.9172044396400452,3758,402,6066,2710,2308,2308,applejack|fluttershy|mane six|pinkie pie|princess cadance|princess celestia|princess luna|rainbow dash|rarity|shining armor|spike|twilight sparkle,bronytoss
254253.png,https://derpicdn.net/img/view/2013/2/24/254253.png,0,0.9205169677734376,0,53,229,303,229,250,applejack|fluttershy|princess celestia|twilight sparkle,
257003.jpg,https://derpicdn.net/img/view/2013/2/27/257003.jpg,0,0.997646689414978,489,326,833,670,344,344,princess celestia|twilight sparkle,greyradian
257491.png,https://derpicdn.net/img/view/2013/2/27/257491.png,0,0.9951187968254088,1824,711,2516,1403,692,692,discord|fluttershy|pinkie pie|rainbow dash|twilight sparkle,tixolseyerk
257940.jpg,https://derpicdn.net/img/view/2013/2/28/257940.jpg,0,0.9884859919548036,74,0,292,214,218,214,applejack|fluttershy|rarity|twilight sparkle,pimmy
257940.jpg,https://derpicdn.net/img/view/2013/2/28/257940.jpg,1,0.9175642728805542,379,323,627,571,248,248,applejack|fluttershy|rarity|twilight sparkle,pimmy
260482.png,https://derpicdn.net/img/view/2013/3/2/260482.png,0,0.9119451642036438,1159,667,1573,1081,414,414,princess celestia|twilight sparkle,the-butch-x
260847.png,https://derpicdn.net/img/view/2013/3/3/260847.png,0,0.987899899482727,343,106,711,474,368,368,applejack|pinkie pie|twilight sparkle,shutterflye
261515.jpg,https://derpicdn.net/img/view/2013/3/3/261515.jpg,0,0.9985136985778807,67,264,225,422,158,158,applejack|fluttershy|mane six|pinkie pie|rainbow dash|rarity|twilight sparkle,shepherd0821
261515.jpg,https://derpicdn.net/img/view/2013/3/3/261515.jpg,1,0.9941613078117372,405,382,555,532,150,150,applejack|fluttershy|mane six|pinkie pie|rainbow dash|rarity|twilight sparkle,shepherd0821
261515.jpg,https://derpicdn.net/img/view/2013/3/3/261515.jpg,3,0.9697512984275818,566,356,698,502,132,146,applejack|fluttershy|mane six|pinkie pie|rainbow dash|rarity|twilight sparkle,shepherd0821
261515.jpg,https://derpicdn.net/img/view/2013/3/3/261515.jpg,4,0.9481847882270812,161,432,275,546,114,114,applejack|fluttershy|mane six|pinkie pie|rainbow dash|rarity|twilight sparkle,shepherd0821
264687.png,https://derpicdn.net/img/view/2013/3/7/264687.png,0,0.9983837604522704,726,39,1204,517,478,478,princess cadance|princess celestia|princess luna|twilight sparkle,bswprecious
264687.png,https://derpicdn.net/img/view/2013/3/7/264687.png,1,0.9763332605361938,1423,306,1884,772,461,466,princess cadance|princess celestia|princess luna|twilight sparkle,bswprecious
264687.png,https://derpicdn.net/img/view/2013/3/7/264687.png,2,0.9323500990867616,222,440,622,840,400,400,princess cadance|princess celestia|princess luna|twilight sparkle,bswprecious
267176.png,https://derpicdn.net/img/view/2013/3/10/267176.png,0,0.9993641972541808,451,395,675,619,224,224,applejack|fluttershy|pinkie pie|rainbow dash|rarity|twilight sparkle,sketchyjackie
267176.png,https://derpicdn.net/img/view/2013/3/10/267176.png,1,0.9644477367401124,780,430,1000,652,220,222,applejack|fluttershy|pinkie pie|rainbow dash|rarity|twilight sparkle,sketchyjackie
269927.png,https://derpicdn.net/img/view/2013/3/13/269927.png,0,0.9548060894012452,219,284,485,550,266,266,pinkie pie|twilight sparkle,ponygoggles
269927.png,https://derpicdn.net/img/view/2013/3/13/269927.png,1,0.9412071108818054,412,240,714,542,302,302,pinkie pie|twilight sparkle,ponygoggles
273.png,https://derpicdn.net/img/view/2012/1/15/273.png,0,0.9993235468864441,42,892,288,1138,246,246,apple bloom|applejack|big macintosh|cutie mark crusaders|fluttershy|mane six|pinkie pie|princess celestia|princess luna|rainbow dash|rarity|scootaloo|sweetie belle|trixie|twilight sparkle,ponymonster
273.png,https://derpicdn.net/img/view/2012/1/15/273.png,1,0.9978482723236084,53,606,321,874,268,268,apple bloom|applejack|big macintosh|cutie mark crusaders|fluttershy|mane six|pinkie pie|princess celestia|princess luna|rainbow dash|rarity|scootaloo|sweetie belle|trixie|twilight sparkle,ponymonster
273.png,https://derpicdn.net/img/view/2012/1/15/273.png,2,0.9768396019935608,51,282,309,540,258,258,apple bloom|applejack|big macintosh|cutie mark crusaders|fluttershy|mane six|pinkie pie|princess celestia|princess luna|rainbow dash|rarity|scootaloo|sweetie belle|trixie|twilight sparkle,ponymonster
273.png,https://derpicdn.net/img/view/2012/1/15/273.png,3,0.9753540158271792,124,40,328,244,204,204,apple bloom|applejack|big macintosh|cutie mark crusaders|fluttershy|mane six|pinkie pie|princess celestia|princess luna|rainbow dash|rarity|scootaloo|sweetie belle|trixie|twilight sparkle,ponymonster
27649.jpg,https://derpicdn.net/img/view/2012/7/1/27649.jpg,0,0.9951626062393188,504,378,772,646,268,268,trixie|twilight sparkle,lunarapologist
27649.jpg,https://derpicdn.net/img/view/2012/7/1/27649.jpg,2,0.95719313621521,285,373,561,649,276,276,trixie|twilight sparkle,lunarapologist
27649.jpg,https://derpicdn.net/img/view/2012/7/1/27649.jpg,3,0.9034827351570128,0,412,195,626,195,214,trixie|twilight sparkle,lunarapologist
27817.png,https://derpicdn.net/img/view/2012/7/1/27817.png,1,0.9642910361289978,14,736,314,1036,300,300,spike|twilight sparkle,castilen
279415.png,https://derpicdn.net/img/view/2013/3/25/279415.png,0,0.9970101118087769,254,979,484,1209,230,230,applejack|fluttershy|mane six|pinkie pie|princess cadance|queen chrysalis|rainbow dash|rarity|shining armor|twilight sparkle,stepandy
279415.png,https://derpicdn.net/img/view/2013/3/25/279415.png,1,0.9193921685218812,81,577,325,821,244,244,applejack|fluttershy|mane six|pinkie pie|princess cadance|queen chrysalis|rainbow dash|rarity|shining armor|twilight sparkle,stepandy
279415.png,https://derpicdn.net/img/view/2013/3/25/279415.png,2,0.9126764535903932,480,243,786,549,306,306,applejack|fluttershy|mane six|pinkie pie|princess cadance|queen chrysalis|rainbow dash|rarity|shining armor|twilight sparkle,stepandy
281323.png,https://derpicdn.net/img/view/2013/3/28/281323.png,0,0.981035590171814,408,0,930,455,522,455,applejack|fluttershy|mane six|pinkie pie|rainbow dash|rarity|twilight sparkle,totallynotabronyfim
281323.png,https://derpicdn.net/img/view/2013/3/28/281323.png,1,0.9079084396362304,972,1,1410,439,438,438,applejack|fluttershy|mane six|pinkie pie|rainbow dash|rarity|twilight sparkle,totallynotabronyfim
281535.png,https://derpicdn.net/img/view/2013/3/28/281535.png,0,0.951175332069397,0,1998,807,2882,807,884,applejack|discord|princess celestia|trixie|twilight sparkle,zutheskunk
282916.png,https://derpicdn.net/img/view/2013/3/30/282916.png,0,0.9986940026283264,692,121,848,277,156,156,big macintosh|princess cadance|princess celestia|princess luna|sweetie belle|twilight sparkle,furryfan87243
282916.png,https://derpicdn.net/img/view/2013/3/30/282916.png,1,0.9736438393592834,488,79,702,293,214,214,big macintosh|princess cadance|princess celestia|princess luna|sweetie belle|twilight sparkle,furryfan87243
282916.png,https://derpicdn.net/img/view/2013/3/30/282916.png,2,0.9710772633552552,852,171,1018,337,166,166,big macintosh|princess cadance|princess celestia|princess luna|sweetie belle|twilight sparkle,furryfan87243
284078.png,https://derpicdn.net/img/view/2013/3/31/284078.png,0,0.9983390569686892,1505,215,1920,715,415,500,applejack|fluttershy|mane six|pinkie pie|rainbow dash|rarity|twilight sparkle,naterrang
284078.png,https://derpicdn.net/img/view/2013/3/31/284078.png,1,0.984014928340912,610,215,1058,663,448,448,applejack|fluttershy|mane six|pinkie pie|rainbow dash|rarity|twilight sparkle,naterrang
284078.png,https://derpicdn.net/img/view/2013/3/31/284078.png,2,0.9432769417762756,344,410,796,862,452,452,applejack|fluttershy|mane six|pinkie pie|rainbow dash|rarity|twilight sparkle,naterrang
285271.jpg,https://derpicdn.net/img/view/2013/4/1/285271.jpg,0,0.9977042078971864,2402,0,2956,444,554,444,princess cadance|princess celestia|princess luna|queen chrysalis|twilight sparkle,moyamoya kuroi
285271.jpg,https://derpicdn.net/img/view/2013/4/1/285271.jpg,1,0.9965155720710754,1033,0,1657,521,624,521,princess cadance|princess celestia|princess luna|queen chrysalis|twilight sparkle,moyamoya kuroi
285271.jpg,https://derpicdn.net/img/view/2013/4/1/285271.jpg,2,0.9560518264770508,36,0,504,438,468,438,princess cadance|princess celestia|princess luna|queen chrysalis|twilight sparkle,moyamoya kuroi
285271.jpg,https://derpicdn.net/img/view/2013/4/1/285271.jpg,3,0.9119191765785216,7,740,1061,1794,1054,1054,princess cadance|princess celestia|princess luna|queen chrysalis|twilight sparkle,moyamoya kuroi
285898.png,https://derpicdn.net/img/view/2013/4/2/285898.png,0,0.9997097849845886,287,0,479,168,192,168,applejack|twilight sparkle,citolo
286507.png,https://derpicdn.net/img/view/2013/4/2/286507.png,0,0.9792805910110474,450,333,810,693,360,360,apple bloom|applejack|big macintosh|cutie mark crusaders|fluttershy|pinkie pie|rainbow dash|rarity|scootaloo|sweetie belle|twilight sparkle,alasou
289.jpg,https://derpicdn.net/img/view/2012/1/15/289.jpg,0,0.999450147151947,34,506,436,908,402,402,applejack|fluttershy|mane six|pinkie pie|rainbow dash|rarity|twilight sparkle,cobilly
289.jpg,https://derpicdn.net/img/view/2012/1/15/289.jpg,1,0.997270405292511,634,536,982,884,348,348,applejack|fluttershy|mane six|pinkie pie|rainbow dash|rarity|twilight sparkle,cobilly
289.jpg,https://derpicdn.net/img/view/2012/1/15/289.jpg,2,0.9858457446098328,1179,519,1611,951,432,432,applejack|fluttershy|mane six|pinkie pie|rainbow dash|rarity|twilight sparkle,cobilly
289.jpg,https://derpicdn.net/img/view/2012/1/15/289.jpg,3,0.9563202857971193,318,503,738,923,420,420,applejack|fluttershy|mane six|pinkie pie|rainbow dash|rarity|twilight sparkle,cobilly
289186.png,https://derpicdn.net/img/view/2013/4/5/289186.png,0,0.9986961483955384,2,0,810,674,808,674,princess cadance|shining armor|twilight sparkle,thunderhawk03
289927.png,https://derpicdn.net/img/view/2013/4/6/289927.png,0,0.999354898929596,177,47,355,225,178,178,applejack|fluttershy|mane six|pinkie pie|rainbow dash|rarity|spike|twilight sparkle,koko24
289927.png,https://derpicdn.net/img/view/2013/4/6/289927.png,1,0.9605258703231812,55,88,203,236,148,148,applejack|fluttershy|mane six|pinkie pie|rainbow dash|rarity|spike|twilight sparkle,koko24
290.jpg,https://derpicdn.net/img/view/2012/1/15/290.jpg,0,0.9474026560783386,2585,100,2973,488,388,388,applejack|fluttershy|mane six|pinkie pie|rainbow dash|rarity|twilight sparkle,madelezabeth
290699.png,https://derpicdn.net/img/view/2013/4/7/290699.png,1,0.9111849069595336,385,110,969,694,584,584,princess luna|twilight sparkle,foxxy-arts
290851.jpg,https://derpicdn.net/img/view/2013/4/7/290851.jpg,1,0.9727330803871156,146,27,402,283,256,256,applejack|fluttershy|mane six|pinkie pie|rainbow dash|rarity|trixie|twilight sparkle,ichibangravity
292534.png,https://derpicdn.net/img/view/2013/4/9/292534.png,0,0.9933611750602722,99,555,415,871,316,316,fluttershy|pinkie pie|twilight sparkle,tehbuttercookie
292534.png,https://derpicdn.net/img/view/2013/4/9/292534.png,1,0.9257864356040956,109,14,403,308,294,294,fluttershy|pinkie pie|twilight sparkle,tehbuttercookie
29296.jpg,https://derpicdn.net/img/view/2012/7/2/29296.jpg,0,0.9960640072822572,246,0,880,611,634,611,princess cadance|shining armor|twilight sparkle,dori-to
2931.jpg,https://derpicdn.net/img/view/2012/2/3/2931.jpg,0,0.9660224318504332,2317,167,2757,607,440,440,apple bloom|applejack|cutie mark crusaders|fluttershy|mane six|pinkie pie|princess celestia|princess luna|rainbow dash|rarity|scootaloo|sweetie belle|trixie|twilight sparkle,solar-slash
2931.jpg,https://derpicdn.net/img/view/2012/2/3/2931.jpg,1,0.9127974510192872,828,173,1210,555,382,382,apple bloom|applejack|cutie mark crusaders|fluttershy|mane six|pinkie pie|princess celestia|princess luna|rainbow dash|rarity|scootaloo|sweetie belle|trixie|twilight sparkle,solar-slash
29447.png,https://derpicdn.net/img/view/2012/7/3/29447.png,0,0.9938074946403505,33,414,329,710,296,296,applejack|fluttershy|mane six|pinkie pie|rainbow dash|rarity|twilight sparkle,loyaldis
29447.png,https://derpicdn.net/img/view/2012/7/3/29447.png,1,0.9357414841651917,744,254,1186,696,442,442,applejack|fluttershy|mane six|pinkie pie|rainbow dash|rarity|twilight sparkle,loyaldis
29447.png,https://derpicdn.net/img/view/2012/7/3/29447.png,2,0.9330867528915404,233,190,791,748,558,558,applejack|fluttershy|mane six|pinkie pie|rainbow dash|rarity|twilight sparkle,loyaldis
29447.png,https://derpicdn.net/img/view/2012/7/3/29447.png,3,0.9173787832260132,653,0,1131,421,478,421,applejack|fluttershy|mane six|pinkie pie|rainbow dash|rarity|twilight sparkle,loyaldis
295624.jpg,https://derpicdn.net/img/view/2013/4/12/295624.jpg,0,0.9769047498703004,44,150,478,584,434,434,rainbow dash|spike|twilight sparkle,makoruu
296219.png,https://derpicdn.net/img/view/2013/4/13/296219.png,1,0.9898927211761476,1340,644,1604,908,264,264,applejack|fluttershy|mane six|pinkie pie|rainbow dash|rarity|spike|twilight sparkle,alasou
297823.jpg,https://derpicdn.net/img/view/2013/4/14/297823.jpg,0,0.9983006715774536,73,0,489,397,416,397,princess cadance|shining armor|twilight sparkle,thunderhawk03
297823.jpg,https://derpicdn.net/img/view/2013/4/14/297823.jpg,1,0.953077495098114,469,0,960,484,491,484,princess cadance|shining armor|twilight sparkle,thunderhawk03
297880.png,https://derpicdn.net/img/view/2013/4/14/297880.png,0,0.9777590036392212,186,15,484,313,298,298,princess celestia|twilight sparkle,inuhoshi-to-darkpen
299636.png,https://derpicdn.net/img/view/2013/4/16/299636.png,2,0.9634804129600524,1931,2842,3205,4116,1274,1274,apple bloom|applejack|babs seed|big macintosh|cutie mark crusaders|fluttershy|mane six|pinkie pie|princess cadance|princess celestia|princess luna|rainbow dash|rarity|scootaloo|shining armor|soarin'|spike|spitfire|sweetie belle|twilight sparkle,template93
3033.jpg,https://derpicdn.net/img/view/2012/2/15/3033.jpg,0,0.9905003905296326,807,501,1175,869,368,368,princess celestia|twilight sparkle,raikoh
3033.jpg,https://derpicdn.net/img/view/2012/2/15/3033.jpg,1,0.9743987321853638,463,85,857,479,394,394,princess celestia|twilight sparkle,raikoh
306523.png,https://derpicdn.net/img/view/2013/4/23/306523.png,0,0.9557084441184998,798,181,1014,397,216,216,applejack|twilight sparkle,rishi-chan
310828.png,https://derpicdn.net/img/view/2013/4/28/310828.png,0,0.98856920003891,290,216,612,538,322,322,trixie|twilight sparkle,pixelkitties
310989.png,https://derpicdn.net/img/view/2013/4/29/310989.png,0,0.988695740699768,442,91,770,419,328,328,rarity|twilight sparkle,mewball
311401.jpg,https://derpicdn.net/img/view/2013/4/29/311401.jpg,0,0.9997501969337464,826,25,1158,357,332,332,applejack|fluttershy|mane six|pinkie pie|rainbow dash|rarity|twilight sparkle,zokkili
311401.jpg,https://derpicdn.net/img/view/2013/4/29/311401.jpg,1,0.9985249042510986,454,392,740,678,286,286,applejack|fluttershy|mane six|pinkie pie|rainbow dash|rarity|twilight sparkle,zokkili
311401.jpg,https://derpicdn.net/img/view/2013/4/29/311401.jpg,2,0.9927150011062622,961,435,1280,769,319,334,applejack|fluttershy|mane six|pinkie pie|rainbow dash|rarity|twilight sparkle,zokkili
311401.jpg,https://derpicdn.net/img/view/2013/4/29/311401.jpg,3,0.9819902777671814,236,0,534,293,298,293,applejack|fluttershy|mane six|pinkie pie|rainbow dash|rarity|twilight sparkle,zokkili
311401.jpg,https://derpicdn.net/img/view/2013/4/29/311401.jpg,4,0.9724406003952026,229,360,541,672,312,312,applejack|fluttershy|mane six|pinkie pie|rainbow dash|rarity|twilight sparkle,zokkili
311401.jpg,https://derpicdn.net/img/view/2013/4/29/311401.jpg,5,0.9719783663749696,647,383,947,683,300,300,applejack|fluttershy|mane six|pinkie pie|rainbow dash|rarity|twilight sparkle,zokkili
316152.png,https://derpicdn.net/img/view/2013/5/4/316152.png,0,0.9457152485847472,598,3,800,239,202,236,applejack|pinkie pie|rainbow dash|twilight sparkle,cybersp0nge
31665.jpg,https://derpicdn.net/img/view/2012/7/4/31665.jpg,0,0.9699051976203918,0,690,241,960,241,270,spike|twilight sparkle,qiisnii
31665.jpg,https://derpicdn.net/img/view/2012/7/4/31665.jpg,1,0.9477785229682922,300,0,608,307,308,307,spike|twilight sparkle,qiisnii
321004.jpg,https://derpicdn.net/img/view/2013/5/10/321004.jpg,0,0.998483419418335,464,352,768,656,304,304,applejack|fluttershy|mane six|pinkie pie|rainbow dash|rarity|twilight sparkle,zakro
321004.jpg,https://derpicdn.net/img/view/2013/5/10/321004.jpg,2,0.9875044822692872,112,397,382,667,270,270,applejack|fluttershy|mane six|pinkie pie|rainbow dash|rarity|twilight sparkle,zakro
321004.jpg,https://derpicdn.net/img/view/2013/5/10/321004.jpg,3,0.9604795575141908,895,0,1200,294,305,294,applejack|fluttershy|mane six|pinkie pie|rainbow dash|rarity|twilight sparkle,zakro
321004.jpg,https://derpicdn.net/img/view/2013/5/10/321004.jpg,4,0.9191128015518188,449,0,727,255,278,255,applejack|fluttershy|mane six|pinkie pie|rainbow dash|rarity|twilight sparkle,zakro
322144.png,https://derpicdn.net/img/view/2013/5/11/322144.png,0,0.9610393643379213,1209,2878,4055,5724,2846,2846,rainbow dash|twilight sparkle,ambris|doktorrf
32236.jpg,https://derpicdn.net/img/view/2012/7/5/32236.jpg,1,0.932068407535553,530,39,886,395,356,356,applejack|fluttershy|mane six|pinkie pie|princess celestia|princess luna|rainbow dash|rarity|twilight sparkle,ぺぷしそ|pepsiso
32236.jpg,https://derpicdn.net/img/view/2012/7/5/32236.jpg,2,0.9201179742813108,187,120,449,382,262,262,applejack|fluttershy|mane six|pinkie pie|princess celestia|princess luna|rainbow dash|rarity|twilight sparkle,ぺぷしそ|pepsiso
324035.png,https://derpicdn.net/img/view/2013/5/13/324035.png,0,0.9962218403816224,40,0,296,255,256,255,applejack|fluttershy|mane six|pinkie pie|princess celestia|princess luna|rainbow dash|rarity|twilight sparkle,vella
32729.jpg,https://derpicdn.net/img/view/2012/7/5/32729.jpg,0,0.9407647252082824,925,488,1259,822,334,334,apple bloom|applejack|cutie mark crusaders|fluttershy|mane six|pinkie pie|princess luna|rainbow dash|rarity|scootaloo|spike|sweetie belle|trixie|twilight sparkle,fadri
327755.png,https://derpicdn.net/img/view/2013/5/18/327755.png,1,0.9285181164741516,527,37,887,397,360,360,applejack|fluttershy|mane six|pinkie pie|princess celestia|princess luna|rainbow dash|rarity|twilight sparkle,pepsiso
328411.png,https://derpicdn.net/img/view/2013/5/19/328411.png,0,0.9880518913269044,1098,354,1758,1014,660,660,scootaloo|sweetie belle|trixie|twilight sparkle,alasou
328411.png,https://derpicdn.net/img/view/2013/5/19/328411.png,1,0.981313169002533,561,330,1237,1006,676,676,scootaloo|sweetie belle|trixie|twilight sparkle,alasou
330063.png,https://derpicdn.net/img/view/2013/5/21/330063.png,0,0.9528821706771852,282,120,612,450,330,330,princess cadance|princess celestia|princess luna|twilight sparkle,
330063.png,https://derpicdn.net/img/view/2013/5/21/330063.png,1,0.9100149869918824,378,1033,722,1377,344,344,princess cadance|princess celestia|princess luna|twilight sparkle,
3305.jpg,https://derpicdn.net/img/view/2012/2/20/3305.jpg,0,0.9876615405082704,158,310,558,710,400,400,applejack|fluttershy|mane six|pinkie pie|rainbow dash|rarity|twilight sparkle,glancojusticar
335996.png,https://derpicdn.net/img/view/2013/5/29/335996.png,1,0.9868555665016174,376,9,612,245,236,236,applejack|fluttershy|mane six|pinkie pie|rainbow dash|rarity|twilight sparkle,probablyfakeblonde
335996.png,https://derpicdn.net/img/view/2013/5/29/335996.png,2,0.9516794681549072,48,453,236,641,188,188,applejack|fluttershy|mane six|pinkie pie|rainbow dash|rarity|twilight sparkle,probablyfakeblonde
336339.png,https://derpicdn.net/img/view/2013/5/29/336339.png,0,0.9779531955718994,205,51,549,395,344,344,applejack|fluttershy|mane six|pinkie pie|rainbow dash|rarity|twilight sparkle,terrac0tta
336761.png,https://derpicdn.net/img/view/2013/5/30/336761.png,0,0.9973751306533812,392,19,614,241,222,222,trixie|twilight sparkle,brianblackberry
337529.jpg,https://derpicdn.net/img/view/2013/5/31/337529.jpg,0,0.9369789361953736,1534,256,7974,6696,6440,6440,apple bloom|applejack|big macintosh|braeburn|cutie mark crusaders|fluttershy|mane six|pinkie pie|princess celestia|princess luna|rainbow dash|rarity|scootaloo|silver spoon|spike|sweetie belle|trixie|twilight sparkle,lacon-te|166|megasweet
337529.jpg,https://derpicdn.net/img/view/2013/5/31/337529.jpg,1,0.9330148696899414,0,0,6226,6764,6226,6764,apple bloom|applejack|big macintosh|braeburn|cutie mark crusaders|fluttershy|mane six|pinkie pie|princess celestia|princess luna|rainbow dash|rarity|scootaloo|silver spoon|spike|sweetie belle|trixie|twilight sparkle,lacon-te|166|megasweet
337743.png,https://derpicdn.net/img/view/2013/5/31/337743.png,0,0.9737976789474488,158,0,714,479,556,479,fluttershy|twilight sparkle,dm29
337743.png,https://derpicdn.net/img/view/2013/5/31/337743.png,1,0.9736032485961914,645,0,1203,483,558,483,fluttershy|twilight sparkle,dm29
339978.png,https://derpicdn.net/img/view/2013/6/3/339978.png,0,0.9863048791885376,305,0,823,491,518,491,spike|twilight sparkle,boomythemc
341893.png,https://derpicdn.net/img/view/2013/6/6/341893.png,0,0.9984766840934752,178,316,552,690,374,374,princess cadance|twilight sparkle,derpsonhooves
342064.png,https://derpicdn.net/img/view/2013/6/7/342064.png,0,0.9446169137954712,865,664,1691,1490,826,826,queen chrysalis|twilight sparkle,blackswhites
3422.jpg,https://derpicdn.net/img/view/2012/2/23/3422.jpg,0,0.9592384099960328,4936,1585,7644,4293,2708,2708,applejack|fluttershy|mane six|pinkie pie|rainbow dash|rarity|spike|twilight sparkle,tygerbug
3422.jpg,https://derpicdn.net/img/view/2012/2/23/3422.jpg,1,0.9488965272903442,2533,2298,4109,3874,1576,1576,applejack|fluttershy|mane six|pinkie pie|rainbow dash|rarity|spike|twilight sparkle,tygerbug
3422.jpg,https://derpicdn.net/img/view/2012/2/23/3422.jpg,2,0.9272403120994568,6692,352,8058,1718,1366,1366,applejack|fluttershy|mane six|pinkie pie|rainbow dash|rarity|spike|twilight sparkle,tygerbug
3422.jpg,https://derpicdn.net/img/view/2012/2/23/3422.jpg,3,0.9270079731941224,987,0,2819,1832,1832,1832,applejack|fluttershy|mane six|pinkie pie|rainbow dash|rarity|spike|twilight sparkle,tygerbug
342292.jpg,https://derpicdn.net/img/view/2013/6/7/342292.jpg,0,0.9562153220176696,295,786,807,1298,512,512,trixie|twilight sparkle,earthenpony
343794.png,https://derpicdn.net/img/view/2013/6/9/343794.png,1,0.9259838461875916,1811,399,2311,899,500,500,applejack|pinkie pie|princess celestia|princess luna|rainbow dash|rarity|twilight sparkle,gonedreamer
346064.jpg,https://derpicdn.net/img/view/2013/6/11/346064.jpg,0,0.9633399844169616,197,13,531,347,334,334,princess celestia|twilight sparkle,moyamoya kuroi
347043.png,https://derpicdn.net/img/view/2013/6/12/347043.png,1,0.911749541759491,325,276,467,418,142,142,applejack|fluttershy|mane six|pinkie pie|rainbow dash|rarity|twilight sparkle,kevinsano
349026.png,https://derpicdn.net/img/view/2013/6/15/349026.png,0,0.9351916909217834,163,77,669,583,506,506,sunset shimmer|twilight sparkle,hoyeechun
349865.png,https://derpicdn.net/img/view/2013/6/16/349865.png,0,0.9960281252861024,800,0,1430,519,630,519,applejack|fluttershy|mane six|pinkie pie|rainbow dash|rarity|twilight sparkle,flutterthrash
352356.png,https://derpicdn.net/img/view/2013/6/19/352356.png,0,0.9457316994667052,144,598,372,826,228,228,applejack|discord|fluttershy|pinkie pie|queen chrysalis|rainbow dash|rarity|trixie|twilight sparkle,aylastardragon
352489.png,https://derpicdn.net/img/view/2013/6/19/352489.png,0,0.9101855158805848,550,56,876,382,326,326,applejack|fluttershy|mane six|pinkie pie|rainbow dash|rarity|twilight sparkle,king-kakapo
358415.png,https://derpicdn.net/img/view/2013/6/27/358415.png,0,0.9664385914802552,3809,754,5023,1968,1214,1214,applejack|fluttershy|mane six|pinkie pie|rainbow dash|rarity|twilight sparkle,tabby444
358415.png,https://derpicdn.net/img/view/2013/6/27/358415.png,2,0.9347773790359496,5518,0,7182,1564,1664,1564,applejack|fluttershy|mane six|pinkie pie|rainbow dash|rarity|twilight sparkle,tabby444
359842.png,https://derpicdn.net/img/view/2013/6/29/359842.png,0,0.9615702033042908,393,128,751,486,358,358,rainbow dash|twilight sparkle,sarath-15
362374.png,https://derpicdn.net/img/view/2013/7/2/362374.png,0,0.9179155230522156,1060,264,1320,524,260,260,fluttershy|twilight sparkle,si1vr
363268.jpg,https://derpicdn.net/img/view/2013/7/3/363268.jpg,0,0.9306778311729432,546,958,896,1308,350,350,applejack|fluttershy|mane six|pinkie pie|rainbow dash|rarity|twilight sparkle,rockcandy01
365264.png,https://derpicdn.net/img/view/2013/7/5/365264.png,0,0.9378628134727478,682,299,1248,865,566,566,spike|twilight sparkle,bakameganekko
366677.png,https://derpicdn.net/img/view/2013/7/7/366677.png,0,0.9714176058769226,112,1540,1938,3366,1826,1826,spike|twilight sparkle,joey darkmeat|tim015
367028.png,https://derpicdn.net/img/view/2013/7/7/367028.png,0,0.9834389090538024,441,573,909,1041,468,468,applejack|fluttershy|mane six|pinkie pie|rainbow dash|rarity|twilight sparkle,tentacuddles
367028.png,https://derpicdn.net/img/view/2013/7/7/367028.png,2,0.9181641340255736,548,116,794,362,246,246,applejack|fluttershy|mane six|pinkie pie|rainbow dash|rarity|twilight sparkle,tentacuddles
367350.png,https://derpicdn.net/img/view/2013/7/8/367350.png,0,0.9998515844345092,688,0,966,261,278,261,applejack|fluttershy|pinkie pie|rarity|spike|twilight sparkle,lizardbeth
367350.png,https://derpicdn.net/img/view/2013/7/8/367350.png,1,0.9911855459213256,53,0,285,227,232,227,applejack|fluttershy|pinkie pie|rarity|spike|twilight sparkle,lizardbeth
367350.png,https://derpicdn.net/img/view/2013/7/8/367350.png,3,0.9820905327796936,343,0,609,263,266,263,applejack|fluttershy|pinkie pie|rarity|spike|twilight sparkle,lizardbeth
3698.png,https://derpicdn.net/img/view/2012/3/3/3698.png,1,0.9686627984046936,232,0,504,270,272,270,trixie|twilight sparkle,joey darkmeat
369931.png,https://derpicdn.net/img/view/2013/7/11/369931.png,0,0.9964343905448914,459,163,907,611,448,448,pinkie pie|scootaloo|twilight sparkle,pijinpyon
369931.png,https://derpicdn.net/img/view/2013/7/11/369931.png,1,0.970432460308075,808,293,1202,687,394,394,pinkie pie|scootaloo|twilight sparkle,pijinpyon
37020.png,https://derpicdn.net/img/view/2012/7/8/37020.png,0,0.9540600776672364,628,289,1010,671,382,382,applejack|big macintosh|fluttershy|pinkie pie|rainbow dash|rarity|twilight sparkle,cartoonlion
371814.png,https://derpicdn.net/img/view/2013/7/12/371814.png,0,0.9916393160820008,57,299,307,549,250,250,applejack|fluttershy|mane six|pinkie pie|rainbow dash|rarity|spike|twilight sparkle,xioade
373908.jpg,https://derpicdn.net/img/view/2013/7/14/373908.jpg,0,0.9323062896728516,140,280,530,670,390,390,spike|twilight sparkle,joey darkmeat|longren
373938.png,https://derpicdn.net/img/view/2013/7/14/373938.png,0,0.996220588684082,1448,776,2148,1476,700,700,sunset shimmer|twilight sparkle,danmakuman
373938.png,https://derpicdn.net/img/view/2013/7/14/373938.png,1,0.9255173206329346,444,175,1142,873,698,698,sunset shimmer|twilight sparkle,danmakuman
379167.png,https://derpicdn.net/img/view/2013/7/20/379167.png,0,0.9943987131118774,224,0,966,636,742,636,rarity|twilight sparkle,rustydooks|miles
380564.png,https://derpicdn.net/img/view/2013/7/21/380564.png,0,0.9278929233551024,885,38,1809,962,924,924,fluttershy|twilight sparkle,locksto
3812.png,https://derpicdn.net/img/view/2012/3/21/3812.png,0,0.9983077049255372,590,66,972,448,382,382,rainbow dash|twilight sparkle,grumblepluck
3812.png,https://derpicdn.net/img/view/2012/3/21/3812.png,1,0.9975816011428832,936,221,1516,801,580,580,rainbow dash|twilight sparkle,grumblepluck
3813.png,https://derpicdn.net/img/view/2012/3/21/3813.png,0,0.9723212718963624,92,150,542,600,450,450,applejack|fluttershy|mane six|pinkie pie|rainbow dash|rarity|twilight sparkle,grumblepluck
3814.png,https://derpicdn.net/img/view/2012/3/21/3814.png,1,0.9882671236991882,1160,141,2168,1149,1008,1008,rainbow dash|twilight sparkle,grumblepluck
384581.png,https://derpicdn.net/img/view/2013/7/29/384581.png,0,0.9942686557769777,123,408,435,720,312,312,applejack|fluttershy|pinkie pie|rainbow dash|rarity|twilight sparkle,dm29
38464.png,https://derpicdn.net/img/view/2012/7/9/38464.png,0,0.9973234534263612,720,18,1000,304,280,286,applejack|fluttershy|mane six|pinkie pie|rainbow dash|rarity|twilight sparkle,stardustxiii
38464.png,https://derpicdn.net/img/view/2012/7/9/38464.png,1,0.936720609664917,142,453,362,673,220,220,applejack|fluttershy|mane six|pinkie pie|rainbow dash|rarity|twilight sparkle,stardustxiii
38464.png,https://derpicdn.net/img/view/2012/7/9/38464.png,2,0.908381462097168,161,94,367,300,206,206,applejack|fluttershy|mane six|pinkie pie|rainbow dash|rarity|twilight sparkle,stardustxiii
384655.png,https://derpicdn.net/img/view/2013/7/29/384655.png,0,0.998879849910736,1200,450,1680,930,480,480,apple bloom|applejack|cutie mark crusaders|fluttershy|mane six|pinkie pie|rainbow dash|rarity|scootaloo|spike|sweetie belle|twilight sparkle,viraljp
384655.png,https://derpicdn.net/img/view/2013/7/29/384655.png,1,0.9795348048210144,463,270,863,670,400,400,apple bloom|applejack|cutie mark crusaders|fluttershy|mane six|pinkie pie|rainbow dash|rarity|scootaloo|spike|sweetie belle|twilight sparkle,viraljp
384696.png,https://derpicdn.net/img/view/2013/7/29/384696.png,0,0.951060712337494,239,9,687,457,448,448,princess luna|twilight sparkle,average-hanzo
38501.png,https://derpicdn.net/img/view/2012/7/9/38501.png,0,0.9249139428138732,1088,243,1436,591,348,348,fluttershy|pinkie pie|rainbow dash|rarity|twilight sparkle,chimicherrychonga
385732.jpg,https://derpicdn.net/img/view/2013/7/30/385732.jpg,0,0.9801364541053772,111,161,397,447,286,286,rainbow dash|scootaloo|spitfire|twilight sparkle,pluckyninja
387413.png,https://derpicdn.net/img/view/2013/7/31/387413.png,0,0.9710827469825744,182,329,500,647,318,318,spike|twilight sparkle,joey darkmeat|shawnyall
387413.png,https://derpicdn.net/img/view/2013/7/31/387413.png,1,0.95585960149765,646,52,1024,430,378,378,spike|twilight sparkle,joey darkmeat|shawnyall
387504.png,https://derpicdn.net/img/view/2013/7/31/387504.png,1,0.9601238965988159,1489,602,1909,1022,420,420,princess cadance|shining armor|spike|twilight sparkle,vector-brony
392784.png,https://derpicdn.net/img/view/2013/8/6/392784.png,0,0.9956894516944884,813,387,1500,1225,687,838,sunset shimmer|trixie|twilight sparkle,xonitum
392784.png,https://derpicdn.net/img/view/2013/8/6/392784.png,1,0.986674427986145,639,783,949,1093,310,310,sunset shimmer|trixie|twilight sparkle,xonitum
392784.png,https://derpicdn.net/img/view/2013/8/6/392784.png,2,0.9852339029312134,344,264,722,642,378,378,sunset shimmer|trixie|twilight sparkle,xonitum
394529.png,https://derpicdn.net/img/view/2013/8/8/394529.png,0,0.9967396855354308,340,238,736,634,396,396,sunset shimmer|trixie|twilight sparkle,xonitum
394529.png,https://derpicdn.net/img/view/2013/8/8/394529.png,1,0.9966044425964355,816,383,1500,1219,684,836,sunset shimmer|trixie|twilight sparkle,xonitum
394767.jpg,https://derpicdn.net/img/view/2013/8/8/394767.jpg,0,0.9350686073303224,394,295,728,629,334,334,princess celestia|twilight sparkle,newyorkx3
396451.jpg,https://derpicdn.net/img/view/2013/8/10/396451.jpg,1,0.9813427329063416,375,3,565,193,190,190,apple bloom|applejack|cutie mark crusaders|diamond tiara|fluttershy|mane six|pinkie pie|rainbow dash|rarity|scootaloo|silver spoon|spike|sweetie belle|twilight sparkle,katiramoon
396579.png,https://derpicdn.net/img/view/2013/8/10/396579.png,0,0.9968031644821168,303,70,755,522,452,452,rarity|twilight sparkle,rwl
39863.jpg,https://derpicdn.net/img/view/2012/7/10/39863.jpg,0,0.9890295267105104,991,739,1473,1221,482,482,applejack|fluttershy|mane six|pinkie pie|rainbow dash|rarity|twilight sparkle,solar-slash
39863.jpg,https://derpicdn.net/img/view/2012/7/10/39863.jpg,1,0.9830414056777954,1248,459,1774,985,526,526,applejack|fluttershy|mane six|pinkie pie|rainbow dash|rarity|twilight sparkle,solar-slash
399585.jpg,https://derpicdn.net/img/view/2013/8/13/399585.jpg,0,0.9861732721328736,1055,100,1683,728,628,628,princess cadance|princess celestia|princess luna|twilight sparkle,wolfjedisamuel
401469.png,https://derpicdn.net/img/view/2013/8/16/401469.png,0,0.9732423424720764,1282,19,1732,469,450,450,applejack|fluttershy|mane six|pinkie pie|princess celestia|princess luna|rainbow dash|rarity|twilight sparkle,pixel-prism
402339.png,https://derpicdn.net/img/view/2013/8/17/402339.png,0,0.9995432496070862,0,0,294,275,294,275,applejack|fluttershy|mane six|pinkie pie|rainbow dash|rarity|twilight sparkle,toodles3702
402339.png,https://derpicdn.net/img/view/2013/8/17/402339.png,1,0.99911767244339,340,308,700,668,360,360,applejack|fluttershy|mane six|pinkie pie|rainbow dash|rarity|twilight sparkle,toodles3702
402339.png,https://derpicdn.net/img/view/2013/8/17/402339.png,2,0.997569501399994,359,2,599,242,240,240,applejack|fluttershy|mane six|pinkie pie|rainbow dash|rarity|twilight sparkle,toodles3702
402339.png,https://derpicdn.net/img/view/2013/8/17/402339.png,4,0.9874268174171448,770,18,1024,280,254,262,applejack|fluttershy|mane six|pinkie pie|rainbow dash|rarity|twilight sparkle,toodles3702
406295.png,https://derpicdn.net/img/view/2013/8/21/406295.png,0,0.96780663728714,0,0,450,450,450,450,applejack|fluttershy|mane six|pinkie pie|rainbow dash|rarity|twilight sparkle,red-poni
409868.png,https://derpicdn.net/img/view/2013/8/25/409868.png,0,0.9452759027481079,161,101,427,367,266,266,sunset shimmer|twilight sparkle,placeholder
410525.png,https://derpicdn.net/img/view/2013/8/25/410525.png,0,0.983720600605011,900,0,1494,586,594,586,rainbow dash|twilight sparkle,average-hanzo
411499.png,https://derpicdn.net/img/view/2013/8/26/411499.png,0,0.994069516658783,823,68,1231,476,408,408,rarity|twilight sparkle,geomancing
412931.jpg,https://derpicdn.net/img/view/2013/8/28/412931.jpg,1,0.933786153793335,1979,171,2319,511,340,340,applejack|fluttershy|mane six|pinkie pie|rainbow dash|rarity|spike|twilight sparkle,mirapony
413423.png,https://derpicdn.net/img/view/2013/8/29/413423.png,0,0.9973198771476746,836,784,1056,1004,220,220,applejack|fluttershy|mane six|pinkie pie|rainbow dash|rarity|twilight sparkle,dm29
413423.png,https://derpicdn.net/img/view/2013/8/29/413423.png,1,0.9905542135238647,159,755,435,1031,276,276,applejack|fluttershy|mane six|pinkie pie|rainbow dash|rarity|twilight sparkle,dm29
413423.png,https://derpicdn.net/img/view/2013/8/29/413423.png,2,0.9769710302352904,623,120,861,358,238,238,applejack|fluttershy|mane six|pinkie pie|rainbow dash|rarity|twilight sparkle,dm29
413423.png,https://derpicdn.net/img/view/2013/8/29/413423.png,3,0.9022646546363832,633,616,857,840,224,224,applejack|fluttershy|mane six|pinkie pie|rainbow dash|rarity|twilight sparkle,dm29
413946.jpg,https://derpicdn.net/img/view/2013/8/29/413946.jpg,0,0.998483180999756,543,22,831,310,288,288,apple bloom|applejack|cutie mark crusaders|fluttershy|mane six|pinkie pie|rainbow dash|rarity|scootaloo|spike|sweetie belle|trixie|twilight sparkle,moriguru
413946.jpg,https://derpicdn.net/img/view/2013/8/29/413946.jpg,1,0.9978838562965392,526,539,768,781,242,242,apple bloom|applejack|cutie mark crusaders|fluttershy|mane six|pinkie pie|rainbow dash|rarity|scootaloo|spike|sweetie belle|trixie|twilight sparkle,moriguru
413946.jpg,https://derpicdn.net/img/view/2013/8/29/413946.jpg,3,0.994905948638916,174,57,446,329,272,272,apple bloom|applejack|cutie mark crusaders|fluttershy|mane six|pinkie pie|rainbow dash|rarity|scootaloo|spike|sweetie belle|trixie|twilight sparkle,moriguru
413946.jpg,https://derpicdn.net/img/view/2013/8/29/413946.jpg,4,0.9932156205177308,400,258,666,524,266,266,apple bloom|applejack|cutie mark crusaders|fluttershy|mane six|pinkie pie|rainbow dash|rarity|scootaloo|spike|sweetie belle|trixie|twilight sparkle,moriguru
414805.png,https://derpicdn.net/img/view/2013/8/30/414805.png,0,0.9961237907409668,95,221,573,699,478,478,rainbow dash|twilight sparkle,ambris
414805.png,https://derpicdn.net/img/view/2013/8/30/414805.png,1,0.9570914506912231,588,244,1148,804,560,560,rainbow dash|twilight sparkle,ambris
41663.jpg,https://derpicdn.net/img/view/2012/7/12/41663.jpg,0,0.9975659251213074,888,0,1564,618,676,618,princess luna|twilight sparkle,astralmelodia
41663.jpg,https://derpicdn.net/img/view/2012/7/12/41663.jpg,1,0.9455106854438782,555,49,987,481,432,432,princess luna|twilight sparkle,astralmelodia
418828.png,https://derpicdn.net/img/view/2013/9/4/418828.png,0,0.9743943214416504,2539,0,5787,3002,3248,3002,sunset shimmer|twilight sparkle,austiniousi
420810.png,https://derpicdn.net/img/view/2013/9/6/420810.png,0,0.9909554719924928,207,0,537,322,330,322,sweetie belle|twilight sparkle,inuhoshi-to-darkpen
420810.png,https://derpicdn.net/img/view/2013/9/6/420810.png,1,0.9794586896896362,171,277,419,525,248,248,sweetie belle|twilight sparkle,inuhoshi-to-darkpen
422975.png,https://derpicdn.net/img/view/2013/9/8/422975.png,0,0.9744051694869996,351,0,959,548,608,548,rainbow dash|twilight sparkle,xioade
425740.png,https://derpicdn.net/img/view/2013/9/12/425740.png,0,0.9773353934288024,95,320,271,496,176,176,princess cadance|twilight sparkle,
427383.jpg,https://derpicdn.net/img/view/2013/9/14/427383.jpg,0,0.9934551119804382,834,462,1592,1220,758,758,applejack|rainbow dash|spike|twilight sparkle,graystripe64
427383.jpg,https://derpicdn.net/img/view/2013/9/14/427383.jpg,1,0.9916388988494872,1523,0,2317,719,794,719,applejack|rainbow dash|spike|twilight sparkle,graystripe64
427383.jpg,https://derpicdn.net/img/view/2013/9/14/427383.jpg,2,0.9667131304740906,2063,819,2671,1427,608,608,applejack|rainbow dash|spike|twilight sparkle,graystripe64
427784.png,https://derpicdn.net/img/view/2013/9/15/427784.png,0,0.9956883788108826,584,152,804,372,220,220,applejack|fluttershy|mane six|pinkie pie|rainbow dash|rarity|twilight sparkle,hakunohamikage
427784.png,https://derpicdn.net/img/view/2013/9/15/427784.png,1,0.9940674304962158,291,340,479,528,188,188,applejack|fluttershy|mane six|pinkie pie|rainbow dash|rarity|twilight sparkle,hakunohamikage
427784.png,https://derpicdn.net/img/view/2013/9/15/427784.png,2,0.969823956489563,19,322,341,644,322,322,applejack|fluttershy|mane six|pinkie pie|rainbow dash|rarity|twilight sparkle,hakunohamikage
43009.png,https://derpicdn.net/img/view/2012/7/13/43009.png,0,0.9868671894073486,767,164,1149,546,382,382,rarity|twilight sparkle,7nights
433144.png,https://derpicdn.net/img/view/2013/9/22/433144.png,0,0.9458532333374025,2056,769,2786,1499,730,730,applejack|fluttershy|pinkie pie|rainbow dash|rarity|twilight sparkle,template93
436649.png,https://derpicdn.net/img/view/2013/9/28/436649.png,0,0.9982041120529176,902,183,1190,471,288,288,rainbow dash|scootaloo|spike|twilight sparkle,ctb-36
436649.png,https://derpicdn.net/img/view/2013/9/28/436649.png,1,0.9251437783241272,147,88,521,462,374,374,rainbow dash|scootaloo|spike|twilight sparkle,ctb-36
437444.jpg,https://derpicdn.net/img/view/2013/9/29/437444.jpg,0,0.9854397773742676,325,108,593,376,268,268,rainbow dash|twilight sparkle,shad3r
437650.png,https://derpicdn.net/img/view/2013/9/29/437650.png,0,0.9968732595443726,1988,1349,2500,1903,512,554,applejack|fluttershy|pinkie pie|twilight sparkle,facerenon
4389.jpg,https://derpicdn.net/img/view/2012/6/6/4389.jpg,0,0.9536974430084229,1666,525,2758,1617,1092,1092,princess celestia|princess luna|twilight sparkle,holivi
43918.png,https://derpicdn.net/img/view/2012/7/14/43918.png,0,0.9898827075958252,375,219,661,505,286,286,applejack|fluttershy|pinkie pie|rainbow dash|rarity|spike|twilight sparkle,cartoonlion
439235.png,https://derpicdn.net/img/view/2013/10/1/439235.png,0,0.9984325766563416,2192,1306,3684,2798,1492,1492,trixie|twilight sparkle,matimus91
439235.png,https://derpicdn.net/img/view/2013/10/1/439235.png,1,0.9489875435829164,849,1246,2275,2672,1426,1426,trixie|twilight sparkle,matimus91
43924.png,https://derpicdn.net/img/view/2012/7/14/43924.png,0,0.9906110167503356,669,0,1263,540,594,540,fluttershy|pinkie pie|rainbow dash|twilight sparkle,cartoonlion
439506.jpg,https://derpicdn.net/img/view/2013/10/1/439506.jpg,0,0.9648278951644896,387,573,763,949,376,376,applejack|fluttershy|mane six|pinkie pie|princess celestia|princess luna|queen chrysalis|rainbow dash|rarity|trixie|twilight sparkle,rikose
439506.jpg,https://derpicdn.net/img/view/2013/10/1/439506.jpg,1,0.9182006716728208,470,74,978,582,508,508,applejack|fluttershy|mane six|pinkie pie|princess celestia|princess luna|queen chrysalis|rainbow dash|rarity|trixie|twilight sparkle,rikose
439506.jpg,https://derpicdn.net/img/view/2013/10/1/439506.jpg,3,0.9147129058837892,91,494,441,844,350,350,applejack|fluttershy|mane six|pinkie pie|princess celestia|princess luna|queen chrysalis|rainbow dash|rarity|trixie|twilight sparkle,rikose
439870.png,https://derpicdn.net/img/view/2013/10/2/439870.png,0,0.9728374481201172,102,5,628,531,526,526,rainbow dash|twilight sparkle,drdicksamazingstick
439870.png,https://derpicdn.net/img/view/2013/10/2/439870.png,1,0.917286217212677,608,0,1742,844,1134,844,rainbow dash|twilight sparkle,drdicksamazingstick
441259.png,https://derpicdn.net/img/view/2013/10/4/441259.png,0,0.9456529021263124,159,0,3985,2700,3826,2700,princess cadance|twilight sparkle,beavernator
441708.png,https://derpicdn.net/img/view/2013/10/4/441708.png,1,0.9843424558639526,798,20,1222,444,424,424,trixie|twilight sparkle,pettankoprincess
442527.png,https://derpicdn.net/img/view/2013/10/6/442527.png,0,0.9963439702987672,1,292,163,454,162,162,applejack|fluttershy|mane six|pinkie pie|rainbow dash|rarity|twilight sparkle,g-blue16
442527.png,https://derpicdn.net/img/view/2013/10/6/442527.png,1,0.9338338971138,514,44,754,284,240,240,applejack|fluttershy|mane six|pinkie pie|rainbow dash|rarity|twilight sparkle,g-blue16
443765.jpg,https://derpicdn.net/img/view/2013/10/7/443765.jpg,0,0.9860279560089112,160,140,1188,1168,1028,1028,spike|twilight sparkle,holivi
44391.png,https://derpicdn.net/img/view/2012/7/14/44391.png,0,0.950364351272583,283,449,571,737,288,288,applejack|big macintosh|fluttershy|pinkie pie|spike|twilight sparkle,gign-3208
44391.png,https://derpicdn.net/img/view/2012/7/14/44391.png,1,0.9377897381782532,1275,366,1723,814,448,448,applejack|big macintosh|fluttershy|pinkie pie|spike|twilight sparkle,gign-3208
445628.png,https://derpicdn.net/img/view/2013/10/10/445628.png,0,0.9978973269462584,701,0,971,220,270,220,applejack|fluttershy|lightning dust|mane six|pinkie pie|rainbow dash|rarity|sunset shimmer|trixie|twilight sparkle,schnuffitrunks
446092.png,https://derpicdn.net/img/view/2013/10/11/446092.png,0,0.9146534204483032,793,86,1017,320,224,234,trixie|twilight sparkle,amy mebberson
44665.jpg,https://derpicdn.net/img/view/2012/7/15/44665.jpg,0,0.9368637204170228,124,163,370,409,246,246,princess celestia|twilight sparkle,madmax
446863.png,https://derpicdn.net/img/view/2013/10/12/446863.png,5,0.9502452611923218,11,0,235,216,224,216,applejack|discord|fluttershy|mane six|pinkie pie|princess celestia|rainbow dash|rarity|twilight sparkle,shepherd0821
447799.png,https://derpicdn.net/img/view/2013/10/13/447799.png,0,0.990699589252472,1140,742,1434,1036,294,294,applejack|fluttershy|mane six|pinkie pie|rainbow dash|rarity|twilight sparkle,cigarscigarettes
447799.png,https://derpicdn.net/img/view/2013/10/13/447799.png,1,0.9815390706062316,1838,706,2132,1000,294,294,applejack|fluttershy|mane six|pinkie pie|rainbow dash|rarity|twilight sparkle,cigarscigarettes
448366.png,https://derpicdn.net/img/view/2013/10/14/448366.png,0,0.9857485890388488,940,66,1562,688,622,622,rainbow dash|rarity|spike|twilight sparkle,niggerfaggot
449817.jpg,https://derpicdn.net/img/view/2013/10/16/449817.jpg,0,0.9813033938407898,0,479,245,735,245,256,applejack|fluttershy|pinkie pie|rainbow dash|rarity|spike|twilight sparkle,tsitra360|demoncat8
449817.jpg,https://derpicdn.net/img/view/2013/10/16/449817.jpg,2,0.9745641350746156,867,478,1035,646,168,168,applejack|fluttershy|pinkie pie|rainbow dash|rarity|spike|twilight sparkle,tsitra360|demoncat8
4538.jpg,https://derpicdn.net/img/view/2012/6/14/4538.jpg,0,0.9941511750221252,643,43,1023,423,380,380,fluttershy|twilight sparkle,moyamoya kuroi
4538.jpg,https://derpicdn.net/img/view/2012/6/14/4538.jpg,1,0.9807766079902648,362,7,682,327,320,320,fluttershy|twilight sparkle,moyamoya kuroi
454922.png,https://derpicdn.net/img/view/2013/10/23/454922.png,0,0.9225187301635742,1331,37,1513,219,182,182,applejack|fluttershy|mane six|pinkie pie|rainbow dash|rarity|twilight sparkle,g-blue16
454922.png,https://derpicdn.net/img/view/2013/10/23/454922.png,1,0.913562834262848,1318,340,1610,632,292,292,applejack|fluttershy|mane six|pinkie pie|rainbow dash|rarity|twilight sparkle,g-blue16
458263.png,https://derpicdn.net/img/view/2013/10/28/458263.png,0,0.9993772506713868,2412,1399,3152,2139,740,740,applejack|fluttershy|mane six|pinkie pie|rainbow dash|rarity|twilight sparkle,gashiboka
458263.png,https://derpicdn.net/img/view/2013/10/28/458263.png,1,0.9807218909263612,847,883,1591,1627,744,744,applejack|fluttershy|mane six|pinkie pie|rainbow dash|rarity|twilight sparkle,gashiboka
459677.png,https://derpicdn.net/img/view/2013/10/29/459677.png,0,0.9957579374313354,199,399,515,715,316,316,applejack|rainbow dash|twilight sparkle,pixelkitties
461190.png,https://derpicdn.net/img/view/2013/10/31/461190.png,0,0.9372088313102722,665,509,1369,1213,704,704,princess cadance|twilight sparkle,tiffanymarsou
464704.png,https://derpicdn.net/img/view/2013/11/5/464704.png,0,0.9775895476341248,458,145,586,273,128,128,applejack|fluttershy|mane six|pinkie pie|rainbow dash|rarity|twilight sparkle,solar-slash
464704.png,https://derpicdn.net/img/view/2013/11/5/464704.png,1,0.9262832403182985,314,136,452,274,138,138,applejack|fluttershy|mane six|pinkie pie|rainbow dash|rarity|twilight sparkle,solar-slash
467221.png,https://derpicdn.net/img/view/2013/11/8/467221.png,0,0.9876391291618348,506,46,792,332,286,286,princess cadance|princess celestia|princess luna|shining armor|spike|twilight sparkle,dm29
467221.png,https://derpicdn.net/img/view/2013/11/8/467221.png,1,0.9703341722488404,786,0,1092,305,306,305,princess cadance|princess celestia|princess luna|shining armor|spike|twilight sparkle,dm29
470490.png,https://derpicdn.net/img/view/2013/11/11/470490.png,0,0.9886603951454164,265,173,683,591,418,418,rarity|twilight sparkle,shinodage
473805.jpg,https://derpicdn.net/img/view/2013/11/16/473805.jpg,0,0.9817428588867188,225,342,375,492,150,150,apple bloom|applejack|big macintosh|cutie mark crusaders|fluttershy|mane six|pinkie pie|princess cadance|princess celestia|princess luna|rainbow dash|rarity|scootaloo|shining armor|sweetie belle|trixie|twilight sparkle,cybersp0nge
475572.png,https://derpicdn.net/img/view/2013/11/18/475572.png,0,0.980401873588562,405,0,781,373,376,373,spike|twilight sparkle,arnachy
475591.png,https://derpicdn.net/img/view/2013/11/18/475591.png,0,0.9691492319107056,0,2,181,184,181,182,princess luna|twilight sparkle,lulubell
479054.png,https://derpicdn.net/img/view/2013/11/23/479054.png,0,0.9763309359550476,1440,68,1726,354,286,286,applejack|big macintosh|shining armor|twilight sparkle,yuzuko
479054.png,https://derpicdn.net/img/view/2013/11/23/479054.png,1,0.9572873115539552,83,68,405,390,322,322,applejack|big macintosh|shining armor|twilight sparkle,yuzuko
479626.jpg,https://derpicdn.net/img/view/2013/11/23/479626.jpg,0,0.959407925605774,143,352,387,596,244,244,discord|twilight sparkle,johnjoseco
481787.png,https://derpicdn.net/img/view/2013/11/26/481787.png,0,0.9968206286430359,1231,289,1643,701,412,412,fluttershy|twilight sparkle,silfoe
483439.png,https://derpicdn.net/img/view/2013/11/27/483439.png,0,0.9605507254600524,51,6,207,162,156,156,rarity|twilight sparkle,goat train
484108.png,https://derpicdn.net/img/view/2013/11/28/484108.png,4,0.9417650103569032,1306,891,1786,1371,480,480,apple bloom|applejack|fluttershy|mane six|pinkie pie|princess cadance|princess celestia|princess luna|rainbow dash|rarity|scootaloo|shining armor|spike|sweetie belle|twilight sparkle,mykegreywolf
484108.png,https://derpicdn.net/img/view/2013/11/28/484108.png,5,0.9222421646118164,2034,1451,2408,1825,374,374,apple bloom|applejack|fluttershy|mane six|pinkie pie|princess cadance|princess celestia|princess luna|rainbow dash|rarity|scootaloo|shining armor|spike|sweetie belle|twilight sparkle,mykegreywolf
485837.png,https://derpicdn.net/img/view/2013/11/30/485837.png,1,0.9961025714874268,0,516,483,1000,483,484,applejack|fluttershy|mane six|pinkie pie|rainbow dash|rarity|twilight sparkle,abductionfromabove
485837.png,https://derpicdn.net/img/view/2013/11/30/485837.png,2,0.9918359518051147,1513,589,1939,1015,426,426,applejack|fluttershy|mane six|pinkie pie|rainbow dash|rarity|twilight sparkle,abductionfromabove
485837.png,https://derpicdn.net/img/view/2013/11/30/485837.png,3,0.9788703322410583,1246,488,1616,858,370,370,applejack|fluttershy|mane six|pinkie pie|rainbow dash|rarity|twilight sparkle,abductionfromabove
486001.png,https://derpicdn.net/img/view/2013/11/30/486001.png,0,0.9745084047317504,402,955,1916,2469,1514,1514,princess celestia|princess luna|twilight sparkle,90sigma
486698.jpg,https://derpicdn.net/img/view/2013/12/1/486698.jpg,0,0.9659551978111268,362,75,606,319,244,244,spike|twilight sparkle,sonikku001
491831.png,https://derpicdn.net/img/view/2013/12/7/491831.png,0,0.9828051924705504,220,0,932,631,712,631,fluttershy|twilight sparkle,rwl
493042.png,https://derpicdn.net/img/view/2013/12/8/493042.png,0,0.9721754193305968,917,0,1565,611,648,611,applejack|fluttershy|mane six|pinkie pie|rainbow dash|rarity|twilight sparkle,renatethepony
493042.png,https://derpicdn.net/img/view/2013/12/8/493042.png,1,0.9576529264450072,168,0,484,294,316,294,applejack|fluttershy|mane six|pinkie pie|rainbow dash|rarity|twilight sparkle,renatethepony
495516.jpg,https://derpicdn.net/img/view/2013/12/12/495516.jpg,0,0.9952850937843324,154,212,364,422,210,210,applejack|fluttershy|twilight sparkle,raikoh
495516.jpg,https://derpicdn.net/img/view/2013/12/12/495516.jpg,1,0.9579543471336364,37,549,205,717,168,168,applejack|fluttershy|twilight sparkle,raikoh
495880.png,https://derpicdn.net/img/view/2013/12/13/495880.png,0,0.99561208486557,1193,0,2095,759,902,759,applejack|fluttershy|mane six|pinkie pie|rainbow dash|rarity|twilight sparkle,ceehoff
496659.png,https://derpicdn.net/img/view/2013/12/14/496659.png,0,0.98322856426239,154,74,300,220,146,146,princess celestia|twilight sparkle,dashyice
500480.jpg,https://derpicdn.net/img/view/2013/12/18/500480.jpg,0,0.9967897534370422,902,0,1500,610,598,610,princess cadance|princess celestia|princess luna|twilight sparkle,oliminor
502890.png,https://derpicdn.net/img/view/2013/12/21/502890.png,0,0.9697535634040833,311,0,711,384,400,384,applejack|fluttershy|mane six|pinkie pie|rainbow dash|rarity|spike|twilight sparkle,chibimlp-lover
503583.png,https://derpicdn.net/img/view/2013/12/22/503583.png,1,0.9422065615653992,124,89,1268,1233,1144,1144,princess luna|twilight sparkle,mistydash
504733.png,https://derpicdn.net/img/view/2013/12/23/504733.png,0,0.9571120738983154,675,263,1053,641,378,378,applejack|fluttershy|mane six|pinkie pie|rainbow dash|rarity|trixie|twilight sparkle,pixelkitties
506904.png,https://derpicdn.net/img/view/2013/12/26/506904.png,0,0.9992519617080688,733,420,1081,768,348,348,applejack|fluttershy|mane six|pinkie pie|rainbow dash|rarity|twilight sparkle,purmu
506904.png,https://derpicdn.net/img/view/2013/12/26/506904.png,2,0.9877339005470276,553,763,915,1125,362,362,applejack|fluttershy|mane six|pinkie pie|rainbow dash|rarity|twilight sparkle,purmu
506904.png,https://derpicdn.net/img/view/2013/12/26/506904.png,3,0.9272267818450928,891,743,1213,1065,322,322,applejack|fluttershy|mane six|pinkie pie|rainbow dash|rarity|twilight sparkle,purmu
50696.png,https://derpicdn.net/img/view/2012/7/20/50696.png,0,0.9908466339111328,663,0,889,191,226,191,applejack|fluttershy|princess celestia|princess luna|rarity|twilight sparkle,jiayi
50696.png,https://derpicdn.net/img/view/2012/7/20/50696.png,2,0.9181225299835204,700,588,880,768,180,180,applejack|fluttershy|princess celestia|princess luna|rarity|twilight sparkle,jiayi
50696.png,https://derpicdn.net/img/view/2012/7/20/50696.png,3,0.9160466194152832,438,0,628,161,190,161,applejack|fluttershy|princess celestia|princess luna|rarity|twilight sparkle,jiayi
510331.png,https://derpicdn.net/img/view/2013/12/30/510331.png,0,0.9920147061347958,26,0,544,518,518,518,trixie|twilight sparkle,inkwell
510331.png,https://derpicdn.net/img/view/2013/12/30/510331.png,1,0.9074308276176452,393,516,727,850,334,334,trixie|twilight sparkle,inkwell
511134.png,https://derpicdn.net/img/view/2013/12/31/511134.png,0,0.9955682754516602,593,1216,939,1562,346,346,sunset shimmer|twilight sparkle,the-butch-x
511134.png,https://derpicdn.net/img/view/2013/12/31/511134.png,1,0.9564637541770936,156,1426,588,1858,432,432,sunset shimmer|twilight sparkle,the-butch-x
512654.png,https://derpicdn.net/img/view/2014/1/2/512654.png,0,0.9941526055336,436,0,998,558,562,558,princess celestia|twilight sparkle,johnnyxluna|goat train
512654.png,https://derpicdn.net/img/view/2014/1/2/512654.png,1,0.9900251626968384,73,0,619,449,546,449,princess celestia|twilight sparkle,johnnyxluna|goat train
512675.png,https://derpicdn.net/img/view/2014/1/2/512675.png,0,0.9505891799926758,536,331,824,619,288,288,trixie|twilight sparkle,bakuel
513123.png,https://derpicdn.net/img/view/2014/1/2/513123.png,0,0.9553157091140748,404,22,650,268,246,246,trixie|twilight sparkle,starshinebeast
513123.png,https://derpicdn.net/img/view/2014/1/2/513123.png,1,0.936919629573822,198,91,386,279,188,188,trixie|twilight sparkle,starshinebeast
513291.png,https://derpicdn.net/img/view/2014/1/2/513291.png,0,0.9933526515960692,0,24,218,260,218,236,rainbow dash|twilight sparkle,lulubell
5139.jpg,https://derpicdn.net/img/view/2012/6/17/5139.jpg,0,0.9919966459274292,694,2140,950,2410,256,270,discord|pinkie pie|twilight sparkle,uc77
515159.png,https://derpicdn.net/img/view/2014/1/4/515159.png,1,0.9657410383224488,164,0,374,203,210,203,applejack|fluttershy|mane six|pinkie pie|rainbow dash|rarity|twilight sparkle,sharmie
517054.png,https://derpicdn.net/img/view/2014/1/6/517054.png,0,0.9994500279426576,1398,0,2142,734,744,734,spike|twilight sparkle,sweethd
52078.jpg,https://derpicdn.net/img/view/2012/7/21/52078.jpg,0,0.991631805896759,279,177,623,521,344,344,fluttershy|rainbow dash|twilight sparkle,mittsies|rip
522874.png,https://derpicdn.net/img/view/2014/1/12/522874.png,0,0.9437951445579528,121,259,253,391,132,132,applejack|fluttershy|mane six|pinkie pie|princess celestia|rainbow dash|rarity|spike|spitfire|twilight sparkle,pauuhanthothecat
523006.png,https://derpicdn.net/img/view/2014/1/13/523006.png,1,0.9703996181488036,461,352,699,590,238,238,applejack|fluttershy|mane six|pinkie pie|rainbow dash|rarity|twilight sparkle,cosmicponye
525806.png,https://derpicdn.net/img/view/2014/1/16/525806.png,0,0.9909007549285888,179,17,687,525,508,508,fluttershy|pinkie pie|rainbow dash|twilight sparkle,rwl
526480.png,https://derpicdn.net/img/view/2014/1/17/526480.png,0,0.9712000489234924,533,6,799,272,266,266,princess cadance|princess celestia|princess luna|shining armor|twilight sparkle,dm29
526480.png,https://derpicdn.net/img/view/2014/1/17/526480.png,1,0.9651904702186584,234,164,452,382,218,218,princess cadance|princess celestia|princess luna|shining armor|twilight sparkle,dm29
5268.jpg,https://derpicdn.net/img/view/2012/6/17/5268.jpg,0,0.9857559204101562,515,0,927,406,412,406,princess celestia|twilight sparkle,johnjoseco
527860.png,https://derpicdn.net/img/view/2014/1/18/527860.png,0,0.9981290698051452,567,336,853,622,286,286,discord|fluttershy|twilight sparkle,c-puff
527860.png,https://derpicdn.net/img/view/2014/1/18/527860.png,1,0.9908698201179504,812,316,1148,652,336,336,discord|fluttershy|twilight sparkle,c-puff
528281.png,https://derpicdn.net/img/view/2014/1/19/528281.png,0,0.956972062587738,764,0,2630,1706,1866,1706,rainbow dash|twilight sparkle,missy12113
529055.png,https://derpicdn.net/img/view/2014/1/19/529055.png,0,0.9813281297683716,3990,0,6972,2899,2982,2899,applejack|fluttershy|mane six|pinkie pie|rainbow dash|rarity|twilight sparkle,masem
529790.png,https://derpicdn.net/img/view/2014/1/20/529790.png,0,0.959380269050598,2467,71,3735,1339,1268,1268,princess cadance|shining armor|twilight sparkle,silfoe
529790.png,https://derpicdn.net/img/view/2014/1/20/529790.png,1,0.9438340067863464,856,0,2250,1259,1394,1259,princess cadance|shining armor|twilight sparkle,silfoe
530545.jpg,https://derpicdn.net/img/view/2014/1/21/530545.jpg,0,0.99026221036911,106,0,344,225,238,225,rainbow dash|twilight sparkle,nekubi
531132.png,https://derpicdn.net/img/view/2014/1/22/531132.png,0,0.9551962614059448,32,66,308,342,276,276,spike|twilight sparkle,dm29
532549.png,https://derpicdn.net/img/view/2014/1/24/532549.png,0,0.9838206768035888,87,0,511,404,424,404,trixie|twilight sparkle,goat train
532826.png,https://derpicdn.net/img/view/2014/1/24/532826.png,0,0.9799197912216188,137,0,485,332,348,332,trixie|twilight sparkle,ranban
533979.png,https://derpicdn.net/img/view/2014/1/25/533979.png,0,0.9991389513015748,725,50,993,318,268,268,fluttershy|twilight sparkle,el-doc
533979.png,https://derpicdn.net/img/view/2014/1/25/533979.png,1,0.9970949292182922,190,0,466,269,276,269,fluttershy|twilight sparkle,el-doc
533979.png,https://derpicdn.net/img/view/2014/1/25/533979.png,2,0.9816110134124756,405,50,677,322,272,272,fluttershy|twilight sparkle,el-doc
534034.png,https://derpicdn.net/img/view/2014/1/25/534034.png,0,0.9823237657546996,177,10,573,406,396,396,discord|princess cadance|twilight sparkle,teammagix
534177.png,https://derpicdn.net/img/view/2014/1/25/534177.png,0,0.9720271229743958,38,210,1210,1382,1172,1172,discord|princess cadance|twilight sparkle,silfoe
535205.png,https://derpicdn.net/img/view/2014/1/26/535205.png,0,0.9940185546875,355,580,729,1014,374,434,discord|twilight sparkle,sewyouplushiethings
536596.png,https://derpicdn.net/img/view/2014/1/28/536596.png,0,0.9978730082511902,93,82,2373,2362,2280,2280,princess cadance|twilight sparkle,scienceisanart
538424.jpg,https://derpicdn.net/img/view/2014/1/30/538424.jpg,2,0.9936783909797668,933,742,1485,1294,552,552,applejack|fluttershy|mane six|pinkie pie|rainbow dash|rarity|twilight sparkle,arrockansate
538424.jpg,https://derpicdn.net/img/view/2014/1/30/538424.jpg,4,0.9898172616958618,1488,1463,1968,1943,480,480,applejack|fluttershy|mane six|pinkie pie|rainbow dash|rarity|twilight sparkle,arrockansate
538424.jpg,https://derpicdn.net/img/view/2014/1/30/538424.jpg,5,0.9883772730827332,55,586,527,1058,472,472,applejack|fluttershy|mane six|pinkie pie|rainbow dash|rarity|twilight sparkle,arrockansate
538424.jpg,https://derpicdn.net/img/view/2014/1/30/538424.jpg,6,0.985709547996521,1078,2047,1614,2583,536,536,applejack|fluttershy|mane six|pinkie pie|rainbow dash|rarity|twilight sparkle,arrockansate
538424.jpg,https://derpicdn.net/img/view/2014/1/30/538424.jpg,8,0.9592147469520568,423,579,933,1089,510,510,applejack|fluttershy|mane six|pinkie pie|rainbow dash|rarity|twilight sparkle,arrockansate
538424.jpg,https://derpicdn.net/img/view/2014/1/30/538424.jpg,9,0.9022199511528016,1740,1158,2152,1570,412,412,applejack|fluttershy|mane six|pinkie pie|rainbow dash|rarity|twilight sparkle,arrockansate
538504.png,https://derpicdn.net/img/view/2014/1/30/538504.png,0,0.993716835975647,408,1158,1038,1788,630,630,apple bloom|applejack|cutie mark crusaders|fluttershy|mane six|pinkie pie|princess celestia|princess luna|rainbow dash|rarity|scootaloo|sweetie belle|twilight sparkle,nora1211
538504.png,https://derpicdn.net/img/view/2014/1/30/538504.png,1,0.9734188318252563,1394,1142,1984,1732,590,590,apple bloom|applejack|cutie mark crusaders|fluttershy|mane six|pinkie pie|princess celestia|princess luna|rainbow dash|rarity|scootaloo|sweetie belle|twilight sparkle,nora1211
538504.png,https://derpicdn.net/img/view/2014/1/30/538504.png,2,0.9335659742355348,12,401,698,1087,686,686,apple bloom|applejack|cutie mark crusaders|fluttershy|mane six|pinkie pie|princess celestia|princess luna|rainbow dash|rarity|scootaloo|sweetie belle|twilight sparkle,nora1211
538992.png,https://derpicdn.net/img/view/2014/1/30/538992.png,0,0.988284707069397,612,147,928,463,316,316,discord|twilight sparkle,c-puff
539318.jpg,https://derpicdn.net/img/view/2014/1/31/539318.jpg,0,0.9493845701217652,484,203,752,471,268,268,apple bloom|applejack|cutie mark crusaders|fluttershy|mane six|pinkie pie|rainbow dash|rarity|scootaloo|spike|sweetie belle|twilight sparkle,shitamachimura
5404.png,https://derpicdn.net/img/view/2012/6/17/5404.png,0,0.9838737249374392,328,18,812,502,484,484,applejack|fluttershy|mane six|pinkie pie|rainbow dash|rarity|trixie|twilight sparkle,zelc-face
541336.png,https://derpicdn.net/img/view/2014/2/2/541336.png,0,0.9231559634208679,27,0,611,543,584,543,spike|twilight sparkle,dm29
5424.png,https://derpicdn.net/img/view/2012/6/17/5424.png,0,0.9890328645706176,438,508,1114,1184,676,676,applejack|fluttershy|mane six|pinkie pie|rainbow dash|rarity|spike|twilight sparkle,myminiatureequine
543656.png,https://derpicdn.net/img/view/2014/2/5/543656.png,0,0.9929044246673584,32,184,236,388,204,204,applejack|fluttershy|mane six|pinkie pie|rainbow dash|rarity|spike|twilight sparkle,
543656.png,https://derpicdn.net/img/view/2014/2/5/543656.png,1,0.9657326936721802,51,0,279,194,228,194,applejack|fluttershy|mane six|pinkie pie|rainbow dash|rarity|spike|twilight sparkle,
543656.png,https://derpicdn.net/img/view/2014/2/5/543656.png,2,0.9647729992866516,358,196,490,328,132,132,applejack|fluttershy|mane six|pinkie pie|rainbow dash|rarity|spike|twilight sparkle,
543656.png,https://derpicdn.net/img/view/2014/2/5/543656.png,3,0.9319989681243896,691,403,815,527,124,124,applejack|fluttershy|mane six|pinkie pie|rainbow dash|rarity|spike|twilight sparkle,
548175.png,https://derpicdn.net/img/view/2014/2/10/548175.png,0,0.9972690343856812,394,48,868,522,474,474,applejack|fluttershy|mane six|pinkie pie|rainbow dash|rarity|twilight sparkle,cosmicponye
548175.png,https://derpicdn.net/img/view/2014/2/10/548175.png,1,0.9877455830574036,962,70,1452,560,490,490,applejack|fluttershy|mane six|pinkie pie|rainbow dash|rarity|twilight sparkle,cosmicponye
548175.png,https://derpicdn.net/img/view/2014/2/10/548175.png,2,0.9790130853652954,239,484,759,1004,520,520,applejack|fluttershy|mane six|pinkie pie|rainbow dash|rarity|twilight sparkle,cosmicponye
548175.png,https://derpicdn.net/img/view/2014/2/10/548175.png,3,0.9622825384140016,1259,463,1803,1007,544,544,applejack|fluttershy|mane six|pinkie pie|rainbow dash|rarity|twilight sparkle,cosmicponye
549979.png,https://derpicdn.net/img/view/2014/2/12/549979.png,0,0.9988874197006226,432,0,842,383,410,383,spike|twilight sparkle,swanlullaby
550035.png,https://derpicdn.net/img/view/2014/2/12/550035.png,0,0.9499098658561708,429,0,899,413,470,413,shining armor|twilight sparkle,dm29
551749.jpg,https://derpicdn.net/img/view/2014/2/14/551749.jpg,0,0.9198700189590454,524,857,840,1173,316,316,applejack|fluttershy|mane six|pinkie pie|rainbow dash|rarity|twilight sparkle,sweetsound
551774.png,https://derpicdn.net/img/view/2014/2/14/551774.png,0,0.9886344671249392,234,544,548,858,314,314,trixie|twilight sparkle,pixelkitties
553492.png,https://derpicdn.net/img/view/2014/2/16/553492.png,0,0.9885434508323668,968,61,1270,363,302,302,applejack|fluttershy|mane six|pinkie pie|rainbow dash|rarity|twilight sparkle,
553492.png,https://derpicdn.net/img/view/2014/2/16/553492.png,2,0.9257000088691713,755,95,1055,395,300,300,applejack|fluttershy|mane six|pinkie pie|rainbow dash|rarity|twilight sparkle,
55441.png,https://derpicdn.net/img/view/2012/7/25/55441.png,1,0.9852909445762634,870,0,1234,343,364,343,applejack|fluttershy|mane six|pinkie pie|rainbow dash|rarity|twilight sparkle,atryl
55441.png,https://derpicdn.net/img/view/2012/7/25/55441.png,2,0.9818989634513856,710,596,1018,900,308,304,applejack|fluttershy|mane six|pinkie pie|rainbow dash|rarity|twilight sparkle,atryl
55441.png,https://derpicdn.net/img/view/2012/7/25/55441.png,3,0.9810462594032288,47,344,413,710,366,366,applejack|fluttershy|mane six|pinkie pie|rainbow dash|rarity|twilight sparkle,atryl
555876.png,https://derpicdn.net/img/view/2014/2/18/555876.png,0,0.9878257513046264,148,2201,1384,3437,1236,1236,princess cadance|princess celestia|princess luna|twilight sparkle,zeldafan777
555876.png,https://derpicdn.net/img/view/2014/2/18/555876.png,1,0.9594544768333436,4859,880,6103,2124,1244,1244,princess cadance|princess celestia|princess luna|twilight sparkle,zeldafan777
557124.jpg,https://derpicdn.net/img/view/2014/2/20/557124.jpg,1,0.9902945160865784,798,59,1252,513,454,454,applejack|twilight sparkle,scorpiyo
558075.jpg,https://derpicdn.net/img/view/2014/2/21/558075.jpg,0,0.9368041157722472,278,622,1000,1398,722,776,applejack|fluttershy|mane six|pinkie pie|rainbow dash|rarity|spike|twilight sparkle,caibaoreturn
559411.jpg,https://derpicdn.net/img/view/2014/2/22/559411.jpg,0,0.9729169607162476,806,81,1092,367,286,286,princess celestia|princess luna|twilight sparkle,mrs1989
559411.jpg,https://derpicdn.net/img/view/2014/2/22/559411.jpg,1,0.9535948634147644,1405,76,1715,386,310,310,princess celestia|princess luna|twilight sparkle,mrs1989
563111.jpg,https://derpicdn.net/img/view/2014/2/28/563111.jpg,0,0.9898472428321838,803,101,1089,387,286,286,applejack|fluttershy|mane six|pinkie pie|rainbow dash|rarity|spike|twilight sparkle,starrypon
56473.png,https://derpicdn.net/img/view/2012/7/25/56473.png,0,0.959177553653717,804,1062,1172,1430,368,368,applejack|fluttershy|mane six|pinkie pie|rainbow dash|rarity|twilight sparkle,schnuffitrunks
56473.png,https://derpicdn.net/img/view/2012/7/25/56473.png,1,0.9142993688583374,1289,1107,1631,1449,342,342,applejack|fluttershy|mane six|pinkie pie|rainbow dash|rarity|twilight sparkle,schnuffitrunks
566988.png,https://derpicdn.net/img/view/2014/3/5/566988.png,0,0.9810819029808044,295,0,655,334,360,334,fluttershy|twilight sparkle,calorie
567467.png,https://derpicdn.net/img/view/2014/3/5/567467.png,0,0.9965543150901794,596,0,1022,413,426,413,applejack|fluttershy|mane six|pinkie pie|rainbow dash|rarity|spitfire|twilight sparkle,circe
567467.png,https://derpicdn.net/img/view/2014/3/5/567467.png,1,0.9067354202270508,18,619,378,979,360,360,applejack|fluttershy|mane six|pinkie pie|rainbow dash|rarity|spitfire|twilight sparkle,circe
567873.png,https://derpicdn.net/img/view/2014/3/6/567873.png,0,0.9901247024536132,124,192,744,812,620,620,applejack|fluttershy|mane six|pinkie pie|rainbow dash|rarity|twilight sparkle,zacatron94
567873.png,https://derpicdn.net/img/view/2014/3/6/567873.png,2,0.9365649223327636,773,300,1317,844,544,544,applejack|fluttershy|mane six|pinkie pie|rainbow dash|rarity|twilight sparkle,zacatron94
571456.png,https://derpicdn.net/img/view/2014/3/10/571456.png,0,0.9961524605751038,498,1023,1446,1971,948,948,applejack|fluttershy|mane six|pinkie pie|rainbow dash|rarity|twilight sparkle,mixipony
571456.png,https://derpicdn.net/img/view/2014/3/10/571456.png,1,0.9954789280891418,1174,18,1980,824,806,806,applejack|fluttershy|mane six|pinkie pie|rainbow dash|rarity|twilight sparkle,mixipony
571456.png,https://derpicdn.net/img/view/2014/3/10/571456.png,2,0.9866722226142884,670,0,1382,689,712,689,applejack|fluttershy|mane six|pinkie pie|rainbow dash|rarity|twilight sparkle,mixipony
571456.png,https://derpicdn.net/img/view/2014/3/10/571456.png,3,0.9591997861862184,514,1843,1418,2747,904,904,applejack|fluttershy|mane six|pinkie pie|rainbow dash|rarity|twilight sparkle,mixipony
571456.png,https://derpicdn.net/img/view/2014/3/10/571456.png,4,0.9414178729057312,1116,1993,2004,2881,888,888,applejack|fluttershy|mane six|pinkie pie|rainbow dash|rarity|twilight sparkle,mixipony
571456.png,https://derpicdn.net/img/view/2014/3/10/571456.png,5,0.9228872656822203,803,2767,1743,3707,940,940,applejack|fluttershy|mane six|pinkie pie|rainbow dash|rarity|twilight sparkle,mixipony
573586.png,https://derpicdn.net/img/view/2014/3/13/573586.png,0,0.9743342399597168,381,57,645,321,264,264,trixie|twilight sparkle,fallenfirefly
574081.png,https://derpicdn.net/img/view/2014/3/13/574081.png,0,0.9893060326576232,686,1117,3828,4259,3142,3142,applejack|fluttershy|mane six|pinkie pie|rainbow dash|rarity|twilight sparkle,djdavid98|uxyd
57481.png,https://derpicdn.net/img/view/2012/7/26/57481.png,0,0.9952876567840576,283,0,641,353,358,353,princess celestia|princess luna|twilight sparkle,cartoonlion
578115.png,https://derpicdn.net/img/view/2014/3/17/578115.png,0,0.9943450093269348,1061,19,1857,815,796,796,applejack|fluttershy|mane six|pinkie pie|rainbow dash|rarity|twilight sparkle,stepandy
578115.png,https://derpicdn.net/img/view/2014/3/17/578115.png,1,0.9914762377738952,142,0,1000,821,858,821,applejack|fluttershy|mane six|pinkie pie|rainbow dash|rarity|twilight sparkle,stepandy
578115.png,https://derpicdn.net/img/view/2014/3/17/578115.png,2,0.98886901140213,577,1035,1275,1733,698,698,applejack|fluttershy|mane six|pinkie pie|rainbow dash|rarity|twilight sparkle,stepandy
578115.png,https://derpicdn.net/img/view/2014/3/17/578115.png,3,0.9299124479293824,1981,961,2751,1731,770,770,applejack|fluttershy|mane six|pinkie pie|rainbow dash|rarity|twilight sparkle,stepandy
579586.png,https://derpicdn.net/img/view/2014/3/19/579586.png,0,0.9579331278800964,66,670,358,962,292,292,applejack|fluttershy|mane six|pinkie pie|rainbow dash|rarity|twilight sparkle,lillynya
584558.png,https://derpicdn.net/img/view/2014/3/25/584558.png,0,0.99479478597641,1237,747,1601,1111,364,364,applejack|fluttershy|mane six|pinkie pie|rainbow dash|rarity|twilight sparkle,php56
584558.png,https://derpicdn.net/img/view/2014/3/25/584558.png,1,0.9935991764068604,97,720,485,1108,388,388,applejack|fluttershy|mane six|pinkie pie|rainbow dash|rarity|twilight sparkle,php56
584558.png,https://derpicdn.net/img/view/2014/3/25/584558.png,2,0.9860052466392516,1250,13,1636,399,386,386,applejack|fluttershy|mane six|pinkie pie|rainbow dash|rarity|twilight sparkle,php56
584630.png,https://derpicdn.net/img/view/2014/3/25/584630.png,0,0.9997100234031676,181,725,653,1197,472,472,applejack|fluttershy|mane six|pinkie pie|rainbow dash|rarity|spike|twilight sparkle,alasou
584630.png,https://derpicdn.net/img/view/2014/3/25/584630.png,1,0.9994786977767944,1733,31,2147,445,414,414,applejack|fluttershy|mane six|pinkie pie|rainbow dash|rarity|spike|twilight sparkle,alasou
584630.png,https://derpicdn.net/img/view/2014/3/25/584630.png,2,0.9986308813095092,1557,976,2059,1478,502,502,applejack|fluttershy|mane six|pinkie pie|rainbow dash|rarity|spike|twilight sparkle,alasou
584630.png,https://derpicdn.net/img/view/2014/3/25/584630.png,3,0.9976966381072998,1083,1572,1561,2050,478,478,applejack|fluttershy|mane six|pinkie pie|rainbow dash|rarity|spike|twilight sparkle,alasou
584630.png,https://derpicdn.net/img/view/2014/3/25/584630.png,4,0.9924103617668152,927,870,1361,1304,434,434,applejack|fluttershy|mane six|pinkie pie|rainbow dash|rarity|spike|twilight sparkle,alasou
584630.png,https://derpicdn.net/img/view/2014/3/25/584630.png,6,0.9847263693809508,311,1649,731,2069,420,420,applejack|fluttershy|mane six|pinkie pie|rainbow dash|rarity|spike|twilight sparkle,alasou
584630.png,https://derpicdn.net/img/view/2014/3/25/584630.png,7,0.9587748050689696,882,47,1350,515,468,468,applejack|fluttershy|mane six|pinkie pie|rainbow dash|rarity|spike|twilight sparkle,alasou
585496.png,https://derpicdn.net/img/view/2014/3/26/585496.png,0,0.989391565322876,355,0,845,476,490,476,spike|twilight sparkle,dm29
587637.png,https://derpicdn.net/img/view/2014/3/29/587637.png,0,0.9586265683174132,659,188,1413,942,754,754,trixie|twilight sparkle,hoyeechun
587637.png,https://derpicdn.net/img/view/2014/3/29/587637.png,1,0.9060900807380676,89,110,899,920,810,810,trixie|twilight sparkle,hoyeechun
590173.png,https://derpicdn.net/img/view/2014/4/1/590173.png,0,0.9477515220642092,305,43,693,431,388,388,shining armor|spike|twilight sparkle,dm29
590831.png,https://derpicdn.net/img/view/2014/4/2/590831.png,0,0.9907529950141908,31,0,491,392,460,392,trixie|twilight sparkle,naomiknight17
591087.png,https://derpicdn.net/img/view/2014/4/2/591087.png,0,0.9839804172515868,18,206,250,438,232,232,princess cadance|shining armor|spike|twilight sparkle,dm29
591087.png,https://derpicdn.net/img/view/2014/4/2/591087.png,2,0.9714890718460084,893,175,1197,479,304,304,princess cadance|shining armor|spike|twilight sparkle,dm29
59796.png,https://derpicdn.net/img/view/2012/7/28/59796.png,1,0.9978508353233336,58,0,584,521,526,521,shining armor|twilight sparkle,homumu
599643.png,https://derpicdn.net/img/view/2014/4/13/599643.png,0,0.9971107244491576,111,0,453,291,342,291,applejack|fluttershy|mane six|pinkie pie|rainbow dash|rarity|spike|twilight sparkle,ambunny
599643.png,https://derpicdn.net/img/view/2014/4/13/599643.png,1,0.9945895075798036,786,254,1078,560,292,306,applejack|fluttershy|mane six|pinkie pie|rainbow dash|rarity|spike|twilight sparkle,ambunny
599643.png,https://derpicdn.net/img/view/2014/4/13/599643.png,2,0.9911531805992126,249,485,449,685,200,200,applejack|fluttershy|mane six|pinkie pie|rainbow dash|rarity|spike|twilight sparkle,ambunny
599643.png,https://derpicdn.net/img/view/2014/4/13/599643.png,3,0.984144687652588,2,282,298,578,296,296,applejack|fluttershy|mane six|pinkie pie|rainbow dash|rarity|spike|twilight sparkle,ambunny
599643.png,https://derpicdn.net/img/view/2014/4/13/599643.png,4,0.9807387590408324,694,0,982,250,288,250,applejack|fluttershy|mane six|pinkie pie|rainbow dash|rarity|spike|twilight sparkle,ambunny
60008.jpg,https://derpicdn.net/img/view/2012/7/28/60008.jpg,0,0.9617480039596558,524,109,976,561,452,452,applejack|discord|fluttershy|mane six|pinkie pie|rainbow dash|rarity|spike|twilight sparkle,ss2sonic
601389.jpg,https://derpicdn.net/img/view/2014/4/15/601389.jpg,0,0.9919790029525756,858,144,1058,344,200,200,discord|princess cadance|princess celestia|princess luna|queen chrysalis|twilight sparkle,slifertheskydragon
601389.jpg,https://derpicdn.net/img/view/2014/4/15/601389.jpg,1,0.973980188369751,151,97,495,441,344,344,discord|princess cadance|princess celestia|princess luna|queen chrysalis|twilight sparkle,slifertheskydragon
602228.png,https://derpicdn.net/img/view/2014/4/17/602228.png,0,0.9894363880157472,78,0,434,328,356,328,applejack|fluttershy|mane six|pinkie pie|princess celestia|princess luna|rainbow dash|rarity|trixie|twilight sparkle,johnjoseco|thepolymath
603668.png,https://derpicdn.net/img/view/2014/4/18/603668.png,0,0.9788604378700256,670,545,1028,903,358,358,rainbow dash|twilight sparkle,rwl
605184.png,https://derpicdn.net/img/view/2014/4/20/605184.png,0,0.9139772653579712,20,0,754,702,734,702,applejack|fluttershy|mane six|pinkie pie|rainbow dash|rarity|twilight sparkle,jankrys00
609591.png,https://derpicdn.net/img/view/2014/4/25/609591.png,0,0.9751984477043152,477,18,799,340,322,322,trixie|twilight sparkle,oniku
609637.png,https://derpicdn.net/img/view/2014/4/25/609637.png,0,0.969731330871582,0,7,644,667,644,660,spike|twilight sparkle,frist44
609817.png,https://derpicdn.net/img/view/2014/4/25/609817.png,0,0.9963098168373108,0,0,320,284,320,284,applejack|fluttershy|mane six|pinkie pie|rainbow dash|rarity|twilight sparkle,buzucat
609817.png,https://derpicdn.net/img/view/2014/4/25/609817.png,1,0.9753499627113342,803,277,1047,521,244,244,applejack|fluttershy|mane six|pinkie pie|rainbow dash|rarity|twilight sparkle,buzucat
611120.png,https://derpicdn.net/img/view/2014/4/27/611120.png,0,0.9307357668876648,1700,1430,1906,1636,206,206,apple bloom|applejack|braeburn|cutie mark crusaders|fluttershy|mane six|pinkie pie|princess luna|rainbow dash|rarity|scootaloo|spike|spitfire|sunset shimmer|sweetie belle|trixie|twilight sparkle,
611597.png,https://derpicdn.net/img/view/2014/4/27/611597.png,0,0.9746707677841188,8,251,288,531,280,280,applejack|fluttershy|mane six|pinkie pie|rainbow dash|rarity|twilight sparkle,omgproductions
611597.png,https://derpicdn.net/img/view/2014/4/27/611597.png,1,0.9579448699951172,267,222,551,506,284,284,applejack|fluttershy|mane six|pinkie pie|rainbow dash|rarity|twilight sparkle,omgproductions
612002.png,https://derpicdn.net/img/view/2014/4/28/612002.png,0,0.9988741278648376,10,8,382,380,372,372,rarity|spike|twilight sparkle,dm29
612203.png,https://derpicdn.net/img/view/2014/4/28/612203.png,0,0.9989786744117736,1697,0,2875,1012,1178,1012,princess celestia|princess luna|twilight sparkle,silfoe
613550.png,https://derpicdn.net/img/view/2014/4/30/613550.png,0,0.9933798909187316,881,382,1213,714,332,332,applejack|fluttershy|mane six|pinkie pie|rainbow dash|rarity|spike|twilight sparkle,andypriceart
613550.png,https://derpicdn.net/img/view/2014/4/30/613550.png,2,0.9610882401466372,4,1083,486,1523,482,440,applejack|fluttershy|mane six|pinkie pie|rainbow dash|rarity|spike|twilight sparkle,andypriceart
615006.jpg,https://derpicdn.net/img/view/2014/5/1/615006.jpg,0,0.9759226441383362,4,388,188,572,184,184,applejack|fluttershy|mane six|pinkie pie|princess celestia|princess luna|rainbow dash|rarity|twilight sparkle,mistydash
615947.png,https://derpicdn.net/img/view/2014/5/3/615947.png,0,0.9749191403388976,252,186,546,480,294,294,princess luna|twilight sparkle,silfoe
616417.png,https://derpicdn.net/img/view/2014/5/3/616417.png,0,0.994959831237793,1594,100,2038,544,444,444,applejack|fluttershy|mane six|pinkie pie|rainbow dash|rarity|twilight sparkle,bswprecious
618452.png,https://derpicdn.net/img/view/2014/5/5/618452.png,0,0.9818081259727478,507,629,849,971,342,342,princess cadance|princess luna|trixie|twilight sparkle,fauxsquared
618775.png,https://derpicdn.net/img/view/2014/5/6/618775.png,0,0.9976487755775452,2278,22,2606,350,328,328,applejack|fluttershy|mane six|pinkie pie|rainbow dash|rarity|twilight sparkle,facerenon
618775.png,https://derpicdn.net/img/view/2014/5/6/618775.png,1,0.9772341251373292,513,50,849,386,336,336,applejack|fluttershy|mane six|pinkie pie|rainbow dash|rarity|twilight sparkle,facerenon
618775.png,https://derpicdn.net/img/view/2014/5/6/618775.png,2,0.9448019862174988,951,0,1321,362,370,362,applejack|fluttershy|mane six|pinkie pie|rainbow dash|rarity|twilight sparkle,facerenon
620072.png,https://derpicdn.net/img/view/2014/5/7/620072.png,0,0.9882041811943054,216,48,566,398,350,350,applejack|fluttershy|mane six|pinkie pie|rainbow dash|rarity|twilight sparkle,schnuffitrunks
620842.png,https://derpicdn.net/img/view/2014/5/8/620842.png,0,0.9760332703590392,548,665,1710,1827,1162,1162,princess celestia|princess luna|twilight sparkle,florecentmoo
622401.png,https://derpicdn.net/img/view/2014/5/10/622401.png,0,0.973050892353058,7368,1489,8456,2577,1088,1088,princess cadance|princess celestia|princess luna|twilight sparkle,jeatz-axl
623039.png,https://derpicdn.net/img/view/2014/5/10/623039.png,0,0.9970720410346984,386,1197,948,1759,562,562,applejack|fluttershy|mane six|pinkie pie|rainbow dash|rarity|twilight sparkle,hecatehell
623039.png,https://derpicdn.net/img/view/2014/5/10/623039.png,1,0.9898026585578918,1059,1,1555,497,496,496,applejack|fluttershy|mane six|pinkie pie|rainbow dash|rarity|twilight sparkle,hecatehell
623039.png,https://derpicdn.net/img/view/2014/5/10/623039.png,2,0.9833322167396544,1423,1261,2001,1839,578,578,applejack|fluttershy|mane six|pinkie pie|rainbow dash|rarity|twilight sparkle,hecatehell
624695.png,https://derpicdn.net/img/view/2014/5/12/624695.png,0,0.9742870926856996,256,0,688,348,432,348,shining armor|twilight sparkle,dm29
624861.png,https://derpicdn.net/img/view/2014/5/12/624861.png,0,0.9753084182739258,385,0,769,371,384,371,princess cadance|princess luna|twilight sparkle,flutterthrash
624861.png,https://derpicdn.net/img/view/2014/5/12/624861.png,1,0.9726940989494324,891,0,1349,413,458,413,princess cadance|princess luna|twilight sparkle,flutterthrash
624906.jpg,https://derpicdn.net/img/view/2014/5/12/624906.jpg,0,0.9843224883079528,61,0,483,387,422,387,trixie|twilight sparkle,mococo
625304.png,https://derpicdn.net/img/view/2014/5/13/625304.png,0,0.9990733861923218,540,16,966,442,426,426,applejack|fluttershy|mane six|pinkie pie|rainbow dash|rarity|twilight sparkle,lexieskye
625304.png,https://derpicdn.net/img/view/2014/5/13/625304.png,1,0.9795494079589844,1107,14,1547,454,440,440,applejack|fluttershy|mane six|pinkie pie|rainbow dash|rarity|twilight sparkle,lexieskye
625304.png,https://derpicdn.net/img/view/2014/5/13/625304.png,2,0.9751445651054382,1183,581,1635,1033,452,452,applejack|fluttershy|mane six|pinkie pie|rainbow dash|rarity|twilight sparkle,lexieskye
6261.png,https://derpicdn.net/img/view/2012/6/18/6261.png,0,0.9973289370536804,162,5,648,491,486,486,spike|twilight sparkle,aleximusprime
627560.png,https://derpicdn.net/img/view/2014/5/15/627560.png,2,0.9455148577690125,71,0,567,466,496,466,applejack|fluttershy|mane six|pinkie pie|rainbow dash|rarity|twilight sparkle,crayon-chewer
627947.png,https://derpicdn.net/img/view/2014/5/16/627947.png,0,0.9045200943946838,48,0,450,384,402,384,trixie|twilight sparkle,ranban
627985.png,https://derpicdn.net/img/view/2014/5/16/627985.png,1,0.9807883501052856,163,0,507,341,344,341,applejack|rarity|twilight sparkle,cultmasteraranukon
628933.png,https://derpicdn.net/img/view/2014/5/17/628933.png,0,0.9853925108909608,279,326,479,526,200,200,princess cadance|princess celestia|princess luna|twilight sparkle,miniyuna
630077.png,https://derpicdn.net/img/view/2014/5/18/630077.png,0,0.9933717250823976,71,893,603,1425,532,532,applejack|fluttershy|mane six|pinkie pie|rainbow dash|rarity|twilight sparkle,luciferamon
630077.png,https://derpicdn.net/img/view/2014/5/18/630077.png,1,0.987525463104248,740,565,1244,1069,504,504,applejack|fluttershy|mane six|pinkie pie|rainbow dash|rarity|twilight sparkle,luciferamon
630077.png,https://derpicdn.net/img/view/2014/5/18/630077.png,2,0.9857614636421204,1541,909,1993,1361,452,452,applejack|fluttershy|mane six|pinkie pie|rainbow dash|rarity|twilight sparkle,luciferamon
631985.png,https://derpicdn.net/img/view/2014/5/20/631985.png,0,0.9788116216659546,684,1153,1024,1536,340,383,princess cadance|princess celestia|princess luna|queen chrysalis|twilight sparkle,oblivionheart13
632720.png,https://derpicdn.net/img/view/2014/5/21/632720.png,0,0.989976406097412,3531,265,4779,1513,1248,1248,sweetie belle|twilight sparkle,silfoe
633173.png,https://derpicdn.net/img/view/2014/5/22/633173.png,0,0.9920048117637634,342,0,1026,624,684,624,trixie|twilight sparkle,misspolycysticovary
633999.png,https://derpicdn.net/img/view/2014/5/23/633999.png,0,0.9987019300460817,344,15,720,391,376,376,princess celestia|princess luna|twilight sparkle,deusexequus
6348.png,https://derpicdn.net/img/view/2012/6/18/6348.png,0,0.994925856590271,166,324,460,618,294,294,applejack|big macintosh|fluttershy|rarity|spike|twilight sparkle,turbulosus
6348.png,https://derpicdn.net/img/view/2012/6/18/6348.png,1,0.97578626871109,936,399,1248,711,312,312,applejack|big macintosh|fluttershy|rarity|spike|twilight sparkle,turbulosus
637611.png,https://derpicdn.net/img/view/2014/5/26/637611.png,0,0.9472575783729552,612,0,1444,722,832,722,trixie|twilight sparkle,misspolycysticovary
637973.png,https://derpicdn.net/img/view/2014/5/27/637973.png,0,0.9356895685195924,1287,180,1613,506,326,326,applejack|discord|fluttershy|mane six|pinkie pie|rainbow dash|rarity|twilight sparkle,
642038.png,https://derpicdn.net/img/view/2014/6/1/642038.png,0,0.9997004866600036,1316,70,1646,408,330,338,applejack|fluttershy|mane six|pinkie pie|rainbow dash|rarity|twilight sparkle,wonton soup
642038.png,https://derpicdn.net/img/view/2014/6/1/642038.png,1,0.9996861219406128,708,193,1018,503,310,310,applejack|fluttershy|mane six|pinkie pie|rainbow dash|rarity|twilight sparkle,wonton soup
642038.png,https://derpicdn.net/img/view/2014/6/1/642038.png,4,0.9889990091323853,0,500,343,914,343,414,applejack|fluttershy|mane six|pinkie pie|rainbow dash|rarity|twilight sparkle,wonton soup
644266.png,https://derpicdn.net/img/view/2014/6/3/644266.png,0,0.9938912987709044,2084,850,2872,1638,788,788,applejack|fluttershy|mane six|pinkie pie|princess cadance|princess celestia|princess luna|rainbow dash|rarity|spike|twilight sparkle,theshadowstone
644266.png,https://derpicdn.net/img/view/2014/6/3/644266.png,1,0.9754283428192142,2822,694,3684,1556,862,862,applejack|fluttershy|mane six|pinkie pie|princess cadance|princess celestia|princess luna|rainbow dash|rarity|spike|twilight sparkle,theshadowstone
644266.png,https://derpicdn.net/img/view/2014/6/3/644266.png,2,0.9678502678871156,581,683,1465,1567,884,884,applejack|fluttershy|mane six|pinkie pie|princess cadance|princess celestia|princess luna|rainbow dash|rarity|spike|twilight sparkle,theshadowstone
644266.png,https://derpicdn.net/img/view/2014/6/3/644266.png,4,0.9213674664497375,1688,168,2454,934,766,766,applejack|fluttershy|mane six|pinkie pie|princess cadance|princess celestia|princess luna|rainbow dash|rarity|spike|twilight sparkle,theshadowstone
649273.png,https://derpicdn.net/img/view/2014/6/9/649273.png,0,0.9161686301231384,0,0,716,784,716,784,trixie|twilight sparkle,doqwor
649760.png,https://derpicdn.net/img/view/2014/6/10/649760.png,0,0.9826908111572266,280,12,446,178,166,166,applejack|fluttershy|mane six|pinkie pie|rainbow dash|rarity|twilight sparkle,yuki-zakuro
6498.png,https://derpicdn.net/img/view/2012/6/18/6498.png,0,0.9906887412071228,32,0,440,301,408,301,applejack|fluttershy|mane six|pinkie pie|rainbow dash|rarity|twilight sparkle,hinoraito
6498.png,https://derpicdn.net/img/view/2012/6/18/6498.png,1,0.9794945716857908,641,0,863,169,222,169,applejack|fluttershy|mane six|pinkie pie|rainbow dash|rarity|twilight sparkle,hinoraito
651353.jpg,https://derpicdn.net/img/view/2014/6/12/651353.jpg,0,0.99980229139328,273,251,467,445,194,194,applejack|fluttershy|mane six|pinkie pie|rainbow dash|rarity|spike|twilight sparkle,audrarius
652272.jpg,https://derpicdn.net/img/view/2014/6/13/652272.jpg,1,0.9924726486206056,1503,267,2113,877,610,610,apple bloom|applejack|babs seed|big macintosh|braeburn|cutie mark crusaders|discord|fluttershy|granny smith|mane six|pinkie pie|princess cadance|princess celestia|princess luna|queen chrysalis|rainbow dash|rarity|scootaloo|shining armor|soarin'|spike|spitfire|sunset shimmer|sweetie belle|trixie|twilight sparkle,spainfischer|kenket
652272.jpg,https://derpicdn.net/img/view/2014/6/13/652272.jpg,4,0.9883841872215272,679,1062,1275,1658,596,596,apple bloom|applejack|babs seed|big macintosh|braeburn|cutie mark crusaders|discord|fluttershy|granny smith|mane six|pinkie pie|princess cadance|princess celestia|princess luna|queen chrysalis|rainbow dash|rarity|scootaloo|shining armor|soarin'|spike|spitfire|sunset shimmer|sweetie belle|trixie|twilight sparkle,spainfischer|kenket
652272.jpg,https://derpicdn.net/img/view/2014/6/13/652272.jpg,5,0.9848228096961976,3189,1180,3555,1546,366,366,apple bloom|applejack|babs seed|big macintosh|braeburn|cutie mark crusaders|discord|fluttershy|granny smith|mane six|pinkie pie|princess cadance|princess celestia|princess luna|queen chrysalis|rainbow dash|rarity|scootaloo|shining armor|soarin'|spike|spitfire|sunset shimmer|sweetie belle|trixie|twilight sparkle,spainfischer|kenket
652272.jpg,https://derpicdn.net/img/view/2014/6/13/652272.jpg,7,0.9816372990608216,3249,818,3555,1124,306,306,apple bloom|applejack|babs seed|big macintosh|braeburn|cutie mark crusaders|discord|fluttershy|granny smith|mane six|pinkie pie|princess cadance|princess celestia|princess luna|queen chrysalis|rainbow dash|rarity|scootaloo|shining armor|soarin'|spike|spitfire|sunset shimmer|sweetie belle|trixie|twilight sparkle,spainfischer|kenket
652272.jpg,https://derpicdn.net/img/view/2014/6/13/652272.jpg,8,0.9809173941612244,409,1545,809,1945,400,400,apple bloom|applejack|babs seed|big macintosh|braeburn|cutie mark crusaders|discord|fluttershy|granny smith|mane six|pinkie pie|princess cadance|princess celestia|princess luna|queen chrysalis|rainbow dash|rarity|scootaloo|shining armor|soarin'|spike|spitfire|sunset shimmer|sweetie belle|trixie|twilight sparkle,spainfischer|kenket
652272.jpg,https://derpicdn.net/img/view/2014/6/13/652272.jpg,11,0.9618521332740784,3165,1562,3556,1994,391,432,apple bloom|applejack|babs seed|big macintosh|braeburn|cutie mark crusaders|discord|fluttershy|granny smith|mane six|pinkie pie|princess cadance|princess celestia|princess luna|queen chrysalis|rainbow dash|rarity|scootaloo|shining armor|soarin'|spike|spitfire|sunset shimmer|sweetie belle|trixie|twilight sparkle,spainfischer|kenket
652272.jpg,https://derpicdn.net/img/view/2014/6/13/652272.jpg,12,0.9609054923057556,2384,793,2782,1191,398,398,apple bloom|applejack|babs seed|big macintosh|braeburn|cutie mark crusaders|discord|fluttershy|granny smith|mane six|pinkie pie|princess cadance|princess celestia|princess luna|queen chrysalis|rainbow dash|rarity|scootaloo|shining armor|soarin'|spike|spitfire|sunset shimmer|sweetie belle|trixie|twilight sparkle,spainfischer|kenket
652272.jpg,https://derpicdn.net/img/view/2014/6/13/652272.jpg,13,0.9590571522712708,1911,702,2483,1274,572,572,apple bloom|applejack|babs seed|big macintosh|braeburn|cutie mark crusaders|discord|fluttershy|granny smith|mane six|pinkie pie|princess cadance|princess celestia|princess luna|queen chrysalis|rainbow dash|rarity|scootaloo|shining armor|soarin'|spike|spitfire|sunset shimmer|sweetie belle|trixie|twilight sparkle,spainfischer|kenket
652272.jpg,https://derpicdn.net/img/view/2014/6/13/652272.jpg,14,0.9489402770996094,2767,707,3285,1225,518,518,apple bloom|applejack|babs seed|big macintosh|braeburn|cutie mark crusaders|discord|fluttershy|granny smith|mane six|pinkie pie|princess cadance|princess celestia|princess luna|queen chrysalis|rainbow dash|rarity|scootaloo|shining armor|soarin'|spike|spitfire|sunset shimmer|sweetie belle|trixie|twilight sparkle,spainfischer|kenket
652272.jpg,https://derpicdn.net/img/view/2014/6/13/652272.jpg,15,0.9475934505462646,1529,0,2111,466,582,466,apple bloom|applejack|babs seed|big macintosh|braeburn|cutie mark crusaders|discord|fluttershy|granny smith|mane six|pinkie pie|princess cadance|princess celestia|princess luna|queen chrysalis|rainbow dash|rarity|scootaloo|shining armor|soarin'|spike|spitfire|sunset shimmer|sweetie belle|trixie|twilight sparkle,spainfischer|kenket
652272.jpg,https://derpicdn.net/img/view/2014/6/13/652272.jpg,16,0.9445895552635192,2762,1509,3320,2000,558,491,apple bloom|applejack|babs seed|big macintosh|braeburn|cutie mark crusaders|discord|fluttershy|granny smith|mane six|pinkie pie|princess cadance|princess celestia|princess luna|queen chrysalis|rainbow dash|rarity|scootaloo|shining armor|soarin'|spike|spitfire|sunset shimmer|sweetie belle|trixie|twilight sparkle,spainfischer|kenket
652272.jpg,https://derpicdn.net/img/view/2014/6/13/652272.jpg,19,0.9348368048667908,8,393,388,773,380,380,apple bloom|applejack|babs seed|big macintosh|braeburn|cutie mark crusaders|discord|fluttershy|granny smith|mane six|pinkie pie|princess cadance|princess celestia|princess luna|queen chrysalis|rainbow dash|rarity|scootaloo|shining armor|soarin'|spike|spitfire|sunset shimmer|sweetie belle|trixie|twilight sparkle,spainfischer|kenket
652272.jpg,https://derpicdn.net/img/view/2014/6/13/652272.jpg,20,0.9234234094619752,2718,298,3210,790,492,492,apple bloom|applejack|babs seed|big macintosh|braeburn|cutie mark crusaders|discord|fluttershy|granny smith|mane six|pinkie pie|princess cadance|princess celestia|princess luna|queen chrysalis|rainbow dash|rarity|scootaloo|shining armor|soarin'|spike|spitfire|sunset shimmer|sweetie belle|trixie|twilight sparkle,spainfischer|kenket
652272.jpg,https://derpicdn.net/img/view/2014/6/13/652272.jpg,22,0.9146532416343688,3144,0,3556,390,412,390,apple bloom|applejack|babs seed|big macintosh|braeburn|cutie mark crusaders|discord|fluttershy|granny smith|mane six|pinkie pie|princess cadance|princess celestia|princess luna|queen chrysalis|rainbow dash|rarity|scootaloo|shining armor|soarin'|spike|spitfire|sunset shimmer|sweetie belle|trixie|twilight sparkle,spainfischer|kenket
6523.png,https://derpicdn.net/img/view/2012/6/18/6523.png,0,0.975652813911438,735,239,1175,679,440,440,princess celestia|twilight sparkle,probablyfakeblonde
652511.png,https://derpicdn.net/img/view/2014/6/13/652511.png,0,0.9697558283805848,88,0,484,381,396,381,spike|twilight sparkle,ctb-36
652700.png,https://derpicdn.net/img/view/2014/6/14/652700.png,0,0.9971070289611816,9,0,759,664,750,664,trixie|twilight sparkle,haxorus31
654492.png,https://derpicdn.net/img/view/2014/6/16/654492.png,0,0.9729267358779908,663,81,973,391,310,310,applejack|fluttershy|mane six|pinkie pie|rainbow dash|rarity|twilight sparkle,mrscroup
656154.png,https://derpicdn.net/img/view/2014/6/18/656154.png,1,0.9707921147346495,712,791,1220,1299,508,508,applejack|fluttershy|mane six|pinkie pie|rainbow dash|rarity|twilight sparkle,duop-qoub
656877.png,https://derpicdn.net/img/view/2014/6/19/656877.png,0,0.9944037199020386,1029,1085,1645,1701,616,616,applejack|fluttershy|mane six|pinkie pie|rainbow dash|rarity|twilight sparkle,misspolycysticovary
657796.png,https://derpicdn.net/img/view/2014/6/20/657796.png,0,0.9912782311439514,1082,365,1782,1065,700,700,princess celestia|princess luna|twilight sparkle,vavacung
657796.png,https://derpicdn.net/img/view/2014/6/20/657796.png,1,0.9787153601646424,70,83,506,519,436,436,princess celestia|princess luna|twilight sparkle,vavacung
657796.png,https://derpicdn.net/img/view/2014/6/20/657796.png,2,0.9692859649658204,749,509,1141,901,392,392,princess celestia|princess luna|twilight sparkle,vavacung
659145.jpg,https://derpicdn.net/img/view/2014/6/22/659145.jpg,0,0.9938399195671082,576,63,1134,621,558,558,princess cadance|princess celestia|princess luna|twilight sparkle,snapai
659145.jpg,https://derpicdn.net/img/view/2014/6/22/659145.jpg,1,0.987135887145996,2,55,584,637,582,582,princess cadance|princess celestia|princess luna|twilight sparkle,snapai
660865.png,https://derpicdn.net/img/view/2014/6/24/660865.png,0,0.9902490973472596,195,115,775,695,580,580,trixie|twilight sparkle,fortum-flame|ponyguy67
661167.png,https://derpicdn.net/img/view/2014/6/25/661167.png,0,0.9954527616500854,448,391,838,781,390,390,rarity|spike|sweetie belle|twilight sparkle,annakitsun3
662374.png,https://derpicdn.net/img/view/2014/6/27/662374.png,0,0.9558826088905334,632,158,1410,936,778,778,applejack|fluttershy|mane six|pinkie pie|rainbow dash|rarity|twilight sparkle,mrbrandonmac
663742.png,https://derpicdn.net/img/view/2014/6/29/663742.png,0,0.9811179041862488,673,1825,1341,2493,668,668,applejack|fluttershy|mane six|pinkie pie|rainbow dash|rarity|twilight sparkle,pixel-prism
663742.png,https://derpicdn.net/img/view/2014/6/29/663742.png,1,0.9679517149925232,1030,1245,1738,1953,708,708,applejack|fluttershy|mane six|pinkie pie|rainbow dash|rarity|twilight sparkle,pixel-prism
663988.png,https://derpicdn.net/img/view/2014/6/29/663988.png,0,0.992740035057068,183,194,383,394,200,200,discord|fluttershy|pinkie pie|twilight sparkle,pepooni
66435.jpg,https://derpicdn.net/img/view/2012/8/4/66435.jpg,1,0.9638909101486206,504,0,838,297,334,297,applejack|fluttershy|mane six|pinkie pie|princess celestia|rainbow dash|rarity|shining armor|twilight sparkle,madmax
66435.jpg,https://derpicdn.net/img/view/2012/8/4/66435.jpg,2,0.9583753943443298,444,271,710,537,266,266,applejack|fluttershy|mane six|pinkie pie|princess celestia|rainbow dash|rarity|shining armor|twilight sparkle,madmax
667038.png,https://derpicdn.net/img/view/2014/7/4/667038.png,0,0.9491283893585204,119,0,459,327,340,327,shining armor|spike|twilight sparkle,frist44
670140.png,https://derpicdn.net/img/view/2014/7/8/670140.png,0,0.9815049171447754,313,204,583,474,270,270,princess cadance|princess celestia|princess luna|twilight sparkle,meekcheep
670140.png,https://derpicdn.net/img/view/2014/7/8/670140.png,1,0.9293782114982604,125,289,413,577,288,288,princess cadance|princess celestia|princess luna|twilight sparkle,meekcheep
670943.png,https://derpicdn.net/img/view/2014/7/9/670943.png,0,0.9379280805587769,135,87,327,279,192,192,fluttershy|pinkie pie|rainbow dash|twilight sparkle,mousu
674476.png,https://derpicdn.net/img/view/2014/7/14/674476.png,0,0.93452650308609,0,0,1025,720,1025,720,spike|twilight sparkle,
675941.png,https://derpicdn.net/img/view/2014/7/16/675941.png,0,0.9989268183708192,36,700,516,1180,480,480,princess cadance|princess celestia|shining armor|twilight sparkle,vavacung
676308.png,https://derpicdn.net/img/view/2014/7/16/676308.png,0,0.9966637492179872,633,181,1024,583,391,402,rainbow dash|twilight sparkle,37517998
676924.png,https://derpicdn.net/img/view/2014/7/17/676924.png,0,0.990425705909729,139,438,455,754,316,316,fluttershy|rainbow dash|twilight sparkle,mlpanon
677064.png,https://derpicdn.net/img/view/2014/7/17/677064.png,1,0.9969736933708192,50,105,638,693,588,588,pinkie pie|twilight sparkle,kaermter
6785.jpg,https://derpicdn.net/img/view/2012/6/18/6785.jpg,0,0.93549245595932,545,431,983,869,438,438,applejack|rainbow dash|twilight sparkle,elosande|dalapony
679051.png,https://derpicdn.net/img/view/2014/7/20/679051.png,1,0.9973358511924744,1644,0,4340,2338,2696,2338,applejack|fluttershy|mane six|pinkie pie|rainbow dash|rarity|spike|twilight sparkle,caliazian
679051.png,https://derpicdn.net/img/view/2014/7/20/679051.png,2,0.9641158580780028,4540,3738,6482,5680,1942,1942,applejack|fluttershy|mane six|pinkie pie|rainbow dash|rarity|spike|twilight sparkle,caliazian
680135.png,https://derpicdn.net/img/view/2014/7/21/680135.png,0,0.988021969795227,162,776,780,1394,618,618,applejack|fluttershy|mane six|pinkie pie|rainbow dash|rarity|twilight sparkle,looji
680135.png,https://derpicdn.net/img/view/2014/7/21/680135.png,1,0.9860218167304992,614,838,1280,1504,666,666,applejack|fluttershy|mane six|pinkie pie|rainbow dash|rarity|twilight sparkle,looji
680135.png,https://derpicdn.net/img/view/2014/7/21/680135.png,3,0.9175280928611756,267,0,659,391,392,391,applejack|fluttershy|mane six|pinkie pie|rainbow dash|rarity|twilight sparkle,looji
68047.png,https://derpicdn.net/img/view/2012/8/6/68047.png,0,0.9867274165153505,367,376,1563,1572,1196,1196,applejack|twilight sparkle,spittfireart
681037.png,https://derpicdn.net/img/view/2014/7/22/681037.png,0,0.9860849976539612,646,883,1192,1429,546,546,applejack|fluttershy|mane six|pinkie pie|rainbow dash|rarity|spike|twilight sparkle,boomythemc|earthsong9405
681037.png,https://derpicdn.net/img/view/2014/7/22/681037.png,2,0.9354319572448728,0,656,594,1266,594,610,applejack|fluttershy|mane six|pinkie pie|rainbow dash|rarity|spike|twilight sparkle,boomythemc|earthsong9405
681037.png,https://derpicdn.net/img/view/2014/7/22/681037.png,3,0.9069077968597412,1156,570,1644,1058,488,488,applejack|fluttershy|mane six|pinkie pie|rainbow dash|rarity|spike|twilight sparkle,boomythemc|earthsong9405
682187.png,https://derpicdn.net/img/view/2014/7/24/682187.png,0,0.9811126589775084,110,51,334,275,224,224,applejack|fluttershy|mane six|pinkie pie|rainbow dash|rarity|twilight sparkle,pepooni
683759.png,https://derpicdn.net/img/view/2014/7/26/683759.png,0,0.9449740052223206,578,0,920,322,342,322,princess cadance|shining armor|twilight sparkle,dm29
683880.jpg,https://derpicdn.net/img/view/2014/7/26/683880.jpg,0,0.9989032745361328,18,1,256,239,238,238,applejack|fluttershy|mane six|pinkie pie|rainbow dash|rarity|twilight sparkle,yulyeen
683880.jpg,https://derpicdn.net/img/view/2014/7/26/683880.jpg,1,0.9950861930847168,512,360,732,580,220,220,applejack|fluttershy|mane six|pinkie pie|rainbow dash|rarity|twilight sparkle,yulyeen
683880.jpg,https://derpicdn.net/img/view/2014/7/26/683880.jpg,2,0.992645800113678,280,0,464,183,184,183,applejack|fluttershy|mane six|pinkie pie|rainbow dash|rarity|twilight sparkle,yulyeen
683880.jpg,https://derpicdn.net/img/view/2014/7/26/683880.jpg,3,0.987608790397644,1257,0,1481,219,224,219,applejack|fluttershy|mane six|pinkie pie|rainbow dash|rarity|twilight sparkle,yulyeen
683880.jpg,https://derpicdn.net/img/view/2014/7/26/683880.jpg,5,0.9587899446487428,798,9,976,187,178,178,applejack|fluttershy|mane six|pinkie pie|rainbow dash|rarity|twilight sparkle,yulyeen
683880.jpg,https://derpicdn.net/img/view/2014/7/26/683880.jpg,7,0.9495701193809508,787,368,963,544,176,176,applejack|fluttershy|mane six|pinkie pie|rainbow dash|rarity|twilight sparkle,yulyeen
683880.jpg,https://derpicdn.net/img/view/2014/7/26/683880.jpg,8,0.91327303647995,1229,330,1495,596,266,266,applejack|fluttershy|mane six|pinkie pie|rainbow dash|rarity|twilight sparkle,yulyeen
685319.png,https://derpicdn.net/img/view/2014/7/28/685319.png,1,0.9336642026901244,676,400,840,564,164,164,applejack|big macintosh|fluttershy|mane six|pinkie pie|rainbow dash|rarity|spike|twilight sparkle,metal-kitty
68657.png,https://derpicdn.net/img/view/2012/8/6/68657.png,0,0.99580055475235,879,1127,1087,1335,208,208,applejack|fluttershy|mane six|pinkie pie|rainbow dash|rarity|twilight sparkle,atryl
68657.png,https://derpicdn.net/img/view/2012/8/6/68657.png,4,0.9231252670288086,388,1083,614,1309,226,226,applejack|fluttershy|mane six|pinkie pie|rainbow dash|rarity|twilight sparkle,atryl
686686.png,https://derpicdn.net/img/view/2014/7/30/686686.png,0,0.9986430406570436,104,602,500,998,396,396,rarity|sunset shimmer|trixie|twilight sparkle,reimon-master-ii|ponyguy67
686686.png,https://derpicdn.net/img/view/2014/7/30/686686.png,1,0.9944102168083192,1152,176,1540,564,388,388,rarity|sunset shimmer|trixie|twilight sparkle,reimon-master-ii|ponyguy67
688965.png,https://derpicdn.net/img/view/2014/8/2/688965.png,0,0.955491542816162,0,69,205,299,205,230,princess luna|twilight sparkle,lulubell
690276.jpg,https://derpicdn.net/img/view/2014/8/3/690276.jpg,0,0.9630199670791626,11,207,923,1119,912,912,sunset shimmer|twilight sparkle,awengrocks|barbeque
690720.png,https://derpicdn.net/img/view/2014/8/4/690720.png,0,0.9904435276985168,114,194,312,392,198,198,applejack|fluttershy|mane six|pinkie pie|rainbow dash|rarity|twilight sparkle,alidythera
692141.png,https://derpicdn.net/img/view/2014/8/5/692141.png,0,0.999093770980835,766,35,982,251,216,216,applejack|fluttershy|mane six|pinkie pie|rainbow dash|rarity|twilight sparkle,mochaspar
692141.png,https://derpicdn.net/img/view/2014/8/5/692141.png,1,0.9949113130569458,0,19,206,227,206,208,applejack|fluttershy|mane six|pinkie pie|rainbow dash|rarity|twilight sparkle,mochaspar
692141.png,https://derpicdn.net/img/view/2014/8/5/692141.png,2,0.9635907411575316,149,144,347,342,198,198,applejack|fluttershy|mane six|pinkie pie|rainbow dash|rarity|twilight sparkle,mochaspar
695614.png,https://derpicdn.net/img/view/2014/8/9/695614.png,0,0.9992534518241882,50,30,410,390,360,360,rainbow dash|twilight sparkle,lucidlarceny
695614.png,https://derpicdn.net/img/view/2014/8/9/695614.png,1,0.9797911643981934,394,44,692,342,298,298,rainbow dash|twilight sparkle,lucidlarceny
697593.png,https://derpicdn.net/img/view/2014/8/11/697593.png,0,0.9824867844581604,935,0,2560,1454,1625,1454,rainbow dash|twilight sparkle,ambris
697593.png,https://derpicdn.net/img/view/2014/8/11/697593.png,1,0.9573195576667786,116,72,1364,1320,1248,1248,rainbow dash|twilight sparkle,ambris
698140.png,https://derpicdn.net/img/view/2014/8/12/698140.png,0,0.9911896586418152,3825,796,4735,1706,910,910,applejack|fluttershy|mane six|pinkie pie|rainbow dash|rarity|twilight sparkle,hawthornss
698140.png,https://derpicdn.net/img/view/2014/8/12/698140.png,1,0.9819947481155396,395,0,1715,1254,1320,1254,applejack|fluttershy|mane six|pinkie pie|rainbow dash|rarity|twilight sparkle,hawthornss
698140.png,https://derpicdn.net/img/view/2014/8/12/698140.png,2,0.9552019238471984,1869,410,2705,1246,836,836,applejack|fluttershy|mane six|pinkie pie|rainbow dash|rarity|twilight sparkle,hawthornss
698180.png,https://derpicdn.net/img/view/2014/8/12/698180.png,0,0.9750499725341796,584,98,1222,736,638,638,sunset shimmer|twilight sparkle,php92
700.png,https://derpicdn.net/img/view/2012/1/17/700.png,0,0.9729347229003906,211,135,1127,1051,916,916,spike|twilight sparkle,snufflin
701578.png,https://derpicdn.net/img/view/2014/8/17/701578.png,0,0.9191714525222778,1274,93,1880,699,606,606,fluttershy|pinkie pie|princess celestia|twilight sparkle,ferexes
701578.png,https://derpicdn.net/img/view/2014/8/17/701578.png,1,0.9007667899131776,248,106,746,604,498,498,fluttershy|pinkie pie|princess celestia|twilight sparkle,ferexes
701748.png,https://derpicdn.net/img/view/2014/8/17/701748.png,1,0.9899023175239564,0,202,345,562,345,360,shining armor|twilight sparkle,empyu
704502.png,https://derpicdn.net/img/view/2014/8/21/704502.png,0,0.9948061108589172,677,88,1365,776,688,688,applejack|fluttershy|mane six|pinkie pie|rainbow dash|rarity|twilight sparkle,mushroomcookiebear
706634.png,https://derpicdn.net/img/view/2014/8/24/706634.png,0,0.967974066734314,0,5,357,387,357,382,princess luna|twilight sparkle,lulubell
707033.png,https://derpicdn.net/img/view/2014/8/24/707033.png,0,0.9402146339416504,274,0,632,326,358,326,rainbow dash|twilight sparkle,ravenpuff
708522.png,https://derpicdn.net/img/view/2014/8/26/708522.png,0,0.9932946562767028,30,24,386,380,356,356,rarity|twilight sparkle,catitty
710266.png,https://derpicdn.net/img/view/2014/8/29/710266.png,0,0.9749367237091064,44,641,214,811,170,170,braeburn|discord|fluttershy|rainbow dash|soarin'|twilight sparkle,megarexetera
710266.png,https://derpicdn.net/img/view/2014/8/29/710266.png,1,0.9408182501792908,195,0,377,178,182,178,braeburn|discord|fluttershy|rainbow dash|soarin'|twilight sparkle,megarexetera
710267.png,https://derpicdn.net/img/view/2014/8/29/710267.png,0,0.9947689175605774,61,0,273,204,212,204,applejack|pinkie pie|rarity|trixie|twilight sparkle,megarexetera
710267.png,https://derpicdn.net/img/view/2014/8/29/710267.png,3,0.9916450381278992,38,348,374,684,336,336,applejack|pinkie pie|rarity|trixie|twilight sparkle,megarexetera
710267.png,https://derpicdn.net/img/view/2014/8/29/710267.png,4,0.9832643270492554,135,824,305,994,170,170,applejack|pinkie pie|rarity|trixie|twilight sparkle,megarexetera
710267.png,https://derpicdn.net/img/view/2014/8/29/710267.png,6,0.9320726990699768,267,7,473,213,206,206,applejack|pinkie pie|rarity|trixie|twilight sparkle,megarexetera
713309.png,https://derpicdn.net/img/view/2014/9/2/713309.png,0,0.9923564195632936,523,4,1059,540,536,536,fluttershy|rarity|twilight sparkle,mlpanon
714595.png,https://derpicdn.net/img/view/2014/9/4/714595.png,0,0.968938410282135,359,160,609,410,250,250,fluttershy|pinkie pie|rainbow dash|rarity|twilight sparkle,az-pekt
714595.png,https://derpicdn.net/img/view/2014/9/4/714595.png,1,0.9614099264144896,1576,177,1846,447,270,270,fluttershy|pinkie pie|rainbow dash|rarity|twilight sparkle,az-pekt
714595.png,https://derpicdn.net/img/view/2014/9/4/714595.png,2,0.9439769387245178,1283,148,1543,408,260,260,fluttershy|pinkie pie|rainbow dash|rarity|twilight sparkle,az-pekt
717026.png,https://derpicdn.net/img/view/2014/9/7/717026.png,0,0.998583734035492,475,0,895,397,420,397,trixie|twilight sparkle,hawthornss
718668.jpg,https://derpicdn.net/img/view/2014/9/9/718668.jpg,0,0.9894070029258728,707,17,841,151,134,134,applejack|fluttershy|pinkie pie|princess cadance|rarity|shining armor|spitfire|sunset shimmer|trixie|twilight sparkle,keyfeathers
718668.jpg,https://derpicdn.net/img/view/2014/9/9/718668.jpg,1,0.9247666001319884,489,567,609,687,120,120,applejack|fluttershy|pinkie pie|princess cadance|rarity|shining armor|spitfire|sunset shimmer|trixie|twilight sparkle,keyfeathers
718668.jpg,https://derpicdn.net/img/view/2014/9/9/718668.jpg,2,0.9048474431037904,272,292,376,396,104,104,applejack|fluttershy|pinkie pie|princess cadance|rarity|shining armor|spitfire|sunset shimmer|trixie|twilight sparkle,keyfeathers
721099.png,https://derpicdn.net/img/view/2014/9/13/721099.png,0,0.996812105178833,590,46,994,450,404,404,trixie|twilight sparkle,catitty
72221.jpg,https://derpicdn.net/img/view/2012/8/11/72221.jpg,0,0.9984726309776306,326,368,642,684,316,316,fluttershy|pinkie pie|rainbow dash|rarity|twilight sparkle,doomy
72221.jpg,https://derpicdn.net/img/view/2012/8/11/72221.jpg,1,0.9475998282432556,937,466,1139,668,202,202,fluttershy|pinkie pie|rainbow dash|rarity|twilight sparkle,doomy
724032.png,https://derpicdn.net/img/view/2014/9/17/724032.png,0,0.9927223920822144,255,60,637,442,382,382,applejack|fluttershy|mane six|pinkie pie|rainbow dash|rarity|twilight sparkle,aleximusprime
724032.png,https://derpicdn.net/img/view/2014/9/17/724032.png,1,0.9849047660827636,800,894,1178,1272,378,378,applejack|fluttershy|mane six|pinkie pie|rainbow dash|rarity|twilight sparkle,aleximusprime
724032.png,https://derpicdn.net/img/view/2014/9/17/724032.png,2,0.9799402952194214,732,13,1140,421,408,408,applejack|fluttershy|mane six|pinkie pie|rainbow dash|rarity|twilight sparkle,aleximusprime
726407.png,https://derpicdn.net/img/view/2014/9/21/726407.png,1,0.972662389278412,628,37,1012,421,384,384,applejack|fluttershy|mane six|pinkie pie|rainbow dash|rarity|spike|twilight sparkle,novaquinmat
727701.png,https://derpicdn.net/img/view/2014/9/23/727701.png,0,0.9838199615478516,443,0,843,374,400,374,apple bloom|applejack|big macintosh|cutie mark crusaders|fluttershy|mane six|pinkie pie|rainbow dash|rarity|scootaloo|sweetie belle|trixie|twilight sparkle,kikirrikitiki
728878.png,https://derpicdn.net/img/view/2014/9/25/728878.png,0,0.9984848499298096,1,0,867,837,866,837,pinkie pie|rainbow dash|twilight sparkle,liggliluff|wjmmovieman
728878.png,https://derpicdn.net/img/view/2014/9/25/728878.png,1,0.9858471751213074,861,0,1635,728,774,728,pinkie pie|rainbow dash|twilight sparkle,liggliluff|wjmmovieman
728878.png,https://derpicdn.net/img/view/2014/9/25/728878.png,2,0.9720745682716372,1653,0,2599,856,946,856,pinkie pie|rainbow dash|twilight sparkle,liggliluff|wjmmovieman
730264.png,https://derpicdn.net/img/view/2014/9/27/730264.png,1,0.981357991695404,171,195,393,417,222,222,shining armor|twilight sparkle,junkyardgypsy
731435.png,https://derpicdn.net/img/view/2014/9/28/731435.png,0,0.9106870889663696,846,17,1150,321,304,304,trixie|twilight sparkle,drake
733144.png,https://derpicdn.net/img/view/2014/10/1/733144.png,0,0.99901020526886,372,92,576,296,204,204,applejack|fluttershy|mane six|pinkie pie|rainbow dash|rarity|twilight sparkle,placeholder
733144.png,https://derpicdn.net/img/view/2014/10/1/733144.png,1,0.9949147701263428,896,92,1098,294,202,202,applejack|fluttershy|mane six|pinkie pie|rainbow dash|rarity|twilight sparkle,placeholder
733144.png,https://derpicdn.net/img/view/2014/10/1/733144.png,3,0.9936794638633728,713,100,911,298,198,198,applejack|fluttershy|mane six|pinkie pie|rainbow dash|rarity|twilight sparkle,placeholder
734177.png,https://derpicdn.net/img/view/2014/10/2/734177.png,0,0.9900994300842284,95,0,487,375,392,375,sunset shimmer|twilight sparkle,gyaheung
734651.png,https://derpicdn.net/img/view/2014/10/3/734651.png,1,0.9893847703933716,874,508,1280,956,406,448,applejack|fluttershy|pinkie pie|rarity|twilight sparkle,rainbowscreen
736300.png,https://derpicdn.net/img/view/2014/10/5/736300.png,0,0.994377851486206,156,90,762,696,606,606,applejack|fluttershy|mane six|pinkie pie|rainbow dash|rarity|twilight sparkle,looji
736300.png,https://derpicdn.net/img/view/2014/10/5/736300.png,2,0.9162919521331788,3747,5,4600,865,853,860,applejack|fluttershy|mane six|pinkie pie|rainbow dash|rarity|twilight sparkle,looji
737700.png,https://derpicdn.net/img/view/2014/10/7/737700.png,0,0.9989832043647766,200,184,512,496,312,312,shining armor|twilight sparkle,carnivorouscaribou
737700.png,https://derpicdn.net/img/view/2014/10/7/737700.png,1,0.9955501556396484,361,0,731,350,370,350,shining armor|twilight sparkle,carnivorouscaribou
738684.jpg,https://derpicdn.net/img/view/2014/10/8/738684.jpg,0,0.968680202960968,297,374,457,534,160,160,applejack|discord|fluttershy|mane six|pinkie pie|princess celestia|princess luna|queen chrysalis|rainbow dash|rarity|spike|trixie|twilight sparkle,rikose
742259.png,https://derpicdn.net/img/view/2014/10/13/742259.png,0,0.9904196858406068,1120,737,1648,1265,528,528,applejack|fluttershy|mane six|pinkie pie|rainbow dash|rarity|twilight sparkle,jowybean
742729.png,https://derpicdn.net/img/view/2014/10/14/742729.png,0,0.9398173093795776,476,176,641,368,165,192,princess cadance|princess celestia|princess luna|twilight sparkle,lemmingluv
743223.png,https://derpicdn.net/img/view/2014/10/15/743223.png,0,0.9967604875564576,487,295,689,497,202,202,rainbow dash|twilight sparkle,ambris
743223.png,https://derpicdn.net/img/view/2014/10/15/743223.png,1,0.993955373764038,130,344,348,562,218,218,rainbow dash|twilight sparkle,ambris
743223.png,https://derpicdn.net/img/view/2014/10/15/743223.png,2,0.9349907636642456,28,446,200,618,172,172,rainbow dash|twilight sparkle,ambris
743223.png,https://derpicdn.net/img/view/2014/10/15/743223.png,3,0.932583510875702,313,400,511,598,198,198,rainbow dash|twilight sparkle,ambris
743445.png,https://derpicdn.net/img/view/2014/10/15/743445.png,0,0.9220069050788879,184,0,620,417,436,417,pinkie pie|twilight sparkle,
754242.png,https://derpicdn.net/img/view/2014/10/30/754242.png,0,0.9894750118255616,2038,83,2294,339,256,256,applejack|fluttershy|mane six|pinkie pie|rainbow dash|rarity|spike|twilight sparkle,blazetbw
754242.png,https://derpicdn.net/img/view/2014/10/30/754242.png,1,0.9281492829322816,927,58,1191,322,264,264,applejack|fluttershy|mane six|pinkie pie|rainbow dash|rarity|spike|twilight sparkle,blazetbw
754303.jpg,https://derpicdn.net/img/view/2014/10/31/754303.jpg,0,0.9458463191986084,740,145,1012,417,272,272,applejack|fluttershy|mane six|pinkie pie|rainbow dash|rarity|twilight sparkle,skjolty|kianamai
754303.jpg,https://derpicdn.net/img/view/2014/10/31/754303.jpg,1,0.929620087146759,1352,236,1590,474,238,238,applejack|fluttershy|mane six|pinkie pie|rainbow dash|rarity|twilight sparkle,skjolty|kianamai
754581.png,https://derpicdn.net/img/view/2014/10/31/754581.png,0,0.993248462677002,848,0,1310,405,462,405,applejack|fluttershy|mane six|pinkie pie|rainbow dash|rarity|spike|twilight sparkle,dm29
754766.png,https://derpicdn.net/img/view/2014/10/31/754766.png,1,0.9876520037651062,829,0,1215,375,386,375,applejack|fluttershy|mane six|pinkie pie|rainbow dash|rarity|spike|twilight sparkle,jackwrench
754767.png,https://derpicdn.net/img/view/2014/10/31/754767.png,0,0.9880585670471193,206,119,1340,1253,1134,1134,princess celestia|twilight sparkle,zacatron94
755493.png,https://derpicdn.net/img/view/2014/11/1/755493.png,0,0.9908185601234436,252,59,538,345,286,286,sunset shimmer|twilight sparkle,tami-kitten
755578.png,https://derpicdn.net/img/view/2014/11/1/755578.png,0,0.9714139103889464,52,60,418,426,366,366,rarity|twilight sparkle,twirity
760249.png,https://derpicdn.net/img/view/2014/11/8/760249.png,0,0.9824355244636536,26,312,196,482,170,170,applejack|fluttershy|mane six|pinkie pie|rainbow dash|rarity|twilight sparkle,stepandy
760627.jpg,https://derpicdn.net/img/view/2014/11/8/760627.jpg,0,0.9783263206481934,849,980,1637,1768,788,788,princess celestia|twilight sparkle,demorgorgon
761883.png,https://derpicdn.net/img/view/2014/11/10/761883.png,0,0.9736610054969788,286,56,434,204,148,148,princess cadance|princess celestia|queen chrysalis|twilight sparkle,mixermike622
762455.jpg,https://derpicdn.net/img/view/2014/11/11/762455.jpg,1,0.9970881938934326,823,266,1121,564,298,298,fluttershy|pinkie pie|rainbow dash|trixie|twilight sparkle,cyanaeolin
763790.png,https://derpicdn.net/img/view/2014/11/13/763790.png,0,0.97673499584198,124,773,282,931,158,158,apple bloom|applejack|babs seed|big macintosh|braeburn|diamond tiara|discord|fluttershy|granny smith|lightning dust|pinkie pie|princess cadance|princess celestia|princess luna|queen chrysalis|rainbow dash|rarity|scootaloo|shining armor|silver spoon|spike|spitfire|sunset shimmer|sweetie belle|trixie|twilight sparkle,amy mebberson
763790.png,https://derpicdn.net/img/view/2014/11/13/763790.png,1,0.9714208841323853,778,899,938,1059,160,160,apple bloom|applejack|babs seed|big macintosh|braeburn|diamond tiara|discord|fluttershy|granny smith|lightning dust|pinkie pie|princess cadance|princess celestia|princess luna|queen chrysalis|rainbow dash|rarity|scootaloo|shining armor|silver spoon|spike|spitfire|sunset shimmer|sweetie belle|trixie|twilight sparkle,amy mebberson
763790.png,https://derpicdn.net/img/view/2014/11/13/763790.png,2,0.96448415517807,498,753,694,949,196,196,apple bloom|applejack|babs seed|big macintosh|braeburn|diamond tiara|discord|fluttershy|granny smith|lightning dust|pinkie pie|princess cadance|princess celestia|princess luna|queen chrysalis|rainbow dash|rarity|scootaloo|shining armor|silver spoon|spike|spitfire|sunset shimmer|sweetie belle|trixie|twilight sparkle,amy mebberson
763790.png,https://derpicdn.net/img/view/2014/11/13/763790.png,3,0.9345797896385192,511,192,691,372,180,180,apple bloom|applejack|babs seed|big macintosh|braeburn|diamond tiara|discord|fluttershy|granny smith|lightning dust|pinkie pie|princess cadance|princess celestia|princess luna|queen chrysalis|rainbow dash|rarity|scootaloo|shining armor|silver spoon|spike|spitfire|sunset shimmer|sweetie belle|trixie|twilight sparkle,amy mebberson
763790.png,https://derpicdn.net/img/view/2014/11/13/763790.png,4,0.9049115777015686,190,351,368,529,178,178,apple bloom|applejack|babs seed|big macintosh|braeburn|diamond tiara|discord|fluttershy|granny smith|lightning dust|pinkie pie|princess cadance|princess celestia|princess luna|queen chrysalis|rainbow dash|rarity|scootaloo|shining armor|silver spoon|spike|spitfire|sunset shimmer|sweetie belle|trixie|twilight sparkle,amy mebberson
767241.png,https://derpicdn.net/img/view/2014/11/18/767241.png,0,0.9593796133995056,1142,767,1380,1005,238,238,princess cadance|princess celestia|princess luna|twilight sparkle,dutchgirl626|rosieu
767339.png,https://derpicdn.net/img/view/2014/11/19/767339.png,0,0.9970645308494568,838,201,1074,437,236,236,applejack|fluttershy|mane six|pinkie pie|rainbow dash|rarity|spike|twilight sparkle,pomnoi
767339.png,https://derpicdn.net/img/view/2014/11/19/767339.png,1,0.9848670363426208,327,207,555,435,228,228,applejack|fluttershy|mane six|pinkie pie|rainbow dash|rarity|spike|twilight sparkle,pomnoi
767339.png,https://derpicdn.net/img/view/2014/11/19/767339.png,3,0.9261786937713624,1033,200,1265,432,232,232,applejack|fluttershy|mane six|pinkie pie|rainbow dash|rarity|spike|twilight sparkle,pomnoi
769219.jpg,https://derpicdn.net/img/view/2014/11/22/769219.jpg,0,0.9990500807762146,202,1272,758,1828,556,556,applejack|fluttershy|mane six|pinkie pie|rainbow dash|rarity|twilight sparkle,joakaha
769219.jpg,https://derpicdn.net/img/view/2014/11/22/769219.jpg,1,0.99576073884964,1932,85,2474,627,542,542,applejack|fluttershy|mane six|pinkie pie|rainbow dash|rarity|twilight sparkle,joakaha
769219.jpg,https://derpicdn.net/img/view/2014/11/22/769219.jpg,2,0.9934987425804138,1008,48,1576,616,568,568,applejack|fluttershy|mane six|pinkie pie|rainbow dash|rarity|twilight sparkle,joakaha
769219.jpg,https://derpicdn.net/img/view/2014/11/22/769219.jpg,3,0.9867966175079346,53,29,695,671,642,642,applejack|fluttershy|mane six|pinkie pie|rainbow dash|rarity|twilight sparkle,joakaha
769219.jpg,https://derpicdn.net/img/view/2014/11/22/769219.jpg,5,0.9598885774612428,1971,1289,2503,1821,532,532,applejack|fluttershy|mane six|pinkie pie|rainbow dash|rarity|twilight sparkle,joakaha
771295.png,https://derpicdn.net/img/view/2014/11/24/771295.png,0,0.9190850853919984,239,127,471,359,232,232,pinkie pie|rarity|spike|twilight sparkle,ctb-36
771295.png,https://derpicdn.net/img/view/2014/11/24/771295.png,1,0.9072393774986268,591,480,781,670,190,190,pinkie pie|rarity|spike|twilight sparkle,ctb-36
772573.png,https://derpicdn.net/img/view/2014/11/27/772573.png,0,0.9945645332336426,234,451,856,1073,622,622,princess celestia|twilight sparkle,mutant-girl013|kianamai
772573.png,https://derpicdn.net/img/view/2014/11/27/772573.png,1,0.9944011569023132,990,58,1700,768,710,710,princess celestia|twilight sparkle,mutant-girl013|kianamai
774450.png,https://derpicdn.net/img/view/2014/11/29/774450.png,0,0.9825000762939452,0,49,987,1053,987,1004,princess cadance|twilight sparkle,
77469.jpg,https://derpicdn.net/img/view/2012/8/18/77469.jpg,0,0.9813171625137328,149,732,655,1238,506,506,apple bloom|applejack|big macintosh|discord|fluttershy|mane six|pinkie pie|princess cadance|princess celestia|princess luna|queen chrysalis|rainbow dash|rarity|scootaloo|shining armor|soarin'|spitfire|sweetie belle|twilight sparkle,philo5
77469.jpg,https://derpicdn.net/img/view/2012/8/18/77469.jpg,1,0.9808871746063232,1448,466,1752,770,304,304,apple bloom|applejack|big macintosh|discord|fluttershy|mane six|pinkie pie|princess cadance|princess celestia|princess luna|queen chrysalis|rainbow dash|rarity|scootaloo|shining armor|soarin'|spitfire|sweetie belle|twilight sparkle,philo5
779529.png,https://derpicdn.net/img/view/2014/12/6/779529.png,0,0.9685158729553224,1185,1371,1645,1831,460,460,princess luna|twilight sparkle,neko-me
779860.png,https://derpicdn.net/img/view/2014/12/7/779860.png,0,0.9970117211341858,853,0,1755,691,902,691,applejack|fluttershy|mane six|pinkie pie|rainbow dash|rarity|twilight sparkle,whatsapokemon
781420.png,https://derpicdn.net/img/view/2014/12/9/781420.png,0,0.9379934668540956,351,209,557,415,206,206,applejack|fluttershy|mane six|pinkie pie|rainbow dash|rarity|twilight sparkle,pixelkitties
781463.png,https://derpicdn.net/img/view/2014/12/9/781463.png,0,0.9927476644515992,533,276,697,440,164,164,big macintosh|twilight sparkle,metal-kitty
782383.jpg,https://derpicdn.net/img/view/2014/12/10/782383.jpg,0,0.9997233748435974,685,0,1024,298,339,298,applejack|fluttershy|mane six|pinkie pie|rainbow dash|rarity|twilight sparkle,dobado
782383.jpg,https://derpicdn.net/img/view/2014/12/10/782383.jpg,1,0.9995205998420716,3,0,333,302,330,302,applejack|fluttershy|mane six|pinkie pie|rainbow dash|rarity|twilight sparkle,dobado
782383.jpg,https://derpicdn.net/img/view/2014/12/10/782383.jpg,2,0.9897151589393616,274,275,738,682,464,407,applejack|fluttershy|mane six|pinkie pie|rainbow dash|rarity|twilight sparkle,dobado
782832.png,https://derpicdn.net/img/view/2014/12/11/782832.png,0,0.9994491934776306,146,1900,1830,3584,1684,1684,applejack|fluttershy|mane six|pinkie pie|rainbow dash|rarity|twilight sparkle,corelle-vairel
782832.png,https://derpicdn.net/img/view/2014/12/11/782832.png,1,0.9978992342948914,3683,0,5131,1413,1448,1413,applejack|fluttershy|mane six|pinkie pie|rainbow dash|rarity|twilight sparkle,corelle-vairel
782832.png,https://derpicdn.net/img/view/2014/12/11/782832.png,2,0.9976942539215088,146,4195,1914,5963,1768,1768,applejack|fluttershy|mane six|pinkie pie|rainbow dash|rarity|twilight sparkle,corelle-vairel
782832.png,https://derpicdn.net/img/view/2014/12/11/782832.png,3,0.9975806474685668,187,0,1711,1455,1524,1455,applejack|fluttershy|mane six|pinkie pie|rainbow dash|rarity|twilight sparkle,corelle-vairel
782832.png,https://derpicdn.net/img/view/2014/12/11/782832.png,4,0.9916961193084716,2607,4088,4183,5664,1576,1576,applejack|fluttershy|mane six|pinkie pie|rainbow dash|rarity|twilight sparkle,corelle-vairel
782832.png,https://derpicdn.net/img/view/2014/12/11/782832.png,5,0.9259359836578368,3519,2296,4909,3686,1390,1390,applejack|fluttershy|mane six|pinkie pie|rainbow dash|rarity|twilight sparkle,corelle-vairel
783476.png,https://derpicdn.net/img/view/2014/12/12/783476.png,0,0.9783223271369934,397,252,557,412,160,160,applejack|fluttershy|mane six|pinkie pie|rainbow dash|rarity|twilight sparkle,dsana
784463.png,https://derpicdn.net/img/view/2014/12/14/784463.png,0,0.9844096899032592,186,357,502,673,316,316,applejack|twilight sparkle,pixelkitties
785311.png,https://derpicdn.net/img/view/2014/12/15/785311.png,0,0.9839691519737244,3,2869,1399,4265,1396,1396,applejack|fluttershy|mane six|pinkie pie|rainbow dash|rarity|twilight sparkle,ladypixelheart
785311.png,https://derpicdn.net/img/view/2014/12/15/785311.png,1,0.9328421950340272,1703,1405,2775,2477,1072,1072,applejack|fluttershy|mane six|pinkie pie|rainbow dash|rarity|twilight sparkle,ladypixelheart
786891.png,https://derpicdn.net/img/view/2014/12/17/786891.png,0,0.9993255138397216,15,31,719,735,704,704,applejack|fluttershy|mane six|pinkie pie|rainbow dash|rarity|twilight sparkle,dtcx97
786891.png,https://derpicdn.net/img/view/2014/12/17/786891.png,1,0.9822921752929688,634,715,1515,1639,881,924,applejack|fluttershy|mane six|pinkie pie|rainbow dash|rarity|twilight sparkle,dtcx97
786891.png,https://derpicdn.net/img/view/2014/12/17/786891.png,2,0.9815437793731692,0,656,888,1650,888,994,applejack|fluttershy|mane six|pinkie pie|rainbow dash|rarity|twilight sparkle,dtcx97
786891.png,https://derpicdn.net/img/view/2014/12/17/786891.png,3,0.9654805064201356,774,1535,1482,2243,708,708,applejack|fluttershy|mane six|pinkie pie|rainbow dash|rarity|twilight sparkle,dtcx97
786891.png,https://derpicdn.net/img/view/2014/12/17/786891.png,4,0.9653540849685668,14,1535,744,2260,730,725,applejack|fluttershy|mane six|pinkie pie|rainbow dash|rarity|twilight sparkle,dtcx97
790222.png,https://derpicdn.net/img/view/2014/12/22/790222.png,0,0.9782413244247437,318,435,606,723,288,288,rainbow dash|soarin'|twilight sparkle,dm29
791182.png,https://derpicdn.net/img/view/2014/12/23/791182.png,0,0.9959042072296144,91,257,287,453,196,196,applejack|discord|fluttershy|mane six|pinkie pie|rainbow dash|rarity|spike|twilight sparkle,inuhoshi-to-darkpen
791182.png,https://derpicdn.net/img/view/2014/12/23/791182.png,1,0.9928766489028932,237,244,451,458,214,214,applejack|discord|fluttershy|mane six|pinkie pie|rainbow dash|rarity|spike|twilight sparkle,inuhoshi-to-darkpen
792487.png,https://derpicdn.net/img/view/2014/12/25/792487.png,0,0.9933093786239624,583,0,961,333,378,333,applejack|fluttershy|mane six|pinkie pie|princess cadance|rainbow dash|rarity|shining armor|spike|twilight sparkle,dm29
796187.png,https://derpicdn.net/img/view/2014/12/30/796187.png,0,0.985995888710022,829,298,1427,896,598,598,princess luna|twilight sparkle,darkflame75
796936.png,https://derpicdn.net/img/view/2015/1/1/796936.png,0,0.9864189624786376,1275,568,1535,828,260,260,applejack|discord|fluttershy|mane six|pinkie pie|princess celestia|princess luna|rainbow dash|rarity|spike|twilight sparkle,panyang-panyang
796936.png,https://derpicdn.net/img/view/2015/1/1/796936.png,1,0.980073094367981,1226,36,1522,332,296,296,applejack|discord|fluttershy|mane six|pinkie pie|princess celestia|princess luna|rainbow dash|rarity|spike|twilight sparkle,panyang-panyang
796964.jpg,https://derpicdn.net/img/view/2015/1/1/796964.jpg,0,0.9605730175971984,2354,64,3322,1032,968,968,princess cadance|princess celestia|princess luna|shining armor|spike|twilight sparkle,silfoe
802347.png,https://derpicdn.net/img/view/2015/1/9/802347.png,0,0.9688476920127868,370,75,614,319,244,244,fluttershy|twilight sparkle,assasinmonkey
802511.png,https://derpicdn.net/img/view/2015/1/9/802511.png,0,0.9975619316101074,69,27,581,539,512,512,sunset shimmer|twilight sparkle,hisshi shoujo
804067.png,https://derpicdn.net/img/view/2015/1/11/804067.png,0,0.9991931319236756,560,18,960,418,400,400,princess celestia|twilight sparkle,t45t13|kianamai
805388.png,https://derpicdn.net/img/view/2015/1/13/805388.png,0,0.9537342190742492,597,172,1255,830,658,658,fluttershy|twilight sparkle,ryuseihikari|ponyguy67
806869.png,https://derpicdn.net/img/view/2015/1/15/806869.png,0,0.9483145475387572,0,356,317,720,317,364,pinkie pie|rainbow dash|spike|twilight sparkle,php44|atryl
806869.png,https://derpicdn.net/img/view/2015/1/15/806869.png,1,0.9152289628982544,417,0,875,412,458,412,pinkie pie|rainbow dash|spike|twilight sparkle,php44|atryl
807303.png,https://derpicdn.net/img/view/2015/1/15/807303.png,0,0.9967624545097352,1771,948,3217,2394,1446,1446,apple bloom|twilight sparkle,template93
807303.png,https://derpicdn.net/img/view/2015/1/15/807303.png,1,0.9865046739578248,3020,241,4550,1771,1530,1530,apple bloom|twilight sparkle,template93
807638.png,https://derpicdn.net/img/view/2015/1/16/807638.png,0,0.9399167895317078,600,428,883,766,283,338,discord|fluttershy|twilight sparkle,artiecanvas
808469.png,https://derpicdn.net/img/view/2015/1/17/808469.png,0,0.9991179108619692,820,494,1162,836,342,342,applejack|fluttershy|mane six|pinkie pie|rainbow dash|rarity|twilight sparkle,gmrqor
808469.png,https://derpicdn.net/img/view/2015/1/17/808469.png,1,0.9281455278396606,778,0,1178,396,400,396,applejack|fluttershy|mane six|pinkie pie|rainbow dash|rarity|twilight sparkle,gmrqor
810693.png,https://derpicdn.net/img/view/2015/1/20/810693.png,0,0.985606849193573,727,218,1205,696,478,478,rainbow dash|twilight sparkle,scherzo
811301.png,https://derpicdn.net/img/view/2015/1/21/811301.png,0,0.9926173090934752,0,36,605,678,605,642,pinkie pie|twilight sparkle,rue-willings
812153.png,https://derpicdn.net/img/view/2015/1/22/812153.png,1,0.9914201498031616,128,0,846,670,718,670,rainbow dash|twilight sparkle,ensayne
813487.png,https://derpicdn.net/img/view/2015/1/24/813487.png,0,0.9676328301429749,276,0,530,225,254,225,applejack|twilight sparkle,jowybean
814577.png,https://derpicdn.net/img/view/2015/1/25/814577.png,0,0.9979477524757384,69,1331,1597,2859,1528,1528,applejack|fluttershy|mane six|pinkie pie|rainbow dash|rarity|twilight sparkle,silverfox057
814577.png,https://derpicdn.net/img/view/2015/1/25/814577.png,1,0.9943320751190186,1363,2550,3000,4500,1637,1950,applejack|fluttershy|mane six|pinkie pie|rainbow dash|rarity|twilight sparkle,silverfox057
814577.png,https://derpicdn.net/img/view/2015/1/25/814577.png,2,0.9929372668266296,1948,0,3000,1099,1052,1099,applejack|fluttershy|mane six|pinkie pie|rainbow dash|rarity|twilight sparkle,silverfox057
814577.png,https://derpicdn.net/img/view/2015/1/25/814577.png,3,0.9874532222747804,1812,1596,2882,2666,1070,1070,applejack|fluttershy|mane six|pinkie pie|rainbow dash|rarity|twilight sparkle,silverfox057
814577.png,https://derpicdn.net/img/view/2015/1/25/814577.png,4,0.9655343294143676,200,0,1324,1073,1124,1073,applejack|fluttershy|mane six|pinkie pie|rainbow dash|rarity|twilight sparkle,silverfox057
815166.jpg,https://derpicdn.net/img/view/2015/1/26/815166.jpg,0,0.9981929063796996,401,13,1065,677,664,664,rarity|twilight sparkle,mad'n evil
818295.png,https://derpicdn.net/img/view/2015/1/31/818295.png,0,0.9240641593933104,1113,884,1569,1340,456,456,rainbow dash|twilight sparkle,foresterrr
820340.jpg,https://derpicdn.net/img/view/2015/2/3/820340.jpg,0,0.9562819004058838,164,289,368,493,204,204,rainbow dash|twilight sparkle,ichibangravity
821756.png,https://derpicdn.net/img/view/2015/2/5/821756.png,0,0.9980872273445128,500,0,1152,608,652,608,applejack|fluttershy|rarity|twilight sparkle,creamygravy edits
821756.png,https://derpicdn.net/img/view/2015/2/5/821756.png,1,0.9965246319770812,1649,384,2377,1112,728,728,applejack|fluttershy|rarity|twilight sparkle,creamygravy edits
8218.png,https://derpicdn.net/img/view/2012/6/18/8218.png,1,0.9766637086868286,658,135,1000,495,342,360,rainbow dash|twilight sparkle,rwl
821837.png,https://derpicdn.net/img/view/2015/2/5/821837.png,0,0.9874789118766784,437,89,761,413,324,324,spike|twilight sparkle,ctb-36
822878.png,https://derpicdn.net/img/view/2015/2/6/822878.png,1,0.9198899865150452,186,591,462,867,276,276,queen chrysalis|twilight sparkle,cold-blooded-twilight
823036.png,https://derpicdn.net/img/view/2015/2/7/823036.png,0,0.9788000583648682,27,17,383,373,356,356,rainbow dash|twilight sparkle,chokico
824479.png,https://derpicdn.net/img/view/2015/2/8/824479.png,0,0.9983200430870056,3063,1658,4541,3136,1478,1478,applejack|fluttershy|mane six|pinkie pie|rainbow dash|rarity|twilight sparkle,tsand106
824479.png,https://derpicdn.net/img/view/2015/2/8/824479.png,1,0.9949807524681092,351,948,1997,2594,1646,1646,applejack|fluttershy|mane six|pinkie pie|rainbow dash|rarity|twilight sparkle,tsand106
824479.png,https://derpicdn.net/img/view/2015/2/8/824479.png,2,0.9846742153167723,4243,1169,5845,2771,1602,1602,applejack|fluttershy|mane six|pinkie pie|rainbow dash|rarity|twilight sparkle,tsand106
824479.png,https://derpicdn.net/img/view/2015/2/8/824479.png,3,0.9604520201683044,2200,190,3938,1928,1738,1738,applejack|fluttershy|mane six|pinkie pie|rainbow dash|rarity|twilight sparkle,tsand106
825019.png,https://derpicdn.net/img/view/2015/2/9/825019.png,0,0.9922086596488952,61,0,471,406,410,406,trixie|twilight sparkle,weiliy
827275.png,https://derpicdn.net/img/view/2015/2/13/827275.png,0,0.9758509993553162,158,137,482,461,324,324,sunset shimmer|twilight sparkle,spectralunicorn
827330.jpg,https://derpicdn.net/img/view/2015/2/13/827330.jpg,1,0.9582937359809875,835,463,1683,1311,848,848,princess cadance|princess celestia|princess luna|twilight sparkle,dari-draws
827569.png,https://derpicdn.net/img/view/2015/2/13/827569.png,0,0.9759421348571776,28,31,842,845,814,814,princess luna|twilight sparkle,php92
827569.png,https://derpicdn.net/img/view/2015/2/13/827569.png,1,0.931224286556244,925,25,1743,843,818,818,princess luna|twilight sparkle,php92
828827.jpg,https://derpicdn.net/img/view/2015/2/15/828827.jpg,0,0.9797971844673156,411,37,752,385,341,348,princess celestia|twilight sparkle,zuneycat
828827.jpg,https://derpicdn.net/img/view/2015/2/15/828827.jpg,1,0.9711425900459292,285,81,495,291,210,210,princess celestia|twilight sparkle,zuneycat
828984.png,https://derpicdn.net/img/view/2015/2/15/828984.png,0,0.9635453224182128,0,1784,298,2110,298,326,princess cadance|princess celestia|princess luna|queen chrysalis|shining armor|twilight sparkle,deusexequus
828984.png,https://derpicdn.net/img/view/2015/2/15/828984.png,1,0.9558308720588684,0,25,408,503,408,478,princess cadance|princess celestia|princess luna|queen chrysalis|shining armor|twilight sparkle,deusexequus
830379.png,https://derpicdn.net/img/view/2015/2/16/830379.png,0,0.9584658741950988,0,374,2488,2928,2488,2554,rarity|twilight sparkle,aenbrdraws
831680.png,https://derpicdn.net/img/view/2015/2/18/831680.png,0,0.9985896944999696,164,0,980,707,816,707,rainbow dash|twilight sparkle,dj-anya97
831680.png,https://derpicdn.net/img/view/2015/2/18/831680.png,1,0.9973160028457642,1170,331,1892,1053,722,722,rainbow dash|twilight sparkle,dj-anya97
831694.png,https://derpicdn.net/img/view/2015/2/18/831694.png,0,0.9592756628990172,812,0,1134,270,322,270,applejack|fluttershy|pinkie pie|rainbow dash|rarity|spike|twilight sparkle,dawnallies
836384.png,https://derpicdn.net/img/view/2015/2/24/836384.png,0,0.9840697646141052,2722,316,3696,1290,974,974,spike|twilight sparkle,lovelyneckbeard
836390.png,https://derpicdn.net/img/view/2015/2/24/836390.png,0,0.990277111530304,337,0,735,351,398,351,spike|twilight sparkle,dm29
837539.png,https://derpicdn.net/img/view/2015/2/26/837539.png,0,0.9699929356575012,82,150,352,420,270,270,princess cadance|princess celestia|princess luna|spike|twilight sparkle,partycannoninc
837644.png,https://derpicdn.net/img/view/2015/2/26/837644.png,0,0.9986606240272522,720,182,1280,758,560,576,spike|twilight sparkle,imsokyo
838404.png,https://derpicdn.net/img/view/2015/2/27/838404.png,0,0.998704195022583,815,0,3001,1838,2186,1838,applejack|fluttershy|mane six|pinkie pie|rainbow dash|rarity|spike|twilight sparkle,thenornonthego
838404.png,https://derpicdn.net/img/view/2015/2/27/838404.png,1,0.9969042539596558,2830,1191,4594,2955,1764,1764,applejack|fluttershy|mane six|pinkie pie|rainbow dash|rarity|spike|twilight sparkle,thenornonthego
838404.png,https://derpicdn.net/img/view/2015/2/27/838404.png,2,0.9912050366401672,4099,1229,5475,2605,1376,1376,applejack|fluttershy|mane six|pinkie pie|rainbow dash|rarity|spike|twilight sparkle,thenornonthego
839400.png,https://derpicdn.net/img/view/2015/2/28/839400.png,0,0.953789472579956,449,0,1401,937,952,937,spike|twilight sparkle,dfectivedvice|pananovich
840088.png,https://derpicdn.net/img/view/2015/3/1/840088.png,0,0.9961040616035458,277,313,531,567,254,254,applejack|fluttershy|mane six|pinkie pie|rainbow dash|rarity|twilight sparkle,bumblebun
842323.jpg,https://derpicdn.net/img/view/2015/3/4/842323.jpg,0,0.9962389469146729,621,133,1067,579,446,446,spike|twilight sparkle,silfoe
8430.png,https://derpicdn.net/img/view/2012/6/18/8430.png,2,0.9860683679580688,1457,337,1825,705,368,368,applejack|fluttershy|mane six|pinkie pie|rainbow dash|rarity|spike|twilight sparkle,fongsaunder
8430.png,https://derpicdn.net/img/view/2012/6/18/8430.png,3,0.9859201312065125,1210,3,1666,459,456,456,applejack|fluttershy|mane six|pinkie pie|rainbow dash|rarity|spike|twilight sparkle,fongsaunder
844299.png,https://derpicdn.net/img/view/2015/3/7/844299.png,0,0.9984421730041504,679,24,1153,498,474,474,princess celestia|twilight sparkle,kianamai|salpa
844826.png,https://derpicdn.net/img/view/2015/3/7/844826.png,0,0.9300421476364136,271,516,519,764,248,248,applejack|fluttershy|pinkie pie|rainbow dash|rarity|twilight sparkle,brisineo
844826.png,https://derpicdn.net/img/view/2015/3/7/844826.png,1,0.9201160073280334,474,510,702,738,228,228,applejack|fluttershy|pinkie pie|rainbow dash|rarity|twilight sparkle,brisineo
844969.png,https://derpicdn.net/img/view/2015/3/8/844969.png,1,0.9509983062744141,606,47,1076,517,470,470,fluttershy|rainbow dash|rarity|twilight sparkle,supermare
847206.png,https://derpicdn.net/img/view/2015/3/11/847206.png,0,0.9841325283050536,1742,624,2774,1656,1032,1032,applejack|fluttershy|mane six|pinkie pie|rainbow dash|rarity|twilight sparkle,antiander
847305.png,https://derpicdn.net/img/view/2015/3/11/847305.png,0,0.9089512825012208,110,0,478,343,368,343,rainbow dash|twilight sparkle,katrittaja
847446.png,https://derpicdn.net/img/view/2015/3/11/847446.png,1,0.9509253501892092,609,141,1911,1443,1302,1302,shining armor|twilight sparkle,thecheeseburger
848059.png,https://derpicdn.net/img/view/2015/3/12/848059.png,0,0.9960319399833679,604,26,1036,458,432,432,applejack|twilight sparkle,rwl
848599.jpg,https://derpicdn.net/img/view/2015/3/13/848599.jpg,0,0.9947755336761476,147,0,587,405,440,405,trixie|twilight sparkle,mabo3
848892.png,https://derpicdn.net/img/view/2015/3/14/848892.png,0,0.9752084016799928,1205,735,1903,1433,698,698,sunset shimmer|trixie|twilight sparkle,darkwolfmx
848932.jpg,https://derpicdn.net/img/view/2015/3/14/848932.jpg,0,0.9673712849617004,226,395,484,653,258,258,apple bloom|applejack|babs seed|cutie mark crusaders|diamond tiara|fluttershy|pinkie pie|princess cadance|rarity|scootaloo|shining armor|soarin'|spitfire|sweetie belle|trixie|twilight sparkle,dan232323
849216.png,https://derpicdn.net/img/view/2015/3/14/849216.png,0,0.9812850356101992,483,0,813,328,330,328,applejack|fluttershy|mane six|pinkie pie|rainbow dash|rarity|sunset shimmer|twilight sparkle,vavacung
849216.png,https://derpicdn.net/img/view/2015/3/14/849216.png,1,0.9730232954025269,0,0,252,253,252,253,applejack|fluttershy|mane six|pinkie pie|rainbow dash|rarity|sunset shimmer|twilight sparkle,vavacung
850307.png,https://derpicdn.net/img/view/2015/3/15/850307.png,0,0.9933836460113524,467,373,633,539,166,166,big macintosh|twilight sparkle,deusexequus
852280.jpg,https://derpicdn.net/img/view/2015/3/18/852280.jpg,0,0.9283382296562196,0,48,709,856,709,808,trixie|twilight sparkle,oboromuramasa11|jyanome
852789.jpg,https://derpicdn.net/img/view/2015/3/19/852789.jpg,1,0.9557302594184875,227,231,473,477,246,246,applejack|fluttershy|mane six|pinkie pie|rainbow dash|rarity|twilight sparkle,s-bis
853209.png,https://derpicdn.net/img/view/2015/3/20/853209.png,1,0.9994458556175232,0,0,414,378,414,378,rainbow dash|rarity|twilight sparkle,raikoh
854452.png,https://derpicdn.net/img/view/2015/3/21/854452.png,0,0.9875779151916504,16,0,614,552,598,552,applejack|fluttershy|mane six|pinkie pie|rainbow dash|rarity|spike|twilight sparkle,mrsremi
857851.png,https://derpicdn.net/img/view/2015/3/26/857851.png,0,0.97733473777771,587,252,735,400,148,148,applejack|twilight sparkle,jowybean
858651.png,https://derpicdn.net/img/view/2015/3/28/858651.png,0,0.9965253472328186,517,524,1199,1206,682,682,spike|twilight sparkle,wodahseht|bri-sta
862887.png,https://derpicdn.net/img/view/2015/4/2/862887.png,0,0.9883323907852172,1208,165,2794,1751,1586,1586,spike|twilight sparkle,thenornonthego
863531.png,https://derpicdn.net/img/view/2015/4/3/863531.png,0,0.994673490524292,588,54,1000,472,412,418,applejack|pinkie pie|twilight sparkle,dstears
863531.png,https://derpicdn.net/img/view/2015/4/3/863531.png,1,0.9902805685997008,103,37,449,383,346,346,applejack|pinkie pie|twilight sparkle,dstears
864240.png,https://derpicdn.net/img/view/2015/4/4/864240.png,0,0.9740166664123536,713,582,869,738,156,156,applejack|fluttershy|mane six|pinkie pie|rainbow dash|rarity|twilight sparkle,egophiliac
864839.png,https://derpicdn.net/img/view/2015/4/4/864839.png,0,0.9240643382072448,453,0,991,470,538,470,starlight glimmer|twilight sparkle,arcuswind
864963.png,https://derpicdn.net/img/view/2015/4/4/864963.png,0,0.9991583228111268,81,78,419,416,338,338,applejack|fluttershy|mane six|pinkie pie|rainbow dash|rarity|twilight sparkle,ayahana
864963.png,https://derpicdn.net/img/view/2015/4/4/864963.png,1,0.9956483840942384,352,0,684,280,332,280,applejack|fluttershy|mane six|pinkie pie|rainbow dash|rarity|twilight sparkle,ayahana
864963.png,https://derpicdn.net/img/view/2015/4/4/864963.png,2,0.9806379079818726,600,0,962,322,362,322,applejack|fluttershy|mane six|pinkie pie|rainbow dash|rarity|twilight sparkle,ayahana
864963.png,https://derpicdn.net/img/view/2015/4/4/864963.png,3,0.9801347851753236,136,390,402,656,266,266,applejack|fluttershy|mane six|pinkie pie|rainbow dash|rarity|twilight sparkle,ayahana
865106.png,https://derpicdn.net/img/view/2015/4/4/865106.png,0,0.9320639371871948,101,1293,449,1641,348,348,applejack|fluttershy|mane six|pinkie pie|rainbow dash|rarity|starlight glimmer|twilight sparkle,esuka
865106.png,https://derpicdn.net/img/view/2015/4/4/865106.png,1,0.9248988628387452,424,1260,828,1664,404,404,applejack|fluttershy|mane six|pinkie pie|rainbow dash|rarity|starlight glimmer|twilight sparkle,esuka
865328.png,https://derpicdn.net/img/view/2015/4/5/865328.png,1,0.995181441307068,1760,422,2638,1300,878,878,princess cadance|princess celestia|princess luna|sunset shimmer|trixie|twilight sparkle,cuddlehooves
865328.png,https://derpicdn.net/img/view/2015/4/5/865328.png,2,0.9742686152458192,867,188,1829,1150,962,962,princess cadance|princess celestia|princess luna|sunset shimmer|trixie|twilight sparkle,cuddlehooves
865899.png,https://derpicdn.net/img/view/2015/4/5/865899.png,0,0.9980869889259338,0,1570,651,2274,651,704,applejack|rainbow dash|starlight glimmer|twilight sparkle,madacon
865899.png,https://derpicdn.net/img/view/2015/4/5/865899.png,1,0.975948691368103,1856,1382,2354,1880,498,498,applejack|rainbow dash|starlight glimmer|twilight sparkle,madacon
866412.png,https://derpicdn.net/img/view/2015/4/6/866412.png,0,0.9926230311393738,646,991,900,1273,254,282,applejack|fluttershy|mane six|pinkie pie|rainbow dash|rarity|twilight sparkle,lillynya
866412.png,https://derpicdn.net/img/view/2015/4/6/866412.png,1,0.9679845571517944,515,460,895,840,380,380,applejack|fluttershy|mane six|pinkie pie|rainbow dash|rarity|twilight sparkle,lillynya
866412.png,https://derpicdn.net/img/view/2015/4/6/866412.png,2,0.9634786248207092,373,0,705,323,332,323,applejack|fluttershy|mane six|pinkie pie|rainbow dash|rarity|twilight sparkle,lillynya
866412.png,https://derpicdn.net/img/view/2015/4/6/866412.png,3,0.9581290483474731,130,5,400,275,270,270,applejack|fluttershy|mane six|pinkie pie|rainbow dash|rarity|twilight sparkle,lillynya
866875.png,https://derpicdn.net/img/view/2015/4/6/866875.png,1,0.95526921749115,1474,281,1844,651,370,370,fluttershy|pinkie pie|trixie|twilight sparkle,vipeydashie|cyanaeolin
867428.png,https://derpicdn.net/img/view/2015/4/7/867428.png,0,0.9739828109741212,242,202,544,504,302,302,starlight glimmer|sunset shimmer|twilight sparkle,
867529.png,https://derpicdn.net/img/view/2015/4/7/867529.png,0,0.9974709749221802,143,5,303,165,160,160,shining armor|twilight sparkle,dm29
868554.png,https://derpicdn.net/img/view/2015/4/8/868554.png,0,0.9624053835868835,223,0,443,193,220,193,princess luna|twilight sparkle,lulubell
869151.png,https://derpicdn.net/img/view/2015/4/8/869151.png,0,0.9930645227432252,347,419,755,827,408,408,applejack|fluttershy|mane six|pinkie pie|rainbow dash|rarity|twilight sparkle,heir-of-rick
869151.png,https://derpicdn.net/img/view/2015/4/8/869151.png,1,0.9915902018547058,187,967,623,1403,436,436,applejack|fluttershy|mane six|pinkie pie|rainbow dash|rarity|twilight sparkle,heir-of-rick
869151.png,https://derpicdn.net/img/view/2015/4/8/869151.png,2,0.9468156099319458,906,846,1342,1282,436,436,applejack|fluttershy|mane six|pinkie pie|rainbow dash|rarity|twilight sparkle,heir-of-rick
869151.png,https://derpicdn.net/img/view/2015/4/8/869151.png,3,0.9333643317222596,1149,446,1587,884,438,438,applejack|fluttershy|mane six|pinkie pie|rainbow dash|rarity|twilight sparkle,heir-of-rick
869151.png,https://derpicdn.net/img/view/2015/4/8/869151.png,4,0.9297239184379578,1475,913,1939,1377,464,464,applejack|fluttershy|mane six|pinkie pie|rainbow dash|rarity|twilight sparkle,heir-of-rick
869205.png,https://derpicdn.net/img/view/2015/4/8/869205.png,0,0.9589661955833436,427,300,740,626,313,326,applejack|rainbow dash|twilight sparkle,deusexequus
869348.png,https://derpicdn.net/img/view/2015/4/9/869348.png,0,0.9752312302589417,121,141,451,471,330,330,sunset shimmer|twilight sparkle,catlover1672
869367.png,https://derpicdn.net/img/view/2015/4/9/869367.png,0,0.9576055407524108,379,147,827,595,448,448,applejack|fluttershy|mane six|pinkie pie|rainbow dash|rarity|twilight sparkle,its-ok-to-smile
869367.png,https://derpicdn.net/img/view/2015/4/9/869367.png,1,0.9126083850860596,2737,25,3265,553,528,528,applejack|fluttershy|mane six|pinkie pie|rainbow dash|rarity|twilight sparkle,its-ok-to-smile
869785.png,https://derpicdn.net/img/view/2015/4/9/869785.png,1,0.93686443567276,448,0,1192,636,744,636,trixie|twilight sparkle,mt
869829.jpg,https://derpicdn.net/img/view/2015/4/9/869829.jpg,0,0.9947182536125184,582,382,816,616,234,234,big macintosh|fluttershy|pinkie pie|queen chrysalis|rainbow dash|rarity|starlight glimmer|sunset shimmer|twilight sparkle,arnne
869829.jpg,https://derpicdn.net/img/view/2015/4/9/869829.jpg,1,0.9861518740653992,452,144,738,430,286,286,big macintosh|fluttershy|pinkie pie|queen chrysalis|rainbow dash|rarity|starlight glimmer|sunset shimmer|twilight sparkle,arnne
869829.jpg,https://derpicdn.net/img/view/2015/4/9/869829.jpg,3,0.9736315608024596,660,109,900,361,240,252,big macintosh|fluttershy|pinkie pie|queen chrysalis|rainbow dash|rarity|starlight glimmer|sunset shimmer|twilight sparkle,arnne
869829.jpg,https://derpicdn.net/img/view/2015/4/9/869829.jpg,4,0.9602782130241394,312,20,534,242,222,222,big macintosh|fluttershy|pinkie pie|queen chrysalis|rainbow dash|rarity|starlight glimmer|sunset shimmer|twilight sparkle,arnne
871442.png,https://derpicdn.net/img/view/2015/4/11/871442.png,0,0.9271247982978821,77,311,445,679,368,368,princess celestia|princess luna|twilight sparkle,isseus|ved
871448.png,https://derpicdn.net/img/view/2015/4/11/871448.png,0,0.990351676940918,400,967,962,1447,562,480,applejack|fluttershy|mane six|pinkie pie|rainbow dash|rarity|twilight sparkle,sakuracheetah
871448.png,https://derpicdn.net/img/view/2015/4/11/871448.png,1,0.9473384618759156,1378,391,2047,1073,669,682,applejack|fluttershy|mane six|pinkie pie|rainbow dash|rarity|twilight sparkle,sakuracheetah
872299.png,https://derpicdn.net/img/view/2015/4/12/872299.png,0,0.9491671323776244,281,0,864,537,583,537,applejack|pinkie pie|rarity|twilight sparkle,
872896.png,https://derpicdn.net/img/view/2015/4/13/872896.png,0,0.978204309940338,1734,618,2368,1252,634,634,rarity|twilight sparkle,pony-berserker
872896.png,https://derpicdn.net/img/view/2015/4/13/872896.png,1,0.9729191064834596,996,725,1664,1393,668,668,rarity|twilight sparkle,pony-berserker
873258.png,https://derpicdn.net/img/view/2015/4/13/873258.png,0,0.994629979133606,274,0,568,287,294,287,applejack|big macintosh|fluttershy|mane six|pinkie pie|rainbow dash|rarity|trixie|twilight sparkle,pixelkitties
873258.png,https://derpicdn.net/img/view/2015/4/13/873258.png,1,0.9931957125663756,569,0,895,313,326,313,applejack|big macintosh|fluttershy|mane six|pinkie pie|rainbow dash|rarity|trixie|twilight sparkle,pixelkitties
873258.png,https://derpicdn.net/img/view/2015/4/13/873258.png,2,0.991726279258728,580,744,900,1082,320,338,applejack|big macintosh|fluttershy|mane six|pinkie pie|rainbow dash|rarity|trixie|twilight sparkle,pixelkitties
873258.png,https://derpicdn.net/img/view/2015/4/13/873258.png,3,0.9389402866363524,28,506,344,822,316,316,applejack|big macintosh|fluttershy|mane six|pinkie pie|rainbow dash|rarity|trixie|twilight sparkle,pixelkitties
874007.png,https://derpicdn.net/img/view/2015/4/14/874007.png,0,0.9965896010398864,2298,482,2922,1106,624,624,fluttershy|twilight sparkle,discorded
874422.png,https://derpicdn.net/img/view/2015/4/15/874422.png,0,0.9627093076705932,483,0,825,316,342,316,sunset shimmer|twilight sparkle,caroo
875342.png,https://derpicdn.net/img/view/2015/4/16/875342.png,0,0.9882287383079528,1619,1872,2257,2510,638,638,applejack|fluttershy|mane six|pinkie pie|princess celestia|rainbow dash|rarity|twilight sparkle,yajima
881475.png,https://derpicdn.net/img/view/2015/4/24/881475.png,0,0.995600700378418,126,69,366,309,240,240,rarity|twilight sparkle,twirity
881632.png,https://derpicdn.net/img/view/2015/4/24/881632.png,0,0.9242005944252014,0,21,479,430,479,409,trixie|twilight sparkle,youhoujou
881833.png,https://derpicdn.net/img/view/2015/4/25/881833.png,0,0.9940454959869384,537,369,1151,983,614,614,applejack|fluttershy|mane six|pinkie pie|rainbow dash|rarity|twilight sparkle,drawntildawn
881897.png,https://derpicdn.net/img/view/2015/4/25/881897.png,0,0.9155676364898682,2342,377,2564,599,222,222,apple bloom|applejack|big macintosh|cutie mark crusaders|discord|fluttershy|mane six|pinkie pie|princess cadance|princess celestia|princess luna|queen chrysalis|rainbow dash|rarity|scootaloo|soarin'|spike|spitfire|starlight glimmer|sunset shimmer|sweetie belle|trixie|twilight sparkle,flare-chaser
882512.png,https://derpicdn.net/img/view/2015/4/25/882512.png,0,0.9790191054344176,484,0,904,402,420,402,rainbow dash|twilight sparkle,dm29
885866.png,https://derpicdn.net/img/view/2015/4/30/885866.png,0,0.9070616364479064,68,72,662,666,594,594,rainbow dash|twilight sparkle,ambris|riole123
886093.png,https://derpicdn.net/img/view/2015/4/30/886093.png,0,0.9483840465545654,317,730,717,1130,400,400,spike|twilight sparkle,serenitythefaierikin
886455.png,https://derpicdn.net/img/view/2015/5/1/886455.png,0,0.9984963536262512,386,822,1592,2028,1206,1206,spike|twilight sparkle,tentinythimbles
891684.png,https://derpicdn.net/img/view/2015/5/8/891684.png,0,0.9957926273345948,394,44,818,468,424,424,applejack|twilight sparkle,jowybean
891684.png,https://derpicdn.net/img/view/2015/5/8/891684.png,1,0.9858298301696776,5,0,541,500,536,500,applejack|twilight sparkle,jowybean
89248.jpg,https://derpicdn.net/img/view/2012/9/3/89248.jpg,0,0.9453036785125732,644,246,858,460,214,214,rainbow dash|trixie|twilight sparkle,dstears
892693.png,https://derpicdn.net/img/view/2015/5/10/892693.png,0,0.9478517174720764,45,0,465,273,420,273,pinkie pie|twilight sparkle,lucy-tan
894479.png,https://derpicdn.net/img/view/2015/5/12/894479.png,0,0.9944722652435304,37,171,393,527,356,356,sunset shimmer|twilight sparkle,spectralunicorn
894479.png,https://derpicdn.net/img/view/2015/5/12/894479.png,1,0.9626039862632751,260,0,672,383,412,383,sunset shimmer|twilight sparkle,spectralunicorn
895436.png,https://derpicdn.net/img/view/2015/5/13/895436.png,0,0.9069048166275024,356,197,746,587,390,390,rainbow dash|twilight sparkle,shikimaakemi
897593.png,https://derpicdn.net/img/view/2015/5/16/897593.png,0,0.9507744908332824,386,0,786,382,400,382,princess celestia|twilight sparkle,
898594.png,https://derpicdn.net/img/view/2015/5/17/898594.png,0,0.9492781758308412,4,315,174,485,170,170,apple bloom|applejack|cutie mark crusaders|discord|fluttershy|mane six|pinkie pie|princess celestia|rainbow dash|rarity|scootaloo|sweetie belle|twilight sparkle,shivall
899155.png,https://derpicdn.net/img/view/2015/5/18/899155.png,0,0.9914150834083556,333,363,1123,1153,790,790,princess celestia|twilight sparkle,twizzle-fizz
899939.png,https://derpicdn.net/img/view/2015/5/19/899939.png,0,0.9416086077690125,49,0,393,271,344,271,princess cadance|twilight sparkle,kuromi
901721.png,https://derpicdn.net/img/view/2015/5/22/901721.png,0,0.9847323894500732,238,38,584,384,346,346,princess cadance|shining armor|twilight sparkle,dm29
902220.png,https://derpicdn.net/img/view/2015/5/23/902220.png,0,0.991239368915558,40,176,422,558,382,382,applejack|fluttershy|mane six|pinkie pie|rainbow dash|rarity|twilight sparkle,pixel-prism
902220.png,https://derpicdn.net/img/view/2015/5/23/902220.png,2,0.9641424417495728,631,22,1015,406,384,384,applejack|fluttershy|mane six|pinkie pie|rainbow dash|rarity|twilight sparkle,pixel-prism
902220.png,https://derpicdn.net/img/view/2015/5/23/902220.png,3,0.9152461886405944,341,191,713,563,372,372,applejack|fluttershy|mane six|pinkie pie|rainbow dash|rarity|twilight sparkle,pixel-prism
906203.jpg,https://derpicdn.net/img/view/2015/5/29/906203.jpg,0,0.9961532354354858,268,546,534,812,266,266,applejack|fluttershy|mane six|pinkie pie|rainbow dash|rarity|spike|sunset shimmer|twilight sparkle,zeldafreak159
906203.jpg,https://derpicdn.net/img/view/2015/5/29/906203.jpg,1,0.9712783098220824,12,495,346,829,334,334,applejack|fluttershy|mane six|pinkie pie|rainbow dash|rarity|spike|sunset shimmer|twilight sparkle,zeldafreak159
906203.jpg,https://derpicdn.net/img/view/2015/5/29/906203.jpg,2,0.9669944047927856,485,559,729,803,244,244,applejack|fluttershy|mane six|pinkie pie|rainbow dash|rarity|spike|sunset shimmer|twilight sparkle,zeldafreak159
9084.png,https://derpicdn.net/img/view/2012/6/19/9084.png,2,0.9735569953918456,1346,101,1670,425,324,324,rainbow dash|twilight sparkle,nyuuchandiannepie
908700.png,https://derpicdn.net/img/view/2015/6/2/908700.png,0,0.9767131209373474,342,9,726,393,384,384,spike|twilight sparkle,dm29
9090.png,https://derpicdn.net/img/view/2012/6/19/9090.png,0,0.9834690093994141,566,208,1400,1042,834,834,rainbow dash|twilight sparkle,nyuuchandiannepie
909170.png,https://derpicdn.net/img/view/2015/6/3/909170.png,0,0.9921780824661256,107,1067,1873,2833,1766,1766,starlight glimmer|twilight sparkle,ushiro no kukan
912759.png,https://derpicdn.net/img/view/2015/6/8/912759.png,0,0.9619868993759156,1372,16,1496,140,124,124,applejack|fluttershy|mane six|pinkie pie|princess celestia|princess luna|rainbow dash|rarity|spike|twilight sparkle,vincentthecrow
913410.png,https://derpicdn.net/img/view/2015/6/9/913410.png,0,0.9462615847587584,272,0,754,380,482,380,princess cadance|princess celestia|princess luna|twilight sparkle,thepoisonjackal
913410.png,https://derpicdn.net/img/view/2015/6/9/913410.png,2,0.9188541769981384,931,73,1263,405,332,332,princess cadance|princess celestia|princess luna|twilight sparkle,thepoisonjackal
914100.png,https://derpicdn.net/img/view/2015/6/10/914100.png,0,0.9977116584777832,463,51,819,407,356,356,fluttershy|twilight sparkle,twirity
914100.png,https://derpicdn.net/img/view/2015/6/10/914100.png,1,0.9802942276000975,172,75,544,447,372,372,fluttershy|twilight sparkle,twirity
917054.png,https://derpicdn.net/img/view/2015/6/14/917054.png,0,0.9511796236038208,2170,0,3329,1290,1159,1290,spike|twilight sparkle,bluemeganium
920032.png,https://derpicdn.net/img/view/2015/6/20/920032.png,0,0.9882034063339232,289,103,601,415,312,312,princess celestia|twilight sparkle,kkmrarar
920776.png,https://derpicdn.net/img/view/2015/6/21/920776.png,0,0.960965931415558,712,794,1468,1550,756,756,princess cadance|princess celestia|princess luna|spike|twilight sparkle,
922364.png,https://derpicdn.net/img/view/2015/6/23/922364.png,0,0.96242755651474,1372,16,1498,142,126,126,applejack|fluttershy|mane six|pinkie pie|princess celestia|princess luna|rainbow dash|rarity|spike|twilight sparkle,vincentthecrow
924815.png,https://derpicdn.net/img/view/2015/6/27/924815.png,0,0.9796556234359741,114,24,855,812,741,788,fluttershy|twilight sparkle,
925168.png,https://derpicdn.net/img/view/2015/6/28/925168.png,0,0.9882864356040956,484,314,1134,964,650,650,fluttershy|twilight sparkle,meekcheep
926118.png,https://derpicdn.net/img/view/2015/6/29/926118.png,0,0.959455907344818,348,500,748,900,400,400,apple bloom|applejack|big macintosh|fluttershy|pinkie pie|princess celestia|princess luna|rainbow dash|rarity|scootaloo|sweetie belle|twilight sparkle,arteses-canvas
926614.png,https://derpicdn.net/img/view/2015/6/30/926614.png,0,0.9234023690223694,276,865,514,1103,238,238,applejack|fluttershy|mane six|pinkie pie|rainbow dash|rarity|twilight sparkle,sharmie
928890.png,https://derpicdn.net/img/view/2015/7/3/928890.png,0,0.9844387173652648,163,24,325,186,162,162,applejack|twilight sparkle,jowybean
929632.jpg,https://derpicdn.net/img/view/2015/7/4/929632.jpg,0,0.951740562915802,418,169,614,365,196,196,pinkie pie|twilight sparkle,parsnip3d
931136.jpg,https://derpicdn.net/img/view/2015/7/6/931136.jpg,0,0.9511756896972656,531,2098,773,2340,242,242,applejack|discord|fluttershy|mane six|pinkie pie|rainbow dash|rarity|spike|spitfire|twilight sparkle,canon-lb|yellowy-cake|baumkuchenpony|jeatz-axl|clashwolf3|chainchomp2 edit|masem|dashiemlpfim
933333.jpg,https://derpicdn.net/img/view/2015/7/9/933333.jpg,0,0.9994932413101196,111,478,769,1136,658,658,sunset shimmer|twilight sparkle,dreamscapevalley
933333.jpg,https://derpicdn.net/img/view/2015/7/9/933333.jpg,1,0.9902678728103638,1452,469,2058,1075,606,606,sunset shimmer|twilight sparkle,dreamscapevalley
933582.jpg,https://derpicdn.net/img/view/2015/7/9/933582.jpg,0,0.9990447163581848,781,17,1107,343,326,326,applejack|fluttershy|pinkie pie|princess cadance|princess celestia|princess luna|rainbow dash|sunset shimmer|trixie|twilight sparkle,kudalyn|pixelkitties|the smiling pony|thegamblehorse|blithedragon|puffpink|theparagon|gsphere|kikiluv|cultleaderfluttershy|0r0ch1|mixermike622|sophocoles|the-rasp-b|kloudmutt|epulson|thex-plotion|sonork91|
933582.jpg,https://derpicdn.net/img/view/2015/7/9/933582.jpg,4,0.9872341752052308,183,1237,423,1477,240,240,applejack|fluttershy|pinkie pie|princess cadance|princess celestia|princess luna|rainbow dash|sunset shimmer|trixie|twilight sparkle,kudalyn|pixelkitties|the smiling pony|thegamblehorse|blithedragon|puffpink|theparagon|gsphere|kikiluv|cultleaderfluttershy|0r0ch1|mixermike622|sophocoles|the-rasp-b|kloudmutt|epulson|thex-plotion|sonork91|
933582.jpg,https://derpicdn.net/img/view/2015/7/9/933582.jpg,5,0.9783121943473816,1275,785,1600,1141,325,356,applejack|fluttershy|pinkie pie|princess cadance|princess celestia|princess luna|rainbow dash|sunset shimmer|trixie|twilight sparkle,kudalyn|pixelkitties|the smiling pony|thegamblehorse|blithedragon|puffpink|theparagon|gsphere|kikiluv|cultleaderfluttershy|0r0ch1|mixermike622|sophocoles|the-rasp-b|kloudmutt|epulson|thex-plotion|sonork91|
933582.jpg,https://derpicdn.net/img/view/2015/7/9/933582.jpg,10,0.939375638961792,577,4,819,246,242,242,applejack|fluttershy|pinkie pie|princess cadance|princess celestia|princess luna|rainbow dash|sunset shimmer|trixie|twilight sparkle,kudalyn|pixelkitties|the smiling pony|thegamblehorse|blithedragon|puffpink|theparagon|gsphere|kikiluv|cultleaderfluttershy|0r0ch1|mixermike622|sophocoles|the-rasp-b|kloudmutt|epulson|thex-plotion|sonork91|
933582.jpg,https://derpicdn.net/img/view/2015/7/9/933582.jpg,12,0.9020752906799316,0,1169,193,1417,193,248,applejack|fluttershy|pinkie pie|princess cadance|princess celestia|princess luna|rainbow dash|sunset shimmer|trixie|twilight sparkle,kudalyn|pixelkitties|the smiling pony|thegamblehorse|blithedragon|puffpink|theparagon|gsphere|kikiluv|cultleaderfluttershy|0r0ch1|mixermike622|sophocoles|the-rasp-b|kloudmutt|epulson|thex-plotion|sonork91|
934855.png,https://derpicdn.net/img/view/2015/7/11/934855.png,2,0.9960105419158936,9,0,473,446,464,446,applejack|fluttershy|mane six|pinkie pie|rainbow dash|rarity|twilight sparkle,mediconmontres
935794.jpg,https://derpicdn.net/img/view/2015/7/12/935794.jpg,0,0.9634353518486024,84,123,344,383,260,260,apple bloom|applejack|pinkie pie|princess luna|rarity|scootaloo|sweetie belle|twilight sparkle,
937672.png,https://derpicdn.net/img/view/2015/7/15/937672.png,0,0.9789869785308838,4250,238,5694,1682,1444,1444,spike|twilight sparkle,dashiesparkle
938587.png,https://derpicdn.net/img/view/2015/7/17/938587.png,0,0.9506852030754088,1937,1065,2487,1615,550,550,applejack|fluttershy|starlight glimmer|twilight sparkle,supermare
938667.png,https://derpicdn.net/img/view/2015/7/17/938667.png,0,0.9925116300582886,390,0,696,295,306,295,applejack|twilight sparkle,jowybean
939117.png,https://derpicdn.net/img/view/2015/7/18/939117.png,0,0.9813748598098756,70,7,458,395,388,388,spike|twilight sparkle,dm29
939620.png,https://derpicdn.net/img/view/2015/7/19/939620.png,0,0.9744938015937804,923,97,1151,325,228,228,rarity|spike|twilight sparkle,1trick
942836.png,https://derpicdn.net/img/view/2015/7/24/942836.png,1,0.9291609525680542,0,294,276,580,276,286,princess cadance|shining armor|twilight sparkle,dm29
943183.png,https://derpicdn.net/img/view/2015/7/24/943183.png,0,0.9902903437614441,463,12,899,448,436,436,applejack|twilight sparkle,jowybean
943183.png,https://derpicdn.net/img/view/2015/7/24/943183.png,1,0.979589343070984,130,115,560,545,430,430,applejack|twilight sparkle,jowybean
945590.jpg,https://derpicdn.net/img/view/2015/7/28/945590.jpg,0,0.9972048997879028,397,210,627,440,230,230,applejack|big macintosh|fluttershy|pinkie pie|queen chrysalis|rainbow dash|rarity|scootaloo|soarin'|spitfire|sweetie belle|trixie|twilight sparkle,potatoochips
945590.jpg,https://derpicdn.net/img/view/2015/7/28/945590.jpg,1,0.99650776386261,586,727,824,977,238,250,applejack|big macintosh|fluttershy|pinkie pie|queen chrysalis|rainbow dash|rarity|scootaloo|soarin'|spitfire|sweetie belle|trixie|twilight sparkle,potatoochips
945590.jpg,https://derpicdn.net/img/view/2015/7/28/945590.jpg,2,0.9939820766448976,215,226,427,438,212,212,applejack|big macintosh|fluttershy|pinkie pie|queen chrysalis|rainbow dash|rarity|scootaloo|soarin'|spitfire|sweetie belle|trixie|twilight sparkle,potatoochips
945590.jpg,https://derpicdn.net/img/view/2015/7/28/945590.jpg,3,0.9871972799301147,0,360,213,574,213,214,applejack|big macintosh|fluttershy|pinkie pie|queen chrysalis|rainbow dash|rarity|scootaloo|soarin'|spitfire|sweetie belle|trixie|twilight sparkle,potatoochips
945590.jpg,https://derpicdn.net/img/view/2015/7/28/945590.jpg,4,0.9773254990577698,399,730,637,968,238,238,applejack|big macintosh|fluttershy|pinkie pie|queen chrysalis|rainbow dash|rarity|scootaloo|soarin'|spitfire|sweetie belle|trixie|twilight sparkle,potatoochips
945590.jpg,https://derpicdn.net/img/view/2015/7/28/945590.jpg,5,0.9747828245162964,398,4,636,242,238,238,applejack|big macintosh|fluttershy|pinkie pie|queen chrysalis|rainbow dash|rarity|scootaloo|soarin'|spitfire|sweetie belle|trixie|twilight sparkle,potatoochips
945590.jpg,https://derpicdn.net/img/view/2015/7/28/945590.jpg,6,0.9655711650848388,413,388,623,598,210,210,applejack|big macintosh|fluttershy|pinkie pie|queen chrysalis|rainbow dash|rarity|scootaloo|soarin'|spitfire|sweetie belle|trixie|twilight sparkle,potatoochips
945590.jpg,https://derpicdn.net/img/view/2015/7/28/945590.jpg,7,0.9208561182022096,217,569,409,761,192,192,applejack|big macintosh|fluttershy|pinkie pie|queen chrysalis|rainbow dash|rarity|scootaloo|soarin'|spitfire|sweetie belle|trixie|twilight sparkle,potatoochips
947579.png,https://derpicdn.net/img/view/2015/7/30/947579.png,0,0.9907580018043518,1178,35,1524,381,346,346,discord|twilight sparkle,heilos
947579.png,https://derpicdn.net/img/view/2015/7/30/947579.png,2,0.9223684668540956,234,68,598,432,364,364,discord|twilight sparkle,heilos
947803.png,https://derpicdn.net/img/view/2015/7/31/947803.png,0,0.9547250866889954,432,60,836,464,404,404,starlight glimmer|sunset shimmer|trixie|twilight sparkle,asika-aida
948438.jpg,https://derpicdn.net/img/view/2015/8/1/948438.jpg,0,0.9520515203475952,160,12,310,162,150,150,applejack|pinkie pie|rainbow dash|rarity|twilight sparkle,tonyfleecs
9512.png,https://derpicdn.net/img/view/2012/6/19/9512.png,0,0.9903010725975036,1050,158,1600,730,550,572,princess cadance|queen chrysalis|twilight sparkle,
952945.png,https://derpicdn.net/img/view/2015/8/7/952945.png,0,0.933901846408844,399,611,631,843,232,232,applejack|rarity|twilight sparkle,dm29
955447.jpg,https://derpicdn.net/img/view/2015/8/11/955447.jpg,0,0.973195493221283,569,296,1011,738,442,442,rainbow dash|twilight sparkle,phenya|phoenixb159
957238.png,https://derpicdn.net/img/view/2015/8/13/957238.png,0,0.9966768026351928,494,0,1004,484,510,484,spike|twilight sparkle,goshaag
957238.png,https://derpicdn.net/img/view/2015/8/13/957238.png,1,0.9946097731590272,901,251,1369,719,468,468,spike|twilight sparkle,goshaag
95771.png,https://derpicdn.net/img/view/2012/9/12/95771.png,2,0.9411014914512634,750,490,1194,934,444,444,applejack|fluttershy|mane six|pinkie pie|rainbow dash|rarity|trixie|twilight sparkle,elenaboosy
960500.png,https://derpicdn.net/img/view/2015/8/18/960500.png,0,0.9992438554763794,146,81,422,357,276,276,pinkie pie|twilight sparkle,luciferamon
960500.png,https://derpicdn.net/img/view/2015/8/18/960500.png,1,0.9642254114151,439,61,697,319,258,258,pinkie pie|twilight sparkle,luciferamon
961695.png,https://derpicdn.net/img/view/2015/8/20/961695.png,0,0.9257683753967284,0,0,1758,1843,1758,1843,shining armor|twilight sparkle,beavernator
962566.png,https://derpicdn.net/img/view/2015/8/21/962566.png,0,0.9962716102600098,320,1393,2240,3313,1920,1920,princess cadance|princess celestia|twilight sparkle,beavernator
964282.png,https://derpicdn.net/img/view/2015/8/23/964282.png,0,0.9987804293632508,724,318,1702,1296,978,978,princess celestia|princess luna|twilight sparkle,pedrohander
965817.png,https://derpicdn.net/img/view/2015/8/26/965817.png,0,0.9993881583213806,366,27,902,563,536,536,princess celestia|spike|twilight sparkle,trickydick|i am nude
966325.png,https://derpicdn.net/img/view/2015/8/26/966325.png,0,0.9948013424873352,462,300,666,504,204,204,applejack|fluttershy|mane six|pinkie pie|rainbow dash|rarity|twilight sparkle,ambris
966325.png,https://derpicdn.net/img/view/2015/8/26/966325.png,1,0.9769995808601379,623,322,863,562,240,240,applejack|fluttershy|mane six|pinkie pie|rainbow dash|rarity|twilight sparkle,ambris
966600.png,https://derpicdn.net/img/view/2015/8/27/966600.png,0,0.9913046360015868,1017,371,1349,703,332,332,fluttershy|pinkie pie|rainbow dash|twilight sparkle,fluttershythekind
969356.png,https://derpicdn.net/img/view/2015/8/30/969356.png,0,0.9960293769836426,216,50,582,416,366,366,sunset shimmer|twilight sparkle,rwl
971672.png,https://derpicdn.net/img/view/2015/9/3/971672.png,0,0.9743593335151672,0,118,763,1022,763,904,applejack|twilight sparkle,notenoughapples
972497.png,https://derpicdn.net/img/view/2015/9/4/972497.png,0,0.9948403835296632,320,269,522,471,202,202,applejack|twilight sparkle,jowybean
975004.png,https://derpicdn.net/img/view/2015/9/8/975004.png,0,0.9926387071609496,950,0,1270,311,320,311,princess cadance|rainbow dash|twilight sparkle,sugarberry
975502.png,https://derpicdn.net/img/view/2015/9/8/975502.png,0,0.9535434246063232,2418,1526,3198,2306,780,780,princess luna|twilight sparkle,corelle-vairel
975502.png,https://derpicdn.net/img/view/2015/9/8/975502.png,1,0.94850355386734,1744,291,2692,1239,948,948,princess luna|twilight sparkle,corelle-vairel
977886.png,https://derpicdn.net/img/view/2015/9/12/977886.png,0,0.9071982502937316,1072,140,1484,552,412,412,starlight glimmer|sunset shimmer|trixie|twilight sparkle,oneovertwo
979718.png,https://derpicdn.net/img/view/2015/9/14/979718.png,0,0.9932661056518556,27,61,249,283,222,222,applejack|fluttershy|mane six|pinkie pie|rainbow dash|rarity|twilight sparkle,zwitterkitsune
979718.png,https://derpicdn.net/img/view/2015/9/14/979718.png,1,0.9926815629005432,1050,48,1280,284,230,236,applejack|fluttershy|mane six|pinkie pie|rainbow dash|rarity|twilight sparkle,zwitterkitsune
979718.png,https://derpicdn.net/img/view/2015/9/14/979718.png,2,0.9625771045684814,630,19,866,255,236,236,applejack|fluttershy|mane six|pinkie pie|rainbow dash|rarity|twilight sparkle,zwitterkitsune
98274.png,https://derpicdn.net/img/view/2012/9/15/98274.png,0,0.974341094493866,64,44,336,316,272,272,spike|twilight sparkle,conchelor
990410.png,https://derpicdn.net/img/view/2015/9/29/990410.png,0,0.9517756700515748,151,292,763,904,612,612,sunset shimmer|twilight sparkle,poisindoodles
990410.png,https://derpicdn.net/img/view/2015/9/29/990410.png,1,0.9027493596076964,533,282,1045,794,512,512,sunset shimmer|twilight sparkle,poisindoodles
990742.png,https://derpicdn.net/img/view/2015/9/29/990742.png,0,0.9905895590782166,557,435,751,629,194,194,rarity|twilight sparkle,maggwai
991502.png,https://derpicdn.net/img/view/2015/9/30/991502.png,0,0.9000748991966248,4278,996,5224,1942,946,946,sunset shimmer|twilight sparkle,askshootingstar1234
992518.png,https://derpicdn.net/img/view/2015/10/2/992518.png,0,0.997402846813202,197,23,409,235,212,212,princess celestia|princess luna|twilight sparkle,foxenawolf
992518.png,https://derpicdn.net/img/view/2015/10/2/992518.png,1,0.9202032685279846,558,82,782,306,224,224,princess celestia|princess luna|twilight sparkle,foxenawolf
992621.png,https://derpicdn.net/img/view/2015/10/2/992621.png,0,0.9748151898384094,290,0,1000,699,710,699,sunset shimmer|twilight sparkle,jessycrackers
992987.png,https://derpicdn.net/img/view/2015/10/2/992987.png,0,0.9991745352745056,924,30,1328,434,404,404,applejack|fluttershy|mane six|pinkie pie|rainbow dash|rarity|twilight sparkle,empyu
992987.png,https://derpicdn.net/img/view/2015/10/2/992987.png,1,0.9978020787239076,192,0,582,379,390,379,applejack|fluttershy|mane six|pinkie pie|rainbow dash|rarity|twilight sparkle,empyu
992987.png,https://derpicdn.net/img/view/2015/10/2/992987.png,2,0.9968064427375792,918,448,1350,880,432,432,applejack|fluttershy|mane six|pinkie pie|rainbow dash|rarity|twilight sparkle,empyu
994563.jpg,https://derpicdn.net/img/view/2015/10/4/994563.jpg,0,0.9994070529937744,426,0,784,345,358,345,spike|twilight sparkle,sennishi
995086.png,https://derpicdn.net/img/view/2015/10/5/995086.png,0,0.9909692406654358,0,2225,833,3065,833,840,applejack|fluttershy|pinkie pie|rainbow dash|rarity|sunset shimmer|twilight sparkle,meganlovesangrybirds
995086.png,https://derpicdn.net/img/view/2015/10/5/995086.png,1,0.9740182161331176,5788,2190,6944,3346,1156,1156,applejack|fluttershy|pinkie pie|rainbow dash|rarity|sunset shimmer|twilight sparkle,meganlovesangrybirds
995086.png,https://derpicdn.net/img/view/2015/10/5/995086.png,2,0.9326578378677368,3770,3515,4764,4509,994,994,applejack|fluttershy|pinkie pie|rainbow dash|rarity|sunset shimmer|twilight sparkle,meganlovesangrybirds
995146.png,https://derpicdn.net/img/view/2015/10/5/995146.png,0,0.95027893781662,824,48,1676,900,852,852,sunset shimmer|twilight sparkle,meganlovesangrybirds
997979.png,https://derpicdn.net/img/view/2015/10/9/997979.png,0,0.9406567811965942,734,144,1032,442,298,298,pinkie pie|spike|twilight sparkle,chiuuchiuu
998949.png,https://derpicdn.net/img/view/2015/10/10/998949.png,0,0.9329451918601992,878,155,2410,1687,1532,1532,fluttershy|twilight sparkle,galekz
999106.png,https://derpicdn.net/img/view/2015/10/10/999106.png,0,0.9988268613815308,31,634,621,1224,590,590,apple bloom|applejack|cutie mark crusaders|discord|fluttershy|mane six|pinkie pie|princess celestia|princess luna|rainbow dash|rarity|scootaloo|spike|sweetie belle|twilight sparkle,aleximusprime
999106.png,https://derpicdn.net/img/view/2015/10/10/999106.png,1,0.9963586926460266,1162,0,1776,534,614,534,apple bloom|applejack|cutie mark crusaders|discord|fluttershy|mane six|pinkie pie|princess celestia|princess luna|rainbow dash|rarity|scootaloo|spike|sweetie belle|twilight sparkle,aleximusprime
999106.png,https://derpicdn.net/img/view/2015/10/10/999106.png,2,0.9884673953056335,1987,1485,2541,2039,554,554,apple bloom|applejack|cutie mark crusaders|discord|fluttershy|mane six|pinkie pie|princess celestia|princess luna|rainbow dash|rarity|scootaloo|spike|sweetie belle|twilight sparkle,aleximusprime
999106.png,https://derpicdn.net/img/view/2015/10/10/999106.png,3,0.98845237493515,2,12,536,546,534,534,apple bloom|applejack|cutie mark crusaders|discord|fluttershy|mane six|pinkie pie|princess celestia|princess luna|rainbow dash|rarity|scootaloo|spike|sweetie belle|twilight sparkle,aleximusprime
999106.png,https://derpicdn.net/img/view/2015/10/10/999106.png,4,0.9844715595245358,1773,58,2207,492,434,434,apple bloom|applejack|cutie mark crusaders|discord|fluttershy|mane six|pinkie pie|princess celestia|princess luna|rainbow dash|rarity|scootaloo|spike|sweetie belle|twilight sparkle,aleximusprime
999106.png,https://derpicdn.net/img/view/2015/10/10/999106.png,5,0.9828441143035888,2592,1158,2992,1558,400,400,apple bloom|applejack|cutie mark crusaders|discord|fluttershy|mane six|pinkie pie|princess celestia|princess luna|rainbow dash|rarity|scootaloo|spike|sweetie belle|twilight sparkle,aleximusprime
999243.png,https://derpicdn.net/img/view/2015/10/11/999243.png,0,0.9871041178703308,234,276,512,554,278,278,apple bloom|applejack|cutie mark crusaders|diamond tiara|fluttershy|mane six|pinkie pie|princess celestia|rainbow dash|rarity|scootaloo|spike|sunset shimmer|sweetie belle|twilight sparkle,lucy-tan
999243.png,https://derpicdn.net/img/view/2015/10/11/999243.png,1,0.9800102710723876,507,46,735,274,228,228,apple bloom|applejack|cutie mark crusaders|diamond tiara|fluttershy|mane six|pinkie pie|princess celestia|rainbow dash|rarity|scootaloo|spike|sunset shimmer|sweetie belle|twilight sparkle,lucy-tan
999505.png,https://derpicdn.net/img/view/2015/10/11/999505.png,3,0.972101092338562,0,1115,394,1639,394,524,applejack|big macintosh|braeburn|discord|fluttershy|mane six|pinkie pie|princess celestia|princess luna|rainbow dash|rarity|scootaloo|soarin'|spike|trixie|twilight sparkle,43roken|kennyklent|rwl|megaimpact|scootiebloom|shoutingisfun|cherivinca|mrscurlystyles|zutheskunk edits|lumineko|evange|cloudshadezer0|raggyrabbit94|ponyshot|willdrawforfood1|vest|haretrinity|the weaver|karl97885|stoney pony|untiltheballoons|technaro|thephoebster|collaredginger|otterlore|randomlywhimsical|ss2sonic|mn27|mickeymonster|madmax|heavymetalbronyyeah|lucy-tan|moonshine
999540.png,https://derpicdn.net/img/view/2015/10/11/999540.png,0,0.9526686668395996,684,950,1080,1346,396,396,princess cadance|princess celestia|princess luna|twilight sparkle,lou1911
999943.jpg,https://derpicdn.net/img/view/2015/10/11/999943.jpg,0,0.9080991148948668,153,679,395,921,242,242,discord|queen chrysalis|spike|sunset shimmer|twilight sparkle,andypriceart
1001055.png,https://derpicdn.net/img/view/2015/10/13/1001055.png,0,0.9955464601516724,462,60,732,330,270,270,shining armor|twilight sparkle,jargon scott
1003179.png,https://derpicdn.net/img/view/2015/10/16/1003179.png,0,0.9974133968353271,339,0,789,444,450,444,princess celestia|twilight sparkle,foxxy-arts
1003401.png,https://derpicdn.net/img/view/2015/10/16/1003401.png,0,0.9993715882301332,0,287,698,987,698,700,princess cadance|princess celestia|princess luna|twilight sparkle,geckogeek
1003401.png,https://derpicdn.net/img/view/2015/10/16/1003401.png,1,0.9944506883621216,2015,1339,3247,2480,1232,1141,princess cadance|princess celestia|princess luna|twilight sparkle,geckogeek
1003401.png,https://derpicdn.net/img/view/2015/10/16/1003401.png,2,0.9911588430404664,1918,0,2558,524,640,524,princess cadance|princess celestia|princess luna|twilight sparkle,geckogeek
1004161.png,https://derpicdn.net/img/view/2015/10/17/1004161.png,0,0.9328911900520324,830,0,1894,918,1064,918,applejack|fluttershy|twilight sparkle,
1007986.png,https://derpicdn.net/img/view/2015/10/23/1007986.png,0,0.9940343499183656,275,35,567,327,292,292,applejack|fluttershy|mane six|pinkie pie|rainbow dash|rarity|twilight sparkle,phyllismi
1007986.png,https://derpicdn.net/img/view/2015/10/23/1007986.png,1,0.9678606986999512,557,347,781,571,224,224,applejack|fluttershy|mane six|pinkie pie|rainbow dash|rarity|twilight sparkle,phyllismi
1007986.png,https://derpicdn.net/img/view/2015/10/23/1007986.png,2,0.9237086176872252,481,586,713,818,232,232,applejack|fluttershy|mane six|pinkie pie|rainbow dash|rarity|twilight sparkle,phyllismi
1007986.png,https://derpicdn.net/img/view/2015/10/23/1007986.png,3,0.9194329380989076,282,371,514,603,232,232,applejack|fluttershy|mane six|pinkie pie|rainbow dash|rarity|twilight sparkle,phyllismi
1007986.png,https://derpicdn.net/img/view/2015/10/23/1007986.png,4,0.9022411704063416,737,298,1111,672,374,374,applejack|fluttershy|mane six|pinkie pie|rainbow dash|rarity|twilight sparkle,phyllismi
1008208.png,https://derpicdn.net/img/view/2015/10/23/1008208.png,0,0.9926193952560424,358,0,1100,626,742,626,fluttershy|twilight sparkle,goshaag
1012616.png,https://derpicdn.net/img/view/2015/10/30/1012616.png,0,0.9861865043640136,225,195,571,541,346,346,sunset shimmer|twilight sparkle,phyllismi
1013107.png,https://derpicdn.net/img/view/2015/10/31/1013107.png,0,0.9647502899169922,516,0,846,319,330,319,trixie|twilight sparkle,wakasumire
1013454.png,https://derpicdn.net/img/view/2015/10/31/1013454.png,0,0.99444842338562,486,459,876,849,390,390,sunset shimmer|twilight sparkle,pezzhippo
1013527.png,https://derpicdn.net/img/view/2015/10/31/1013527.png,0,0.9955582022666932,3513,1282,6341,4110,2828,2828,applejack|fluttershy|twilight sparkle,salemcat|kysss90
1013527.png,https://derpicdn.net/img/view/2015/10/31/1013527.png,1,0.9929340481758118,1133,2544,3723,5134,2590,2590,applejack|fluttershy|twilight sparkle,salemcat|kysss90
1016020.png,https://derpicdn.net/img/view/2015/11/4/1016020.png,0,0.9035994410514832,4195,1968,6331,4104,2136,2136,sunset shimmer|twilight sparkle,osipush
1016348.png,https://derpicdn.net/img/view/2015/11/5/1016348.png,0,0.9845706820487976,0,39,1541,1593,1541,1554,sunset shimmer|twilight sparkle,sikander
1016348.png,https://derpicdn.net/img/view/2015/11/5/1016348.png,1,0.9754081964492798,1461,175,3000,1767,1539,1592,sunset shimmer|twilight sparkle,sikander
1017278.png,https://derpicdn.net/img/view/2015/11/6/1017278.png,0,0.998465061187744,598,0,1326,589,728,589,starlight glimmer|twilight sparkle,pinkamenascratch
1018.png,https://derpicdn.net/img/view/2012/1/20/1018.png,0,0.9844068884849548,0,0,369,371,369,371,apple bloom|applejack|big macintosh|cutie mark crusaders|fluttershy|mane six|pinkie pie|princess celestia|princess luna|rainbow dash|rarity|scootaloo|spike|sweetie belle|trixie|twilight sparkle,blue-paint-sea
1018.png,https://derpicdn.net/img/view/2012/1/20/1018.png,1,0.9793483018875122,1020,690,1286,956,266,266,apple bloom|applejack|big macintosh|cutie mark crusaders|fluttershy|mane six|pinkie pie|princess celestia|princess luna|rainbow dash|rarity|scootaloo|spike|sweetie belle|trixie|twilight sparkle,blue-paint-sea
1018.png,https://derpicdn.net/img/view/2012/1/20/1018.png,2,0.978236973285675,1560,275,1918,633,358,358,apple bloom|applejack|big macintosh|cutie mark crusaders|fluttershy|mane six|pinkie pie|princess celestia|princess luna|rainbow dash|rarity|scootaloo|spike|sweetie belle|trixie|twilight sparkle,blue-paint-sea
1018.png,https://derpicdn.net/img/view/2012/1/20/1018.png,3,0.931245982646942,1035,323,1361,649,326,326,apple bloom|applejack|big macintosh|cutie mark crusaders|fluttershy|mane six|pinkie pie|princess celestia|princess luna|rainbow dash|rarity|scootaloo|spike|sweetie belle|trixie|twilight sparkle,blue-paint-sea
1018383.png,https://derpicdn.net/img/view/2015/11/7/1018383.png,0,0.9010605216026306,51,576,357,882,306,306,discord|spike|twilight sparkle,esuka
1021147.png,https://derpicdn.net/img/view/2015/11/11/1021147.png,1,0.9987897872924804,400,702,876,1178,476,476,applejack|fluttershy|mane six|pinkie pie|rainbow dash|rarity|twilight sparkle,jessesmash32
1021147.png,https://derpicdn.net/img/view/2015/11/11/1021147.png,2,0.9968293309211732,710,725,1196,1211,486,486,applejack|fluttershy|mane six|pinkie pie|rainbow dash|rarity|twilight sparkle,jessesmash32
1021147.png,https://derpicdn.net/img/view/2015/11/11/1021147.png,3,0.9955546855926514,1199,85,1665,551,466,466,applejack|fluttershy|mane six|pinkie pie|rainbow dash|rarity|twilight sparkle,jessesmash32
1021147.png,https://derpicdn.net/img/view/2015/11/11/1021147.png,4,0.9879816174507141,1097,770,1489,1162,392,392,applejack|fluttershy|mane six|pinkie pie|rainbow dash|rarity|twilight sparkle,jessesmash32
1022334.png,https://derpicdn.net/img/view/2015/11/14/1022334.png,0,0.9302643537521362,888,0,1970,1072,1082,1072,rarity|twilight sparkle,geraritydevillefort
1023245.png,https://derpicdn.net/img/view/2015/11/15/1023245.png,0,0.9706376194953918,664,24,1142,502,478,478,fluttershy|twilight sparkle,
1024342.png,https://derpicdn.net/img/view/2015/11/17/1024342.png,0,0.9955023527145386,448,182,674,408,226,226,pinkie pie|twilight sparkle,小鴉
1026472.png,https://derpicdn.net/img/view/2015/11/20/1026472.png,0,0.999130368232727,0,728,669,1406,669,678,princess cadance|princess celestia|princess luna|twilight sparkle,papibabidi
1026472.png,https://derpicdn.net/img/view/2015/11/20/1026472.png,1,0.9980196952819824,782,753,1492,1463,710,710,princess cadance|princess celestia|princess luna|twilight sparkle,papibabidi
1026472.png,https://derpicdn.net/img/view/2015/11/20/1026472.png,2,0.9786345958709716,760,68,1470,778,710,710,princess cadance|princess celestia|princess luna|twilight sparkle,papibabidi
1026472.png,https://derpicdn.net/img/view/2015/11/20/1026472.png,3,0.9704782962799072,53,43,683,673,630,630,princess cadance|princess celestia|princess luna|twilight sparkle,papibabidi
1026630.jpg,https://derpicdn.net/img/view/2015/11/20/1026630.jpg,0,0.9061006903648376,100,50,388,338,288,288,fluttershy|twilight sparkle,sennishi
1027615.png,https://derpicdn.net/img/view/2015/11/22/1027615.png,0,0.9930893778800964,13,0,751,700,738,700,fluttershy|rainbow dash|twilight sparkle,geraritydevillefort
1029454.png,https://derpicdn.net/img/view/2015/11/24/1029454.png,0,0.9818647503852844,121,109,263,251,142,142,trixie|twilight sparkle,bauru
1030308.png,https://derpicdn.net/img/view/2015/11/26/1030308.png,0,0.9184296131134032,1396,354,2300,1258,904,904,starlight glimmer|twilight sparkle,emera33
1031552.png,https://derpicdn.net/img/view/2015/11/28/1031552.png,0,0.9656615257263184,0,0,180,237,180,237,rainbow dash|twilight sparkle,
1031990.png,https://derpicdn.net/img/view/2015/11/28/1031990.png,0,0.9960818886756896,7,0,625,544,618,544,starlight glimmer|twilight sparkle,
1032078.png,https://derpicdn.net/img/view/2015/11/28/1032078.png,0,0.9837413430213928,733,0,1505,699,772,699,fluttershy|pinkie pie|spike|twilight sparkle,
1032434.png,https://derpicdn.net/img/view/2015/11/29/1032434.png,0,0.9973419904708862,202,576,624,998,422,422,fluttershy|starlight glimmer|twilight sparkle,violyre
1032984.png,https://derpicdn.net/img/view/2015/11/29/1032984.png,0,0.96273010969162,1975,516,2355,896,380,380,applejack|fluttershy|mane six|pinkie pie|rainbow dash|rarity|starlight glimmer|twilight sparkle,creationis
10332.png,https://derpicdn.net/img/view/2012/6/19/10332.png,0,0.9967183470726012,584,115,892,423,308,308,spike|twilight sparkle,bamboodog
1033615.png,https://derpicdn.net/img/view/2015/11/30/1033615.png,1,0.9782044291496276,2341,115,2919,693,578,578,applejack|fluttershy|mane six|pinkie pie|rainbow dash|rarity|twilight sparkle,kaiilu
1033615.png,https://derpicdn.net/img/view/2015/11/30/1033615.png,2,0.9644707441329956,1733,27,2389,683,656,656,applejack|fluttershy|mane six|pinkie pie|rainbow dash|rarity|twilight sparkle,kaiilu
1034503.png,https://derpicdn.net/img/view/2015/12/1/1034503.png,0,0.9745285511016846,2685,404,3551,1270,866,866,princess celestia|princess luna|twilight sparkle,megarainbowdash2000
1034815.png,https://derpicdn.net/img/view/2015/12/1/1034815.png,0,0.9986403584480286,0,121,350,477,350,356,applejack|fluttershy|mane six|pinkie pie|rainbow dash|rarity|starlight glimmer|twilight sparkle,hungrysohma
1034815.png,https://derpicdn.net/img/view/2015/12/1/1034815.png,1,0.9490078687667848,14,598,432,1016,418,418,applejack|fluttershy|mane six|pinkie pie|rainbow dash|rarity|starlight glimmer|twilight sparkle,hungrysohma
1034815.png,https://derpicdn.net/img/view/2015/12/1/1034815.png,2,0.9420816898345948,1258,590,1600,948,342,358,applejack|fluttershy|mane six|pinkie pie|rainbow dash|rarity|starlight glimmer|twilight sparkle,hungrysohma
1034815.png,https://derpicdn.net/img/view/2015/12/1/1034815.png,3,0.9307555556297302,920,621,1372,1067,452,446,applejack|fluttershy|mane six|pinkie pie|rainbow dash|rarity|starlight glimmer|twilight sparkle,hungrysohma
1043120.png,https://derpicdn.net/img/view/2015/12/13/1043120.png,2,0.9499562978744508,119,95,511,487,392,392,applejack|fluttershy|pinkie pie|rainbow dash|rarity|spike|starlight glimmer|twilight sparkle,psyxofthoros
1043361.png,https://derpicdn.net/img/view/2015/12/13/1043361.png,1,0.9986128211021424,3994,0,6218,1848,2224,1848,princess cadance|princess celestia|princess luna|twilight sparkle,90sigma
1043361.png,https://derpicdn.net/img/view/2015/12/13/1043361.png,3,0.9113933444023132,1401,3179,3507,5285,2106,2106,princess cadance|princess celestia|princess luna|twilight sparkle,90sigma
1044901.png,https://derpicdn.net/img/view/2015/12/15/1044901.png,0,0.91484135389328,418,418,1118,1118,700,700,spike|twilight sparkle,mxcoriginal
1046349.png,https://derpicdn.net/img/view/2015/12/17/1046349.png,0,0.9936734437942504,1073,172,1429,528,356,356,trixie|twilight sparkle,playfulelegy
1046349.png,https://derpicdn.net/img/view/2015/12/17/1046349.png,1,0.9857471585273744,249,113,691,555,442,442,trixie|twilight sparkle,playfulelegy
1047664.png,https://derpicdn.net/img/view/2015/12/19/1047664.png,1,0.9977546930313108,0,1165,464,1667,464,502,applejack|fluttershy|mane six|pinkie pie|rainbow dash|rarity|spike|twilight sparkle,
1047664.png,https://derpicdn.net/img/view/2015/12/19/1047664.png,2,0.9974432587623596,793,1143,1280,1671,487,528,applejack|fluttershy|mane six|pinkie pie|rainbow dash|rarity|spike|twilight sparkle,
1048134.png,https://derpicdn.net/img/view/2015/12/19/1048134.png,0,0.9992306232452391,317,614,839,1136,522,522,applejack|fluttershy|mane six|pinkie pie|rainbow dash|rarity|twilight sparkle,art-fany
1050851.png,https://derpicdn.net/img/view/2015/12/23/1050851.png,0,0.9948689937591552,942,984,1328,1370,386,386,starlight glimmer|trixie|twilight sparkle,rainbownspeedash
1052702.png,https://derpicdn.net/img/view/2015/12/25/1052702.png,0,0.9880540370941162,117,0,506,325,389,325,fluttershy|twilight sparkle,lovefool2
1054096.png,https://derpicdn.net/img/view/2015/12/28/1054096.png,1,0.9181398153305054,899,337,1357,795,458,458,applejack|fluttershy|mane six|pinkie pie|rainbow dash|rarity|twilight sparkle,sourcherry
1054702.jpg,https://derpicdn.net/img/view/2015/12/28/1054702.jpg,0,0.9866918325424194,645,1937,1155,2447,510,510,spike|twilight sparkle,seer45
1055526.png,https://derpicdn.net/img/view/2015/12/30/1055526.png,1,0.9588695168495178,785,0,1389,479,604,479,trixie|twilight sparkle,punzil504
1056212.jpg,https://derpicdn.net/img/view/2015/12/31/1056212.jpg,0,0.9949184060096741,0,354,266,634,266,280,big macintosh|twilight sparkle,piripaints
105686.png,https://derpicdn.net/img/view/2012/9/24/105686.png,0,0.9963422417640686,257,4,463,210,206,206,applejack|fluttershy|mane six|pinkie pie|rainbow dash|rarity|twilight sparkle,dcencia
1056895.jpg,https://derpicdn.net/img/view/2015/12/31/1056895.jpg,0,0.9957959055900574,1415,1693,2200,2479,785,786,big macintosh|discord|pinkie pie|princess celestia|princess luna|queen chrysalis|rarity|twilight sparkle,uncommented
1056895.jpg,https://derpicdn.net/img/view/2015/12/31/1056895.jpg,1,0.9957890510559082,261,109,829,677,568,568,big macintosh|discord|pinkie pie|princess celestia|princess luna|queen chrysalis|rarity|twilight sparkle,uncommented
1056895.jpg,https://derpicdn.net/img/view/2015/12/31/1056895.jpg,2,0.9926034808158876,457,1389,1015,1947,558,558,big macintosh|discord|pinkie pie|princess celestia|princess luna|queen chrysalis|rarity|twilight sparkle,uncommented
1056895.jpg,https://derpicdn.net/img/view/2015/12/31/1056895.jpg,4,0.9851507544517516,91,1726,803,2438,712,712,big macintosh|discord|pinkie pie|princess celestia|princess luna|queen chrysalis|rarity|twilight sparkle,uncommented
1056895.jpg,https://derpicdn.net/img/view/2015/12/31/1056895.jpg,5,0.9600700736045836,791,362,1363,934,572,572,big macintosh|discord|pinkie pie|princess celestia|princess luna|queen chrysalis|rarity|twilight sparkle,uncommented
1056895.jpg,https://derpicdn.net/img/view/2015/12/31/1056895.jpg,6,0.9339194893836976,0,2451,498,3047,498,596,big macintosh|discord|pinkie pie|princess celestia|princess luna|queen chrysalis|rarity|twilight sparkle,uncommented
1057882.png,https://derpicdn.net/img/view/2016/1/2/1057882.png,0,0.9860966801643372,235,330,485,580,250,250,spike|twilight sparkle,aidapone
1059405.png,https://derpicdn.net/img/view/2016/1/4/1059405.png,1,0.9945287704467772,1258,600,1600,948,342,348,princess luna|rainbow dash|twilight sparkle,nightmaremoons
1059405.png,https://derpicdn.net/img/view/2016/1/4/1059405.png,3,0.9497709274291992,302,119,756,573,454,454,princess luna|rainbow dash|twilight sparkle,nightmaremoons
1060133.png,https://derpicdn.net/img/view/2016/1/5/1060133.png,0,0.9901303052902222,602,0,904,297,302,297,applejack|fluttershy|mane six|pinkie pie|princess cadance|princess celestia|princess luna|rainbow dash|rarity|twilight sparkle,kkitsu
1061378.png,https://derpicdn.net/img/view/2016/1/7/1061378.png,1,0.9566444158554076,345,223,591,469,246,246,applejack|fluttershy|mane six|pinkie pie|rainbow dash|rarity|twilight sparkle,aidapone
1062656.png,https://derpicdn.net/img/view/2016/1/9/1062656.png,0,0.9912708401679992,175,0,639,370,464,370,princess cadance|shining armor|trixie|twilight sparkle,sugarberry
1065147.jpg,https://derpicdn.net/img/view/2016/1/12/1065147.jpg,0,0.992414116859436,868,140,1302,574,434,434,fluttershy|rarity|twilight sparkle,yam
1065817.jpg,https://derpicdn.net/img/view/2016/1/13/1065817.jpg,0,0.9881111979484558,257,0,807,421,550,421,applejack|fluttershy|mane six|pinkie pie|rainbow dash|rarity|starlight glimmer|twilight sparkle,xpesifeindx|90sigma|mcawesomebrony|dashiesparkle|bronyvectors|mr-kennedy92|gyrotech|mihaaaa
1065817.jpg,https://derpicdn.net/img/view/2016/1/13/1065817.jpg,1,0.9806642532348632,1373,232,1781,640,408,408,applejack|fluttershy|mane six|pinkie pie|rainbow dash|rarity|starlight glimmer|twilight sparkle,xpesifeindx|90sigma|mcawesomebrony|dashiesparkle|bronyvectors|mr-kennedy92|gyrotech|mihaaaa
1065817.jpg,https://derpicdn.net/img/view/2016/1/13/1065817.jpg,2,0.9319591522216796,1007,0,1607,470,600,470,applejack|fluttershy|mane six|pinkie pie|rainbow dash|rarity|starlight glimmer|twilight sparkle,xpesifeindx|90sigma|mcawesomebrony|dashiesparkle|bronyvectors|mr-kennedy92|gyrotech|mihaaaa
1065817.jpg,https://derpicdn.net/img/view/2016/1/13/1065817.jpg,3,0.903045117855072,90,256,464,630,374,374,applejack|fluttershy|mane six|pinkie pie|rainbow dash|rarity|starlight glimmer|twilight sparkle,xpesifeindx|90sigma|mcawesomebrony|dashiesparkle|bronyvectors|mr-kennedy92|gyrotech|mihaaaa
1067012.png,https://derpicdn.net/img/view/2016/1/15/1067012.png,0,0.9553940892219543,5574,262,6318,1006,744,744,applejack|fluttershy|pinkie pie|rainbow dash|rarity|twilight sparkle,alcohors
1067012.png,https://derpicdn.net/img/view/2016/1/15/1067012.png,1,0.9363606572151184,3399,293,4373,1267,974,974,applejack|fluttershy|pinkie pie|rainbow dash|rarity|twilight sparkle,alcohors
1067465.png,https://derpicdn.net/img/view/2016/1/16/1067465.png,0,0.9956115484237672,834,202,1518,886,684,684,pinkie pie|twilight sparkle,whazzam95
1068118.png,https://derpicdn.net/img/view/2016/1/17/1068118.png,0,0.9062360525131226,2331,1010,2697,1376,366,366,fluttershy|rainbow dash|spike|starlight glimmer|twilight sparkle,oinktweetstudios
1073249.png,https://derpicdn.net/img/view/2016/1/25/1073249.png,0,0.977139174938202,123,204,469,550,346,346,pinkie pie|twilight sparkle,dm29
1076276.png,https://derpicdn.net/img/view/2016/1/30/1076276.png,0,0.9890027046203612,295,908,745,1358,450,450,applejack|fluttershy|mane six|pinkie pie|rainbow dash|rarity|starlight glimmer|twilight sparkle,ctb-36
1076699.png,https://derpicdn.net/img/view/2016/1/30/1076699.png,0,0.995263934135437,46,0,758,695,712,695,apple bloom|twilight sparkle,neondion60
1078271.png,https://derpicdn.net/img/view/2016/2/1/1078271.png,1,0.9820177555084229,2440,780,3392,1732,952,952,starlight glimmer|sunset shimmer|trixie|twilight sparkle,sketchmcreations
1078913.jpg,https://derpicdn.net/img/view/2016/2/2/1078913.jpg,0,0.973412811756134,979,11,1103,135,124,124,applejack|fluttershy|pinkie pie|rainbow dash|rarity|sunset shimmer|twilight sparkle,azaleasdolls
1078913.jpg,https://derpicdn.net/img/view/2016/2/2/1078913.jpg,1,0.9582332968711852,282,7,440,165,158,158,applejack|fluttershy|pinkie pie|rainbow dash|rarity|sunset shimmer|twilight sparkle,azaleasdolls
1078913.jpg,https://derpicdn.net/img/view/2016/2/2/1078913.jpg,2,0.9248303771018982,1413,0,1587,151,174,151,applejack|fluttershy|pinkie pie|rainbow dash|rarity|sunset shimmer|twilight sparkle,azaleasdolls
1080365.png,https://derpicdn.net/img/view/2016/2/4/1080365.png,0,0.9989909529685974,95,18,545,468,450,450,starlight glimmer|twilight sparkle,
1081805.png,https://derpicdn.net/img/view/2016/2/6/1081805.png,0,0.985781729221344,784,447,1280,961,496,514,applejack|twilight sparkle,ncmares
108802.png,https://derpicdn.net/img/view/2012/9/28/108802.png,0,0.9993526339530944,291,59,463,231,172,172,applejack|fluttershy|mane six|pinkie pie|rainbow dash|rarity|twilight sparkle,mlpfwb
1090751.png,https://derpicdn.net/img/view/2016/2/17/1090751.png,1,0.9927901029586792,2653,204,3449,1000,796,796,shining armor|twilight sparkle,vector-brony
1091158.png,https://derpicdn.net/img/view/2016/2/18/1091158.png,0,0.9835762977600098,680,935,1452,1707,772,772,princess cadance|princess celestia|princess flurry heart|princess luna|twilight sparkle,glittypie
1091158.png,https://derpicdn.net/img/view/2016/2/18/1091158.png,1,0.9822666645050048,1800,923,2754,1877,954,954,princess cadance|princess celestia|princess flurry heart|princess luna|twilight sparkle,glittypie
1091158.png,https://derpicdn.net/img/view/2016/2/18/1091158.png,2,0.9767724871635436,28,898,734,1604,706,706,princess cadance|princess celestia|princess flurry heart|princess luna|twilight sparkle,glittypie
1091158.png,https://derpicdn.net/img/view/2016/2/18/1091158.png,3,0.9710495471954346,2664,1638,3244,2218,580,580,princess cadance|princess celestia|princess flurry heart|princess luna|twilight sparkle,glittypie
1091158.png,https://derpicdn.net/img/view/2016/2/18/1091158.png,4,0.9063165187835692,1328,1224,1996,1892,668,668,princess cadance|princess celestia|princess flurry heart|princess luna|twilight sparkle,glittypie
1091865.png,https://derpicdn.net/img/view/2016/2/19/1091865.png,0,0.9945706725120544,1826,15,2884,1073,1058,1058,spike|twilight sparkle,miss-cats|eagle1division
1091865.png,https://derpicdn.net/img/view/2016/2/19/1091865.png,1,0.9878989458084106,521,1461,1437,2377,916,916,spike|twilight sparkle,miss-cats|eagle1division
10948.jpg,https://derpicdn.net/img/view/2012/6/20/10948.jpg,0,0.999403715133667,486,665,762,941,276,276,trixie|twilight sparkle,shepherd0821
10948.jpg,https://derpicdn.net/img/view/2012/6/20/10948.jpg,1,0.9424242377281188,85,61,353,329,268,268,trixie|twilight sparkle,shepherd0821
1094985.png,https://derpicdn.net/img/view/2016/2/23/1094985.png,0,0.9922756552696228,1232,595,1596,959,364,364,spike|sunset shimmer|twilight sparkle,majkashinoda626
1094985.png,https://derpicdn.net/img/view/2016/2/23/1094985.png,1,0.9812384843826294,704,404,1414,1114,710,710,spike|sunset shimmer|twilight sparkle,majkashinoda626
1094985.png,https://derpicdn.net/img/view/2016/2/23/1094985.png,3,0.971671223640442,1489,500,2035,1046,546,546,spike|sunset shimmer|twilight sparkle,majkashinoda626
1095104.png,https://derpicdn.net/img/view/2016/2/23/1095104.png,0,0.9912094473838806,974,141,1184,351,210,210,applejack|fluttershy|pinkie pie|rainbow dash|rarity|twilight sparkle,rmzero|boastudio
109610.png,https://derpicdn.net/img/view/2012/9/29/109610.png,0,0.97580486536026,1607,1358,2067,1818,460,460,applejack|fluttershy|pinkie pie|princess cadance|princess celestia|princess luna|queen chrysalis|rainbow dash|rarity|scootaloo|soarin'|spitfire|trixie|twilight sparkle,parttimebrony|haloreplicas
109610.png,https://derpicdn.net/img/view/2012/9/29/109610.png,1,0.9410842657089232,119,0,579,448,460,448,applejack|fluttershy|pinkie pie|princess cadance|princess celestia|princess luna|queen chrysalis|rainbow dash|rarity|scootaloo|soarin'|spitfire|trixie|twilight sparkle,parttimebrony|haloreplicas
109610.png,https://derpicdn.net/img/view/2012/9/29/109610.png,2,0.9076648950576782,272,743,714,1185,442,442,applejack|fluttershy|pinkie pie|princess cadance|princess celestia|princess luna|queen chrysalis|rainbow dash|rarity|scootaloo|soarin'|spitfire|trixie|twilight sparkle,parttimebrony|haloreplicas
1098677.png,https://derpicdn.net/img/view/2016/2/28/1098677.png,0,0.9564872980117798,234,402,494,662,260,260,applejack|fluttershy|mane six|pinkie pie|rainbow dash|rarity|twilight sparkle,nanook123
1098677.png,https://derpicdn.net/img/view/2016/2/28/1098677.png,1,0.9207127690315248,117,0,335,216,218,216,applejack|fluttershy|mane six|pinkie pie|rainbow dash|rarity|twilight sparkle,nanook123
1101323.png,https://derpicdn.net/img/view/2016/3/3/1101323.png,0,0.9970983266830444,473,12,1000,552,527,540,applejack|fluttershy|mane six|pinkie pie|rainbow dash|rarity|spike|twilight sparkle,theroyalprincesses
1101323.png,https://derpicdn.net/img/view/2016/3/3/1101323.png,1,0.9920743703842164,0,33,500,583,500,550,applejack|fluttershy|mane six|pinkie pie|rainbow dash|rarity|spike|twilight sparkle,theroyalprincesses
1102749.png,https://derpicdn.net/img/view/2016/3/5/1102749.png,0,0.990515410900116,71,289,361,579,290,290,queen chrysalis|twilight sparkle,empyu
1102749.png,https://derpicdn.net/img/view/2016/3/5/1102749.png,1,0.9733067154884338,622,301,934,613,312,312,queen chrysalis|twilight sparkle,empyu
1103090.png,https://derpicdn.net/img/view/2016/3/6/1103090.png,0,0.9418681263923644,1042,0,1738,541,696,541,applejack|fluttershy|mane six|pinkie pie|rainbow dash|rarity|spike|starlight glimmer|twilight sparkle,doge4ce
1106175.png,https://derpicdn.net/img/view/2016/3/10/1106175.png,0,0.9995800852775574,126,558,592,1000,466,442,applejack|fluttershy|mane six|pinkie pie|rainbow dash|rarity|twilight sparkle,lennonblack
1106175.png,https://derpicdn.net/img/view/2016/3/10/1106175.png,2,0.9944722652435304,543,142,935,534,392,392,applejack|fluttershy|mane six|pinkie pie|rainbow dash|rarity|twilight sparkle,lennonblack
1110664.png,https://derpicdn.net/img/view/2016/3/17/1110664.png,0,0.996212124824524,93,6,405,318,312,312,sunset shimmer|twilight sparkle,phyllismi
1110664.png,https://derpicdn.net/img/view/2016/3/17/1110664.png,1,0.971638023853302,358,66,586,294,228,228,sunset shimmer|twilight sparkle,phyllismi
1110793.png,https://derpicdn.net/img/view/2016/3/17/1110793.png,0,0.9041786193847656,804,252,1556,1004,752,752,applejack|fluttershy|pinkie pie|princess celestia|princess luna|rainbow dash|rarity|spike|twilight sparkle,deathpwny
1111539.png,https://derpicdn.net/img/view/2016/3/18/1111539.png,0,0.9397544264793396,109,347,331,569,222,222,applejack|twilight sparkle,jowybean
1112665.jpg,https://derpicdn.net/img/view/2016/3/20/1112665.jpg,0,0.9758410453796388,845,7,1280,513,435,506,starlight glimmer|twilight sparkle,
1114472.png,https://derpicdn.net/img/view/2016/3/22/1114472.png,0,0.9966028928756714,553,584,819,850,266,266,applejack|fluttershy|mane six|pinkie pie|rainbow dash|rarity|twilight sparkle,bluesidearts
1114472.png,https://derpicdn.net/img/view/2016/3/22/1114472.png,1,0.9944739937782288,1239,550,1559,870,320,320,applejack|fluttershy|mane six|pinkie pie|rainbow dash|rarity|twilight sparkle,bluesidearts
1114472.png,https://derpicdn.net/img/view/2016/3/22/1114472.png,2,0.984809637069702,151,0,373,217,222,217,applejack|fluttershy|mane six|pinkie pie|rainbow dash|rarity|twilight sparkle,bluesidearts
1114472.png,https://derpicdn.net/img/view/2016/3/22/1114472.png,5,0.9097554087638856,624,33,898,307,274,274,applejack|fluttershy|mane six|pinkie pie|rainbow dash|rarity|twilight sparkle,bluesidearts
1114760.png,https://derpicdn.net/img/view/2016/3/22/1114760.png,0,0.999635934829712,87,182,1619,1714,1532,1532,princess cadance|trixie|twilight sparkle,mississippikite
1117404.png,https://derpicdn.net/img/view/2016/3/26/1117404.png,0,0.9981786608695984,913,553,1361,1000,448,447,applejack|fluttershy|mane six|pinkie pie|rainbow dash|rarity|twilight sparkle,lennonblack
1117404.png,https://derpicdn.net/img/view/2016/3/26/1117404.png,1,0.9944944977760316,592,546,1076,1000,484,454,applejack|fluttershy|mane six|pinkie pie|rainbow dash|rarity|twilight sparkle,lennonblack
1122102.png,https://derpicdn.net/img/view/2016/4/2/1122102.png,0,0.995457112789154,0,185,233,421,233,236,starlight glimmer|sunset shimmer|trixie|twilight sparkle,sagsaint
1122102.png,https://derpicdn.net/img/view/2016/4/2/1122102.png,1,0.9834636449813844,268,0,652,358,384,358,starlight glimmer|sunset shimmer|trixie|twilight sparkle,sagsaint
1122102.png,https://derpicdn.net/img/view/2016/4/2/1122102.png,2,0.9797751307487488,117,102,425,410,308,308,starlight glimmer|sunset shimmer|trixie|twilight sparkle,sagsaint
1123824.jpg,https://derpicdn.net/img/view/2016/4/3/1123824.jpg,0,0.9995887875556946,1796,1473,2456,2133,660,660,applejack|fluttershy|mane six|pinkie pie|rainbow dash|rarity|twilight sparkle,aoin
1123824.jpg,https://derpicdn.net/img/view/2016/4/3/1123824.jpg,1,0.9949127435684204,637,1341,1213,1917,576,576,applejack|fluttershy|mane six|pinkie pie|rainbow dash|rarity|twilight sparkle,aoin
1129282.png,https://derpicdn.net/img/view/2016/4/10/1129282.png,0,0.9983469843864441,140,93,652,605,512,512,rarity|twilight sparkle,siggie740
1131024.png,https://derpicdn.net/img/view/2016/4/13/1131024.png,0,0.91463440656662,173,0,945,760,772,760,princess flurry heart|twilight sparkle,rivibaes
1134952.png,https://derpicdn.net/img/view/2016/4/18/1134952.png,0,0.99614816904068,985,56,1495,566,510,510,applejack|pinkie pie|rainbow dash|twilight sparkle,southparktaoist
1134952.png,https://derpicdn.net/img/view/2016/4/18/1134952.png,2,0.9897742867469788,379,96,827,544,448,448,applejack|pinkie pie|rainbow dash|twilight sparkle,southparktaoist
1134952.png,https://derpicdn.net/img/view/2016/4/18/1134952.png,3,0.9858813285827636,175,911,751,1487,576,576,applejack|pinkie pie|rainbow dash|twilight sparkle,southparktaoist
1134952.png,https://derpicdn.net/img/view/2016/4/18/1134952.png,4,0.9841258525848388,1288,424,1734,870,446,446,applejack|pinkie pie|rainbow dash|twilight sparkle,southparktaoist
1134952.png,https://derpicdn.net/img/view/2016/4/18/1134952.png,5,0.9174981713294984,656,1371,1246,1961,590,590,applejack|pinkie pie|rainbow dash|twilight sparkle,southparktaoist
113576.png,https://derpicdn.net/img/view/2012/10/4/113576.png,0,0.9793553352355956,698,0,1010,237,312,237,apple bloom|applejack|cutie mark crusaders|diamond tiara|discord|fluttershy|mane six|pinkie pie|queen chrysalis|rainbow dash|rarity|scootaloo|spike|sweetie belle|twilight sparkle,schnuffitrunks
1136328.png,https://derpicdn.net/img/view/2016/4/20/1136328.png,0,0.9854012727737428,124,50,316,242,192,192,spike|twilight sparkle,wubcakeva
1137766.png,https://derpicdn.net/img/view/2016/4/22/1137766.png,0,0.9859208464622498,335,0,1427,938,1092,938,shining armor|twilight sparkle,zoruanna
1138401.png,https://derpicdn.net/img/view/2016/4/23/1138401.png,0,0.984040915966034,631,41,950,367,319,326,shining armor|twilight sparkle,dm29
1139360.png,https://derpicdn.net/img/view/2016/4/24/1139360.png,0,0.9466294050216676,701,96,1133,528,432,432,applejack|fluttershy|mane six|pinkie pie|rainbow dash|rarity|spike|twilight sparkle,orcakisses
1139360.png,https://derpicdn.net/img/view/2016/4/24/1139360.png,1,0.931892454624176,305,216,637,548,332,332,applejack|fluttershy|mane six|pinkie pie|rainbow dash|rarity|spike|twilight sparkle,orcakisses
1141664.jpg,https://derpicdn.net/img/view/2016/4/28/1141664.jpg,0,0.9970909357070924,748,74,1064,390,316,316,discord|twilight sparkle,celestiathegreatest
1149448.png,https://derpicdn.net/img/view/2016/5/8/1149448.png,0,0.97816002368927,1574,0,3490,1807,1916,1807,fluttershy|twilight sparkle,ambassad0r
1151184.jpg,https://derpicdn.net/img/view/2016/5/10/1151184.jpg,0,0.986527681350708,1536,367,2602,1433,1066,1066,princess celestia|starlight glimmer|trixie|twilight sparkle,midnightmeowth
1153093.png,https://derpicdn.net/img/view/2016/5/13/1153093.png,0,0.9448554515838624,2282,574,3586,1878,1304,1304,princess celestia|twilight sparkle,therainbowphoenix
1154307.jpg,https://derpicdn.net/img/view/2016/5/14/1154307.jpg,0,0.996934175491333,0,0,578,686,578,686,trixie|twilight sparkle,ayahana
1154307.jpg,https://derpicdn.net/img/view/2016/5/14/1154307.jpg,1,0.9769309759140016,254,7,900,779,646,772,trixie|twilight sparkle,ayahana
1157771.png,https://derpicdn.net/img/view/2016/5/19/1157771.png,0,0.9781108498573304,9,9,491,491,482,482,spike|twilight sparkle,empyu
1158059.png,https://derpicdn.net/img/view/2016/5/19/1158059.png,0,0.9996167421340942,2100,426,2555,906,455,480,apple bloom|cutie mark crusaders|scootaloo|sweetie belle|twilight sparkle,iamadinosaurrarrr
1158059.png,https://derpicdn.net/img/view/2016/5/19/1158059.png,1,0.9976000785827636,351,432,867,948,516,516,apple bloom|cutie mark crusaders|scootaloo|sweetie belle|twilight sparkle,iamadinosaurrarrr
1158059.png,https://derpicdn.net/img/view/2016/5/19/1158059.png,2,0.9942054748535156,1030,0,1880,698,850,698,apple bloom|cutie mark crusaders|scootaloo|sweetie belle|twilight sparkle,iamadinosaurrarrr
1158742.jpg,https://derpicdn.net/img/view/2016/5/20/1158742.jpg,0,0.9552945494651794,275,318,663,706,388,388,rainbow dash|twilight sparkle,ciciya
1160022.jpg,https://derpicdn.net/img/view/2016/5/22/1160022.jpg,0,0.986126720905304,426,1512,984,2070,558,558,princess celestia|twilight sparkle,
1160022.jpg,https://derpicdn.net/img/view/2016/5/22/1160022.jpg,1,0.9489142298698424,1687,1525,2239,2077,552,552,princess celestia|twilight sparkle,
1160193.png,https://derpicdn.net/img/view/2016/5/22/1160193.png,0,0.9993391633033752,641,0,921,255,280,255,pinkie pie|twilight sparkle,dusthiel
1160193.png,https://derpicdn.net/img/view/2016/5/22/1160193.png,1,0.999011754989624,194,5,414,225,220,220,pinkie pie|twilight sparkle,dusthiel
1161399.png,https://derpicdn.net/img/view/2016/5/23/1161399.png,1,0.9611895680427552,541,5,759,223,218,218,applejack|fluttershy|pinkie pie|rainbow dash|rarity|starlight glimmer|sunset shimmer|trixie|twilight sparkle,ramseybrony17
11618.png,https://derpicdn.net/img/view/2012/6/20/11618.png,0,0.9826303124427797,358,819,680,1141,322,322,applejack|fluttershy|mane six|pinkie pie|princess celestia|princess luna|rainbow dash|rarity|spike|twilight sparkle,jiayi
11618.png,https://derpicdn.net/img/view/2012/6/20/11618.png,1,0.9805456399917604,401,221,723,543,322,322,applejack|fluttershy|mane six|pinkie pie|princess celestia|princess luna|rainbow dash|rarity|spike|twilight sparkle,jiayi
11618.png,https://derpicdn.net/img/view/2012/6/20/11618.png,2,0.9739219546318054,156,764,450,1058,294,294,applejack|fluttershy|mane six|pinkie pie|princess celestia|princess luna|rainbow dash|rarity|spike|twilight sparkle,jiayi
1164303.png,https://derpicdn.net/img/view/2016/5/27/1164303.png,0,0.9784692525863647,0,44,672,776,672,732,pinkie pie|twilight sparkle,silberhase
1165749.png,https://derpicdn.net/img/view/2016/5/29/1165749.png,0,0.9853230118751526,246,0,634,371,388,371,applejack|fluttershy|mane six|pinkie pie|rainbow dash|rarity|twilight sparkle,steveholt
1168932.png,https://derpicdn.net/img/view/2016/6/3/1168932.png,0,0.9882580041885376,757,1060,1051,1354,294,294,applejack|fluttershy|pinkie pie|rainbow dash|rarity|spike|twilight sparkle,snow angel
1168932.png,https://derpicdn.net/img/view/2016/6/3/1168932.png,1,0.925873875617981,469,794,821,1146,352,352,applejack|fluttershy|pinkie pie|rainbow dash|rarity|spike|twilight sparkle,snow angel
1172033.png,https://derpicdn.net/img/view/2016/6/6/1172033.png,1,0.9749525785446168,374,577,894,1097,520,520,applejack|fluttershy|mane six|pinkie pie|rainbow dash|rarity|twilight sparkle,mississippikite
1172033.png,https://derpicdn.net/img/view/2016/6/6/1172033.png,2,0.9426283240318298,2030,420,2588,978,558,558,applejack|fluttershy|mane six|pinkie pie|rainbow dash|rarity|twilight sparkle,mississippikite
1173940.png,https://derpicdn.net/img/view/2016/6/9/1173940.png,0,0.9685434699058532,308,0,882,486,574,486,spike|twilight sparkle,kaylathehedgehog
1173945.png,https://derpicdn.net/img/view/2016/6/9/1173945.png,0,0.9313929080963136,56,0,602,524,546,524,rainbow dash|twilight sparkle,kittyhawk-contrail
1176734.jpg,https://derpicdn.net/img/view/2016/6/12/1176734.jpg,0,0.9694737195968628,162,58,708,604,546,546,rainbow dash|twilight sparkle,shimazun
11806.png,https://derpicdn.net/img/view/2012/6/20/11806.png,0,0.918596625328064,935,118,1171,354,236,236,applejack|big macintosh|discord|fluttershy|granny smith|pinkie pie|princess celestia|rainbow dash|rarity|twilight sparkle,akili-amethyst
1183593.png,https://derpicdn.net/img/view/2016/6/21/1183593.png,0,0.998488426208496,522,31,984,493,462,462,trixie|twilight sparkle,yaaaco
1184515.png,https://derpicdn.net/img/view/2016/6/22/1184515.png,1,0.9654333591461182,649,0,1325,676,676,676,rainbow dash|spitfire|twilight sparkle,pearlyiridescence
1185204.png,https://derpicdn.net/img/view/2016/6/23/1185204.png,1,0.9970866441726683,660,550,1160,1050,500,500,princess cadance|princess celestia|princess luna|twilight sparkle,midnightsix3
1185204.png,https://derpicdn.net/img/view/2016/6/23/1185204.png,2,0.9957188963890076,272,214,792,734,520,520,princess cadance|princess celestia|princess luna|twilight sparkle,midnightsix3
1185204.png,https://derpicdn.net/img/view/2016/6/23/1185204.png,3,0.9909510612487792,685,58,1165,538,480,480,princess cadance|princess celestia|princess luna|twilight sparkle,midnightsix3
1188796.jpg,https://derpicdn.net/img/view/2016/6/28/1188796.jpg,0,0.909588634967804,1052,100,1840,888,788,788,applejack|fluttershy|mane six|pinkie pie|rainbow dash|rarity|twilight sparkle,vindhov
1189053.png,https://derpicdn.net/img/view/2016/6/28/1189053.png,2,0.9549449682235718,2866,3861,4046,5041,1180,1180,applejack|fluttershy|mane six|pinkie pie|princess celestia|princess luna|rainbow dash|rarity|starlight glimmer|sunset shimmer|twilight sparkle,princess-madeleine
1190512.png,https://derpicdn.net/img/view/2016/6/30/1190512.png,1,0.904882311820984,0,320,314,636,314,316,sunset shimmer|twilight sparkle,
11906.jpg,https://derpicdn.net/img/view/2012/6/20/11906.jpg,1,0.952855110168457,0,470,279,762,279,292,applejack|fluttershy|mane six|pinkie pie|rainbow dash|rarity|twilight sparkle,meimone
11906.jpg,https://derpicdn.net/img/view/2012/6/20/11906.jpg,2,0.907842218875885,229,362,479,612,250,250,applejack|fluttershy|mane six|pinkie pie|rainbow dash|rarity|twilight sparkle,meimone
1194333.png,https://derpicdn.net/img/view/2016/7/5/1194333.png,0,0.997547686100006,1575,728,2219,1372,644,644,princess cadance|princess celestia|princess flurry heart|princess luna|twilight sparkle,meskitt
1194333.png,https://derpicdn.net/img/view/2016/7/5/1194333.png,1,0.9740223288536072,868,411,1738,1281,870,870,princess cadance|princess celestia|princess flurry heart|princess luna|twilight sparkle,meskitt
1197101.png,https://derpicdn.net/img/view/2016/7/9/1197101.png,0,0.9945276975631714,1823,431,2399,1007,576,576,apple bloom|applejack|princess cadance|twilight sparkle,shutterflyeqd
1197101.png,https://derpicdn.net/img/view/2016/7/9/1197101.png,1,0.9917056560516356,789,462,1445,1118,656,656,apple bloom|applejack|princess cadance|twilight sparkle,shutterflyeqd
1197101.png,https://derpicdn.net/img/view/2016/7/9/1197101.png,2,0.9045150876045228,1317,599,1865,1147,548,548,apple bloom|applejack|princess cadance|twilight sparkle,shutterflyeqd
1197129.png,https://derpicdn.net/img/view/2016/7/9/1197129.png,0,0.9941680431365968,1822,431,2400,1009,578,578,apple bloom|applejack|princess cadance|twilight sparkle,shutterflyeqd
1197129.png,https://derpicdn.net/img/view/2016/7/9/1197129.png,1,0.986528217792511,812,473,1444,1105,632,632,apple bloom|applejack|princess cadance|twilight sparkle,shutterflyeqd
1197553.png,https://derpicdn.net/img/view/2016/7/10/1197553.png,0,0.9880722165107728,2802,329,3336,863,534,534,apple bloom|applejack|big macintosh|granny smith|princess cadance|princess flurry heart|shining armor|twilight sparkle,sweetsismagic
1197553.png,https://derpicdn.net/img/view/2016/7/10/1197553.png,1,0.9848147630691528,174,103,716,645,542,542,apple bloom|applejack|big macintosh|granny smith|princess cadance|princess flurry heart|shining armor|twilight sparkle,sweetsismagic
1198489.png,https://derpicdn.net/img/view/2016/7/11/1198489.png,1,0.9701303839683532,1935,1037,2901,2003,966,966,sunset shimmer|twilight sparkle,deadliestvenom
1199346.png,https://derpicdn.net/img/view/2016/7/12/1199346.png,1,0.9993144273757936,229,0,449,199,220,199,rainbow dash|twilight sparkle,arcadias|caroo
1200179.png,https://derpicdn.net/img/view/2016/7/13/1200179.png,0,0.9878041744232178,2860,1412,3956,2508,1096,1096,princess flurry heart|starlight glimmer|twilight sparkle,shabrina025
1200179.png,https://derpicdn.net/img/view/2016/7/13/1200179.png,1,0.9854329228401184,2346,1637,3200,2491,854,854,princess flurry heart|starlight glimmer|twilight sparkle,shabrina025
1203666.png,https://derpicdn.net/img/view/2016/7/18/1203666.png,0,0.9985338449478148,1262,0,1872,548,610,548,applejack|fluttershy|pinkie pie|twilight sparkle,bloodwolvenl
1203666.png,https://derpicdn.net/img/view/2016/7/18/1203666.png,1,0.9980193376541138,1207,551,1821,1165,614,614,applejack|fluttershy|pinkie pie|twilight sparkle,bloodwolvenl
1203666.png,https://derpicdn.net/img/view/2016/7/18/1203666.png,2,0.9977821111679076,41,582,455,996,414,414,applejack|fluttershy|pinkie pie|twilight sparkle,bloodwolvenl
1203666.png,https://derpicdn.net/img/view/2016/7/18/1203666.png,3,0.9221653342247008,802,666,1148,1012,346,346,applejack|fluttershy|pinkie pie|twilight sparkle,bloodwolvenl
121150.png,https://derpicdn.net/img/view/2012/10/13/121150.png,1,0.9875376224517822,1069,180,1309,420,240,240,applejack|fluttershy|mane six|pinkie pie|rainbow dash|rarity|twilight sparkle,terry
121150.png,https://derpicdn.net/img/view/2012/10/13/121150.png,2,0.9476410746574402,1400,117,1694,411,294,294,applejack|fluttershy|mane six|pinkie pie|rainbow dash|rarity|twilight sparkle,terry
1212971.png,https://derpicdn.net/img/view/2016/7/30/1212971.png,1,0.9977673888206482,7,0,253,244,246,244,applejack|fluttershy|mane six|pinkie pie|princess celestia|princess luna|rainbow dash|rarity|spike|starlight glimmer|twilight sparkle,silentwulv
1212971.png,https://derpicdn.net/img/view/2016/7/30/1212971.png,3,0.9957322478294371,744,0,1024,256,280,256,applejack|fluttershy|mane six|pinkie pie|princess celestia|princess luna|rainbow dash|rarity|spike|starlight glimmer|twilight sparkle,silentwulv
1212971.png,https://derpicdn.net/img/view/2016/7/30/1212971.png,4,0.9945778250694276,0,506,255,765,255,259,applejack|fluttershy|mane six|pinkie pie|princess celestia|princess luna|rainbow dash|rarity|spike|starlight glimmer|twilight sparkle,silentwulv
1212971.png,https://derpicdn.net/img/view/2016/7/30/1212971.png,6,0.9895784258842468,747,496,1017,765,270,269,applejack|fluttershy|mane six|pinkie pie|princess celestia|princess luna|rainbow dash|rarity|spike|starlight glimmer|twilight sparkle,silentwulv
1212971.png,https://derpicdn.net/img/view/2016/7/30/1212971.png,9,0.9724051356315612,261,0,535,259,274,259,applejack|fluttershy|mane six|pinkie pie|princess celestia|princess luna|rainbow dash|rarity|spike|starlight glimmer|twilight sparkle,silentwulv
1212971.png,https://derpicdn.net/img/view/2016/7/30/1212971.png,10,0.9560612440109252,4,257,242,495,238,238,applejack|fluttershy|mane six|pinkie pie|princess celestia|princess luna|rainbow dash|rarity|spike|starlight glimmer|twilight sparkle,silentwulv
1214881.png,https://derpicdn.net/img/view/2016/8/1/1214881.png,0,0.9613478779792786,2688,665,3584,1569,896,904,spike|starlight glimmer|twilight sparkle,porygon2z
1214881.png,https://derpicdn.net/img/view/2016/8/1/1214881.png,2,0.9540397524833679,360,0,1918,1384,1558,1384,spike|starlight glimmer|twilight sparkle,porygon2z
1215337.png,https://derpicdn.net/img/view/2016/8/2/1215337.png,0,0.9982914328575134,3039,1233,4279,2473,1240,1240,applejack|fluttershy|mane six|pinkie pie|rainbow dash|rarity|twilight sparkle,v-d-k
1215337.png,https://derpicdn.net/img/view/2016/8/2/1215337.png,1,0.982254683971405,1592,0,2430,768,838,768,applejack|fluttershy|mane six|pinkie pie|rainbow dash|rarity|twilight sparkle,v-d-k
1218066.png,https://derpicdn.net/img/view/2016/8/6/1218066.png,0,0.9122291803359984,250,771,906,1427,656,656,big macintosh|princess cadance|princess celestia|princess flurry heart|princess luna|shining armor|twilight sparkle,drawponies
121832.png,https://derpicdn.net/img/view/2012/10/14/121832.png,0,0.9697908759117126,247,0,417,135,170,135,applejack|fluttershy|mane six|pinkie pie|princess celestia|princess luna|rainbow dash|rarity|scootaloo|twilight sparkle,bronyzero7|johnjoseco
121832.png,https://derpicdn.net/img/view/2012/10/14/121832.png,1,0.96181458234787,478,123,712,357,234,234,applejack|fluttershy|mane six|pinkie pie|princess celestia|princess luna|rainbow dash|rarity|scootaloo|twilight sparkle,bronyzero7|johnjoseco
121832.png,https://derpicdn.net/img/view/2012/10/14/121832.png,2,0.9125382304191588,77,111,369,403,292,292,applejack|fluttershy|mane six|pinkie pie|princess celestia|princess luna|rainbow dash|rarity|scootaloo|twilight sparkle,bronyzero7|johnjoseco
1219753.png,https://derpicdn.net/img/view/2016/8/7/1219753.png,0,0.9061806797981262,15,0,423,394,408,394,starlight glimmer|twilight sparkle,empyu
1220437.png,https://derpicdn.net/img/view/2016/8/8/1220437.png,0,0.9993296265602112,1012,338,2238,1564,1226,1226,rainbow dash|twilight sparkle,ho7y5hoxx
1223667.png,https://derpicdn.net/img/view/2016/8/12/1223667.png,0,0.9987561702728271,441,248,1075,882,634,634,rainbow dash|twilight sparkle,leafflurry
1223995.png,https://derpicdn.net/img/view/2016/8/13/1223995.png,0,0.9950217604637146,455,0,1899,1318,1444,1318,spike|twilight sparkle,porygon2z
1225003.png,https://derpicdn.net/img/view/2016/8/14/1225003.png,0,0.9880751967430116,754,50,1724,1020,970,970,princess celestia|twilight sparkle,ho7y5hoxx
1225003.png,https://derpicdn.net/img/view/2016/8/14/1225003.png,1,0.9589741230010986,2056,289,3062,1295,1006,1006,princess celestia|twilight sparkle,ho7y5hoxx
1226517.png,https://derpicdn.net/img/view/2016/8/16/1226517.png,0,0.984772801399231,396,421,850,875,454,454,sunset shimmer|twilight sparkle,toasterwitch
1226517.png,https://derpicdn.net/img/view/2016/8/16/1226517.png,1,0.942874312400818,346,7,898,559,552,552,sunset shimmer|twilight sparkle,toasterwitch
1227942.png,https://derpicdn.net/img/view/2016/8/18/1227942.png,0,0.9873767495155334,25,191,357,499,332,308,queen chrysalis|twilight sparkle,mixermike622
1228495.png,https://derpicdn.net/img/view/2016/8/19/1228495.png,0,0.9350887537002563,5,0,171,158,166,158,princess cadance|princess luna|twilight sparkle,bright ink
1230654.png,https://derpicdn.net/img/view/2016/8/21/1230654.png,0,0.9384776949882508,285,6,813,534,528,528,starlight glimmer|twilight sparkle,
1232988.png,https://derpicdn.net/img/view/2016/8/24/1232988.png,0,0.9986059069633484,1987,385,3000,1445,1013,1060,rainbow dash|soarin'|spitfire|twilight sparkle,lrusu
1233087.png,https://derpicdn.net/img/view/2016/8/25/1233087.png,0,0.907748818397522,112,79,560,527,448,448,rarity|twilight sparkle,sugaropolis
1235765.png,https://derpicdn.net/img/view/2016/8/28/1235765.png,0,0.9978200197219848,255,0,519,263,264,263,applejack|fluttershy|mane six|pinkie pie|rainbow dash|rarity|twilight sparkle,looji
1236511.png,https://derpicdn.net/img/view/2016/8/29/1236511.png,0,0.949482798576355,0,342,361,730,361,388,discord|princess celestia|twilight sparkle,creepycurse
123885.jpg,https://derpicdn.net/img/view/2012/10/15/123885.jpg,0,0.9950597286224364,738,156,866,284,128,128,applejack|pinkie pie|rainbow dash|rarity|twilight sparkle,robd2003
123885.jpg,https://derpicdn.net/img/view/2012/10/15/123885.jpg,1,0.9905744194984436,100,323,322,545,222,222,applejack|pinkie pie|rainbow dash|rarity|twilight sparkle,robd2003
1242342.png,https://derpicdn.net/img/view/2016/9/5/1242342.png,0,0.9645374417304992,2124,50,3000,948,876,898,rainbow dash|twilight sparkle,slb94
1242455.png,https://derpicdn.net/img/view/2016/9/5/1242455.png,0,0.9606651663780212,2121,47,3000,953,879,906,rainbow dash|twilight sparkle,slb94
1242964.png,https://derpicdn.net/img/view/2016/9/6/1242964.png,0,0.9623519778251648,2497,619,2977,1099,480,480,applejack|fluttershy|mane six|pinkie pie|rainbow dash|rarity|twilight sparkle,rarityforever
1243080.png,https://derpicdn.net/img/view/2016/9/6/1243080.png,0,0.9636304974555968,5253,0,13719,7663,8466,7663,fluttershy|twilight sparkle,cyanlightning
1243255.png,https://derpicdn.net/img/view/2016/9/6/1243255.png,0,0.9821539521217346,0,812,5909,7020,5909,6208,fluttershy|twilight sparkle,cyanlightning
1243255.png,https://derpicdn.net/img/view/2016/9/6/1243255.png,1,0.9791387915611268,6570,118,13224,6814,6654,6696,fluttershy|twilight sparkle,cyanlightning
1244750.png,https://derpicdn.net/img/view/2016/9/8/1244750.png,1,0.9979739785194396,471,101,837,467,366,366,applejack|fluttershy|mane six|pinkie pie|rainbow dash|rarity|starlight glimmer|twilight sparkle,fatcakes
1244750.png,https://derpicdn.net/img/view/2016/9/8/1244750.png,2,0.9962590932846068,772,735,1138,1101,366,366,applejack|fluttershy|mane six|pinkie pie|rainbow dash|rarity|starlight glimmer|twilight sparkle,fatcakes
1244750.png,https://derpicdn.net/img/view/2016/9/8/1244750.png,3,0.9952122569084167,811,368,1221,778,410,410,applejack|fluttershy|mane six|pinkie pie|rainbow dash|rarity|starlight glimmer|twilight sparkle,fatcakes
1244750.png,https://derpicdn.net/img/view/2016/9/8/1244750.png,4,0.9835219979286194,75,337,481,743,406,406,applejack|fluttershy|mane six|pinkie pie|rainbow dash|rarity|starlight glimmer|twilight sparkle,fatcakes
1244750.png,https://derpicdn.net/img/view/2016/9/8/1244750.png,5,0.9796305298805236,473,914,839,1280,366,366,applejack|fluttershy|mane six|pinkie pie|rainbow dash|rarity|starlight glimmer|twilight sparkle,fatcakes
1244751.png,https://derpicdn.net/img/view/2016/9/8/1244751.png,1,0.9976093173027042,471,103,835,467,364,364,applejack|fluttershy|mane six|pinkie pie|rainbow dash|rarity|starlight glimmer|twilight sparkle,fatcakes
1244751.png,https://derpicdn.net/img/view/2016/9/8/1244751.png,2,0.9959875345230104,769,731,1145,1107,376,376,applejack|fluttershy|mane six|pinkie pie|rainbow dash|rarity|starlight glimmer|twilight sparkle,fatcakes
1244751.png,https://derpicdn.net/img/view/2016/9/8/1244751.png,3,0.9951851963996888,811,368,1221,778,410,410,applejack|fluttershy|mane six|pinkie pie|rainbow dash|rarity|starlight glimmer|twilight sparkle,fatcakes
1244751.png,https://derpicdn.net/img/view/2016/9/8/1244751.png,4,0.9804149866104126,73,335,483,745,410,410,applejack|fluttershy|mane six|pinkie pie|rainbow dash|rarity|starlight glimmer|twilight sparkle,fatcakes
1244751.png,https://derpicdn.net/img/view/2016/9/8/1244751.png,5,0.9790257811546326,480,923,830,1273,350,350,applejack|fluttershy|mane six|pinkie pie|rainbow dash|rarity|starlight glimmer|twilight sparkle,fatcakes
1247731.png,https://derpicdn.net/img/view/2016/9/12/1247731.png,0,0.9911797046661376,1754,354,2370,970,616,616,apple bloom|applejack|cutie mark crusaders|fluttershy|mane six|pinkie pie|rainbow dash|rarity|scootaloo|sweetie belle|twilight sparkle,lifesharbinger
1247731.png,https://derpicdn.net/img/view/2016/9/12/1247731.png,1,0.9890010952949524,0,0,1173,975,1173,975,apple bloom|applejack|cutie mark crusaders|fluttershy|mane six|pinkie pie|rainbow dash|rarity|scootaloo|sweetie belle|twilight sparkle,lifesharbinger
1248211.png,https://derpicdn.net/img/view/2016/9/13/1248211.png,0,0.9968989491462708,134,466,886,1218,752,752,pinkie pie|twilight sparkle,vanillaghosties
1250928.png,https://derpicdn.net/img/view/2016/9/17/1250928.png,0,0.9966217279434204,338,0,1034,545,696,545,applejack|fluttershy|mane six|pinkie pie|rainbow dash|rarity|twilight sparkle,vanillaghosties
1260414.png,https://derpicdn.net/img/view/2016/9/28/1260414.png,1,0.9967163205146792,325,1276,879,1830,554,554,princess luna|spike|twilight sparkle,valcron
1260414.png,https://derpicdn.net/img/view/2016/9/28/1260414.png,2,0.9787249565124512,0,1297,502,1863,502,566,princess luna|spike|twilight sparkle,valcron
1260749.png,https://derpicdn.net/img/view/2016/9/29/1260749.png,0,0.9425964951515198,17,0,651,626,634,626,sunset shimmer|twilight sparkle,mewy101
1263382.png,https://derpicdn.net/img/view/2016/10/2/1263382.png,0,0.9786007404327391,133,0,595,391,462,391,applejack|pinkie pie|rarity|spike|twilight sparkle,
1264105.png,https://derpicdn.net/img/view/2016/10/3/1264105.png,0,0.9916762113571168,1546,0,3296,1354,1750,1354,trixie|twilight sparkle,wilshirewolf
1264936.png,https://derpicdn.net/img/view/2016/10/4/1264936.png,0,0.9950906038284302,396,396,1244,1244,848,848,applejack|fluttershy|mane six|pinkie pie|rainbow dash|rarity|spike|starlight glimmer|twilight sparkle,squipycheetah
1264936.png,https://derpicdn.net/img/view/2016/10/4/1264936.png,1,0.96369606256485,2627,495,3273,1141,646,646,applejack|fluttershy|mane six|pinkie pie|rainbow dash|rarity|spike|starlight glimmer|twilight sparkle,squipycheetah
1278971.png,https://derpicdn.net/img/view/2016/10/22/1278971.png,0,0.9983227849006652,0,1284,494,1854,494,570,starlight glimmer|sunset shimmer|twilight sparkle,hiccupsdoesart
1278971.png,https://derpicdn.net/img/view/2016/10/22/1278971.png,1,0.9939170479774476,1080,1265,1699,1947,619,682,starlight glimmer|sunset shimmer|twilight sparkle,hiccupsdoesart
1278971.png,https://derpicdn.net/img/view/2016/10/22/1278971.png,2,0.9774638414382936,878,1424,1330,1876,452,452,starlight glimmer|sunset shimmer|twilight sparkle,hiccupsdoesart
1279722.png,https://derpicdn.net/img/view/2016/10/23/1279722.png,0,0.969473123550415,0,137,369,519,369,382,applejack|big macintosh|discord|fluttershy|lightning dust|pinkie pie|rarity|starlight glimmer|sunset shimmer|trixie|twilight sparkle,mississippikite
1279722.png,https://derpicdn.net/img/view/2016/10/23/1279722.png,3,0.9360875487327576,163,0,401,220,238,220,applejack|big macintosh|discord|fluttershy|lightning dust|pinkie pie|rarity|starlight glimmer|sunset shimmer|trixie|twilight sparkle,mississippikite
1279722.png,https://derpicdn.net/img/view/2016/10/23/1279722.png,4,0.9111170768737792,99,380,411,692,312,312,applejack|big macintosh|discord|fluttershy|lightning dust|pinkie pie|rarity|starlight glimmer|sunset shimmer|trixie|twilight sparkle,mississippikite
1281025.png,https://derpicdn.net/img/view/2016/10/25/1281025.png,0,0.968161642551422,30,555,244,769,214,214,applejack|pinkie pie|princess cadance|princess celestia|princess flurry heart|princess luna|rainbow dash|rarity|shining armor|starlight glimmer|twilight sparkle,
1281025.png,https://derpicdn.net/img/view/2016/10/25/1281025.png,1,0.916697919368744,24,187,236,399,212,212,applejack|pinkie pie|princess cadance|princess celestia|princess flurry heart|princess luna|rainbow dash|rarity|shining armor|starlight glimmer|twilight sparkle,
1282102.png,https://derpicdn.net/img/view/2016/10/26/1282102.png,0,0.9402735233306884,214,24,456,266,242,242,fluttershy|twilight sparkle,spectralunicorn
1284.jpg,https://derpicdn.net/img/view/2012/1/22/1284.jpg,0,0.9899311661720276,139,175,397,433,258,258,princess celestia|spike|twilight sparkle,kp-shadowsquirrel
1284201.png,https://derpicdn.net/img/view/2016/10/29/1284201.png,0,0.9903484582901,648,70,984,406,336,336,applejack|fluttershy|mane six|pinkie pie|rainbow dash|rarity|spike|twilight sparkle,shimazun
1284201.png,https://derpicdn.net/img/view/2016/10/29/1284201.png,1,0.9901599884033204,986,142,1278,434,292,292,applejack|fluttershy|mane six|pinkie pie|rainbow dash|rarity|spike|twilight sparkle,shimazun
1284201.png,https://derpicdn.net/img/view/2016/10/29/1284201.png,2,0.9764593839645386,86,569,516,999,430,430,applejack|fluttershy|mane six|pinkie pie|rainbow dash|rarity|spike|twilight sparkle,shimazun
128499.png,https://derpicdn.net/img/view/2012/10/21/128499.png,0,0.9176660180091858,745,339,1083,677,338,338,applejack|fluttershy|mane six|pinkie pie|princess celestia|rainbow dash|rarity|twilight sparkle,jamey4|nianara
1285053.png,https://derpicdn.net/img/view/2016/10/30/1285053.png,0,0.9893046021461488,800,73,1372,645,572,572,rarity|twilight sparkle,maxiima
1285761.png,https://derpicdn.net/img/view/2016/10/31/1285761.png,0,0.9978430867195128,401,14,551,164,150,150,applejack|fluttershy|mane six|pinkie pie|rainbow dash|rarity|twilight sparkle,falldust
1285761.png,https://derpicdn.net/img/view/2016/10/31/1285761.png,1,0.9865173101425172,452,331,592,471,140,140,applejack|fluttershy|mane six|pinkie pie|rainbow dash|rarity|twilight sparkle,falldust
1285761.png,https://derpicdn.net/img/view/2016/10/31/1285761.png,2,0.9296602606773376,140,65,268,193,128,128,applejack|fluttershy|mane six|pinkie pie|rainbow dash|rarity|twilight sparkle,falldust
1286586.png,https://derpicdn.net/img/view/2016/11/1/1286586.png,0,0.9730772376060486,183,74,413,304,230,230,applejack|fluttershy|mane six|pinkie pie|rainbow dash|rarity|spike|starlight glimmer|trixie|twilight sparkle,bezziie
1286586.png,https://derpicdn.net/img/view/2016/11/1/1286586.png,1,0.9488930702209472,404,378,646,620,242,242,applejack|fluttershy|mane six|pinkie pie|rainbow dash|rarity|spike|starlight glimmer|trixie|twilight sparkle,bezziie
1287775.png,https://derpicdn.net/img/view/2016/11/3/1287775.png,0,0.93937748670578,68,0,387,333,319,333,princess luna|twilight sparkle,
1288532.png,https://derpicdn.net/img/view/2016/11/4/1288532.png,0,0.9971106648445128,12,599,1308,1895,1296,1296,applejack|rainbow dash|twilight sparkle,coma392
1290051.png,https://derpicdn.net/img/view/2016/11/6/1290051.png,0,0.9994431734085084,395,103,597,305,202,202,applejack|sunset shimmer|twilight sparkle,cera-miaw
1290051.png,https://derpicdn.net/img/view/2016/11/6/1290051.png,1,0.9821144938468932,709,103,905,299,196,196,applejack|sunset shimmer|twilight sparkle,cera-miaw
1290051.png,https://derpicdn.net/img/view/2016/11/6/1290051.png,2,0.9391083717346193,139,110,325,296,186,186,applejack|sunset shimmer|twilight sparkle,cera-miaw
1292268.png,https://derpicdn.net/img/view/2016/11/9/1292268.png,4,0.9702504873275756,769,0,1021,219,252,219,applejack|fluttershy|mane six|pinkie pie|rainbow dash|rarity|starlight glimmer|sunset shimmer|twilight sparkle,monochromacat
1292268.png,https://derpicdn.net/img/view/2016/11/9/1292268.png,5,0.956810176372528,33,366,223,556,190,190,applejack|fluttershy|mane six|pinkie pie|rainbow dash|rarity|starlight glimmer|sunset shimmer|twilight sparkle,monochromacat
1293360.png,https://derpicdn.net/img/view/2016/11/11/1293360.png,1,0.9901192784309388,801,26,1433,658,632,632,applejack|fluttershy|mane six|pinkie pie|rainbow dash|rarity|twilight sparkle,alazak
1293360.png,https://derpicdn.net/img/view/2016/11/11/1293360.png,3,0.910822868347168,1015,596,1477,1058,462,462,applejack|fluttershy|mane six|pinkie pie|rainbow dash|rarity|twilight sparkle,alazak
1302478.png,https://derpicdn.net/img/view/2016/11/24/1302478.png,0,0.9994934797286988,68,75,1620,1627,1552,1552,spike|twilight sparkle,sollace
1303457.png,https://derpicdn.net/img/view/2016/11/25/1303457.png,0,0.994610607624054,667,19,1049,401,382,382,rainbow dash|twilight sparkle,shimmering--sunlight
1308533.png,https://derpicdn.net/img/view/2016/12/2/1308533.png,0,0.9798425436019896,1244,1069,1964,1789,720,720,applejack|fluttershy|mane six|pinkie pie|princess celestia|rainbow dash|rarity|twilight sparkle,magister39
1310467.png,https://derpicdn.net/img/view/2016/12/5/1310467.png,0,0.9900986552238464,65,0,331,255,266,255,applejack|fluttershy|mane six|pinkie pie|rainbow dash|rarity|trixie|twilight sparkle,jirousan|emeraldjeweltm|bezziie
1310467.png,https://derpicdn.net/img/view/2016/12/5/1310467.png,1,0.9158594012260436,0,547,362,1001,362,454,applejack|fluttershy|mane six|pinkie pie|rainbow dash|rarity|trixie|twilight sparkle,jirousan|emeraldjeweltm|bezziie
1312083.png,https://derpicdn.net/img/view/2016/12/7/1312083.png,0,0.997383713722229,89,746,1231,1888,1142,1142,applejack|rainbow dash|twilight sparkle,coma392
1312083.png,https://derpicdn.net/img/view/2016/12/7/1312083.png,1,0.9322897791862488,796,1925,2286,3415,1490,1490,applejack|rainbow dash|twilight sparkle,coma392
1314335.png,https://derpicdn.net/img/view/2016/12/10/1314335.png,0,0.9963867068290708,79,270,409,600,330,330,trixie|twilight sparkle,southparktaoist
1315214.png,https://derpicdn.net/img/view/2016/12/11/1315214.png,4,0.938930869102478,741,709,961,929,220,220,apple bloom|applejack|babs seed|cutie mark crusaders|fluttershy|mane six|pinkie pie|rainbow dash|rarity|scootaloo|soarin'|starlight glimmer|sweetie belle|twilight sparkle,stuflox
1315214.png,https://derpicdn.net/img/view/2016/12/11/1315214.png,5,0.9158147573471068,570,661,826,917,256,256,apple bloom|applejack|babs seed|cutie mark crusaders|fluttershy|mane six|pinkie pie|rainbow dash|rarity|scootaloo|soarin'|starlight glimmer|sweetie belle|twilight sparkle,stuflox
1316647.png,https://derpicdn.net/img/view/2016/12/13/1316647.png,0,0.9740829467773438,538,593,2836,2891,2298,2298,sunset shimmer|twilight sparkle,lovehtf421
1316926.png,https://derpicdn.net/img/view/2016/12/13/1316926.png,0,0.9760617017745972,1655,1728,2535,2608,880,880,applejack|fluttershy|mane six|pinkie pie|princess celestia|rainbow dash|rarity|twilight sparkle,magister39
1317979.png,https://derpicdn.net/img/view/2016/12/15/1317979.png,0,0.9414825439453124,5,0,123,113,118,113,applejack|fluttershy|mane six|pinkie pie|rainbow dash|rarity|twilight sparkle,catmag
1317993.png,https://derpicdn.net/img/view/2016/12/15/1317993.png,0,0.9809913635253906,80,129,1006,1055,926,926,rainbow dash|twilight sparkle,powdan
1318291.png,https://derpicdn.net/img/view/2016/12/15/1318291.png,0,0.9867591857910156,521,332,1239,1050,718,718,sunset shimmer|twilight sparkle,kikirdcz
1318626.png,https://derpicdn.net/img/view/2016/12/16/1318626.png,0,0.994188904762268,665,846,945,1126,280,280,applejack|discord|fluttershy|mane six|pinkie pie|rainbow dash|rarity|twilight sparkle,loomx
1321967.png,https://derpicdn.net/img/view/2016/12/21/1321967.png,0,0.9503324627876282,239,185,541,487,302,302,applejack|fluttershy|mane six|pinkie pie|rainbow dash|rarity|twilight sparkle,ashidaru
1324778.png,https://derpicdn.net/img/view/2016/12/25/1324778.png,0,0.9573964476585388,4422,552,5604,1734,1182,1182,applejack|fluttershy|mane six|pinkie pie|rainbow dash|rarity|twilight sparkle,rubywave32
1324778.png,https://derpicdn.net/img/view/2016/12/25/1324778.png,1,0.9271381497383118,280,704,1446,1870,1166,1166,applejack|fluttershy|mane six|pinkie pie|rainbow dash|rarity|twilight sparkle,rubywave32
1325237.png,https://derpicdn.net/img/view/2016/12/25/1325237.png,0,0.9395468831062316,701,113,943,355,242,242,applejack|fluttershy|mane six|pinkie pie|rainbow dash|rarity|spike|twilight sparkle,crescentmyst
1326614.png,https://derpicdn.net/img/view/2016/12/27/1326614.png,0,0.9914169907569884,1230,512,1686,968,456,456,applejack|fluttershy|mane six|pinkie pie|rainbow dash|rarity|twilight sparkle,halem1991
1329896.png,https://derpicdn.net/img/view/2017/1/1/1329896.png,0,0.9374994039535522,2111,320,3475,1684,1364,1364,pinkie pie|twilight sparkle,tersisa
1338212.png,https://derpicdn.net/img/view/2017/1/13/1338212.png,0,0.9871669411659241,0,0,337,266,337,266,applejack|fluttershy|mane six|pinkie pie|rainbow dash|rarity|twilight sparkle,apple-jazzy
1338212.png,https://derpicdn.net/img/view/2017/1/13/1338212.png,2,0.9050644040107728,183,79,495,391,312,312,applejack|fluttershy|mane six|pinkie pie|rainbow dash|rarity|twilight sparkle,apple-jazzy
1340779.png,https://derpicdn.net/img/view/2017/1/16/1340779.png,0,0.9974673986434937,586,840,990,1244,404,404,applejack|fluttershy|mane six|pinkie pie|rainbow dash|rarity|twilight sparkle,amarynceus
1340779.png,https://derpicdn.net/img/view/2017/1/16/1340779.png,1,0.9973987936973572,939,638,1369,1068,430,430,applejack|fluttershy|mane six|pinkie pie|rainbow dash|rarity|twilight sparkle,amarynceus
1340779.png,https://derpicdn.net/img/view/2017/1/16/1340779.png,5,0.9786084890365601,420,21,636,237,216,216,applejack|fluttershy|mane six|pinkie pie|rainbow dash|rarity|twilight sparkle,amarynceus
1340779.png,https://derpicdn.net/img/view/2017/1/16/1340779.png,6,0.9663408994674684,1094,3192,1510,3608,416,416,applejack|fluttershy|mane six|pinkie pie|rainbow dash|rarity|twilight sparkle,amarynceus
1341165.png,https://derpicdn.net/img/view/2017/1/17/1341165.png,0,0.9989851117134094,106,244,468,606,362,362,shining armor|twilight sparkle,enigmaticwisp
1341273.png,https://derpicdn.net/img/view/2017/1/17/1341273.png,0,0.9934805035591124,135,120,519,504,384,384,rainbow dash|twilight sparkle,saphi-boo
1342368.png,https://derpicdn.net/img/view/2017/1/18/1342368.png,0,0.9659647941589355,1330,1051,3045,2915,1715,1864,spike|twilight sparkle,vector-brony
1350130.png,https://derpicdn.net/img/view/2017/1/29/1350130.png,0,0.94866943359375,1492,340,2032,880,540,540,apple bloom|applejack|cutie mark crusaders|fluttershy|mane six|pinkie pie|rainbow dash|rarity|scootaloo|sweetie belle|twilight sparkle,windymils
13515.jpg,https://derpicdn.net/img/view/2012/6/21/13515.jpg,0,0.983696699142456,285,16,549,280,264,264,spike|twilight sparkle,mew
1352347.png,https://derpicdn.net/img/view/2017/1/31/1352347.png,0,0.9516892433166504,612,218,850,456,238,238,applejack|fluttershy|mane six|pinkie pie|rainbow dash|rarity|starlight glimmer|sunset shimmer|twilight sparkle,sigmastarlight|serenawyr|svgwolf|bronyanimstudios|djbit-3|dashiemlpfim|boneswolbach
1352632.png,https://derpicdn.net/img/view/2017/2/1/1352632.png,0,0.937847375869751,236,508,416,688,180,180,apple bloom|applejack|big macintosh|cutie mark crusaders|discord|fluttershy|mane six|pinkie pie|princess cadance|princess celestia|princess flurry heart|princess luna|queen chrysalis|rainbow dash|rarity|scootaloo|shining armor|spike|starlight glimmer|sweetie belle|twilight sparkle,andypriceart
1354065.png,https://derpicdn.net/img/view/2017/2/3/1354065.png,0,0.9693393111228944,360,60,588,288,228,228,applejack|fluttershy|pinkie pie|twilight sparkle,stardrawsponies
1354065.png,https://derpicdn.net/img/view/2017/2/3/1354065.png,1,0.9125530123710632,489,50,771,332,282,282,applejack|fluttershy|pinkie pie|twilight sparkle,stardrawsponies
1354638.png,https://derpicdn.net/img/view/2017/2/4/1354638.png,0,0.9379723072052002,539,111,943,515,404,404,princess luna|twilight sparkle,jellybeanbullet
1357749.png,https://derpicdn.net/img/view/2017/2/8/1357749.png,0,0.921631395816803,625,0,863,223,238,223,apple bloom|applejack|cutie mark crusaders|fluttershy|mane six|pinkie pie|princess cadance|princess celestia|princess luna|rainbow dash|rarity|scootaloo|shining armor|spike|starlight glimmer|sunset shimmer|sweetie belle|trixie|twilight sparkle,
1360230.png,https://derpicdn.net/img/view/2017/2/11/1360230.png,0,0.9851548671722412,495,185,815,505,320,320,rarity|sweetie belle|twilight sparkle,tahublade7
1360700.png,https://derpicdn.net/img/view/2017/2/12/1360700.png,0,0.9987466335296632,40,0,402,346,362,346,applejack|fluttershy|rainbow dash|rarity|twilight sparkle,cigarscigarettes
1369344.png,https://derpicdn.net/img/view/2017/2/21/1369344.png,0,0.996510922908783,1019,145,1307,433,288,288,applejack|fluttershy|mane six|pinkie pie|rainbow dash|rarity|twilight sparkle,
1369344.png,https://derpicdn.net/img/view/2017/2/21/1369344.png,1,0.9787917137145996,485,58,823,396,338,338,applejack|fluttershy|mane six|pinkie pie|rainbow dash|rarity|twilight sparkle,
1369344.png,https://derpicdn.net/img/view/2017/2/21/1369344.png,2,0.9005686044692993,255,137,523,405,268,268,applejack|fluttershy|mane six|pinkie pie|rainbow dash|rarity|twilight sparkle,
137033.png,https://derpicdn.net/img/view/2012/10/30/137033.png,0,0.9822602272033693,524,429,790,695,266,266,pinkie pie|twilight sparkle,professor-ponyarity
1371314.png,https://derpicdn.net/img/view/2017/2/23/1371314.png,1,0.9903960824012756,372,200,758,586,386,386,princess luna|sunset shimmer|twilight sparkle,little-tweenframes
1371314.png,https://derpicdn.net/img/view/2017/2/23/1371314.png,3,0.9420888423919678,523,675,1037,1189,514,514,princess luna|sunset shimmer|twilight sparkle,little-tweenframes
1371499.png,https://derpicdn.net/img/view/2017/2/24/1371499.png,0,0.9746461510658264,0,0,1481,1415,1481,1415,rainbow dash|twilight sparkle,themoonraven|mr-pony-man
1371499.png,https://derpicdn.net/img/view/2017/2/24/1371499.png,1,0.9499493837356568,992,0,2525,1541,1533,1541,rainbow dash|twilight sparkle,themoonraven|mr-pony-man
1372958.png,https://derpicdn.net/img/view/2017/2/25/1372958.png,0,0.970823347568512,80,25,374,333,294,308,rarity|twilight sparkle,
1375678.png,https://derpicdn.net/img/view/2017/2/28/1375678.png,0,0.9411091804504396,91,0,1097,923,1006,923,spike|twilight sparkle,lemonthyme
1378160.png,https://derpicdn.net/img/view/2017/3/3/1378160.png,0,0.9682456254959106,612,0,1140,465,528,465,sunset shimmer|twilight sparkle,little-tweenframes
1378160.png,https://derpicdn.net/img/view/2017/3/3/1378160.png,1,0.9630023241043092,442,183,708,449,266,266,sunset shimmer|twilight sparkle,little-tweenframes
13788.png,https://derpicdn.net/img/view/2012/6/21/13788.png,0,0.999189555644989,766,873,1000,1131,234,258,applejack|fluttershy|pinkie pie|rainbow dash|rarity|soarin'|spitfire|twilight sparkle,
13788.png,https://derpicdn.net/img/view/2012/6/21/13788.png,1,0.9969554543495178,268,279,544,555,276,276,applejack|fluttershy|pinkie pie|rainbow dash|rarity|soarin'|spitfire|twilight sparkle,
13788.png,https://derpicdn.net/img/view/2012/6/21/13788.png,2,0.9952196478843688,757,7,1000,285,243,278,applejack|fluttershy|pinkie pie|rainbow dash|rarity|soarin'|spitfire|twilight sparkle,
13788.png,https://derpicdn.net/img/view/2012/6/21/13788.png,3,0.9946625232696532,272,564,530,822,258,258,applejack|fluttershy|pinkie pie|rainbow dash|rarity|soarin'|spitfire|twilight sparkle,
13788.png,https://derpicdn.net/img/view/2012/6/21/13788.png,4,0.9877197742462158,786,613,1000,839,214,226,applejack|fluttershy|pinkie pie|rainbow dash|rarity|soarin'|spitfire|twilight sparkle,
13788.png,https://derpicdn.net/img/view/2012/6/21/13788.png,5,0.9756079912185668,258,12,536,290,278,278,applejack|fluttershy|pinkie pie|rainbow dash|rarity|soarin'|spitfire|twilight sparkle,
13788.png,https://derpicdn.net/img/view/2012/6/21/13788.png,6,0.9560763835906982,782,308,1000,542,218,234,applejack|fluttershy|pinkie pie|rainbow dash|rarity|soarin'|spitfire|twilight sparkle,
1378925.png,https://derpicdn.net/img/view/2017/3/4/1378925.png,0,0.9959313869476318,387,0,789,328,402,328,starlight glimmer|sunset shimmer|trixie|twilight sparkle,thealjavis
1378925.png,https://derpicdn.net/img/view/2017/3/4/1378925.png,2,0.9903913736343384,119,86,463,430,344,344,starlight glimmer|sunset shimmer|trixie|twilight sparkle,thealjavis
1378925.png,https://derpicdn.net/img/view/2017/3/4/1378925.png,3,0.9225075840950012,922,290,1188,556,266,266,starlight glimmer|sunset shimmer|trixie|twilight sparkle,thealjavis
1379334.png,https://derpicdn.net/img/view/2017/3/4/1379334.png,0,0.98995441198349,493,36,801,344,308,308,rainbow dash|scootaloo|spike|twilight sparkle,saphi-boo
1380201.png,https://derpicdn.net/img/view/2017/3/5/1380201.png,0,0.995593011379242,224,24,586,386,362,362,applejack|twilight sparkle,rwl
1382328.png,https://derpicdn.net/img/view/2017/3/8/1382328.png,0,0.9911956191062928,670,922,1200,1476,530,554,discord|princess cadance|twilight sparkle,theroyalprincesses
1382328.png,https://derpicdn.net/img/view/2017/3/8/1382328.png,1,0.9424847960472108,48,813,736,1501,688,688,discord|princess cadance|twilight sparkle,theroyalprincesses
1383333.png,https://derpicdn.net/img/view/2017/3/10/1383333.png,0,0.9739404916763306,1885,4,2641,760,756,756,applejack|fluttershy|pinkie pie|rainbow dash|rarity|twilight sparkle,theelinker|heir-of-rick
1385839.png,https://derpicdn.net/img/view/2017/3/13/1385839.png,0,0.9901730418205258,1824,75,2972,1223,1148,1148,fluttershy|rarity|starlight glimmer|sunset shimmer|twilight sparkle,shogundun
1387222.png,https://derpicdn.net/img/view/2017/3/14/1387222.png,1,0.9575179219245912,411,639,855,1083,444,444,applejack|fluttershy|mane six|pinkie pie|rainbow dash|rarity|twilight sparkle,jack-pie
1387222.png,https://derpicdn.net/img/view/2017/3/14/1387222.png,2,0.949461042881012,1270,247,1800,777,530,530,applejack|fluttershy|mane six|pinkie pie|rainbow dash|rarity|twilight sparkle,jack-pie
1387222.png,https://derpicdn.net/img/view/2017/3/14/1387222.png,3,0.9067901968955994,5,288,427,710,422,422,applejack|fluttershy|mane six|pinkie pie|rainbow dash|rarity|twilight sparkle,jack-pie
1388864.png,https://derpicdn.net/img/view/2017/3/16/1388864.png,0,0.9876917600631714,449,242,1359,1152,910,910,princess cadance|princess celestia|princess luna|queen chrysalis|twilight sparkle,cleoziep
1388864.png,https://derpicdn.net/img/view/2017/3/16/1388864.png,1,0.9834855198860168,3367,224,4403,1260,1036,1036,princess cadance|princess celestia|princess luna|queen chrysalis|twilight sparkle,cleoziep
1389756.png,https://derpicdn.net/img/view/2017/3/17/1389756.png,0,0.9745253920555116,947,338,1213,604,266,266,applejack|fluttershy|mane six|pinkie pie|rainbow dash|rarity|twilight sparkle,
1389756.png,https://derpicdn.net/img/view/2017/3/17/1389756.png,1,0.939760446548462,761,343,1009,591,248,248,applejack|fluttershy|mane six|pinkie pie|rainbow dash|rarity|twilight sparkle,
139032.png,https://derpicdn.net/img/view/2012/11/1/139032.png,0,0.9980865120887756,1045,523,1459,937,414,414,applejack|fluttershy|pinkie pie|rainbow dash|rarity|twilight sparkle,aleximusprime
139032.png,https://derpicdn.net/img/view/2012/11/1/139032.png,1,0.9743613600730896,340,0,598,217,258,217,applejack|fluttershy|pinkie pie|rainbow dash|rarity|twilight sparkle,aleximusprime
1390706.png,https://derpicdn.net/img/view/2017/3/18/1390706.png,0,0.992020547389984,875,0,1467,579,592,579,rainbow dash|twilight sparkle,kiarawizard01
1390706.png,https://derpicdn.net/img/view/2017/3/18/1390706.png,1,0.9613565802574158,338,0,1076,712,738,712,rainbow dash|twilight sparkle,kiarawizard01
1391952.png,https://derpicdn.net/img/view/2017/3/20/1391952.png,0,0.992715299129486,355,0,909,498,554,498,sunset shimmer|twilight sparkle,tambelon
1391952.png,https://derpicdn.net/img/view/2017/3/20/1391952.png,1,0.9845864772796632,0,0,595,529,595,529,sunset shimmer|twilight sparkle,tambelon
1398062.png,https://derpicdn.net/img/view/2017/3/27/1398062.png,0,0.998200535774231,0,126,1184,1328,1184,1202,starlight glimmer|twilight sparkle,shutterflyeqd
1400764.png,https://derpicdn.net/img/view/2017/3/31/1400764.png,0,0.9396370649337769,1140,760,4290,3910,3150,3150,starlight glimmer|sunset shimmer|trixie|twilight sparkle,suramii
1403432.png,https://derpicdn.net/img/view/2017/4/3/1403432.png,0,0.9986499547958374,127,29,399,301,272,272,fluttershy|rarity|twilight sparkle,kapusha-blr
1403432.png,https://derpicdn.net/img/view/2017/4/3/1403432.png,1,0.9870346188545228,451,432,691,672,240,240,fluttershy|rarity|twilight sparkle,kapusha-blr
1403432.png,https://derpicdn.net/img/view/2017/4/3/1403432.png,2,0.9473397135734558,630,33,904,307,274,274,fluttershy|rarity|twilight sparkle,kapusha-blr
1404854.png,https://derpicdn.net/img/view/2017/4/5/1404854.png,1,0.9778395295143129,3822,1195,4588,1961,766,766,applejack|fluttershy|mane six|pinkie pie|rainbow dash|rarity|twilight sparkle,deratrox
1404855.png,https://derpicdn.net/img/view/2017/4/5/1404855.png,0,0.991819441318512,4693,295,5391,993,698,698,applejack|fluttershy|mane six|pinkie pie|rainbow dash|rarity|twilight sparkle,deratrox
1404855.png,https://derpicdn.net/img/view/2017/4/5/1404855.png,1,0.9915558695793152,2081,0,2853,770,772,770,applejack|fluttershy|mane six|pinkie pie|rainbow dash|rarity|twilight sparkle,deratrox
1406290.png,https://derpicdn.net/img/view/2017/4/7/1406290.png,0,0.9800204038619996,3511,1735,4081,2305,570,570,applejack|fluttershy|pinkie pie|princess celestia|princess luna|rainbow dash|rarity|twilight sparkle,magister39
1411738.png,https://derpicdn.net/img/view/2017/4/15/1411738.png,0,0.969999134540558,806,130,1170,494,364,364,pinkie pie|rainbow dash|twilight sparkle,
1412097.png,https://derpicdn.net/img/view/2017/4/15/1412097.png,0,0.9814600944519044,1510,0,2722,1000,1212,1000,applejack|fluttershy|pinkie pie|rainbow dash|twilight sparkle,
1414054.png,https://derpicdn.net/img/view/2017/4/17/1414054.png,0,0.950278639793396,942,130,1288,476,346,346,applejack|fluttershy|mane six|pinkie pie|rainbow dash|rarity|twilight sparkle,
1420628.png,https://derpicdn.net/img/view/2017/4/24/1420628.png,0,0.9731574654579164,287,0,691,391,404,391,princess celestia|twilight sparkle,slavedemorto
1422218.png,https://derpicdn.net/img/view/2017/4/26/1422218.png,0,0.9969832897186279,342,442,668,768,326,326,sunset shimmer|twilight sparkle,carouselunique|little-tweenframes
1422218.png,https://derpicdn.net/img/view/2017/4/26/1422218.png,1,0.9910815358161926,691,25,1359,693,668,668,sunset shimmer|twilight sparkle,carouselunique|little-tweenframes
1422218.png,https://derpicdn.net/img/view/2017/4/26/1422218.png,2,0.9493818879127502,1520,98,1974,552,454,454,sunset shimmer|twilight sparkle,carouselunique|little-tweenframes
1426372.png,https://derpicdn.net/img/view/2017/5/1/1426372.png,0,0.9084517955780028,227,1442,703,1918,476,476,pinkie pie|starlight glimmer|twilight sparkle,tom117z
1429202.png,https://derpicdn.net/img/view/2017/5/5/1429202.png,0,0.9788713455200196,570,182,1390,1002,820,820,starlight glimmer|twilight sparkle,ferasor
1430796.png,https://derpicdn.net/img/view/2017/5/7/1430796.png,0,0.9905652403831482,1069,0,1895,739,826,739,applejack|fluttershy|mane six|pinkie pie|rainbow dash|rarity|twilight sparkle,blackmagicdapony
1430963.png,https://derpicdn.net/img/view/2017/5/7/1430963.png,0,0.9803715348243712,232,0,763,528,531,528,pinkie pie|rainbow dash|twilight sparkle,
1431936.png,https://derpicdn.net/img/view/2017/5/8/1431936.png,1,0.9355216026306152,1508,408,1866,766,358,358,applejack|fluttershy|pinkie pie|rarity|twilight sparkle,neohary
143198.jpg,https://derpicdn.net/img/view/2012/11/5/143198.jpg,0,0.9883899688720704,3171,600,3857,1286,686,686,applejack|fluttershy|pinkie pie|princess celestia|princess luna|rainbow dash|rarity|soarin'|spitfire|twilight sparkle,sketchyjackie
143198.jpg,https://derpicdn.net/img/view/2012/11/5/143198.jpg,1,0.953513205051422,1542,137,2112,707,570,570,applejack|fluttershy|pinkie pie|princess celestia|princess luna|rainbow dash|rarity|soarin'|spitfire|twilight sparkle,sketchyjackie
1433623.png,https://derpicdn.net/img/view/2017/5/10/1433623.png,0,0.992143988609314,363,2563,1343,3543,980,980,applejack|fluttershy|mane six|pinkie pie|rainbow dash|rarity|twilight sparkle,up1ter
143800.png,https://derpicdn.net/img/view/2012/11/6/143800.png,0,0.992826759815216,1625,710,1967,1052,342,342,applejack|fluttershy|mane six|pinkie pie|rainbow dash|rarity|twilight sparkle,bongo
143800.png,https://derpicdn.net/img/view/2012/11/6/143800.png,2,0.9109482169151306,530,806,780,1056,250,250,applejack|fluttershy|mane six|pinkie pie|rainbow dash|rarity|twilight sparkle,bongo
1446160.png,https://derpicdn.net/img/view/2017/5/26/1446160.png,0,0.9208301901817322,267,52,695,480,428,428,pinkie pie|twilight sparkle,mlp-silver-quill
1446751.png,https://derpicdn.net/img/view/2017/5/26/1446751.png,0,0.9392024278640748,269,0,847,497,578,497,spike|sunset shimmer|twilight sparkle,little-tweenframes
1449476.png,https://derpicdn.net/img/view/2017/5/29/1449476.png,0,0.975810170173645,841,227,1151,537,310,310,sunset shimmer|twilight sparkle,yaycelestia0331
1451117.png,https://derpicdn.net/img/view/2017/6/1/1451117.png,0,0.9984363317489624,1072,0,1254,159,182,159,apple bloom|applejack|big macintosh|cutie mark crusaders|diamond tiara|fluttershy|rainbow dash|rarity|scootaloo|silver spoon|sunset shimmer|sweetie belle|twilight sparkle,redheadfly
1451117.png,https://derpicdn.net/img/view/2017/6/1/1451117.png,2,0.9464437961578368,753,37,937,221,184,184,apple bloom|applejack|big macintosh|cutie mark crusaders|diamond tiara|fluttershy|rainbow dash|rarity|scootaloo|silver spoon|sunset shimmer|sweetie belle|twilight sparkle,redheadfly
1452042.png,https://derpicdn.net/img/view/2017/6/2/1452042.png,0,0.9574583172798156,946,1217,1564,1835,618,618,applejack|fluttershy|mane six|pinkie pie|rainbow dash|rarity|twilight sparkle,zukiq314
1452042.png,https://derpicdn.net/img/view/2017/6/2/1452042.png,1,0.9538287520408628,121,983,655,1517,534,534,applejack|fluttershy|mane six|pinkie pie|rainbow dash|rarity|twilight sparkle,zukiq314
1453022.png,https://derpicdn.net/img/view/2017/6/3/1453022.png,0,0.9721012115478516,108,0,560,374,452,374,applejack|discord|fluttershy|pinkie pie|princess luna|rainbow dash|rarity|sunset shimmer|twilight sparkle,s1nb0y
1453022.png,https://derpicdn.net/img/view/2017/6/3/1453022.png,1,0.9608802795410156,871,48,1279,456,408,408,applejack|discord|fluttershy|pinkie pie|princess luna|rainbow dash|rarity|sunset shimmer|twilight sparkle,s1nb0y
1453022.png,https://derpicdn.net/img/view/2017/6/3/1453022.png,2,0.9464331865310668,473,1229,1083,1839,610,610,applejack|discord|fluttershy|pinkie pie|princess luna|rainbow dash|rarity|sunset shimmer|twilight sparkle,s1nb0y
1453022.png,https://derpicdn.net/img/view/2017/6/3/1453022.png,3,0.9371803402900696,1063,12,1481,430,418,418,applejack|discord|fluttershy|pinkie pie|princess luna|rainbow dash|rarity|sunset shimmer|twilight sparkle,s1nb0y
1453594.png,https://derpicdn.net/img/view/2017/6/4/1453594.png,1,0.9412156939506532,1780,214,2170,604,390,390,pinkie pie|rarity|twilight sparkle,ogaraorcynder
1457890.png,https://derpicdn.net/img/view/2017/6/9/1457890.png,0,0.977570116519928,2202,579,2902,1279,700,700,applejack|fluttershy|mane six|pinkie pie|rainbow dash|rarity|twilight sparkle,siggie740
1459887.png,https://derpicdn.net/img/view/2017/6/12/1459887.png,0,0.988345980644226,788,1030,1220,1462,432,432,rarity|twilight sparkle,ogaraorcynder
1460939.png,https://derpicdn.net/img/view/2017/6/13/1460939.png,0,0.9263432621955872,583,0,1853,1080,1270,1080,trixie|twilight sparkle,blackfalcon8
1464854.png,https://derpicdn.net/img/view/2017/6/18/1464854.png,0,0.9701061248779296,16,611,230,825,214,214,applejack|fluttershy|sunset shimmer|trixie|twilight sparkle,
1464854.png,https://derpicdn.net/img/view/2017/6/18/1464854.png,1,0.903844952583313,345,274,555,484,210,210,applejack|fluttershy|sunset shimmer|trixie|twilight sparkle,
1466906.png,https://derpicdn.net/img/view/2017/6/20/1466906.png,0,0.97849440574646,0,0,3736,3198,3736,3198,trixie|twilight sparkle,joey darkmeat|yana-j
1467722.png,https://derpicdn.net/img/view/2017/6/21/1467722.png,0,0.9969031810760498,164,48,654,538,490,490,applejack|fluttershy|princess celestia|rarity|soarin'|sunset shimmer|twilight sparkle,farewelldecency
1467722.png,https://derpicdn.net/img/view/2017/6/21/1467722.png,4,0.9627785086631776,172,1362,646,1836,474,474,applejack|fluttershy|princess celestia|rarity|soarin'|sunset shimmer|twilight sparkle,farewelldecency
1467722.png,https://derpicdn.net/img/view/2017/6/21/1467722.png,5,0.9621177315711976,1471,816,1873,1218,402,402,applejack|fluttershy|princess celestia|rarity|soarin'|sunset shimmer|twilight sparkle,farewelldecency
1468665.png,https://derpicdn.net/img/view/2017/6/22/1468665.png,0,0.9677714705467224,1461,0,2021,537,560,537,applejack|fluttershy|mane six|pinkie pie|rainbow dash|rarity|twilight sparkle,bunny-hana
1468665.png,https://derpicdn.net/img/view/2017/6/22/1468665.png,1,0.928531289100647,2030,30,2570,570,540,540,applejack|fluttershy|mane six|pinkie pie|rainbow dash|rarity|twilight sparkle,bunny-hana
1468665.png,https://derpicdn.net/img/view/2017/6/22/1468665.png,2,0.9172203540802002,353,1,1009,657,656,656,applejack|fluttershy|mane six|pinkie pie|rainbow dash|rarity|twilight sparkle,bunny-hana
1469356.png,https://derpicdn.net/img/view/2017/6/23/1469356.png,0,0.9979292750358582,1622,940,2128,1446,506,506,starlight glimmer|twilight sparkle,zogzor
1470244.png,https://derpicdn.net/img/view/2017/6/24/1470244.png,0,0.991669774055481,625,606,879,860,254,254,applejack|fluttershy|mane six|pinkie pie|rainbow dash|rarity|twilight sparkle,katarinacipcic
1470529.png,https://derpicdn.net/img/view/2017/6/24/1470529.png,0,0.9858987927436828,80,388,526,834,446,446,applejack|fluttershy|mane six|pinkie pie|rainbow dash|rarity|twilight sparkle,midnightpremiere
1470902.png,https://derpicdn.net/img/view/2017/6/25/1470902.png,0,0.9956929683685304,1045,120,2679,1754,1634,1634,trixie|twilight sparkle,joemasterpencil|joey darkmeat
1471355.png,https://derpicdn.net/img/view/2017/6/25/1471355.png,1,0.9580588340759276,642,162,1196,716,554,554,princess cadance|princess celestia|princess luna|starlight glimmer|sunset shimmer|trixie|twilight sparkle,duskie-06
1471355.png,https://derpicdn.net/img/view/2017/6/25/1471355.png,2,0.9546054601669312,1543,764,2041,1262,498,498,princess cadance|princess celestia|princess luna|starlight glimmer|sunset shimmer|trixie|twilight sparkle,duskie-06
1472729.png,https://derpicdn.net/img/view/2017/6/27/1472729.png,0,0.9480595588684082,540,154,824,438,284,284,princess luna|twilight sparkle,pndrws
1492981.png,https://derpicdn.net/img/view/2017/7/23/1492981.png,0,0.95159512758255,982,981,1576,1575,594,594,starlight glimmer|sunset shimmer|trixie|twilight sparkle,andromedasparkz
1493516.png,https://derpicdn.net/img/view/2017/7/24/1493516.png,0,0.9984050989151,255,0,1095,641,840,641,trixie|twilight sparkle,higgly-chan
1494345.png,https://derpicdn.net/img/view/2017/7/25/1494345.png,0,0.9858893156051636,1263,758,2143,1638,880,880,discord|spike|twilight sparkle,candasaurus
1499.jpg,https://derpicdn.net/img/view/2012/1/22/1499.jpg,0,0.994449496269226,0,66,424,510,424,444,fluttershy|twilight sparkle,mysticalpha
1499932.png,https://derpicdn.net/img/view/2017/8/1/1499932.png,0,0.9790446758270264,525,0,717,189,192,189,princess cadance|princess celestia|princess luna|twilight sparkle,
1500372.png,https://derpicdn.net/img/view/2017/8/1/1500372.png,0,0.9589300751686096,2154,1,2672,519,518,518,applejack|rarity|twilight sparkle,
1500372.png,https://derpicdn.net/img/view/2017/8/1/1500372.png,1,0.9423717260360718,100,0,686,560,586,560,applejack|rarity|twilight sparkle,
1503879.png,https://derpicdn.net/img/view/2017/8/6/1503879.png,0,0.9965382814407348,540,482,982,924,442,442,queen chrysalis|twilight sparkle,saturdaymorningproj
1505574.png,https://derpicdn.net/img/view/2017/8/8/1505574.png,0,0.9846236109733582,1666,0,3706,2024,2040,2024,rainbow dash|twilight sparkle,t.f.a.n.c.s.
1505869.png,https://derpicdn.net/img/view/2017/8/8/1505869.png,0,0.9872924685478208,1090,0,1758,650,668,650,trixie|twilight sparkle,celine-artnsfw
1505869.png,https://derpicdn.net/img/view/2017/8/8/1505869.png,1,0.9636913537979126,430,211,758,539,328,328,trixie|twilight sparkle,celine-artnsfw
1509857.png,https://derpicdn.net/img/view/2017/8/13/1509857.png,0,0.9951877593994141,688,727,1508,1547,820,820,sunset shimmer|twilight sparkle,denahzi
1515336.png,https://derpicdn.net/img/view/2017/8/20/1515336.png,0,0.9993539452552797,136,0,1258,1056,1122,1056,applejack|fluttershy|mane six|pinkie pie|rainbow dash|rarity|twilight sparkle,twidasher
1515336.png,https://derpicdn.net/img/view/2017/8/20/1515336.png,2,0.9320633411407472,1251,0,2251,955,1000,955,applejack|fluttershy|mane six|pinkie pie|rainbow dash|rarity|twilight sparkle,twidasher
151648.jpg,https://derpicdn.net/img/view/2012/11/14/151648.jpg,0,0.9984731674194336,1006,603,1216,813,210,210,princess luna|twilight sparkle,kloudmutt
151648.jpg,https://derpicdn.net/img/view/2012/11/14/151648.jpg,2,0.9929742217063904,735,335,925,525,190,190,princess luna|twilight sparkle,kloudmutt
151648.jpg,https://derpicdn.net/img/view/2012/11/14/151648.jpg,3,0.9864093065261841,579,659,823,903,244,244,princess luna|twilight sparkle,kloudmutt
151648.jpg,https://derpicdn.net/img/view/2012/11/14/151648.jpg,4,0.9466944336891174,372,324,560,512,188,188,princess luna|twilight sparkle,kloudmutt
1517401.png,https://derpicdn.net/img/view/2017/8/22/1517401.png,0,0.9420852661132812,205,137,419,351,214,214,spike|twilight sparkle,foudubulbe
1517941.png,https://derpicdn.net/img/view/2017/8/23/1517941.png,0,0.9983673691749572,600,18,916,334,316,316,starlight glimmer|twilight sparkle,
1520620.png,https://derpicdn.net/img/view/2017/8/27/1520620.png,0,0.9434641599655152,74,305,584,815,510,510,applejack|fluttershy|mane six|pinkie pie|rainbow dash|rarity|starlight glimmer|twilight sparkle,liniitadash23
1524007.png,https://derpicdn.net/img/view/2017/8/31/1524007.png,0,0.992527186870575,598,0,922,301,324,301,princess flurry heart|sunset shimmer|twilight sparkle,wubcakeva
1524014.png,https://derpicdn.net/img/view/2017/8/31/1524014.png,0,0.9204632639884948,191,107,1701,1617,1510,1510,spike|twilight sparkle,docwario
1529.jpg,https://derpicdn.net/img/view/2012/1/23/1529.jpg,1,0.9363449811935424,342,39,768,465,426,426,pinkie pie|twilight sparkle,mysticalpha
1534271.png,https://derpicdn.net/img/view/2017/9/13/1534271.png,0,0.9003576636314392,156,287,348,479,192,192,applejack|fluttershy|pinkie pie|rainbow dash|rarity|spike|twilight sparkle,
1536197.png,https://derpicdn.net/img/view/2017/9/15/1536197.png,0,0.9769796133041382,2343,184,3009,850,666,666,applejack|fluttershy|mane six|pinkie pie|rainbow dash|rarity|spike|twilight sparkle,romyvdhel-art
1536197.png,https://derpicdn.net/img/view/2017/9/15/1536197.png,1,0.9526949524879456,1399,131,2017,749,618,618,applejack|fluttershy|mane six|pinkie pie|rainbow dash|rarity|spike|twilight sparkle,romyvdhel-art
1536197.png,https://derpicdn.net/img/view/2017/9/15/1536197.png,3,0.940565824508667,4547,446,5175,1074,628,628,applejack|fluttershy|mane six|pinkie pie|rainbow dash|rarity|spike|twilight sparkle,romyvdhel-art
1536197.png,https://derpicdn.net/img/view/2017/9/15/1536197.png,4,0.9375492334365844,3669,0,4287,605,618,605,applejack|fluttershy|mane six|pinkie pie|rainbow dash|rarity|spike|twilight sparkle,romyvdhel-art
1536748.png,https://derpicdn.net/img/view/2017/9/16/1536748.png,1,0.9152252078056335,988,303,1116,431,128,128,applejack|fluttershy|mane six|pinkie pie|rainbow dash|rarity|twilight sparkle,
1538583.png,https://derpicdn.net/img/view/2017/9/18/1538583.png,0,0.9604644775390624,75,249,345,519,270,270,spike|twilight sparkle,robiinart
1542867.png,https://derpicdn.net/img/view/2017/9/23/1542867.png,0,0.9967803359031676,436,569,696,829,260,260,applejack|fluttershy|mane six|pinkie pie|rainbow dash|rarity|twilight sparkle,jadekettu
1542867.png,https://derpicdn.net/img/view/2017/9/23/1542867.png,1,0.9822801351547241,646,0,868,212,222,212,applejack|fluttershy|mane six|pinkie pie|rainbow dash|rarity|twilight sparkle,jadekettu
1542867.png,https://derpicdn.net/img/view/2017/9/23/1542867.png,2,0.9689637422561646,0,148,235,388,235,240,applejack|fluttershy|mane six|pinkie pie|rainbow dash|rarity|twilight sparkle,jadekettu
1542867.png,https://derpicdn.net/img/view/2017/9/23/1542867.png,3,0.9089066982269288,978,776,1238,1036,260,260,applejack|fluttershy|mane six|pinkie pie|rainbow dash|rarity|twilight sparkle,jadekettu
1545641.png,https://derpicdn.net/img/view/2017/9/26/1545641.png,1,0.9905595183372498,4605,733,6851,2979,2246,2246,princess cadance|princess celestia|princess luna|twilight sparkle,tralomine
1545641.png,https://derpicdn.net/img/view/2017/9/26/1545641.png,2,0.91664856672287,2280,367,4130,2217,1850,1850,princess cadance|princess celestia|princess luna|twilight sparkle,tralomine
1545773.png,https://derpicdn.net/img/view/2017/9/27/1545773.png,0,0.9969452619552612,52,211,494,653,442,442,sunset shimmer|twilight sparkle,klavierpony
1549318.png,https://derpicdn.net/img/view/2017/10/1/1549318.png,0,0.9769628047943116,1635,322,2173,982,538,660,fluttershy|twilight sparkle,chrissie-boo
1551475.png,https://derpicdn.net/img/view/2017/10/3/1551475.png,0,0.979260802268982,2503,1026,3203,1726,700,700,applejack|fluttershy|mane six|pinkie pie|rainbow dash|rarity|spike|twilight sparkle,shutterflyeqd
1553334.png,https://derpicdn.net/img/view/2017/10/6/1553334.png,0,0.9984323382377625,59,28,569,538,510,510,pinkie pie|twilight sparkle,senaelik
1553369.png,https://derpicdn.net/img/view/2017/10/6/1553369.png,0,0.9994359612464904,36,387,404,755,368,368,applejack|fluttershy|mane six|pinkie pie|rainbow dash|rarity|twilight sparkle,sycotei-b
1553369.png,https://derpicdn.net/img/view/2017/10/6/1553369.png,1,0.9965708255767822,559,370,885,696,326,326,applejack|fluttershy|mane six|pinkie pie|rainbow dash|rarity|twilight sparkle,sycotei-b
1553369.png,https://derpicdn.net/img/view/2017/10/6/1553369.png,3,0.9160409569740297,393,592,651,850,258,258,applejack|fluttershy|mane six|pinkie pie|rainbow dash|rarity|twilight sparkle,sycotei-b
1555068.png,https://derpicdn.net/img/view/2017/10/8/1555068.png,0,0.9916775822639464,1,0,1201,768,1200,768,starlight glimmer|twilight sparkle,
1555174.png,https://derpicdn.net/img/view/2017/10/8/1555174.png,0,0.9612436890602112,263,287,655,679,392,392,starlight glimmer|trixie|twilight sparkle,artiecanvas
1555199.png,https://derpicdn.net/img/view/2017/10/8/1555199.png,0,0.971903920173645,134,1657,2012,3535,1878,1878,princess cadance|twilight sparkle,amarthgul
1556682.png,https://derpicdn.net/img/view/2017/10/9/1556682.png,0,0.9922866821289062,0,227,394,663,394,436,starlight glimmer|twilight sparkle,nika191319
1557564.png,https://derpicdn.net/img/view/2017/10/10/1557564.png,0,0.9826223850250244,216,37,866,687,650,650,applejack|fluttershy|mane six|pinkie pie|rainbow dash|rarity|twilight sparkle,binkyt11
1558195.png,https://derpicdn.net/img/view/2017/10/11/1558195.png,0,0.9798858165740968,780,0,1640,786,860,786,applejack|fluttershy|mane six|pinkie pie|rainbow dash|rarity|starlight glimmer|sunset shimmer|twilight sparkle,scarlett-letter
1558195.png,https://derpicdn.net/img/view/2017/10/11/1558195.png,1,0.9784687757492064,801,1200,1547,1946,746,746,applejack|fluttershy|mane six|pinkie pie|rainbow dash|rarity|starlight glimmer|sunset shimmer|twilight sparkle,scarlett-letter
1558195.png,https://derpicdn.net/img/view/2017/10/11/1558195.png,2,0.9541870951652528,1985,1137,2691,1869,706,732,applejack|fluttershy|mane six|pinkie pie|rainbow dash|rarity|starlight glimmer|sunset shimmer|twilight sparkle,scarlett-letter
1558195.png,https://derpicdn.net/img/view/2017/10/11/1558195.png,4,0.9100267291069032,1047,608,1787,1348,740,740,applejack|fluttershy|mane six|pinkie pie|rainbow dash|rarity|starlight glimmer|sunset shimmer|twilight sparkle,scarlett-letter
1560975.png,https://derpicdn.net/img/view/2017/10/14/1560975.png,0,0.9765992760658264,608,166,990,548,382,382,princess cadance|princess flurry heart|shining armor|twilight sparkle,liniitadash23
156169.png,https://derpicdn.net/img/view/2012/11/18/156169.png,0,0.9917457103729248,369,143,685,459,316,316,princess cadance|princess luna|shining armor|twilight sparkle,johnjoseco
1565241.png,https://derpicdn.net/img/view/2017/10/19/1565241.png,0,0.9924336075782776,70,729,634,1293,564,564,spike|starlight glimmer|sunset shimmer|twilight sparkle,
1565241.png,https://derpicdn.net/img/view/2017/10/19/1565241.png,1,0.9817124009132384,673,663,1253,1243,580,580,spike|starlight glimmer|sunset shimmer|twilight sparkle,
156673.png,https://derpicdn.net/img/view/2012/11/19/156673.png,0,0.9843993186950684,184,0,602,390,418,390,princess cadance|twilight sparkle,lustrous-dreams
1568400.png,https://derpicdn.net/img/view/2017/10/23/1568400.png,0,0.9584994912147522,231,0,859,620,628,620,fluttershy|twilight sparkle,breeoche
1570395.png,https://derpicdn.net/img/view/2017/10/26/1570395.png,1,0.9593287706375122,565,62,809,306,244,244,applejack|fluttershy|pinkie pie|rarity|twilight sparkle,foxenawolf
1570814.png,https://derpicdn.net/img/view/2017/10/26/1570814.png,0,0.9590282440185548,467,0,2423,1444,1956,1444,spike|twilight sparkle,porygon2z
1573163.png,https://derpicdn.net/img/view/2017/10/29/1573163.png,1,0.9577481150627136,1973,0,2627,638,654,638,applejack|fluttershy|mane six|pinkie pie|princess flurry heart|rainbow dash|rarity|spike|starlight glimmer|sweetie belle|trixie|twilight sparkle,sonofaskywalker
1573221.png,https://derpicdn.net/img/view/2017/10/29/1573221.png,0,0.996267557144165,828,291,1010,473,182,182,princess celestia|princess luna|twilight sparkle,jowybean
1578087.png,https://derpicdn.net/img/view/2017/11/4/1578087.png,0,0.969547688961029,653,0,1375,696,722,696,pinkie pie|sunset shimmer|twilight sparkle,
1581544.png,https://derpicdn.net/img/view/2017/11/8/1581544.png,0,0.9978016018867492,1701,861,2355,1515,654,654,spike|starlight glimmer|twilight sparkle,katakiuchi4u
1581544.png,https://derpicdn.net/img/view/2017/11/8/1581544.png,1,0.9967119693756104,257,561,1185,1489,928,928,spike|starlight glimmer|twilight sparkle,katakiuchi4u
1581544.png,https://derpicdn.net/img/view/2017/11/8/1581544.png,2,0.9622676372528076,1329,1556,1991,2218,662,662,spike|starlight glimmer|twilight sparkle,katakiuchi4u
1586184.png,https://derpicdn.net/img/view/2017/11/14/1586184.png,0,0.95902818441391,0,278,693,974,693,696,queen chrysalis|rainbow dash|twilight sparkle,yourfavoritesenpai
1587765.png,https://derpicdn.net/img/view/2017/11/16/1587765.png,0,0.9989500045776368,119,640,335,856,216,216,applejack|fluttershy|mane six|pinkie pie|rainbow dash|rarity|twilight sparkle,sharmie
1588302.png,https://derpicdn.net/img/view/2017/11/17/1588302.png,0,0.9775172472000122,263,119,651,507,388,388,sunset shimmer|twilight sparkle,little-tweenframes
1588906.png,https://derpicdn.net/img/view/2017/11/18/1588906.png,0,0.9995120763778688,832,1572,2002,2742,1170,1170,applejack|fluttershy|mane six|pinkie pie|rainbow dash|rarity|twilight sparkle,crunchnugget
1590531.png,https://derpicdn.net/img/view/2017/11/20/1590531.png,1,0.9418610930442808,3627,0,4525,893,898,893,applejack|fluttershy|mane six|pinkie pie|rainbow dash|rarity|twilight sparkle,sentireaeris
1591054.png,https://derpicdn.net/img/view/2017/11/21/1591054.png,0,0.98243510723114,1903,873,2629,1599,726,726,spike|twilight sparkle,double-zr-tap
1592023.png,https://derpicdn.net/img/view/2017/11/22/1592023.png,0,0.9984227418899536,133,16,525,408,392,392,fluttershy|pinkie pie|twilight sparkle,dream--chan
1593252.png,https://derpicdn.net/img/view/2017/11/24/1593252.png,0,0.9964403510093688,970,179,1312,521,342,342,applejack|fluttershy|mane six|pinkie pie|rainbow dash|rarity|spike|twilight sparkle,pencil bolt
1593252.png,https://derpicdn.net/img/view/2017/11/24/1593252.png,1,0.962021827697754,0,1100,306,1436,306,336,applejack|fluttershy|mane six|pinkie pie|rainbow dash|rarity|spike|twilight sparkle,pencil bolt
1593430.png,https://derpicdn.net/img/view/2017/11/24/1593430.png,0,0.9835278391838074,417,41,733,357,316,316,trixie|twilight sparkle,sion
1593606.png,https://derpicdn.net/img/view/2017/11/25/1593606.png,1,0.9957778453826904,1221,167,1929,875,708,708,applejack|fluttershy|mane six|pinkie pie|rainbow dash|rarity|starlight glimmer|trixie|twilight sparkle,quarium
1593606.png,https://derpicdn.net/img/view/2017/11/25/1593606.png,3,0.9952662587165833,46,149,830,933,784,784,applejack|fluttershy|mane six|pinkie pie|rainbow dash|rarity|starlight glimmer|trixie|twilight sparkle,quarium
1593606.png,https://derpicdn.net/img/view/2017/11/25/1593606.png,4,0.9927773475646972,80,3277,782,3979,702,702,applejack|fluttershy|mane six|pinkie pie|rainbow dash|rarity|starlight glimmer|trixie|twilight sparkle,quarium
1593606.png,https://derpicdn.net/img/view/2017/11/25/1593606.png,7,0.9545278549194336,0,1937,1160,3237,1160,1300,applejack|fluttershy|mane six|pinkie pie|rainbow dash|rarity|starlight glimmer|trixie|twilight sparkle,quarium
1597113.png,https://derpicdn.net/img/view/2017/11/29/1597113.png,1,0.9756574034690856,4699,1997,5400,2731,701,734,applejack|fluttershy|pinkie pie|rainbow dash|rarity|twilight sparkle,shiningwaterfall|grievousfan|jhayarr23|cuboneminer
1597113.png,https://derpicdn.net/img/view/2017/11/29/1597113.png,3,0.9456111788749696,4876,82,5400,644,524,562,applejack|fluttershy|pinkie pie|rainbow dash|rarity|twilight sparkle,shiningwaterfall|grievousfan|jhayarr23|cuboneminer
1597113.png,https://derpicdn.net/img/view/2017/11/29/1597113.png,5,0.9305882453918456,1718,0,2474,659,756,659,applejack|fluttershy|pinkie pie|rainbow dash|rarity|twilight sparkle,shiningwaterfall|grievousfan|jhayarr23|cuboneminer
1597113.png,https://derpicdn.net/img/view/2017/11/29/1597113.png,6,0.9304055571556092,0,2109,581,2733,581,624,applejack|fluttershy|pinkie pie|rainbow dash|rarity|twilight sparkle,shiningwaterfall|grievousfan|jhayarr23|cuboneminer
1597113.png,https://derpicdn.net/img/view/2017/11/29/1597113.png,7,0.9005752801895142,2062,1901,3110,2949,1048,1048,applejack|fluttershy|pinkie pie|rainbow dash|rarity|twilight sparkle,shiningwaterfall|grievousfan|jhayarr23|cuboneminer
1597956.png,https://derpicdn.net/img/view/2017/12/1/1597956.png,0,0.9939460158348083,709,26,1110,428,401,402,trixie|twilight sparkle,kiyoon
1598338.png,https://derpicdn.net/img/view/2017/12/1/1598338.png,1,0.914559543132782,50,0,2010,1941,1960,1941,fluttershy|pinkie pie|princess celestia|princess luna|rarity|twilight sparkle,firimil
1598486.png,https://derpicdn.net/img/view/2017/12/1/1598486.png,0,0.9817918539047241,16,967,336,1287,320,320,applejack|fluttershy|mane six|pinkie pie|rainbow dash|rarity|twilight sparkle,prettyshinegp
1598486.png,https://derpicdn.net/img/view/2017/12/1/1598486.png,1,0.9681977033615112,620,1016,918,1314,298,298,applejack|fluttershy|mane six|pinkie pie|rainbow dash|rarity|twilight sparkle,prettyshinegp
1598486.png,https://derpicdn.net/img/view/2017/12/1/1598486.png,2,0.9592390060424804,721,0,997,264,276,264,applejack|fluttershy|mane six|pinkie pie|rainbow dash|rarity|twilight sparkle,prettyshinegp
1599042.png,https://derpicdn.net/img/view/2017/12/2/1599042.png,2,0.99567449092865,726,8,2158,1440,1432,1432,applejack|fluttershy|mane six|pinkie pie|rainbow dash|rarity|twilight sparkle,waterz-colrxz
1599042.png,https://derpicdn.net/img/view/2017/12/2/1599042.png,3,0.9944348335266112,694,1816,2110,3232,1416,1416,applejack|fluttershy|mane six|pinkie pie|rainbow dash|rarity|twilight sparkle,waterz-colrxz
1599042.png,https://derpicdn.net/img/view/2017/12/2/1599042.png,5,0.9523301720619202,1751,1236,3000,2716,1249,1480,applejack|fluttershy|mane six|pinkie pie|rainbow dash|rarity|twilight sparkle,waterz-colrxz
1599804.png,https://derpicdn.net/img/view/2017/12/3/1599804.png,0,0.9982903599739076,401,27,639,265,238,238,applejack|fluttershy|mane six|pinkie pie|rainbow dash|rarity|twilight sparkle,kaelonial
1599804.png,https://derpicdn.net/img/view/2017/12/3/1599804.png,1,0.9975093603134156,838,495,1064,721,226,226,applejack|fluttershy|mane six|pinkie pie|rainbow dash|rarity|twilight sparkle,kaelonial
1599804.png,https://derpicdn.net/img/view/2017/12/3/1599804.png,2,0.988151490688324,736,226,1006,496,270,270,applejack|fluttershy|mane six|pinkie pie|rainbow dash|rarity|twilight sparkle,kaelonial
1599804.png,https://derpicdn.net/img/view/2017/12/3/1599804.png,3,0.97694593667984,143,486,381,724,238,238,applejack|fluttershy|mane six|pinkie pie|rainbow dash|rarity|twilight sparkle,kaelonial
1599804.png,https://derpicdn.net/img/view/2017/12/3/1599804.png,4,0.9720922708511353,174,241,418,485,244,244,applejack|fluttershy|mane six|pinkie pie|rainbow dash|rarity|twilight sparkle,kaelonial
1599804.png,https://derpicdn.net/img/view/2017/12/3/1599804.png,5,0.950469136238098,427,577,643,793,216,216,applejack|fluttershy|mane six|pinkie pie|rainbow dash|rarity|twilight sparkle,kaelonial
1602341.png,https://derpicdn.net/img/view/2017/12/7/1602341.png,0,0.987565815448761,4761,805,6269,2313,1508,1508,princess cadance|princess celestia|princess luna|twilight sparkle,desrun|isorrayi
1602341.png,https://derpicdn.net/img/view/2017/12/7/1602341.png,2,0.9792885184288024,1750,0,3162,1362,1412,1362,princess cadance|princess celestia|princess luna|twilight sparkle,desrun|isorrayi
160276.png,https://derpicdn.net/img/view/2012/11/23/160276.png,0,0.9982268214225768,490,680,770,960,280,280,pinkie pie|twilight sparkle,isaiahdjkim
1603712.png,https://derpicdn.net/img/view/2017/12/9/1603712.png,0,0.9669094681739808,165,0,1559,1348,1394,1348,starlight glimmer|twilight sparkle,pony-stark
1612316.png,https://derpicdn.net/img/view/2017/12/20/1612316.png,0,0.9797824025154114,632,0,978,343,346,343,discord|twilight sparkle,tiz4905|cottonponysfm
1612522.png,https://derpicdn.net/img/view/2017/12/21/1612522.png,0,0.9143593311309814,345,214,729,598,384,384,princess luna|twilight sparkle,jykinturah
1612551.png,https://derpicdn.net/img/view/2017/12/21/1612551.png,0,0.9290512800216676,121,0,613,432,492,432,princess celestia|twilight sparkle,pencils
1615241.png,https://derpicdn.net/img/view/2017/12/24/1615241.png,2,0.9448509216308594,470,38,858,426,388,388,princess cadance|princess celestia|princess flurry heart|princess luna|twilight sparkle,romanrazor
1615692.png,https://derpicdn.net/img/view/2017/12/25/1615692.png,1,0.93735009431839,77,102,425,450,348,348,applejack|fluttershy|pinkie pie|rainbow dash|rarity|starlight glimmer|sunset shimmer|trixie|twilight sparkle,berrypawnch|spellboundcanvas
1615820.png,https://derpicdn.net/img/view/2017/12/25/1615820.png,0,0.9963361620903016,563,294,939,670,376,376,applejack|fluttershy|mane six|pinkie pie|rainbow dash|rarity|spike|starlight glimmer|trixie|twilight sparkle,yewdee
1615820.png,https://derpicdn.net/img/view/2017/12/25/1615820.png,1,0.9839988946914672,210,253,600,643,390,390,applejack|fluttershy|mane six|pinkie pie|rainbow dash|rarity|spike|starlight glimmer|trixie|twilight sparkle,yewdee
1615820.png,https://derpicdn.net/img/view/2017/12/25/1615820.png,2,0.9821491241455078,1540,313,1890,699,350,386,applejack|fluttershy|mane six|pinkie pie|rainbow dash|rarity|spike|starlight glimmer|trixie|twilight sparkle,yewdee
1615820.png,https://derpicdn.net/img/view/2017/12/25/1615820.png,3,0.9790374040603638,1078,650,1514,1086,436,436,applejack|fluttershy|mane six|pinkie pie|rainbow dash|rarity|spike|starlight glimmer|trixie|twilight sparkle,yewdee
1615820.png,https://derpicdn.net/img/view/2017/12/25/1615820.png,4,0.9724097847938538,951,200,1363,612,412,412,applejack|fluttershy|mane six|pinkie pie|rainbow dash|rarity|spike|starlight glimmer|trixie|twilight sparkle,yewdee
1616204.png,https://derpicdn.net/img/view/2017/12/25/1616204.png,0,0.9972078800201416,1499,0,2119,482,620,482,applejack|fluttershy|mane six|pinkie pie|rainbow dash|rarity|starlight glimmer|twilight sparkle,sentireaeris
1616204.png,https://derpicdn.net/img/view/2017/12/25/1616204.png,1,0.9898528456687928,38,137,1212,1311,1174,1174,applejack|fluttershy|mane six|pinkie pie|rainbow dash|rarity|starlight glimmer|twilight sparkle,sentireaeris
1616503.png,https://derpicdn.net/img/view/2017/12/26/1616503.png,1,0.9267991781234741,2202,0,2930,681,728,681,applejack|fluttershy|mane six|pinkie pie|rainbow dash|rarity|spike|twilight sparkle,porygon2z
1616928.png,https://derpicdn.net/img/view/2017/12/26/1616928.png,0,0.965486228466034,1899,0,6457,3520,4558,3520,rainbow dash|twilight sparkle,xpesifeindx
1618218.png,https://derpicdn.net/img/view/2017/12/28/1618218.png,0,0.9570075869560242,528,3329,936,3737,408,408,princess cadance|twilight sparkle,alphamonouryuuken
1618323.png,https://derpicdn.net/img/view/2017/12/28/1618323.png,0,0.9832054972648621,258,157,790,689,532,532,rainbow dash|twilight sparkle,shad0w-galaxy
1619467.png,https://derpicdn.net/img/view/2017/12/30/1619467.png,0,0.987394154071808,742,623,1722,1603,980,980,spike|twilight sparkle,siggie740
1619467.png,https://derpicdn.net/img/view/2017/12/30/1619467.png,1,0.9470803141593932,211,1112,941,1842,730,730,spike|twilight sparkle,siggie740
1621228.png,https://derpicdn.net/img/view/2018/1/1/1621228.png,0,0.9959896802902222,880,19,1200,339,320,320,applejack|big macintosh|braeburn|fluttershy|mane six|pinkie pie|rainbow dash|rarity|shining armor|soarin'|twilight sparkle,chaoskomori|misspolycysticovary
1621552.png,https://derpicdn.net/img/view/2018/1/1/1621552.png,0,0.9032623767852784,255,208,515,468,260,260,rarity|starlight glimmer|twilight sparkle,xxmaskedponyxx
1623083.png,https://derpicdn.net/img/view/2018/1/3/1623083.png,0,0.9218650460243224,0,0,1024,955,1024,955,princess celestia|spike|twilight sparkle,yuyusunshine
1624370.png,https://derpicdn.net/img/view/2018/1/5/1624370.png,0,0.9892076253890992,116,0,710,594,594,594,spike|twilight sparkle,emositecc
163464.png,https://derpicdn.net/img/view/2012/11/26/163464.png,0,0.9887189269065856,375,34,735,394,360,360,applejack|fluttershy|princess celestia|princess luna|rainbow dash|rarity|twilight sparkle,johnjoseco
163464.png,https://derpicdn.net/img/view/2012/11/26/163464.png,1,0.971549153327942,857,166,1100,422,243,256,applejack|fluttershy|princess celestia|princess luna|rainbow dash|rarity|twilight sparkle,johnjoseco
1634735.png,https://derpicdn.net/img/view/2018/1/18/1634735.png,0,0.9965143203735352,36,416,314,694,278,278,applejack|fluttershy|mane six|pinkie pie|rainbow dash|rarity|spike|twilight sparkle,wawtoons|yoshigreenwater|dashiemlpfim
1638120.png,https://derpicdn.net/img/view/2018/1/22/1638120.png,0,0.9959629774093628,858,353,1368,863,510,510,rainbow dash|twilight sparkle,eternalsubscriber
1639760.png,https://derpicdn.net/img/view/2018/1/24/1639760.png,0,0.974659264087677,308,0,612,279,304,279,starlight glimmer|twilight sparkle,eiwly
1641510.png,https://derpicdn.net/img/view/2018/1/26/1641510.png,0,0.9752790927886964,1342,205,1628,491,286,286,applejack|fluttershy|mane six|pinkie pie|princess cadance|princess celestia|princess luna|rainbow dash|rarity|spike|twilight sparkle,
1643789.png,https://derpicdn.net/img/view/2018/1/29/1643789.png,1,0.98858380317688,834,145,1074,385,240,240,applejack|fluttershy|mane six|pinkie pie|rainbow dash|rarity|spike|starlight glimmer|twilight sparkle,
1643789.png,https://derpicdn.net/img/view/2018/1/29/1643789.png,2,0.9836738109588624,978,122,1254,398,276,276,applejack|fluttershy|mane six|pinkie pie|rainbow dash|rarity|spike|starlight glimmer|twilight sparkle,
1645737.png,https://derpicdn.net/img/view/2018/2/1/1645737.png,1,0.9850971698760986,0,58,613,730,613,672,applejack|fluttershy|mane six|pinkie pie|rainbow dash|rarity|twilight sparkle,yetioner|cheezedoodle96|antylavx|game-beatx14|timeymarey007|tralomine|cloudyglow|gebros
1645737.png,https://derpicdn.net/img/view/2018/2/1/1645737.png,2,0.9559916257858276,0,1375,752,2160,752,785,applejack|fluttershy|mane six|pinkie pie|rainbow dash|rarity|twilight sparkle,yetioner|cheezedoodle96|antylavx|game-beatx14|timeymarey007|tralomine|cloudyglow|gebros
1645737.png,https://derpicdn.net/img/view/2018/2/1/1645737.png,3,0.9030832648277284,2575,140,2991,556,416,416,applejack|fluttershy|mane six|pinkie pie|rainbow dash|rarity|twilight sparkle,yetioner|cheezedoodle96|antylavx|game-beatx14|timeymarey007|tralomine|cloudyglow|gebros
1648700.png,https://derpicdn.net/img/view/2018/2/5/1648700.png,0,0.9971349239349364,164,392,664,892,500,500,discord|rarity|twilight sparkle,palolabg|swan song
1650311.png,https://derpicdn.net/img/view/2018/2/7/1650311.png,1,0.9275782704353333,113,37,421,345,308,308,spike|twilight sparkle,kkmrarar
1651505.png,https://derpicdn.net/img/view/2018/2/9/1651505.png,1,0.9398893117904664,346,375,962,991,616,616,princess cadance|princess celestia|princess luna|twilight sparkle,emberfan11
1651505.png,https://derpicdn.net/img/view/2018/2/9/1651505.png,2,0.9108127355575562,1870,244,2404,778,534,534,princess cadance|princess celestia|princess luna|twilight sparkle,emberfan11
1658816.png,https://derpicdn.net/img/view/2018/2/18/1658816.png,0,0.9774138927459716,0,31,267,309,267,278,princess luna|twilight sparkle,
1661752.png,https://derpicdn.net/img/view/2018/2/21/1661752.png,0,0.9833418130874634,8,0,406,392,398,392,sunset shimmer|twilight sparkle,
166313.png,https://derpicdn.net/img/view/2012/11/28/166313.png,0,0.9856898784637452,179,0,559,362,380,362,spike|twilight sparkle,arnachy
1663364.png,https://derpicdn.net/img/view/2018/2/23/1663364.png,0,0.947920024394989,518,123,852,457,334,334,princess luna|rarity|starlight glimmer|sunset shimmer|sweetie belle|trixie|twilight sparkle,the-butch-x
1666566.png,https://derpicdn.net/img/view/2018/2/26/1666566.png,0,0.9689131379127502,370,480,624,772,254,292,applejack|fluttershy|mane six|pinkie pie|queen chrysalis|rainbow dash|rarity|twilight sparkle,caelynmlp|andypriceart
1666566.png,https://derpicdn.net/img/view/2018/2/26/1666566.png,1,0.9548159241676332,43,334,219,510,176,176,applejack|fluttershy|mane six|pinkie pie|queen chrysalis|rainbow dash|rarity|twilight sparkle,caelynmlp|andypriceart
1666730.png,https://derpicdn.net/img/view/2018/2/26/1666730.png,0,0.9982930421829224,1342,1966,1806,2430,464,464,applejack|fluttershy|mane six|pinkie pie|rainbow dash|rarity|twilight sparkle,serafelis
1667037.png,https://derpicdn.net/img/view/2018/2/27/1667037.png,0,0.965499222278595,1406,185,1796,575,390,390,princess cadance|princess celestia|princess luna|twilight sparkle,
1667128.png,https://derpicdn.net/img/view/2018/2/27/1667128.png,1,0.9906884431838988,1021,974,1389,1342,368,368,applejack|fluttershy|mane six|pinkie pie|rainbow dash|rarity|spike|twilight sparkle,ejlightning007arts
1667128.png,https://derpicdn.net/img/view/2018/2/27/1667128.png,4,0.9718417525291444,818,1532,1158,1872,340,340,applejack|fluttershy|mane six|pinkie pie|rainbow dash|rarity|spike|twilight sparkle,ejlightning007arts
1671649.png,https://derpicdn.net/img/view/2018/3/4/1671649.png,0,0.9347224831581116,784,51,906,173,122,122,applejack|fluttershy|mane six|pinkie pie|rainbow dash|rarity|twilight sparkle,sutexii
1671649.png,https://derpicdn.net/img/view/2018/3/4/1671649.png,1,0.9012845754623412,892,113,1006,227,114,114,applejack|fluttershy|mane six|pinkie pie|rainbow dash|rarity|twilight sparkle,sutexii
1673641.png,https://derpicdn.net/img/view/2018/3/7/1673641.png,0,0.9849936366081238,1889,854,3204,2308,1315,1454,rarity|twilight sparkle,artiks
1675084.png,https://derpicdn.net/img/view/2018/3/9/1675084.png,0,0.9853201508522034,421,220,785,584,364,364,princess luna|shining armor|starlight glimmer|twilight sparkle,jachau
1677856.png,https://derpicdn.net/img/view/2018/3/12/1677856.png,2,0.9865933656692504,42,423,336,717,294,294,applejack|fluttershy|mane six|pinkie pie|rainbow dash|rarity|twilight sparkle,poowndraww
1677856.png,https://derpicdn.net/img/view/2018/3/12/1677856.png,3,0.986077845096588,563,424,923,784,360,360,applejack|fluttershy|mane six|pinkie pie|rainbow dash|rarity|twilight sparkle,poowndraww
1677856.png,https://derpicdn.net/img/view/2018/3/12/1677856.png,4,0.9136327505111694,433,0,859,403,426,403,applejack|fluttershy|mane six|pinkie pie|rainbow dash|rarity|twilight sparkle,poowndraww
1685602.png,https://derpicdn.net/img/view/2018/3/20/1685602.png,0,0.9487084150314332,462,338,808,684,346,346,applejack|fluttershy|mane six|pinkie pie|rainbow dash|rarity|spike|twilight sparkle,
1687359.png,https://derpicdn.net/img/view/2018/3/22/1687359.png,0,0.9945273399353028,572,814,978,1220,406,406,applejack|fluttershy|mane six|pinkie pie|rainbow dash|rarity|twilight sparkle,flipwix
1687359.png,https://derpicdn.net/img/view/2018/3/22/1687359.png,1,0.9935529828071594,1242,255,1772,785,530,530,applejack|fluttershy|mane six|pinkie pie|rainbow dash|rarity|twilight sparkle,flipwix
1687359.png,https://derpicdn.net/img/view/2018/3/22/1687359.png,3,0.96504408121109,24,849,448,1273,424,424,applejack|fluttershy|mane six|pinkie pie|rainbow dash|rarity|twilight sparkle,flipwix
1687359.png,https://derpicdn.net/img/view/2018/3/22/1687359.png,4,0.9632935523986816,1032,793,1474,1235,442,442,applejack|fluttershy|mane six|pinkie pie|rainbow dash|rarity|twilight sparkle,flipwix
1689242.png,https://derpicdn.net/img/view/2018/3/24/1689242.png,0,0.9917970895767212,381,176,527,322,146,146,pinkie pie|twilight sparkle,pyropk
1689242.png,https://derpicdn.net/img/view/2018/3/24/1689242.png,1,0.9680984616279602,548,178,686,316,138,138,pinkie pie|twilight sparkle,pyropk
1689242.png,https://derpicdn.net/img/view/2018/3/24/1689242.png,2,0.9402993321418762,689,144,867,322,178,178,pinkie pie|twilight sparkle,pyropk
1689792.png,https://derpicdn.net/img/view/2018/3/25/1689792.png,1,0.990248680114746,507,410,735,638,228,228,applejack|fluttershy|pinkie pie|rainbow dash|twilight sparkle,guzzlord
1689792.png,https://derpicdn.net/img/view/2018/3/25/1689792.png,2,0.990230917930603,13,0,245,215,232,215,applejack|fluttershy|pinkie pie|rainbow dash|twilight sparkle,guzzlord
1689792.png,https://derpicdn.net/img/view/2018/3/25/1689792.png,4,0.9876054525375366,116,403,344,631,228,228,applejack|fluttershy|pinkie pie|rainbow dash|twilight sparkle,guzzlord
1690005.png,https://derpicdn.net/img/view/2018/3/25/1690005.png,0,0.996918797492981,98,59,1026,987,928,928,rarity|twilight sparkle,lilfunkman
1692096.png,https://derpicdn.net/img/view/2018/3/27/1692096.png,0,0.9900893568992616,340,0,1102,630,762,630,spike|twilight sparkle,riukime|emositecc
1692096.png,https://derpicdn.net/img/view/2018/3/27/1692096.png,1,0.9584779739379884,1240,554,1808,1122,568,568,spike|twilight sparkle,riukime|emositecc
1692114.png,https://derpicdn.net/img/view/2018/3/27/1692114.png,1,0.9779585599899292,760,0,1074,300,314,300,fluttershy|twilight sparkle,
1692114.png,https://derpicdn.net/img/view/2018/3/27/1692114.png,2,0.93062561750412,194,0,570,366,376,366,fluttershy|twilight sparkle,
1692641.png,https://derpicdn.net/img/view/2018/3/28/1692641.png,0,0.9985492825508118,529,222,785,478,256,256,applejack|fluttershy|mane six|pinkie pie|rainbow dash|rarity|starlight glimmer|twilight sparkle,
1692641.png,https://derpicdn.net/img/view/2018/3/28/1692641.png,1,0.9404284358024596,147,278,429,560,282,282,applejack|fluttershy|mane six|pinkie pie|rainbow dash|rarity|starlight glimmer|twilight sparkle,
1692641.png,https://derpicdn.net/img/view/2018/3/28/1692641.png,2,0.9011551141738892,855,309,1105,559,250,250,applejack|fluttershy|mane six|pinkie pie|rainbow dash|rarity|starlight glimmer|twilight sparkle,
1692820.png,https://derpicdn.net/img/view/2018/3/28/1692820.png,0,0.99285227060318,431,499,767,835,336,336,princess cadance|princess celestia|princess luna|twilight sparkle,radicalweegee
1692820.png,https://derpicdn.net/img/view/2018/3/28/1692820.png,1,0.9923059344291688,115,390,409,684,294,294,princess cadance|princess celestia|princess luna|twilight sparkle,radicalweegee
1692820.png,https://derpicdn.net/img/view/2018/3/28/1692820.png,2,0.954740047454834,467,60,827,420,360,360,princess cadance|princess celestia|princess luna|twilight sparkle,radicalweegee
1694055.png,https://derpicdn.net/img/view/2018/3/29/1694055.png,0,0.947418212890625,137,231,555,649,418,418,sunset shimmer|twilight sparkle,chautung
1696295.png,https://derpicdn.net/img/view/2018/4/1/1696295.png,0,0.9198192954063416,1416,324,1698,606,282,282,applejack|fluttershy|mane six|pinkie pie|rainbow dash|rarity|spike|starlight glimmer|twilight sparkle,
1699248.png,https://derpicdn.net/img/view/2018/4/4/1699248.png,0,0.9955901503562928,835,0,2415,1307,1580,1307,applejack|fluttershy|mane six|pinkie pie|rainbow dash|rarity|spike|twilight sparkle,compassrose0425
1699248.png,https://derpicdn.net/img/view/2018/4/4/1699248.png,1,0.9877685308456421,3061,1234,4395,2568,1334,1334,applejack|fluttershy|mane six|pinkie pie|rainbow dash|rarity|spike|twilight sparkle,compassrose0425
1699248.png,https://derpicdn.net/img/view/2018/4/4/1699248.png,2,0.9679172039031982,1447,1438,2399,2390,952,952,applejack|fluttershy|mane six|pinkie pie|rainbow dash|rarity|spike|twilight sparkle,compassrose0425
1699248.png,https://derpicdn.net/img/view/2018/4/4/1699248.png,3,0.936752200126648,1965,2541,2663,3239,698,698,applejack|fluttershy|mane six|pinkie pie|rainbow dash|rarity|spike|twilight sparkle,compassrose0425
1699248.png,https://derpicdn.net/img/view/2018/4/4/1699248.png,4,0.9351354837417604,677,1438,1619,2380,942,942,applejack|fluttershy|mane six|pinkie pie|rainbow dash|rarity|spike|twilight sparkle,compassrose0425
1702238.png,https://derpicdn.net/img/view/2018/4/8/1702238.png,0,0.9868111610412598,2764,458,3696,1390,932,932,fluttershy|pinkie pie|twilight sparkle,chub-wub
1702451.png,https://derpicdn.net/img/view/2018/4/8/1702451.png,0,0.999619722366333,1463,643,1749,929,286,286,applejack|fluttershy|mane six|pinkie pie|rainbow dash|rarity|twilight sparkle,silverhyena
1702451.png,https://derpicdn.net/img/view/2018/4/8/1702451.png,1,0.997845470905304,1395,145,1667,417,272,272,applejack|fluttershy|mane six|pinkie pie|rainbow dash|rarity|twilight sparkle,silverhyena
1702451.png,https://derpicdn.net/img/view/2018/4/8/1702451.png,2,0.9958563446998596,1180,608,1532,960,352,352,applejack|fluttershy|mane six|pinkie pie|rainbow dash|rarity|twilight sparkle,silverhyena
1702451.png,https://derpicdn.net/img/view/2018/4/8/1702451.png,3,0.9949391484260559,1136,123,1394,381,258,258,applejack|fluttershy|mane six|pinkie pie|rainbow dash|rarity|twilight sparkle,silverhyena
1702451.png,https://derpicdn.net/img/view/2018/4/8/1702451.png,4,0.9924941062927246,334,323,596,585,262,262,applejack|fluttershy|mane six|pinkie pie|rainbow dash|rarity|twilight sparkle,silverhyena
1702451.png,https://derpicdn.net/img/view/2018/4/8/1702451.png,5,0.9910869002342224,898,577,1166,845,268,268,applejack|fluttershy|mane six|pinkie pie|rainbow dash|rarity|twilight sparkle,silverhyena
1702451.png,https://derpicdn.net/img/view/2018/4/8/1702451.png,6,0.9844309091567992,48,156,392,500,344,344,applejack|fluttershy|mane six|pinkie pie|rainbow dash|rarity|twilight sparkle,silverhyena
1704787.png,https://derpicdn.net/img/view/2018/4/11/1704787.png,0,0.9854913353919984,1075,433,2480,1943,1405,1510,rainbow dash|twilight sparkle,twidasher
1705167.png,https://derpicdn.net/img/view/2018/4/11/1705167.png,0,0.9923174381256104,1027,5,2480,1461,1453,1456,rainbow dash|twilight sparkle,twidasher
1705979.png,https://derpicdn.net/img/view/2018/4/12/1705979.png,0,0.9922816157341005,177,0,1275,1042,1098,1042,rainbow dash|twilight sparkle,twidasher
1707438.png,https://derpicdn.net/img/view/2018/4/14/1707438.png,0,0.9935696721076964,895,172,2249,1526,1354,1354,rainbow dash|twilight sparkle,twidasher
170854.jpg,https://derpicdn.net/img/view/2012/12/2/170854.jpg,0,0.9366638660430908,1062,173,1744,855,682,682,apple bloom|fluttershy|princess celestia|twilight sparkle,mysticalpha
170854.jpg,https://derpicdn.net/img/view/2012/12/2/170854.jpg,1,0.9341256022453308,52,150,682,780,630,630,apple bloom|fluttershy|princess celestia|twilight sparkle,mysticalpha
1711818.png,https://derpicdn.net/img/view/2018/4/19/1711818.png,0,0.9108094573020936,356,196,1810,1650,1454,1454,rainbow dash|twilight sparkle,twidasher
1712369.png,https://derpicdn.net/img/view/2018/4/20/1712369.png,3,0.9842169880867004,29,257,323,551,294,294,applejack|fluttershy|mane six|pinkie pie|rainbow dash|rarity|spike|starlight glimmer|sunset shimmer|twilight sparkle,castaspellliana
1713536.png,https://derpicdn.net/img/view/2018/4/21/1713536.png,0,0.9986956119537354,77,0,665,556,588,556,fluttershy|pinkie pie|twilight sparkle,jojofassbender
1715520.png,https://derpicdn.net/img/view/2018/4/23/1715520.png,0,0.9959723353385924,978,23,1256,301,278,278,discord|twilight sparkle,tf-sential
1715520.png,https://derpicdn.net/img/view/2018/4/23/1715520.png,1,0.9951075315475464,998,742,1252,971,254,229,discord|twilight sparkle,tf-sential
1715520.png,https://derpicdn.net/img/view/2018/4/23/1715520.png,5,0.955472767353058,703,442,997,736,294,294,discord|twilight sparkle,tf-sential
1717555.png,https://derpicdn.net/img/view/2018/4/26/1717555.png,0,0.9920436143875122,1252,181,2628,1557,1376,1376,applejack|fluttershy|mane six|pinkie pie|rainbow dash|rarity|spike|twilight sparkle,ejlightning007arts|hendro107
1717555.png,https://derpicdn.net/img/view/2018/4/26/1717555.png,1,0.9253093004226683,2284,1369,3038,2123,754,754,applejack|fluttershy|mane six|pinkie pie|rainbow dash|rarity|spike|twilight sparkle,ejlightning007arts|hendro107
1718711.png,https://derpicdn.net/img/view/2018/4/28/1718711.png,1,0.9422610998153688,257,6,555,304,298,298,applejack|fluttershy|twilight sparkle,sashamalinka|thegreatrouge
1718711.png,https://derpicdn.net/img/view/2018/4/28/1718711.png,2,0.9068531990051272,222,1205,604,1587,382,382,applejack|fluttershy|twilight sparkle,sashamalinka|thegreatrouge
1719525.png,https://derpicdn.net/img/view/2018/4/28/1719525.png,1,0.9958563446998596,0,36,268,314,268,278,applejack|fluttershy|mane six|pinkie pie|rainbow dash|rarity|twilight sparkle,xgglitch
1719525.png,https://derpicdn.net/img/view/2018/4/28/1719525.png,2,0.9833968281745912,0,425,259,687,259,262,applejack|fluttershy|mane six|pinkie pie|rainbow dash|rarity|twilight sparkle,xgglitch
1719525.png,https://derpicdn.net/img/view/2018/4/28/1719525.png,3,0.979059636592865,681,13,1011,343,330,330,applejack|fluttershy|mane six|pinkie pie|rainbow dash|rarity|twilight sparkle,xgglitch
1719726.png,https://derpicdn.net/img/view/2018/4/29/1719726.png,0,0.995640218257904,51,423,317,689,266,266,applejack|fluttershy|mane six|pinkie pie|rainbow dash|rarity|twilight sparkle,catscratchpaper
1719912.png,https://derpicdn.net/img/view/2018/4/29/1719912.png,1,0.908994436264038,1036,96,1592,652,556,556,starlight glimmer|sunset shimmer|twilight sparkle,castaspellliana
1723120.png,https://derpicdn.net/img/view/2018/5/3/1723120.png,0,0.95494943857193,905,0,1699,704,794,704,fluttershy|princess celestia|spike|twilight sparkle,az-derped-unicorn
1725920.png,https://derpicdn.net/img/view/2018/5/6/1725920.png,0,0.9960862398147584,617,0,919,275,302,275,fluttershy|pinkie pie|rarity|starlight glimmer|trixie|twilight sparkle,pixelkitties
1725920.png,https://derpicdn.net/img/view/2018/5/6/1725920.png,1,0.9721061587333679,554,244,940,630,386,386,fluttershy|pinkie pie|rarity|starlight glimmer|trixie|twilight sparkle,pixelkitties
1725920.png,https://derpicdn.net/img/view/2018/5/6/1725920.png,4,0.914159655570984,17,599,315,891,298,292,fluttershy|pinkie pie|rarity|starlight glimmer|trixie|twilight sparkle,pixelkitties
1727268.png,https://derpicdn.net/img/view/2018/5/8/1727268.png,0,0.9205317497253418,446,0,1426,787,980,787,starlight glimmer|twilight sparkle,sileentdo
1731831.png,https://derpicdn.net/img/view/2018/5/13/1731831.png,1,0.9604278206825256,373,134,765,526,392,392,starlight glimmer|twilight sparkle,kuzumori
1733600.png,https://derpicdn.net/img/view/2018/5/15/1733600.png,0,0.9969394207000732,20,1222,2148,3350,2128,2128,sunset shimmer|twilight sparkle,vector-brony
1734607.png,https://derpicdn.net/img/view/2018/5/17/1734607.png,0,0.9883311986923218,748,11,1132,395,384,384,starlight glimmer|sunset shimmer|trixie|twilight sparkle,
1734607.png,https://derpicdn.net/img/view/2018/5/17/1734607.png,1,0.9055735468864441,1369,61,1801,493,432,432,starlight glimmer|sunset shimmer|trixie|twilight sparkle,
1735387.png,https://derpicdn.net/img/view/2018/5/18/1735387.png,0,0.9714130759239196,3002,0,3714,602,712,602,pinkie pie|princess celestia|twilight sparkle,da-fuze
1735465.png,https://derpicdn.net/img/view/2018/5/18/1735465.png,1,0.9910048246383668,1876,534,2570,1228,694,694,fluttershy|rainbow dash|sunset shimmer|twilight sparkle,little-tweenframes|jase1505|motherlyscootaloo|couchcrusader|jake heritagu|amarynceus|silfoe|lilfunkman
1735465.png,https://derpicdn.net/img/view/2018/5/18/1735465.png,3,0.9777056574821472,846,322,1428,904,582,582,fluttershy|rainbow dash|sunset shimmer|twilight sparkle,little-tweenframes|jase1505|motherlyscootaloo|couchcrusader|jake heritagu|amarynceus|silfoe|lilfunkman
1735465.png,https://derpicdn.net/img/view/2018/5/18/1735465.png,4,0.9574496150016784,2127,1171,2769,1813,642,642,fluttershy|rainbow dash|sunset shimmer|twilight sparkle,little-tweenframes|jase1505|motherlyscootaloo|couchcrusader|jake heritagu|amarynceus|silfoe|lilfunkman
1738648.png,https://derpicdn.net/img/view/2018/5/22/1738648.png,0,0.9909749031066896,1593,85,2333,825,740,740,applejack|fluttershy|mane six|pinkie pie|rainbow dash|rarity|twilight sparkle,jack-pie
1738648.png,https://derpicdn.net/img/view/2018/5/22/1738648.png,1,0.9819477796554564,410,154,1136,880,726,726,applejack|fluttershy|mane six|pinkie pie|rainbow dash|rarity|twilight sparkle,jack-pie
1738648.png,https://derpicdn.net/img/view/2018/5/22/1738648.png,3,0.9332078695297241,320,969,926,1575,606,606,applejack|fluttershy|mane six|pinkie pie|rainbow dash|rarity|twilight sparkle,jack-pie
1743891.png,https://derpicdn.net/img/view/2018/5/28/1743891.png,0,0.9712857007980348,76,0,838,654,762,654,sunset shimmer|twilight sparkle,envygirl95
1744016.png,https://derpicdn.net/img/view/2018/5/28/1744016.png,0,0.9831244945526124,912,889,1560,1537,648,648,princess celestia|twilight sparkle,wildviolet-m
1747322.png,https://derpicdn.net/img/view/2018/6/1/1747322.png,0,0.9510844945907592,179,42,781,644,602,602,applejack|fluttershy|mane six|pinkie pie|rainbow dash|rarity|starlight glimmer|twilight sparkle,taurson
1751403.png,https://derpicdn.net/img/view/2018/6/6/1751403.png,0,0.9167748093605042,925,341,1757,1173,832,832,rarity|twilight sparkle,cosmiccorvid
175193.jpg,https://derpicdn.net/img/view/2012/12/7/175193.jpg,0,0.9862774610519408,1720,1024,2352,1656,632,632,applejack|fluttershy|mane six|pinkie pie|rainbow dash|rarity|twilight sparkle,steve thomas
175193.jpg,https://derpicdn.net/img/view/2012/12/7/175193.jpg,1,0.9787744283676147,725,1109,1261,1645,536,536,applejack|fluttershy|mane six|pinkie pie|rainbow dash|rarity|twilight sparkle,steve thomas
1753384.png,https://derpicdn.net/img/view/2018/6/9/1753384.png,1,0.989982008934021,791,11,1503,723,712,712,fluttershy|twilight sparkle,witchette
175348.png,https://derpicdn.net/img/view/2012/12/7/175348.png,0,0.996749758720398,1339,55,1989,705,650,650,applejack|fluttershy|mane six|pinkie pie|rainbow dash|rarity|twilight sparkle,hirurux
175348.png,https://derpicdn.net/img/view/2012/12/7/175348.png,2,0.9898850917816162,1756,93,2380,717,624,624,applejack|fluttershy|mane six|pinkie pie|rainbow dash|rarity|twilight sparkle,hirurux
1757045.png,https://derpicdn.net/img/view/2018/6/14/1757045.png,0,0.9507603645324708,0,262,333,600,333,338,applejack|fluttershy|mane six|pinkie pie|rainbow dash|rarity|spike|starlight glimmer|twilight sparkle,
1757138.png,https://derpicdn.net/img/view/2018/6/14/1757138.png,1,0.9776833653450012,919,9,1407,497,488,488,pinkie pie|twilight sparkle,
1757138.png,https://derpicdn.net/img/view/2018/6/14/1757138.png,2,0.9622260332107544,398,705,920,1227,522,522,pinkie pie|twilight sparkle,
1757310.png,https://derpicdn.net/img/view/2018/6/14/1757310.png,0,0.9774659872055054,21,0,467,411,446,411,starlight glimmer|sunset shimmer|twilight sparkle,chautung
1757310.png,https://derpicdn.net/img/view/2018/6/14/1757310.png,2,0.9534294009208679,653,0,1083,396,430,396,starlight glimmer|sunset shimmer|twilight sparkle,chautung
1757812.png,https://derpicdn.net/img/view/2018/6/14/1757812.png,0,0.9956530928611756,1767,1141,2477,1851,710,710,fluttershy|twilight sparkle,flipwix
1757812.png,https://derpicdn.net/img/view/2018/6/14/1757812.png,1,0.9947749972343444,284,421,922,1059,638,638,fluttershy|twilight sparkle,flipwix
1759365.png,https://derpicdn.net/img/view/2018/6/16/1759365.png,0,0.9494732618331908,44,31,346,333,302,302,princess cadance|princess celestia|princess luna|twilight sparkle,jargon scott
1764873.png,https://derpicdn.net/img/view/2018/6/24/1764873.png,2,0.9131565093994141,968,263,1532,827,564,564,applejack|fluttershy|mane six|pinkie pie|rainbow dash|rarity|twilight sparkle,peridotkitty
1765285.png,https://derpicdn.net/img/view/2018/6/24/1765285.png,0,0.9297335147857666,597,1428,1409,2236,812,808,applejack|fluttershy|mane six|pinkie pie|rainbow dash|rarity|twilight sparkle,delzol
1765990.png,https://derpicdn.net/img/view/2018/6/25/1765990.png,0,0.998602032661438,2326,193,3016,883,690,690,applejack|fluttershy|mane six|pinkie pie|rainbow dash|rarity|twilight sparkle,senseidezzy
1765990.png,https://derpicdn.net/img/view/2018/6/25/1765990.png,1,0.9981622099876404,269,198,937,866,668,668,applejack|fluttershy|mane six|pinkie pie|rainbow dash|rarity|twilight sparkle,senseidezzy
1765990.png,https://derpicdn.net/img/view/2018/6/25/1765990.png,2,0.995022475719452,1303,1306,1975,1978,672,672,applejack|fluttershy|mane six|pinkie pie|rainbow dash|rarity|twilight sparkle,senseidezzy
1765990.png,https://derpicdn.net/img/view/2018/6/25/1765990.png,3,0.9604994654655457,1390,2377,1912,2899,522,522,applejack|fluttershy|mane six|pinkie pie|rainbow dash|rarity|twilight sparkle,senseidezzy
1767483.png,https://derpicdn.net/img/view/2018/6/27/1767483.png,0,0.9943679571151732,0,0,654,653,654,653,spike|twilight sparkle,bumblebun
1767602.png,https://derpicdn.net/img/view/2018/6/27/1767602.png,1,0.9000321626663208,0,1313,457,1801,457,488,princess cadance|princess celestia|princess flurry heart|princess luna|twilight sparkle,karzii
1769058.png,https://derpicdn.net/img/view/2018/6/29/1769058.png,1,0.9355900287628174,583,8,897,322,314,314,rainbow dash|soarin'|twilight sparkle,s1nb0y
1769058.png,https://derpicdn.net/img/view/2018/6/29/1769058.png,2,0.9132821559906006,32,141,318,427,286,286,rainbow dash|soarin'|twilight sparkle,s1nb0y
177008.jpg,https://derpicdn.net/img/view/2012/12/9/177008.jpg,0,0.9740419983863832,297,333,545,581,248,248,apple bloom|applejack|cutie mark crusaders|fluttershy|mane six|pinkie pie|princess celestia|princess luna|rainbow dash|rarity|scootaloo|spike|sweetie belle|twilight sparkle,harukohoshiko
177008.jpg,https://derpicdn.net/img/view/2012/12/9/177008.jpg,4,0.9212632775306702,714,67,1110,463,396,396,apple bloom|applejack|cutie mark crusaders|fluttershy|mane six|pinkie pie|princess celestia|princess luna|rainbow dash|rarity|scootaloo|spike|sweetie belle|twilight sparkle,harukohoshiko
1771845.png,https://derpicdn.net/img/view/2018/7/3/1771845.png,1,0.9947242140769958,0,404,617,1138,617,734,applejack|fluttershy|mane six|pinkie pie|rainbow dash|rarity|twilight sparkle,sophillia
1771845.png,https://derpicdn.net/img/view/2018/7/3/1771845.png,2,0.987208366394043,0,1032,508,1550,508,518,applejack|fluttershy|mane six|pinkie pie|rainbow dash|rarity|twilight sparkle,sophillia
1771845.png,https://derpicdn.net/img/view/2018/7/3/1771845.png,3,0.9118247032165528,435,953,1023,1541,588,588,applejack|fluttershy|mane six|pinkie pie|rainbow dash|rarity|twilight sparkle,sophillia
17779.jpg,https://derpicdn.net/img/view/2012/6/23/17779.jpg,0,0.9883556365966796,19,7,283,271,264,264,princess cadance|shining armor|twilight sparkle,solar-slash
1783479.png,https://derpicdn.net/img/view/2018/7/17/1783479.png,0,0.9973560571670532,612,0,1082,440,470,440,applejack|fluttershy|mane six|pinkie pie|rainbow dash|rarity|twilight sparkle,cinnamonaurora
1783479.png,https://derpicdn.net/img/view/2018/7/17/1783479.png,1,0.9958381056785583,1524,104,1972,552,448,448,applejack|fluttershy|mane six|pinkie pie|rainbow dash|rarity|twilight sparkle,cinnamonaurora
1783479.png,https://derpicdn.net/img/view/2018/7/17/1783479.png,2,0.989088773727417,1827,1069,2235,1495,408,426,applejack|fluttershy|mane six|pinkie pie|rainbow dash|rarity|twilight sparkle,cinnamonaurora
1783479.png,https://derpicdn.net/img/view/2018/7/17/1783479.png,4,0.9467626214027404,12,925,468,1381,456,456,applejack|fluttershy|mane six|pinkie pie|rainbow dash|rarity|twilight sparkle,cinnamonaurora
1787747.png,https://derpicdn.net/img/view/2018/7/23/1787747.png,0,0.9351987242698668,270,30,670,430,400,400,princess flurry heart|twilight sparkle,
1787843.png,https://derpicdn.net/img/view/2018/7/23/1787843.png,0,0.9997047781944276,1318,0,2092,698,774,698,applejack|fluttershy|mane six|pinkie pie|rainbow dash|rarity|twilight sparkle,iblisart
1787843.png,https://derpicdn.net/img/view/2018/7/23/1787843.png,2,0.9980345368385316,10,1148,728,1866,718,718,applejack|fluttershy|mane six|pinkie pie|rainbow dash|rarity|twilight sparkle,iblisart
1787843.png,https://derpicdn.net/img/view/2018/7/23/1787843.png,4,0.9626128673553468,1367,1105,2187,1925,820,820,applejack|fluttershy|mane six|pinkie pie|rainbow dash|rarity|twilight sparkle,iblisart
1787843.png,https://derpicdn.net/img/view/2018/7/23/1787843.png,5,0.9456496238708496,0,62,697,790,697,728,applejack|fluttershy|mane six|pinkie pie|rainbow dash|rarity|twilight sparkle,iblisart
1789102.png,https://derpicdn.net/img/view/2018/7/25/1789102.png,0,0.9993054866790771,411,12,661,262,250,250,sunset shimmer|twilight sparkle,asttefany
1789102.png,https://derpicdn.net/img/view/2018/7/25/1789102.png,1,0.9979586601257324,136,19,394,277,258,258,sunset shimmer|twilight sparkle,asttefany
1789722.png,https://derpicdn.net/img/view/2018/7/25/1789722.png,2,0.938738226890564,382,20,914,552,532,532,princess cadance|princess luna|twilight sparkle,2snacks
1791997.png,https://derpicdn.net/img/view/2018/7/28/1791997.png,0,0.9865318536758424,1080,108,2428,1456,1348,1348,sunset shimmer|twilight sparkle,aka-ryuga
1793936.png,https://derpicdn.net/img/view/2018/7/31/1793936.png,0,0.9995808005332948,0,0,910,867,910,867,applejack|fluttershy|mane six|pinkie pie|rainbow dash|rarity|twilight sparkle,jolliapplegirl
1793936.png,https://derpicdn.net/img/view/2018/7/31/1793936.png,1,0.9974836111068726,3151,0,4077,924,926,924,applejack|fluttershy|mane six|pinkie pie|rainbow dash|rarity|twilight sparkle,jolliapplegirl
1793936.png,https://derpicdn.net/img/view/2018/7/31/1793936.png,2,0.9848795533180236,1877,93,2621,837,744,744,applejack|fluttershy|mane six|pinkie pie|rainbow dash|rarity|twilight sparkle,jolliapplegirl
1793936.png,https://derpicdn.net/img/view/2018/7/31/1793936.png,3,0.9012994170188904,219,1737,1117,2635,898,898,applejack|fluttershy|mane six|pinkie pie|rainbow dash|rarity|twilight sparkle,jolliapplegirl
1794951.png,https://derpicdn.net/img/view/2018/8/1/1794951.png,0,0.9847065210342408,106,762,414,1070,308,308,queen chrysalis|twilight sparkle,hollybright
1794951.png,https://derpicdn.net/img/view/2018/8/1/1794951.png,1,0.9689275622367859,32,47,894,909,862,862,queen chrysalis|twilight sparkle,hollybright
1794951.png,https://derpicdn.net/img/view/2018/8/1/1794951.png,2,0.9132072329521179,944,0,1348,383,404,383,queen chrysalis|twilight sparkle,hollybright
1796876.png,https://derpicdn.net/img/view/2018/8/3/1796876.png,0,0.993259072303772,548,47,1092,591,544,544,rainbow dash|twilight sparkle,shad0w-galaxy
1796876.png,https://derpicdn.net/img/view/2018/8/3/1796876.png,1,0.9909757375717164,890,0,1640,648,750,648,rainbow dash|twilight sparkle,shad0w-galaxy
1798660.png,https://derpicdn.net/img/view/2018/8/5/1798660.png,0,0.9957678914070128,798,568,1298,1068,500,500,spike|twilight sparkle,urbanqhoul
1802565.png,https://derpicdn.net/img/view/2018/8/9/1802565.png,0,0.9921249747276306,1467,698,2155,1386,688,688,discord|princess luna|rainbow dash|twilight sparkle,saphi-boo
1802565.png,https://derpicdn.net/img/view/2018/8/9/1802565.png,1,0.9804130792617798,67,732,603,1268,536,536,discord|princess luna|rainbow dash|twilight sparkle,saphi-boo
1802565.png,https://derpicdn.net/img/view/2018/8/9/1802565.png,3,0.9486948251724244,1135,813,1601,1279,466,466,discord|princess luna|rainbow dash|twilight sparkle,saphi-boo
1812769.png,https://derpicdn.net/img/view/2018/8/21/1812769.png,1,0.9350941181182858,1758,408,1920,572,162,164,applejack|fluttershy|mane six|pinkie pie|rainbow dash|rarity|spike|sunset shimmer|twilight sparkle,
1818501.png,https://derpicdn.net/img/view/2018/8/28/1818501.png,0,0.997726559638977,823,95,1274,547,451,452,pinkie pie|twilight sparkle,geisharozu
182579.jpg,https://derpicdn.net/img/view/2012/12/14/182579.jpg,0,0.9983896613121032,0,418,207,638,207,220,applejack|fluttershy|pinkie pie|rainbow dash|rarity|spike|twilight sparkle,megasweet
182579.jpg,https://derpicdn.net/img/view/2012/12/14/182579.jpg,1,0.9960641860961914,232,262,408,438,176,176,applejack|fluttershy|pinkie pie|rainbow dash|rarity|spike|twilight sparkle,megasweet
182579.jpg,https://derpicdn.net/img/view/2012/12/14/182579.jpg,2,0.9873995780944824,84,214,318,448,234,234,applejack|fluttershy|pinkie pie|rainbow dash|rarity|spike|twilight sparkle,megasweet
1826415.png,https://derpicdn.net/img/view/2018/9/6/1826415.png,0,0.9997149109840392,628,329,940,641,312,312,applejack|fluttershy|mane six|pinkie pie|rainbow dash|rarity|starlight glimmer|sunset shimmer|twilight sparkle,ak4neh
1826415.png,https://derpicdn.net/img/view/2018/9/6/1826415.png,1,0.9991044402122498,44,630,354,940,310,310,applejack|fluttershy|mane six|pinkie pie|rainbow dash|rarity|starlight glimmer|sunset shimmer|twilight sparkle,ak4neh
1826415.png,https://derpicdn.net/img/view/2018/9/6/1826415.png,2,0.9978269934654236,324,4,582,262,258,258,applejack|fluttershy|mane six|pinkie pie|rainbow dash|rarity|starlight glimmer|sunset shimmer|twilight sparkle,ak4neh
1826415.png,https://derpicdn.net/img/view/2018/9/6/1826415.png,4,0.9955545663833618,359,390,619,650,260,260,applejack|fluttershy|mane six|pinkie pie|rainbow dash|rarity|starlight glimmer|sunset shimmer|twilight sparkle,ak4neh
1826415.png,https://derpicdn.net/img/view/2018/9/6/1826415.png,5,0.9664023518562316,0,0,293,291,293,291,applejack|fluttershy|mane six|pinkie pie|rainbow dash|rarity|starlight glimmer|sunset shimmer|twilight sparkle,ak4neh
1828594.png,https://derpicdn.net/img/view/2018/9/9/1828594.png,1,0.9195748567581176,3155,650,4631,2126,1476,1476,applejack|fluttershy|twilight sparkle,compassrose0425
1829717.png,https://derpicdn.net/img/view/2018/9/10/1829717.png,1,0.9094681739807128,4654,2164,5626,3136,972,972,applejack|fluttershy|mane six|pinkie pie|rainbow dash|rarity|spike|twilight sparkle,ruhisu
1832212.png,https://derpicdn.net/img/view/2018/9/14/1832212.png,0,0.9931769967079164,1182,103,1892,813,710,710,applejack|fluttershy|mane six|pinkie pie|rainbow dash|rarity|spike|twilight sparkle,phucknuckl
1832212.png,https://derpicdn.net/img/view/2018/9/14/1832212.png,1,0.9742612242698668,2594,1049,3410,1865,816,816,applejack|fluttershy|mane six|pinkie pie|rainbow dash|rarity|spike|twilight sparkle,phucknuckl
1832292.png,https://derpicdn.net/img/view/2018/9/14/1832292.png,0,0.9979047775268556,1176,1182,2162,2168,986,986,apple bloom|applejack|big macintosh|cutie mark crusaders|fluttershy|granny smith|mane six|pinkie pie|princess cadance|princess celestia|princess luna|rainbow dash|rarity|scootaloo|shining armor|spike|spitfire|starlight glimmer|sunset shimmer|sweetie belle|trixie|twilight sparkle,phucknuckl
1832292.png,https://derpicdn.net/img/view/2018/9/14/1832292.png,1,0.9943768978118896,4457,4053,5443,5039,986,986,apple bloom|applejack|big macintosh|cutie mark crusaders|fluttershy|granny smith|mane six|pinkie pie|princess cadance|princess celestia|princess luna|rainbow dash|rarity|scootaloo|shining armor|spike|spitfire|starlight glimmer|sunset shimmer|sweetie belle|trixie|twilight sparkle,phucknuckl
1832292.png,https://derpicdn.net/img/view/2018/9/14/1832292.png,2,0.9535900950431824,2250,1294,3100,2144,850,850,apple bloom|applejack|big macintosh|cutie mark crusaders|fluttershy|granny smith|mane six|pinkie pie|princess cadance|princess celestia|princess luna|rainbow dash|rarity|scootaloo|shining armor|spike|spitfire|starlight glimmer|sunset shimmer|sweetie belle|trixie|twilight sparkle,phucknuckl
1832292.png,https://derpicdn.net/img/view/2018/9/14/1832292.png,3,0.9497602581977844,1153,4033,2033,4913,880,880,apple bloom|applejack|big macintosh|cutie mark crusaders|fluttershy|granny smith|mane six|pinkie pie|princess cadance|princess celestia|princess luna|rainbow dash|rarity|scootaloo|shining armor|spike|spitfire|starlight glimmer|sunset shimmer|sweetie belle|trixie|twilight sparkle,phucknuckl
1832292.png,https://derpicdn.net/img/view/2018/9/14/1832292.png,4,0.9400027990341188,6923,0,7783,773,860,773,apple bloom|applejack|big macintosh|cutie mark crusaders|fluttershy|granny smith|mane six|pinkie pie|princess cadance|princess celestia|princess luna|rainbow dash|rarity|scootaloo|shining armor|spike|spitfire|starlight glimmer|sunset shimmer|sweetie belle|trixie|twilight sparkle,phucknuckl
1832292.png,https://derpicdn.net/img/view/2018/9/14/1832292.png,6,0.9137735366821288,0,5427,840,6297,840,870,apple bloom|applejack|big macintosh|cutie mark crusaders|fluttershy|granny smith|mane six|pinkie pie|princess cadance|princess celestia|princess luna|rainbow dash|rarity|scootaloo|shining armor|spike|spitfire|starlight glimmer|sunset shimmer|sweetie belle|trixie|twilight sparkle,phucknuckl
1835131.png,https://derpicdn.net/img/view/2018/9/17/1835131.png,0,0.9704907536506652,622,0,1166,517,544,517,sunset shimmer|twilight sparkle,nichroniclesvsart
1835131.png,https://derpicdn.net/img/view/2018/9/17/1835131.png,1,0.9584950804710388,22,812,734,1524,712,712,sunset shimmer|twilight sparkle,nichroniclesvsart
1835131.png,https://derpicdn.net/img/view/2018/9/17/1835131.png,2,0.9196805357933044,108,10,612,514,504,504,sunset shimmer|twilight sparkle,nichroniclesvsart
1835396.png,https://derpicdn.net/img/view/2018/9/18/1835396.png,1,0.9805201888084412,0,0,2075,2078,2075,2078,apple bloom|cutie mark crusaders|rainbow dash|scootaloo|sweetie belle|twilight sparkle,reginault|cloudyglow|mundschenk85|parclytaxel|yanoda|dashiesparkle
1837544.png,https://derpicdn.net/img/view/2018/9/21/1837544.png,2,0.9802513122558594,353,1199,1843,2689,1490,1490,princess cadance|princess flurry heart|shining armor|spike|twilight sparkle,chainchomp2 edit|mundschenk85|captnblitz|estories|chrzanek97|unfiltered-n
1837544.png,https://derpicdn.net/img/view/2018/9/21/1837544.png,3,0.9128326177597046,3524,2047,4856,3379,1332,1332,princess cadance|princess flurry heart|shining armor|spike|twilight sparkle,chainchomp2 edit|mundschenk85|captnblitz|estories|chrzanek97|unfiltered-n
1837677.png,https://derpicdn.net/img/view/2018/9/21/1837677.png,0,0.9955669641494752,210,119,700,649,490,530,rainbow dash|soarin'|twilight sparkle,zouyugi
1837677.png,https://derpicdn.net/img/view/2018/9/21/1837677.png,1,0.9792276620864868,74,281,286,493,212,212,rainbow dash|soarin'|twilight sparkle,zouyugi
1839303.png,https://derpicdn.net/img/view/2018/9/23/1839303.png,0,0.9365906715393066,936,196,1350,610,414,414,spike|twilight sparkle,dsana
1840539.png,https://derpicdn.net/img/view/2018/9/24/1840539.png,0,0.9592452049255372,531,963,865,1297,334,334,big macintosh|princess cadance|princess celestia|princess luna|shining armor|twilight sparkle,goat train
1841441.png,https://derpicdn.net/img/view/2018/9/26/1841441.png,0,0.9968301057815552,1136,23,1844,731,708,708,applejack|fluttershy|mane six|pinkie pie|rainbow dash|rarity|twilight sparkle,taaffeiite
1841441.png,https://derpicdn.net/img/view/2018/9/26/1841441.png,1,0.9948906302452089,1111,1386,1849,2124,738,738,applejack|fluttershy|mane six|pinkie pie|rainbow dash|rarity|twilight sparkle,taaffeiite
1841441.png,https://derpicdn.net/img/view/2018/9/26/1841441.png,2,0.9912607669830322,2341,1446,2997,2102,656,656,applejack|fluttershy|mane six|pinkie pie|rainbow dash|rarity|twilight sparkle,taaffeiite
1845592.png,https://derpicdn.net/img/view/2018/10/1/1845592.png,0,0.9629316926002502,0,91,1253,1349,1253,1258,sunset shimmer|twilight sparkle,shayla567
1845592.png,https://derpicdn.net/img/view/2018/10/1/1845592.png,1,0.9546290636062622,946,27,2310,1391,1364,1364,sunset shimmer|twilight sparkle,shayla567
1846607.png,https://derpicdn.net/img/view/2018/10/2/1846607.png,0,0.9982817769050598,8,31,290,313,282,282,fluttershy|rarity|twilight sparkle,saphi-boo
1846607.png,https://derpicdn.net/img/view/2018/10/2/1846607.png,1,0.9955623149871826,761,563,1053,855,292,292,fluttershy|rarity|twilight sparkle,saphi-boo
1846607.png,https://derpicdn.net/img/view/2018/10/2/1846607.png,2,0.984446942806244,124,583,428,887,304,304,fluttershy|rarity|twilight sparkle,saphi-boo
1846607.png,https://derpicdn.net/img/view/2018/10/2/1846607.png,3,0.9155300259590148,515,80,743,308,228,228,fluttershy|rarity|twilight sparkle,saphi-boo
1846688.png,https://derpicdn.net/img/view/2018/10/3/1846688.png,0,0.9955516457557678,553,144,829,420,276,276,fluttershy|pinkie pie|rainbow dash|rarity|twilight sparkle,tonyfleecs
1846688.png,https://derpicdn.net/img/view/2018/10/3/1846688.png,1,0.9430909156799316,0,151,263,429,263,278,fluttershy|pinkie pie|rainbow dash|rarity|twilight sparkle,tonyfleecs
1846692.png,https://derpicdn.net/img/view/2018/10/3/1846692.png,0,0.9214962720870972,49,744,385,1080,336,336,fluttershy|pinkie pie|rainbow dash|rarity|twilight sparkle,tonyfleecs
1846888.png,https://derpicdn.net/img/view/2018/10/3/1846888.png,0,0.9982474446296692,3071,12,3933,874,862,862,rarity|twilight sparkle,lilfunkman
1847611.png,https://derpicdn.net/img/view/2018/10/4/1847611.png,0,0.9597251415252686,753,279,1589,1115,836,836,princess flurry heart|spike|twilight sparkle,aleximusprime
1856709.png,https://derpicdn.net/img/view/2018/10/14/1856709.png,0,0.998110055923462,1248,42,1868,662,620,620,fluttershy|twilight sparkle,serafelis
1856709.png,https://derpicdn.net/img/view/2018/10/14/1856709.png,1,0.9826723337173462,325,82,917,674,592,592,fluttershy|twilight sparkle,serafelis
1858769.png,https://derpicdn.net/img/view/2018/10/17/1858769.png,0,0.9852803945541382,1376,0,1710,329,334,329,applejack|fluttershy|pinkie pie|rainbow dash|rarity|sunset shimmer|twilight sparkle,selenaede|ilaria122
1858769.png,https://derpicdn.net/img/view/2018/10/17/1858769.png,1,0.9813401103019714,129,36,415,322,286,286,applejack|fluttershy|pinkie pie|rainbow dash|rarity|sunset shimmer|twilight sparkle,selenaede|ilaria122
1858769.png,https://derpicdn.net/img/view/2018/10/17/1858769.png,2,0.9380683302879332,2646,0,2972,325,326,325,applejack|fluttershy|pinkie pie|rainbow dash|rarity|sunset shimmer|twilight sparkle,selenaede|ilaria122
1862349.png,https://derpicdn.net/img/view/2018/10/21/1862349.png,0,0.9548715353012084,3943,1404,5101,2562,1158,1158,applejack|fluttershy|mane six|pinkie pie|rainbow dash|rarity|twilight sparkle,aleximusprime
1869065.png,https://derpicdn.net/img/view/2018/10/29/1869065.png,0,0.9705946445465088,225,297,489,561,264,264,applejack|fluttershy|pinkie pie|rainbow dash|rarity|sunset shimmer|twilight sparkle,
1869065.png,https://derpicdn.net/img/view/2018/10/29/1869065.png,1,0.9353175163269044,601,136,861,396,260,260,applejack|fluttershy|pinkie pie|rainbow dash|rarity|sunset shimmer|twilight sparkle,
1876648.png,https://derpicdn.net/img/view/2018/11/6/1876648.png,0,0.9506118893623352,709,29,1700,1025,991,996,rarity|spike|twilight sparkle,mistleinn
1879883.png,https://derpicdn.net/img/view/2018/11/11/1879883.png,0,0.9991209506988524,39,0,897,819,858,819,applejack|fluttershy|mane six|pinkie pie|rainbow dash|rarity|twilight sparkle,geraritydevillefort
1879883.png,https://derpicdn.net/img/view/2018/11/11/1879883.png,1,0.9924068450927734,84,933,898,1747,814,814,applejack|fluttershy|mane six|pinkie pie|rainbow dash|rarity|twilight sparkle,geraritydevillefort
1879883.png,https://derpicdn.net/img/view/2018/11/11/1879883.png,2,0.9841580390930176,1891,930,2679,1718,788,788,applejack|fluttershy|mane six|pinkie pie|rainbow dash|rarity|twilight sparkle,geraritydevillefort
1879883.png,https://derpicdn.net/img/view/2018/11/11/1879883.png,3,0.9747264385223388,919,0,1821,779,902,779,applejack|fluttershy|mane six|pinkie pie|rainbow dash|rarity|twilight sparkle,geraritydevillefort
1881884.png,https://derpicdn.net/img/view/2018/11/14/1881884.png,0,0.9939061403274536,0,41,165,213,165,172,applejack|fluttershy|mane six|pinkie pie|rainbow dash|rarity|starlight glimmer|twilight sparkle,theprince
1881884.png,https://derpicdn.net/img/view/2018/11/14/1881884.png,1,0.9938445687294006,878,0,1142,260,264,260,applejack|fluttershy|mane six|pinkie pie|rainbow dash|rarity|starlight glimmer|twilight sparkle,theprince
1882224.png,https://derpicdn.net/img/view/2018/11/14/1882224.png,1,0.9986310601234436,3078,0,4436,1319,1358,1319,applejack|fluttershy|mane six|pinkie pie|rainbow dash|rarity|twilight sparkle,xsatanielx
1882224.png,https://derpicdn.net/img/view/2018/11/14/1882224.png,2,0.9889098405838012,3026,3985,4636,5595,1610,1610,applejack|fluttershy|mane six|pinkie pie|rainbow dash|rarity|twilight sparkle,xsatanielx
1882224.png,https://derpicdn.net/img/view/2018/11/14/1882224.png,3,0.9554188251495358,3205,2134,4355,3284,1150,1150,applejack|fluttershy|mane six|pinkie pie|rainbow dash|rarity|twilight sparkle,xsatanielx
1883188.png,https://derpicdn.net/img/view/2018/11/15/1883188.png,0,0.9910585880279541,250,0,876,606,626,606,spike|twilight sparkle,befishproductions
1884533.png,https://derpicdn.net/img/view/2018/11/17/1884533.png,0,0.9886229038238524,0,0,877,886,877,886,queen chrysalis|twilight sparkle,hardbrony
1885201.png,https://derpicdn.net/img/view/2018/11/18/1885201.png,0,0.9780982732772828,604,149,1238,783,634,634,sunset shimmer|twilight sparkle,ch-chau
1885515.png,https://derpicdn.net/img/view/2018/11/18/1885515.png,0,0.9565409421920776,433,65,623,255,190,190,princess cadance|twilight sparkle,andypriceart
1889581.png,https://derpicdn.net/img/view/2018/11/24/1889581.png,0,0.9995061159133912,589,36,1023,470,434,434,scootaloo|twilight sparkle,ridgessky
1889581.png,https://derpicdn.net/img/view/2018/11/24/1889581.png,1,0.9202877283096312,244,168,596,520,352,352,scootaloo|twilight sparkle,ridgessky
1892038.png,https://derpicdn.net/img/view/2018/11/27/1892038.png,0,0.9742177128791808,284,351,1552,1619,1268,1268,rainbow dash|twilight sparkle,8bitgalaxy
1895521.png,https://derpicdn.net/img/view/2018/12/1/1895521.png,0,0.9127819538116456,338,28,660,350,322,322,applejack|fluttershy|mane six|pinkie pie|rainbow dash|rarity|twilight sparkle,wanderingpegasus
1895746.png,https://derpicdn.net/img/view/2018/12/1/1895746.png,0,0.9965632557868958,1964,0,3598,1585,1634,1585,trixie|twilight sparkle,reconweirdstuff
1898934.png,https://derpicdn.net/img/view/2018/12/5/1898934.png,0,0.9812988638877868,3125,583,4143,1601,1018,1018,applejack|fluttershy|princess flurry heart|rainbow dash|twilight sparkle,cuddlelamb
1899382.png,https://derpicdn.net/img/view/2018/12/5/1899382.png,0,0.9995104074478148,0,822,1075,1944,1075,1122,applejack|fluttershy|twilight sparkle,yunlongchen
1899382.png,https://derpicdn.net/img/view/2018/12/5/1899382.png,1,0.9966109991073608,1309,1496,2175,2362,866,866,applejack|fluttershy|twilight sparkle,yunlongchen
1899382.png,https://derpicdn.net/img/view/2018/12/5/1899382.png,2,0.920000433921814,1061,60,1859,858,798,798,applejack|fluttershy|twilight sparkle,yunlongchen
1900445.png,https://derpicdn.net/img/view/2018/12/6/1900445.png,0,0.9923194646835328,101,0,447,320,346,320,spike|twilight sparkle,digitalsnail
1900946.png,https://derpicdn.net/img/view/2018/12/7/1900946.png,0,0.9984400272369384,151,0,845,560,694,560,starlight glimmer|trixie|twilight sparkle,sketchmcreations|cheezedoodle96|8-notes|0nautile18e26|tardifice
190627.png,https://derpicdn.net/img/view/2012/12/22/190627.png,2,0.9636912345886228,0,913,598,1551,598,638,apple bloom|applejack|babs seed|braeburn|diamond tiara|discord|fluttershy|mane six|pinkie pie|princess celestia|princess luna|queen chrysalis|rainbow dash|rarity|scootaloo|spike|spitfire|sweetie belle|trixie|twilight sparkle,blackbewhite2k7
190627.png,https://derpicdn.net/img/view/2012/12/22/190627.png,4,0.9238898158073424,536,1676,1290,2430,754,754,apple bloom|applejack|babs seed|braeburn|diamond tiara|discord|fluttershy|mane six|pinkie pie|princess celestia|princess luna|queen chrysalis|rainbow dash|rarity|scootaloo|spike|spitfire|sweetie belle|trixie|twilight sparkle,blackbewhite2k7
1908167.png,https://derpicdn.net/img/view/2018/12/14/1908167.png,0,0.9971671104431152,1066,0,1920,649,854,649,pinkie pie|sunset shimmer|twilight sparkle,
1908167.png,https://derpicdn.net/img/view/2018/12/14/1908167.png,1,0.9833231568336488,133,201,1119,1080,986,879,pinkie pie|sunset shimmer|twilight sparkle,
191873.jpg,https://derpicdn.net/img/view/2012/12/24/191873.jpg,0,0.9844093322753906,2,115,966,1079,964,964,pinkie pie|spike|trixie|twilight sparkle,ss2sonic
191873.jpg,https://derpicdn.net/img/view/2012/12/24/191873.jpg,1,0.9682412147521972,696,143,1654,1107,958,964,pinkie pie|spike|trixie|twilight sparkle,ss2sonic
191873.jpg,https://derpicdn.net/img/view/2012/12/24/191873.jpg,2,0.9626736640930176,555,869,991,1305,436,436,pinkie pie|spike|trixie|twilight sparkle,ss2sonic
1926049.png,https://derpicdn.net/img/view/2019/1/4/1926049.png,0,0.94360089302063,698,462,1220,984,522,522,fluttershy|twilight sparkle,chokuru
1926049.png,https://derpicdn.net/img/view/2019/1/4/1926049.png,1,0.9348805546760559,410,1113,938,1641,528,528,fluttershy|twilight sparkle,chokuru
1926911.png,https://derpicdn.net/img/view/2019/1/5/1926911.png,0,0.9919975996017456,0,283,179,465,179,182,shining armor|spike|twilight sparkle,darkodraco
1926911.png,https://derpicdn.net/img/view/2019/1/5/1926911.png,2,0.9398195743560792,49,0,355,302,306,302,shining armor|spike|twilight sparkle,darkodraco
1927190.png,https://derpicdn.net/img/view/2019/1/5/1927190.png,1,0.953131914138794,1962,521,2394,953,432,432,applejack|fluttershy|mane six|pinkie pie|rainbow dash|rarity|spike|twilight sparkle,samum41
19287.jpg,https://derpicdn.net/img/view/2012/6/24/19287.jpg,2,0.9782593250274658,1344,140,1996,792,652,652,applejack|fluttershy|mane six|pinkie pie|rainbow dash|rarity|twilight sparkle,forgotten-wings
1932029.png,https://derpicdn.net/img/view/2019/1/11/1932029.png,0,0.9956660270690918,402,659,836,1093,434,434,spike|twilight sparkle,toasterwitch
1932029.png,https://derpicdn.net/img/view/2019/1/11/1932029.png,1,0.9869190454483032,1087,54,1561,528,474,474,spike|twilight sparkle,toasterwitch
1934549.png,https://derpicdn.net/img/view/2019/1/13/1934549.png,0,0.979697287082672,745,79,1645,979,900,900,starlight glimmer|trixie|twilight sparkle,romablueberry
1937225.png,https://derpicdn.net/img/view/2019/1/17/1937225.png,0,0.9962992668151855,280,276,810,806,530,530,spike|twilight sparkle,rupertbluefox
1939405.png,https://derpicdn.net/img/view/2019/1/19/1939405.png,1,0.9851372241973876,608,183,836,411,228,228,applejack|fluttershy|mane six|pinkie pie|rainbow dash|rarity|twilight sparkle,renciel
1939405.png,https://derpicdn.net/img/view/2019/1/19/1939405.png,2,0.9680509567260742,490,38,694,242,204,204,applejack|fluttershy|mane six|pinkie pie|rainbow dash|rarity|twilight sparkle,renciel
1940447.png,https://derpicdn.net/img/view/2019/1/20/1940447.png,0,0.9983363151550292,362,0,792,409,430,409,applejack|fluttershy|mane six|pinkie pie|rainbow dash|rarity|twilight sparkle,purrling
1940447.png,https://derpicdn.net/img/view/2019/1/20/1940447.png,1,0.9579929113388062,307,788,629,1110,322,322,applejack|fluttershy|mane six|pinkie pie|rainbow dash|rarity|twilight sparkle,purrling
1940447.png,https://derpicdn.net/img/view/2019/1/20/1940447.png,2,0.9518510103225708,334,456,686,808,352,352,applejack|fluttershy|mane six|pinkie pie|rainbow dash|rarity|twilight sparkle,purrling
1940447.png,https://derpicdn.net/img/view/2019/1/20/1940447.png,3,0.902810513973236,554,755,894,1095,340,340,applejack|fluttershy|mane six|pinkie pie|rainbow dash|rarity|twilight sparkle,purrling
1940512.png,https://derpicdn.net/img/view/2019/1/21/1940512.png,0,0.9091481566429138,2173,747,2751,1325,578,578,applejack|fluttershy|mane six|pinkie pie|rainbow dash|rarity|twilight sparkle,janegumball
1949557.png,https://derpicdn.net/img/view/2019/1/31/1949557.png,0,0.986823797225952,487,2743,1045,3301,558,558,applejack|fluttershy|mane six|pinkie pie|rainbow dash|rarity|twilight sparkle,sugar morning
1954667.png,https://derpicdn.net/img/view/2019/2/5/1954667.png,0,0.9580578804016112,802,986,2010,2194,1208,1208,rarity|twilight sparkle,lilfunkman
19564.png,https://derpicdn.net/img/view/2012/6/24/19564.png,0,0.998513638973236,489,305,841,657,352,352,applejack|fluttershy|mane six|pinkie pie|rainbow dash|rarity|spike|twilight sparkle,madmax
19564.png,https://derpicdn.net/img/view/2012/6/24/19564.png,1,0.9969797730445862,235,324,595,684,360,360,applejack|fluttershy|mane six|pinkie pie|rainbow dash|rarity|spike|twilight sparkle,madmax
19564.png,https://derpicdn.net/img/view/2012/6/24/19564.png,2,0.9962999820709229,176,136,450,410,274,274,applejack|fluttershy|mane six|pinkie pie|rainbow dash|rarity|spike|twilight sparkle,madmax
19564.png,https://derpicdn.net/img/view/2012/6/24/19564.png,3,0.980705499649048,0,475,366,857,366,382,applejack|fluttershy|mane six|pinkie pie|rainbow dash|rarity|spike|twilight sparkle,madmax
1956442.png,https://derpicdn.net/img/view/2019/2/8/1956442.png,0,0.9703495502471924,1073,483,1481,891,408,408,princess celestia|sunset shimmer|twilight sparkle,
1956442.png,https://derpicdn.net/img/view/2019/2/8/1956442.png,1,0.9699121117591858,374,378,832,836,458,458,princess celestia|sunset shimmer|twilight sparkle,
1958524.png,https://derpicdn.net/img/view/2019/2/10/1958524.png,0,0.9997549653053284,559,0,799,215,240,215,applejack|fluttershy|mane six|pinkie pie|rainbow dash|rarity|twilight sparkle,云观雾里
1958524.png,https://derpicdn.net/img/view/2019/2/10/1958524.png,1,0.9923496842384338,8,236,246,474,238,238,applejack|fluttershy|mane six|pinkie pie|rainbow dash|rarity|twilight sparkle,云观雾里
1958524.png,https://derpicdn.net/img/view/2019/2/10/1958524.png,2,0.9303923845291138,591,394,799,602,208,208,applejack|fluttershy|mane six|pinkie pie|rainbow dash|rarity|twilight sparkle,云观雾里
1963942.png,https://derpicdn.net/img/view/2019/2/16/1963942.png,0,0.9941949248313904,72,520,562,1010,490,490,applejack|fluttershy|pinkie pie|rainbow dash|rarity|twilight sparkle,yewdee
1965833.png,https://derpicdn.net/img/view/2019/2/19/1965833.png,0,0.9962971210479736,759,70,1515,826,756,756,princess luna|twilight sparkle,j3r1k0
1966433.png,https://derpicdn.net/img/view/2019/2/19/1966433.png,0,0.9800605177879332,67,5,841,769,774,764,pinkie pie|starlight glimmer|twilight sparkle,
1969033.png,https://derpicdn.net/img/view/2019/2/22/1969033.png,1,0.9819359183311462,2885,500,3529,1144,644,644,applejack|fluttershy|mane six|pinkie pie|rainbow dash|rarity|spike|starlight glimmer|twilight sparkle,cuttledreams
1969033.png,https://derpicdn.net/img/view/2019/2/22/1969033.png,2,0.9637356400489808,2169,567,2697,1095,528,528,applejack|fluttershy|mane six|pinkie pie|rainbow dash|rarity|spike|starlight glimmer|twilight sparkle,cuttledreams
1969349.png,https://derpicdn.net/img/view/2019/2/23/1969349.png,0,0.9853775501251221,2269,1317,3063,2111,794,794,apple bloom|applejack|big macintosh|cutie mark crusaders|fluttershy|granny smith|mane six|pinkie pie|princess cadance|princess celestia|princess flurry heart|princess luna|rainbow dash|rarity|scootaloo|shining armor|spike|spitfire|starlight glimmer|sunset shimmer|sweetie belle|trixie|twilight sparkle,phucknuckl
1969349.png,https://derpicdn.net/img/view/2019/2/23/1969349.png,1,0.9409310221672058,4496,4063,5404,4971,908,908,apple bloom|applejack|big macintosh|cutie mark crusaders|fluttershy|granny smith|mane six|pinkie pie|princess cadance|princess celestia|princess flurry heart|princess luna|rainbow dash|rarity|scootaloo|shining armor|spike|spitfire|starlight glimmer|sunset shimmer|sweetie belle|trixie|twilight sparkle,phucknuckl
1969349.png,https://derpicdn.net/img/view/2019/2/23/1969349.png,2,0.9361391067504884,1123,1174,2271,2322,1148,1148,apple bloom|applejack|big macintosh|cutie mark crusaders|fluttershy|granny smith|mane six|pinkie pie|princess cadance|princess celestia|princess flurry heart|princess luna|rainbow dash|rarity|scootaloo|shining armor|spike|spitfire|starlight glimmer|sunset shimmer|sweetie belle|trixie|twilight sparkle,phucknuckl
1969349.png,https://derpicdn.net/img/view/2019/2/23/1969349.png,3,0.9268565773963928,0,5437,826,6383,826,946,apple bloom|applejack|big macintosh|cutie mark crusaders|fluttershy|granny smith|mane six|pinkie pie|princess cadance|princess celestia|princess flurry heart|princess luna|rainbow dash|rarity|scootaloo|shining armor|spike|spitfire|starlight glimmer|sunset shimmer|sweetie belle|trixie|twilight sparkle,phucknuckl
1969349.png,https://derpicdn.net/img/view/2019/2/23/1969349.png,4,0.9027346968650818,4645,8186,5665,9206,1020,1020,apple bloom|applejack|big macintosh|cutie mark crusaders|fluttershy|granny smith|mane six|pinkie pie|princess cadance|princess celestia|princess flurry heart|princess luna|rainbow dash|rarity|scootaloo|shining armor|spike|spitfire|starlight glimmer|sunset shimmer|sweetie belle|trixie|twilight sparkle,phucknuckl
1971778.png,https://derpicdn.net/img/view/2019/2/26/1971778.png,0,0.9913774132728576,0,0,322,282,322,282,starlight glimmer|sunset shimmer|trixie|twilight sparkle,
1971778.png,https://derpicdn.net/img/view/2019/2/26/1971778.png,1,0.9882946014404296,0,217,327,559,327,342,starlight glimmer|sunset shimmer|trixie|twilight sparkle,
1972107.png,https://derpicdn.net/img/view/2019/2/26/1972107.png,0,0.9560787677764891,1521,166,1778,476,257,310,discord|princess celestia|princess luna|twilight sparkle,sunny way
1975467.png,https://derpicdn.net/img/view/2019/3/2/1975467.png,1,0.993390679359436,0,0,361,367,361,367,princess luna|starlight glimmer|sunset shimmer|trixie|twilight sparkle,shimazun
1975467.png,https://derpicdn.net/img/view/2019/3/2/1975467.png,2,0.9932401776313782,0,1993,544,2689,544,696,princess luna|starlight glimmer|sunset shimmer|trixie|twilight sparkle,shimazun
1980885.png,https://derpicdn.net/img/view/2019/3/9/1980885.png,1,0.9849153757095336,96,557,474,935,378,378,sunset shimmer|twilight sparkle,animechristy
1981941.png,https://derpicdn.net/img/view/2019/3/10/1981941.png,0,0.9938780069351196,1256,0,2028,655,772,655,applejack|fluttershy|mane six|pinkie pie|rainbow dash|rarity|twilight sparkle,yugovostok
1981941.png,https://derpicdn.net/img/view/2019/3/10/1981941.png,1,0.9909844994544984,984,405,1652,1073,668,668,applejack|fluttershy|mane six|pinkie pie|rainbow dash|rarity|twilight sparkle,yugovostok
1981941.png,https://derpicdn.net/img/view/2019/3/10/1981941.png,3,0.9810853600502014,434,671,1036,1273,602,602,applejack|fluttershy|mane six|pinkie pie|rainbow dash|rarity|twilight sparkle,yugovostok
1981941.png,https://derpicdn.net/img/view/2019/3/10/1981941.png,4,0.9615370035171508,52,574,666,1188,614,614,applejack|fluttershy|mane six|pinkie pie|rainbow dash|rarity|twilight sparkle,yugovostok
1986219.png,https://derpicdn.net/img/view/2019/3/15/1986219.png,4,0.9426648020744324,708,0,1032,355,324,355,applejack|fluttershy|pinkie pie|rainbow dash|rarity|spike|sunset shimmer|twilight sparkle,タツオ
1986219.png,https://derpicdn.net/img/view/2019/3/15/1986219.png,6,0.921271026134491,765,411,1032,769,267,358,applejack|fluttershy|pinkie pie|rainbow dash|rarity|spike|sunset shimmer|twilight sparkle,タツオ
1988369.png,https://derpicdn.net/img/view/2019/3/17/1988369.png,4,0.9516581296920776,951,2135,1661,2845,710,710,princess cadance|princess celestia|princess luna|queen chrysalis|twilight sparkle,cuddlelamb
1990312.png,https://derpicdn.net/img/view/2019/3/19/1990312.png,0,0.995730757713318,20,9,216,205,196,196,trixie|twilight sparkle,lotte
1990856.png,https://derpicdn.net/img/view/2019/3/20/1990856.png,0,0.9716901779174804,326,181,1668,1523,1342,1342,rainbow dash|twilight sparkle,taurson
1991505.png,https://derpicdn.net/img/view/2019/3/21/1991505.png,0,0.9471428394317628,62,106,222,266,160,160,princess celestia|princess luna|twilight sparkle,merumeto
1993509.png,https://derpicdn.net/img/view/2019/3/24/1993509.png,0,0.9765577912330629,0,0,1283,1284,1283,1284,sunset shimmer|twilight sparkle,winter-scarf|jackiephantom13|diamond-bases
1993509.png,https://derpicdn.net/img/view/2019/3/24/1993509.png,1,0.9449735283851624,955,78,2091,1214,1136,1136,sunset shimmer|twilight sparkle,winter-scarf|jackiephantom13|diamond-bases
1996958.png,https://derpicdn.net/img/view/2019/3/28/1996958.png,0,0.9292906522750854,1622,0,5928,4089,4306,4089,rainbow dash|twilight sparkle,microgrid|yourfavoritesenpai
1997129.png,https://derpicdn.net/img/view/2019/3/28/1997129.png,0,0.9612072706222534,3025,1638,3823,2436,798,798,applejack|fluttershy|pinkie pie|princess celestia|rainbow dash|rarity|spitfire|twilight sparkle,brainiac
1997129.png,https://derpicdn.net/img/view/2019/3/28/1997129.png,1,0.9418317079544068,4403,2122,4845,2564,442,442,applejack|fluttershy|pinkie pie|princess celestia|rainbow dash|rarity|spitfire|twilight sparkle,brainiac
1999826.png,https://derpicdn.net/img/view/2019/4/1/1999826.png,0,0.9636515378952026,38,0,780,709,742,709,sunset shimmer|twilight sparkle,
1999928.png,https://derpicdn.net/img/view/2019/4/1/1999928.png,0,0.9661809802055359,422,40,982,600,560,560,princess celestia|twilight sparkle,friendlyraccoon
1999935.png,https://derpicdn.net/img/view/2019/4/1/1999935.png,0,0.9858713150024414,975,1101,1159,1285,184,184,applejack|fluttershy|pinkie pie|rainbow dash|rarity|spike|sunset shimmer|twilight sparkle,
1999935.png,https://derpicdn.net/img/view/2019/4/1/1999935.png,1,0.9797398447990416,774,1076,972,1274,198,198,applejack|fluttershy|pinkie pie|rainbow dash|rarity|spike|sunset shimmer|twilight sparkle,
2007075.png,https://derpicdn.net/img/view/2019/4/9/2007075.png,0,0.9954718351364136,361,14,631,286,270,272,discord|twilight sparkle,
2010480.png,https://derpicdn.net/img/view/2019/4/13/2010480.png,0,0.998269259929657,1205,0,1835,602,630,602,apple bloom|applejack|cutie mark crusaders|fluttershy|mane six|pinkie pie|rainbow dash|rarity|scootaloo|sweetie belle|twilight sparkle,hooves-art|beardeddoomguy
2011930.png,https://derpicdn.net/img/view/2019/4/14/2011930.png,0,0.9574087858200072,270,0,800,476,530,476,sunset shimmer|twilight sparkle,phyllismi
2014772.png,https://derpicdn.net/img/view/2019/4/17/2014772.png,0,0.9998819828033448,655,0,1119,373,464,373,applejack|fluttershy|mane six|pinkie pie|rainbow dash|rarity|twilight sparkle,erkythehero23
2014772.png,https://derpicdn.net/img/view/2019/4/17/2014772.png,1,0.9996312856674194,101,0,545,362,444,362,applejack|fluttershy|mane six|pinkie pie|rainbow dash|rarity|twilight sparkle,erkythehero23
2014772.png,https://derpicdn.net/img/view/2019/4/17/2014772.png,3,0.9991452693939208,1242,0,1558,308,316,308,applejack|fluttershy|mane six|pinkie pie|rainbow dash|rarity|twilight sparkle,erkythehero23
2014772.png,https://derpicdn.net/img/view/2019/4/17/2014772.png,5,0.994709312915802,1271,537,1581,847,310,310,applejack|fluttershy|mane six|pinkie pie|rainbow dash|rarity|twilight sparkle,erkythehero23
2020615.png,https://derpicdn.net/img/view/2019/4/23/2020615.png,0,0.9671741724014282,122,22,480,380,358,358,starlight glimmer|twilight sparkle,
2021850.png,https://derpicdn.net/img/view/2019/4/24/2021850.png,0,0.9922143816947936,271,178,703,610,432,432,applejack|fluttershy|mane six|pinkie pie|rainbow dash|rarity|twilight sparkle,
2024181.png,https://derpicdn.net/img/view/2019/4/27/2024181.png,1,0.9135383367538452,40,0,590,488,550,488,pinkie pie|twilight sparkle,wacky-skiff
2028201.png,https://derpicdn.net/img/view/2019/5/1/2028201.png,0,0.9269357323646544,1354,1408,1776,1830,422,422,big macintosh|princess cadance|princess celestia|princess luna|rainbow dash|rarity|spike|twilight sparkle,andypriceart
2030334.png,https://derpicdn.net/img/view/2019/5/4/2030334.png,0,0.9864521026611328,105,2831,1327,4053,1222,1222,applejack|fluttershy|mane six|pinkie pie|rainbow dash|rarity|twilight sparkle,batonya12561
2035860.png,https://derpicdn.net/img/view/2019/5/11/2035860.png,1,0.9800143837928772,1281,1445,1769,1933,488,488,princess cadance|princess celestia|princess flurry heart|princess luna|shining armor|twilight sparkle,cutepencilcase
2038723.png,https://derpicdn.net/img/view/2019/5/14/2038723.png,0,0.9882441759109496,825,37,1141,353,316,316,applejack|fluttershy|mane six|pinkie pie|rainbow dash|rarity|twilight sparkle,anyazen
2038723.png,https://derpicdn.net/img/view/2019/5/14/2038723.png,1,0.955718159675598,37,196,381,540,344,344,applejack|fluttershy|mane six|pinkie pie|rainbow dash|rarity|twilight sparkle,anyazen
2048322.png,https://derpicdn.net/img/view/2019/5/25/2048322.png,1,0.9917344450950624,272,216,592,536,320,320,applejack|fluttershy|mane six|pinkie pie|rainbow dash|rarity|twilight sparkle,vkyw
2048322.png,https://derpicdn.net/img/view/2019/5/25/2048322.png,2,0.990647315979004,3,142,247,386,244,244,applejack|fluttershy|mane six|pinkie pie|rainbow dash|rarity|twilight sparkle,vkyw
2048453.png,https://derpicdn.net/img/view/2019/5/25/2048453.png,0,0.984515368938446,1305,490,2189,1374,884,884,starlight glimmer|sunset shimmer|trixie|twilight sparkle,apexpredator923
2048453.png,https://derpicdn.net/img/view/2019/5/25/2048453.png,1,0.9181768894195556,245,319,1471,1545,1226,1226,starlight glimmer|sunset shimmer|trixie|twilight sparkle,apexpredator923
2051974.png,https://derpicdn.net/img/view/2019/5/28/2051974.png,0,0.9893068075180054,795,4,979,188,184,184,apple bloom|cutie mark crusaders|fluttershy|scootaloo|sweetie belle|twilight sparkle,holivi
2051979.png,https://derpicdn.net/img/view/2019/5/28/2051979.png,0,0.9936572909355164,1666,2598,2848,3780,1182,1182,applejack|fluttershy|mane six|pinkie pie|rainbow dash|rarity|twilight sparkle,sannykat
2051979.png,https://derpicdn.net/img/view/2019/5/28/2051979.png,1,0.9936559200286864,58,129,1586,1657,1528,1528,applejack|fluttershy|mane six|pinkie pie|rainbow dash|rarity|twilight sparkle,sannykat
2051979.png,https://derpicdn.net/img/view/2019/5/28/2051979.png,2,0.9782678484916688,186,1846,1608,3268,1422,1422,applejack|fluttershy|mane six|pinkie pie|rainbow dash|rarity|twilight sparkle,sannykat
2051979.png,https://derpicdn.net/img/view/2019/5/28/2051979.png,3,0.9091333746910096,2905,2182,4373,3650,1468,1468,applejack|fluttershy|mane six|pinkie pie|rainbow dash|rarity|twilight sparkle,sannykat
2053674.png,https://derpicdn.net/img/view/2019/5/30/2053674.png,0,0.9314488172531128,1163,554,1695,1086,532,532,starlight glimmer|sunset shimmer|twilight sparkle,dippygamer64|amelia-bases
205489.png,https://derpicdn.net/img/view/2013/1/7/205489.png,0,0.9640818238258362,1571,195,1907,531,336,336,princess celestia|rarity|twilight sparkle,adcoon
2057540.png,https://derpicdn.net/img/view/2019/6/4/2057540.png,0,0.9898062944412231,384,13,720,349,336,336,applejack|fluttershy|mane six|pinkie pie|rainbow dash|rarity|spike|twilight sparkle,sacredroses-art|sacred-dreams
2057540.png,https://derpicdn.net/img/view/2019/6/4/2057540.png,1,0.9511977434158324,652,0,924,260,272,260,applejack|fluttershy|mane six|pinkie pie|rainbow dash|rarity|spike|twilight sparkle,sacredroses-art|sacred-dreams
2062078.png,https://derpicdn.net/img/view/2019/6/10/2062078.png,0,0.9337300062179564,67,0,881,796,814,796,starlight glimmer|trixie|twilight sparkle,owlpirate
2062434.png,https://derpicdn.net/img/view/2019/6/10/2062434.png,0,0.9899250864982604,590,122,1500,1060,910,938,applejack|fluttershy|mane six|pinkie pie|rainbow dash|rarity|twilight sparkle,cloudyglow
2062653.png,https://derpicdn.net/img/view/2019/6/11/2062653.png,1,0.9575409889221193,384,381,972,969,588,588,sunset shimmer|twilight sparkle,
2063091.png,https://derpicdn.net/img/view/2019/6/11/2063091.png,0,0.9985106587409972,248,0,1242,896,994,896,applejack|fluttershy|mane six|pinkie pie|rainbow dash|rarity|twilight sparkle,shadow-nights
2063091.png,https://derpicdn.net/img/view/2019/6/11/2063091.png,1,0.9909773468971252,1521,89,2622,1215,1101,1126,applejack|fluttershy|mane six|pinkie pie|rainbow dash|rarity|twilight sparkle,shadow-nights
206383.jpg,https://derpicdn.net/img/view/2013/1/8/206383.jpg,0,0.9856401085853576,1694,524,2058,888,364,364,apple bloom|applejack|big macintosh|fluttershy|pinkie pie|rainbow dash|rarity|scootaloo|sweetie belle|twilight sparkle,yulyeen
206383.jpg,https://derpicdn.net/img/view/2013/1/8/206383.jpg,1,0.9422417283058168,395,1051,885,1541,490,490,apple bloom|applejack|big macintosh|fluttershy|pinkie pie|rainbow dash|rarity|scootaloo|sweetie belle|twilight sparkle,yulyeen
2066835.png,https://derpicdn.net/img/view/2019/6/16/2066835.png,0,0.9129335284233092,1374,686,1556,868,182,182,apple bloom|applejack|babs seed|big macintosh|cutie mark crusaders|diamond tiara|fluttershy|granny smith|mane six|pinkie pie|rainbow dash|rarity|scootaloo|silver spoon|spike|starlight glimmer|sweetie belle|twilight sparkle,
2069678.png,https://derpicdn.net/img/view/2019/6/19/2069678.png,0,0.9855591654777528,645,1115,1143,1613,498,498,applejack|fluttershy|mane six|pinkie pie|rainbow dash|rarity|twilight sparkle,muffinshire
2074264.png,https://derpicdn.net/img/view/2019/6/24/2074264.png,0,0.9889256954193116,218,0,1310,939,1092,939,fluttershy|rainbow dash|spike|twilight sparkle,
2074265.png,https://derpicdn.net/img/view/2019/6/24/2074265.png,0,0.9877127408981324,223,0,1310,942,1087,942,fluttershy|rainbow dash|spike|twilight sparkle,
2081692.png,https://derpicdn.net/img/view/2019/7/3/2081692.png,0,0.9974958300590516,2129,2411,3009,3291,880,880,applejack|fluttershy|pinkie pie|princess cadance|princess celestia|princess luna|rainbow dash|rarity|spike|twilight sparkle,partylikeanartist
2081692.png,https://derpicdn.net/img/view/2019/7/3/2081692.png,1,0.9957905411720276,3938,1399,5000,2489,1062,1090,applejack|fluttershy|pinkie pie|princess cadance|princess celestia|princess luna|rainbow dash|rarity|spike|twilight sparkle,partylikeanartist
2081692.png,https://derpicdn.net/img/view/2019/7/3/2081692.png,2,0.9947118163108826,1531,1381,2507,2357,976,976,applejack|fluttershy|pinkie pie|princess cadance|princess celestia|princess luna|rainbow dash|rarity|spike|twilight sparkle,partylikeanartist
2081692.png,https://derpicdn.net/img/view/2019/7/3/2081692.png,4,0.9905850887298584,1976,509,2940,1473,964,964,applejack|fluttershy|pinkie pie|princess cadance|princess celestia|princess luna|rainbow dash|rarity|spike|twilight sparkle,partylikeanartist
2081692.png,https://derpicdn.net/img/view/2019/7/3/2081692.png,7,0.9757623672485352,4090,3141,4942,3993,852,852,applejack|fluttershy|pinkie pie|princess cadance|princess celestia|princess luna|rainbow dash|rarity|spike|twilight sparkle,partylikeanartist
2081692.png,https://derpicdn.net/img/view/2019/7/3/2081692.png,8,0.9721925854682922,787,2160,1665,3038,878,878,applejack|fluttershy|pinkie pie|princess cadance|princess celestia|princess luna|rainbow dash|rarity|spike|twilight sparkle,partylikeanartist
2081692.png,https://derpicdn.net/img/view/2019/7/3/2081692.png,9,0.9296576380729676,31,1452,1021,2442,990,990,applejack|fluttershy|pinkie pie|princess cadance|princess celestia|princess luna|rainbow dash|rarity|spike|twilight sparkle,partylikeanartist
2083567.png,https://derpicdn.net/img/view/2019/7/5/2083567.png,0,0.9987373948097228,1318,0,1911,524,593,524,applejack|fluttershy|mane six|pinkie pie|rainbow dash|rarity|twilight sparkle,770nanao15
2083567.png,https://derpicdn.net/img/view/2019/7/5/2083567.png,1,0.9958508014678956,37,0,647,537,610,537,applejack|fluttershy|mane six|pinkie pie|rainbow dash|rarity|twilight sparkle,770nanao15
2083567.png,https://derpicdn.net/img/view/2019/7/5/2083567.png,2,0.9898010492324828,17,647,593,1223,576,576,applejack|fluttershy|mane six|pinkie pie|rainbow dash|rarity|twilight sparkle,770nanao15
2083567.png,https://derpicdn.net/img/view/2019/7/5/2083567.png,4,0.945881724357605,667,0,1265,508,598,508,applejack|fluttershy|mane six|pinkie pie|rainbow dash|rarity|twilight sparkle,770nanao15
2084575.png,https://derpicdn.net/img/view/2019/7/6/2084575.png,0,0.9925562739372252,22,430,356,725,334,295,princess celestia|starlight glimmer|twilight sparkle,
2086446.png,https://derpicdn.net/img/view/2019/7/8/2086446.png,0,0.961007297039032,484,0,1020,492,536,492,pinkie pie|twilight sparkle,
2086448.png,https://derpicdn.net/img/view/2019/7/8/2086448.png,0,0.9584747552871704,99,0,497,393,398,393,pinkie pie|twilight sparkle,
2089054.png,https://derpicdn.net/img/view/2019/7/11/2089054.png,0,0.991544544696808,628,641,1498,1511,870,870,princess luna|twilight sparkle,mailner
2095575.png,https://derpicdn.net/img/view/2019/7/19/2095575.png,2,0.9366475939750672,1454,369,2112,1027,658,658,applejack|fluttershy|mane six|pinkie pie|rainbow dash|rarity|twilight sparkle,lupiarts
2096515.png,https://derpicdn.net/img/view/2019/7/20/2096515.png,0,0.940740704536438,359,0,925,564,566,564,princess celestia|twilight sparkle,unoriginai
210278.png,https://derpicdn.net/img/view/2013/1/12/210278.png,0,0.9889883399009703,1276,545,1520,789,244,244,apple bloom|applejack|babs seed|big macintosh|cutie mark crusaders|diamond tiara|discord|fluttershy|granny smith|pinkie pie|princess cadance|princess celestia|princess luna|queen chrysalis|rainbow dash|rarity|scootaloo|shining armor|silver spoon|spike|sweetie belle|trixie|twilight sparkle,smwstudios
210278.png,https://derpicdn.net/img/view/2013/1/12/210278.png,1,0.9424888491630554,614,1495,796,1677,182,182,apple bloom|applejack|babs seed|big macintosh|cutie mark crusaders|diamond tiara|discord|fluttershy|granny smith|pinkie pie|princess cadance|princess celestia|princess luna|queen chrysalis|rainbow dash|rarity|scootaloo|shining armor|silver spoon|spike|sweetie belle|trixie|twilight sparkle,smwstudios
2103217.png,https://derpicdn.net/img/view/2019/7/28/2103217.png,0,0.9876164197921752,43,0,413,367,370,367,applejack|rainbow dash|twilight sparkle,
2106702.png,https://derpicdn.net/img/view/2019/8/1/2106702.png,0,0.9993050694465636,3,23,1051,1071,1048,1048,rainbow dash|twilight sparkle,stuwor-art|stupid works-stuwor
2110114.png,https://derpicdn.net/img/view/2019/8/5/2110114.png,1,0.9732034802436828,209,210,853,854,644,644,spike|starlight glimmer|twilight sparkle,ipun
2110114.png,https://derpicdn.net/img/view/2019/8/5/2110114.png,2,0.9544108510017396,699,298,1069,668,370,370,spike|starlight glimmer|twilight sparkle,ipun
2114886.png,https://derpicdn.net/img/view/2019/8/11/2114886.png,0,0.9958209395408628,747,0,2003,1143,1256,1143,princess luna|twilight sparkle,mazzianz
2114886.png,https://derpicdn.net/img/view/2019/8/11/2114886.png,1,0.941646695137024,138,657,1034,1553,896,896,princess luna|twilight sparkle,mazzianz
2117591.png,https://derpicdn.net/img/view/2019/8/14/2117591.png,0,0.9978660941123962,361,212,657,508,296,296,princess cadance|shining armor|twilight sparkle,kirillk
2117591.png,https://derpicdn.net/img/view/2019/8/14/2117591.png,1,0.9977442026138306,364,1116,654,1406,290,290,princess cadance|shining armor|twilight sparkle,kirillk
2117591.png,https://derpicdn.net/img/view/2019/8/14/2117591.png,2,0.9952336549758912,1070,1216,1348,1494,278,278,princess cadance|shining armor|twilight sparkle,kirillk
2117591.png,https://derpicdn.net/img/view/2019/8/14/2117591.png,3,0.9845815300941468,1068,325,1348,605,280,280,princess cadance|shining armor|twilight sparkle,kirillk
2117591.png,https://derpicdn.net/img/view/2019/8/14/2117591.png,4,0.9731196761131288,7,1084,391,1468,384,384,princess cadance|shining armor|twilight sparkle,kirillk
2117591.png,https://derpicdn.net/img/view/2019/8/14/2117591.png,5,0.9651219844818116,0,178,400,578,400,400,princess cadance|shining armor|twilight sparkle,kirillk
2117591.png,https://derpicdn.net/img/view/2019/8/14/2117591.png,6,0.900878369808197,781,1098,1049,1366,268,268,princess cadance|shining armor|twilight sparkle,kirillk
2120750.png,https://derpicdn.net/img/view/2019/8/17/2120750.png,0,0.9784005880355836,241,0,1915,804,1674,804,princess celestia|twilight sparkle,
2123416.png,https://derpicdn.net/img/view/2019/8/20/2123416.png,0,0.9995437264442444,821,0,1279,398,458,398,applejack|fluttershy|mane six|pinkie pie|rainbow dash|rarity|twilight sparkle,silberhoernchen
2123416.png,https://derpicdn.net/img/view/2019/8/20/2123416.png,1,0.9910483956336976,502,314,1032,844,530,530,applejack|fluttershy|mane six|pinkie pie|rainbow dash|rarity|twilight sparkle,silberhoernchen
2123416.png,https://derpicdn.net/img/view/2019/8/20/2123416.png,2,0.9357426166534424,0,433,398,853,398,420,applejack|fluttershy|mane six|pinkie pie|rainbow dash|rarity|twilight sparkle,silberhoernchen
2128129.png,https://derpicdn.net/img/view/2019/8/26/2128129.png,0,0.9931606650352478,2246,668,2854,1276,608,608,applejack|fluttershy|mane six|pinkie pie|rainbow dash|rarity|spike|twilight sparkle,shad0w-galaxy
2128129.png,https://derpicdn.net/img/view/2019/8/26/2128129.png,1,0.9921925067901612,225,210,915,900,690,690,applejack|fluttershy|mane six|pinkie pie|rainbow dash|rarity|spike|twilight sparkle,shad0w-galaxy
2128129.png,https://derpicdn.net/img/view/2019/8/26/2128129.png,2,0.9846320748329164,1063,768,1661,1366,598,598,applejack|fluttershy|mane six|pinkie pie|rainbow dash|rarity|spike|twilight sparkle,shad0w-galaxy
2128129.png,https://derpicdn.net/img/view/2019/8/26/2128129.png,3,0.9803808927536012,2948,221,3578,851,630,630,applejack|fluttershy|mane six|pinkie pie|rainbow dash|rarity|spike|twilight sparkle,shad0w-galaxy
2128569.png,https://derpicdn.net/img/view/2019/8/26/2128569.png,0,0.9855512976646424,443,726,1041,1324,598,598,applejack|fluttershy|mane six|pinkie pie|rainbow dash|rarity|spike|twilight sparkle,
2128569.png,https://derpicdn.net/img/view/2019/8/26/2128569.png,1,0.9827395677566528,170,154,760,744,590,590,applejack|fluttershy|mane six|pinkie pie|rainbow dash|rarity|spike|twilight sparkle,
2128569.png,https://derpicdn.net/img/view/2019/8/26/2128569.png,2,0.9632800817489624,992,736,1422,1166,430,430,applejack|fluttershy|mane six|pinkie pie|rainbow dash|rarity|spike|twilight sparkle,
2131341.png,https://derpicdn.net/img/view/2019/8/30/2131341.png,0,0.9804156422615052,38,0,1398,1242,1360,1242,trixie|twilight sparkle,thatdreamerarts
2132079.png,https://derpicdn.net/img/view/2019/8/31/2132079.png,0,0.9236078858375548,488,25,1022,559,534,534,applejack|fluttershy|mane six|pinkie pie|rainbow dash|rarity|spike|twilight sparkle,
2132146.png,https://derpicdn.net/img/view/2019/8/31/2132146.png,0,0.9710806012153624,729,479,1005,755,276,276,starlight glimmer|twilight sparkle,
2132146.png,https://derpicdn.net/img/view/2019/8/31/2132146.png,1,0.9098780155181884,1251,407,1463,619,212,212,starlight glimmer|twilight sparkle,
213481.png,https://derpicdn.net/img/view/2013/1/15/213481.png,0,0.999717891216278,624,131,1124,631,500,500,shining armor|twilight sparkle,dm29
2138891.png,https://derpicdn.net/img/view/2019/9/7/2138891.png,0,0.9792795181274414,125,9,713,599,588,590,princess celestia|princess luna|twilight sparkle,
2141720.png,https://derpicdn.net/img/view/2019/9/11/2141720.png,0,0.9698874950408936,402,16,1140,754,738,738,rainbow dash|twilight sparkle,stupid works-stuwor
2141720.png,https://derpicdn.net/img/view/2019/9/11/2141720.png,1,0.947903335094452,754,163,1420,829,666,666,rainbow dash|twilight sparkle,stupid works-stuwor
2142058.png,https://derpicdn.net/img/view/2019/9/12/2142058.png,0,0.9682555198669434,1071,0,3309,1671,2238,1671,applejack|rainbow dash|twilight sparkle,psfmer
214343.jpg,https://derpicdn.net/img/view/2013/1/16/214343.jpg,0,0.9405992031097412,26,0,534,496,508,496,spike|twilight sparkle,ss2sonic
214343.jpg,https://derpicdn.net/img/view/2013/1/16/214343.jpg,1,0.9044318199157716,648,0,1050,384,402,384,spike|twilight sparkle,ss2sonic
21441.png,https://derpicdn.net/img/view/2012/6/26/21441.png,0,0.9088847041130066,260,0,704,405,444,405,fluttershy|twilight sparkle,c0nker
2147885.png,https://derpicdn.net/img/view/2019/9/19/2147885.png,0,0.9949369430541992,1315,1513,2197,2395,882,882,rainbow dash|twilight sparkle,shad0w-galaxy
2151839.png,https://derpicdn.net/img/view/2019/9/24/2151839.png,1,0.9209747314453124,0,241,243,505,243,264,applejack|fluttershy|rainbow dash|twilight sparkle,vavacung
2152098.png,https://derpicdn.net/img/view/2019/9/24/2152098.png,0,0.9556668400764464,437,2354,645,2562,208,208,princess cadance|princess celestia|princess flurry heart|princess luna|twilight sparkle,sintakhra
2158134.png,https://derpicdn.net/img/view/2019/10/2/2158134.png,0,0.9245198965072632,1072,406,1304,638,232,232,applejack|fluttershy|mane six|pinkie pie|rainbow dash|rarity|spike|twilight sparkle,
2158188.png,https://derpicdn.net/img/view/2019/10/2/2158188.png,0,0.9371330142021179,493,541,1089,1137,596,596,rainbow dash|twilight sparkle,cinnamonnnnn
2158817.png,https://derpicdn.net/img/view/2019/10/3/2158817.png,0,0.9903988242149352,1419,37,1907,525,488,488,princess cadance|princess celestia|princess flurry heart|princess luna|shining armor|starlight glimmer|sunset shimmer|trixie|twilight sparkle,
2158817.png,https://derpicdn.net/img/view/2019/10/3/2158817.png,2,0.9351200461387634,297,16,573,292,276,276,princess cadance|princess celestia|princess flurry heart|princess luna|shining armor|starlight glimmer|sunset shimmer|trixie|twilight sparkle,
2159596.png,https://derpicdn.net/img/view/2019/10/4/2159596.png,0,0.9442393183708192,379,0,711,292,332,292,discord|fluttershy|princess celestia|twilight sparkle,paradigmpizza
2161123.png,https://derpicdn.net/img/view/2019/10/5/2161123.png,0,0.9992557168006896,1462,989,2076,1603,614,614,applejack|fluttershy|mane six|pinkie pie|rainbow dash|rarity|starlight glimmer|twilight sparkle,mrkat7214
2161123.png,https://derpicdn.net/img/view/2019/10/5/2161123.png,2,0.9758602976799012,2059,967,2693,1601,634,634,applejack|fluttershy|mane six|pinkie pie|rainbow dash|rarity|starlight glimmer|twilight sparkle,mrkat7214
2163977.png,https://derpicdn.net/img/view/2019/10/9/2163977.png,0,0.9799724817276,284,110,842,668,558,558,princess celestia|princess luna|twilight sparkle,
2164777.png,https://derpicdn.net/img/view/2019/10/10/2164777.png,0,0.9534804224967957,693,506,989,802,296,296,apple bloom|applejack|fluttershy|mane six|pinkie pie|rainbow dash|rarity|scootaloo|spike|starlight glimmer|sunset shimmer|sweetie belle|trixie|twilight sparkle,cheezedoodle96|jlryan|dragonchaser123|osipush|jaybugjimmies|kevintan137|tomfraggle
2164778.png,https://derpicdn.net/img/view/2019/10/10/2164778.png,0,0.9853907227516174,1717,1389,2253,1925,536,536,applejack|fluttershy|lightning dust|mane six|pinkie pie|rainbow dash|rarity|spitfire|trixie|twilight sparkle,imafutureguitarhero|aeridiccore
216524.jpg,https://derpicdn.net/img/view/2013/1/18/216524.jpg,0,0.9354722499847412,1665,680,2559,1574,894,894,applejack|fluttershy|rarity|twilight sparkle,superkeen
2166848.png,https://derpicdn.net/img/view/2019/10/13/2166848.png,1,0.9969916939735411,982,655,1360,1033,378,378,applejack|fluttershy|mane six|pinkie pie|princess celestia|rainbow dash|rarity|spike|twilight sparkle,sinrar
2166848.png,https://derpicdn.net/img/view/2019/10/13/2166848.png,2,0.9944350123405457,1245,816,1679,1250,434,434,applejack|fluttershy|mane six|pinkie pie|princess celestia|rainbow dash|rarity|spike|twilight sparkle,sinrar
2166881.png,https://derpicdn.net/img/view/2019/10/13/2166881.png,0,0.9978455305099488,768,0,1228,417,460,417,applejack|fluttershy|mane six|pinkie pie|rainbow dash|rarity|twilight sparkle,zalakir
2167173.png,https://derpicdn.net/img/view/2019/10/13/2167173.png,0,0.9912152886390686,1125,1869,2157,2893,1032,1024,applejack|fluttershy|mane six|pinkie pie|rainbow dash|rarity|twilight sparkle,banquo0
2169538.png,https://derpicdn.net/img/view/2019/10/15/2169538.png,0,0.9719726443290708,377,0,679,243,302,243,pinkie pie|rarity|spike|twilight sparkle,suikuzu
2171582.png,https://derpicdn.net/img/view/2019/10/17/2171582.png,0,0.994223177433014,5518,1229,7040,2751,1522,1522,applejack|fluttershy|mane six|pinkie pie|rainbow dash|rarity|starlight glimmer|sunset shimmer|twilight sparkle,twilytwilytwinkletwily
2171582.png,https://derpicdn.net/img/view/2019/10/17/2171582.png,2,0.9360871911048888,4421,3234,5733,4546,1312,1312,applejack|fluttershy|mane six|pinkie pie|rainbow dash|rarity|starlight glimmer|sunset shimmer|twilight sparkle,twilytwilytwinkletwily
2171886.png,https://derpicdn.net/img/view/2019/10/17/2171886.png,0,0.9446154236793518,266,366,516,616,250,250,applejack|fluttershy|mane six|pinkie pie|rainbow dash|rarity|twilight sparkle,ryuredwings
2173953.png,https://derpicdn.net/img/view/2019/10/19/2173953.png,0,0.9701820611953736,1557,256,2241,940,684,684,applejack|fluttershy|mane six|pinkie pie|rainbow dash|rarity|spike|twilight sparkle,zvn
2173953.png,https://derpicdn.net/img/view/2019/10/19/2173953.png,1,0.9597164392471312,2304,782,2768,1246,464,464,applejack|fluttershy|mane six|pinkie pie|rainbow dash|rarity|spike|twilight sparkle,zvn
2174525.png,https://derpicdn.net/img/view/2019/10/20/2174525.png,0,0.9994102716445924,651,0,1271,618,620,618,applejack|fluttershy|mane six|pinkie pie|rainbow dash|rarity|spike|twilight sparkle,chopchopguy
2174525.png,https://derpicdn.net/img/view/2019/10/20/2174525.png,1,0.9821966290473938,1420,113,1836,529,416,416,applejack|fluttershy|mane six|pinkie pie|rainbow dash|rarity|spike|twilight sparkle,chopchopguy
2174525.png,https://derpicdn.net/img/view/2019/10/20/2174525.png,2,0.900959312915802,75,355,529,809,454,454,applejack|fluttershy|mane six|pinkie pie|rainbow dash|rarity|spike|twilight sparkle,chopchopguy
2174642.png,https://derpicdn.net/img/view/2019/10/20/2174642.png,0,0.9901004433631896,640,358,850,568,210,210,applejack|fluttershy|mane six|pinkie pie|rainbow dash|rarity|spike|twilight sparkle,nupiethehero
2174980.png,https://derpicdn.net/img/view/2019/10/21/2174980.png,0,0.9913259148597716,1530,326,2654,1450,1124,1124,rarity|twilight sparkle,thefloatingtree
2174980.png,https://derpicdn.net/img/view/2019/10/21/2174980.png,1,0.9675729274749756,659,226,1525,1092,866,866,rarity|twilight sparkle,thefloatingtree
2176359.png,https://derpicdn.net/img/view/2019/10/22/2176359.png,0,0.9914707541465759,232,0,636,375,404,375,rarity|twilight sparkle,
2177851.png,https://derpicdn.net/img/view/2019/10/24/2177851.png,0,0.9712191224098206,1651,264,2283,896,632,632,starlight glimmer|trixie|twilight sparkle,amgiwolf
2182246.png,https://derpicdn.net/img/view/2019/10/29/2182246.png,0,0.9819695353507996,832,615,1294,1077,462,462,apple bloom|applejack|big macintosh|cutie mark crusaders|discord|fluttershy|granny smith|mane six|pinkie pie|princess cadance|princess celestia|princess flurry heart|princess luna|queen chrysalis|rainbow dash|rarity|scootaloo|shining armor|spike|starlight glimmer|sweetie belle|trixie|twilight sparkle,estories|sonofaskywalker|emberfiremane|gamemasterluna|luckreza8|uponia|andoanimalia|frownfactory|theorak|dragonchaser123|tardifice|dashiesparkle|jeatz-axl|mixiepie|hendro107|cloudyglow|jhayarr23|missgoldendragon|phucknuckl|koolfrood|drakizora|emeraldblast63|sketchmcreations|parclytaxel|slb94|cyanlightning|cheezedoodle96
2183005.png,https://derpicdn.net/img/view/2019/10/30/2183005.png,0,0.9622626304626464,1592,23,1866,297,274,274,applejack|fluttershy|mane six|pinkie pie|rainbow dash|rarity|twilight sparkle,wanderingpegasus
2183786.png,https://derpicdn.net/img/view/2019/10/31/2183786.png,0,0.9982484579086304,692,0,1882,1123,1190,1123,sunset shimmer|twilight sparkle,artiks
21854.png,https://derpicdn.net/img/view/2012/6/26/21854.png,0,0.948739767074585,0,11,212,239,212,228,spike|twilight sparkle,foervraengd
2187035.png,https://derpicdn.net/img/view/2019/11/4/2187035.png,0,0.9967561960220336,692,475,1458,1241,766,766,applejack|fluttershy|mane six|pinkie pie|rainbow dash|rarity|twilight sparkle,lrusu
2187035.png,https://derpicdn.net/img/view/2019/11/4/2187035.png,2,0.9923333525657654,0,237,797,1041,797,804,applejack|fluttershy|mane six|pinkie pie|rainbow dash|rarity|twilight sparkle,lrusu
2187833.png,https://derpicdn.net/img/view/2019/11/4/2187833.png,0,0.9944563508033752,2346,1057,3156,1867,810,810,applejack|fluttershy|mane six|pinkie pie|rainbow dash|rarity|spike|twilight sparkle,asinglepetal
2187833.png,https://derpicdn.net/img/view/2019/11/4/2187833.png,1,0.9817740917205808,1511,151,2405,1045,894,894,applejack|fluttershy|mane six|pinkie pie|rainbow dash|rarity|spike|twilight sparkle,asinglepetal
2187833.png,https://derpicdn.net/img/view/2019/11/4/2187833.png,2,0.9809437394142152,1429,1041,2193,1805,764,764,applejack|fluttershy|mane six|pinkie pie|rainbow dash|rarity|spike|twilight sparkle,asinglepetal
2187833.png,https://derpicdn.net/img/view/2019/11/4/2187833.png,3,0.9560849666595459,0,960,693,1664,693,704,applejack|fluttershy|mane six|pinkie pie|rainbow dash|rarity|spike|twilight sparkle,asinglepetal
2187833.png,https://derpicdn.net/img/view/2019/11/4/2187833.png,4,0.9524776935577391,613,584,1331,1302,718,718,applejack|fluttershy|mane six|pinkie pie|rainbow dash|rarity|spike|twilight sparkle,asinglepetal
2190688.png,https://derpicdn.net/img/view/2019/11/8/2190688.png,0,0.9988669157028198,2196,189,3100,1103,904,914,applejack|fluttershy|mane six|pinkie pie|rainbow dash|rarity|starlight glimmer|sunset shimmer|twilight sparkle,avrameow
2190688.png,https://derpicdn.net/img/view/2019/11/8/2190688.png,1,0.9941364526748656,1542,0,2220,572,678,572,applejack|fluttershy|mane six|pinkie pie|rainbow dash|rarity|starlight glimmer|sunset shimmer|twilight sparkle,avrameow
2190688.png,https://derpicdn.net/img/view/2019/11/8/2190688.png,3,0.9771535992622375,2161,1221,2991,2051,830,830,applejack|fluttershy|mane six|pinkie pie|rainbow dash|rarity|starlight glimmer|sunset shimmer|twilight sparkle,avrameow
2190688.png,https://derpicdn.net/img/view/2019/11/8/2190688.png,4,0.952419638633728,83,1068,1045,2030,962,962,applejack|fluttershy|mane six|pinkie pie|rainbow dash|rarity|starlight glimmer|sunset shimmer|twilight sparkle,avrameow
2195985.png,https://derpicdn.net/img/view/2019/11/14/2195985.png,2,0.9719738364219666,149,911,705,1467,556,556,applejack|fluttershy|mane six|pinkie pie|rainbow dash|rarity|twilight sparkle,silbersternenlicht
2203805.png,https://derpicdn.net/img/view/2019/11/23/2203805.png,0,0.9918044805526732,299,0,843,496,544,496,starlight glimmer|trixie|twilight sparkle,princeoracle
2203805.png,https://derpicdn.net/img/view/2019/11/23/2203805.png,1,0.9160712361335754,4,58,336,390,332,332,starlight glimmer|trixie|twilight sparkle,princeoracle
2205012.png,https://derpicdn.net/img/view/2019/11/25/2205012.png,0,0.9629639387130736,171,27,1233,1089,1062,1062,starlight glimmer|trixie|twilight sparkle,moonatik
2207024.png,https://derpicdn.net/img/view/2019/11/27/2207024.png,0,0.9538898468017578,264,26,499,274,235,248,trixie|twilight sparkle,joey darkmeat
2211187.png,https://derpicdn.net/img/view/2019/12/2/2211187.png,0,0.9935656785964966,1,75,787,861,786,786,rainbow dash|twilight sparkle,stuwor-art
2211462.png,https://derpicdn.net/img/view/2019/12/3/2211462.png,0,0.9128318428993224,1072,153,1914,995,842,842,starlight glimmer|sunset shimmer|twilight sparkle,neongothic
2219052.png,https://derpicdn.net/img/view/2019/12/12/2219052.png,0,0.9972299933433532,31,12,433,414,402,402,pinkie pie|twilight sparkle,groggyman
2219052.png,https://derpicdn.net/img/view/2019/12/12/2219052.png,1,0.9678295254707336,717,161,1113,557,396,396,pinkie pie|twilight sparkle,groggyman
22198.png,https://derpicdn.net/img/view/2012/6/26/22198.png,0,0.997475564479828,440,65,914,539,474,474,princess luna|twilight sparkle,vest
2222634.png,https://derpicdn.net/img/view/2019/12/17/2222634.png,0,0.9857178926467896,1076,4,2102,1030,1026,1026,rainbow dash|twilight sparkle,koloredkat
2222774.png,https://derpicdn.net/img/view/2019/12/17/2222774.png,0,0.9669203162193298,3325,97,5729,2501,2404,2404,starlight glimmer|twilight sparkle,illumnious
2222809.jpg,https://derpicdn.net/img/view/2019/12/17/2222809.jpg,0,0.9877142906188964,121,344,391,614,270,270,pinkie pie|rainbow dash|twilight sparkle,dirtyker
2222809.jpg,https://derpicdn.net/img/view/2019/12/17/2222809.jpg,1,0.9660442471504213,325,557,697,929,372,372,pinkie pie|rainbow dash|twilight sparkle,dirtyker
2223266.png,https://derpicdn.net/img/view/2019/12/17/2223266.png,0,0.9701830148696899,1013,75,1697,759,684,684,rainbow dash|twilight sparkle,koloredkat
2223269.png,https://derpicdn.net/img/view/2019/12/17/2223269.png,0,0.972820520401001,429,114,847,532,418,418,rainbow dash|twilight sparkle,koloredkat
2224207.jpg,https://derpicdn.net/img/view/2019/12/19/2224207.jpg,1,0.9972063899040222,1474,839,1862,1227,388,388,applejack|fluttershy|mane six|pinkie pie|rainbow dash|rarity|twilight sparkle,miokomata
2224207.jpg,https://derpicdn.net/img/view/2019/12/19/2224207.jpg,2,0.9690439105033876,756,860,1160,1264,404,404,applejack|fluttershy|mane six|pinkie pie|rainbow dash|rarity|twilight sparkle,miokomata
2224512.png,https://derpicdn.net/img/view/2019/12/19/2224512.png,0,0.9867815971374512,168,369,1538,1739,1370,1370,princess cadance|twilight sparkle,apexpredator923
2224512.png,https://derpicdn.net/img/view/2019/12/19/2224512.png,1,0.9422299861907959,2819,224,3743,1148,924,924,princess cadance|twilight sparkle,apexpredator923
2225670.jpg,https://derpicdn.net/img/view/2019/12/21/2225670.jpg,0,0.9973918199539183,957,67,1280,435,323,368,princess celestia|twilight sparkle,platinumfeather2002
2225670.jpg,https://derpicdn.net/img/view/2019/12/21/2225670.jpg,1,0.9815866351127625,0,13,283,305,283,292,princess celestia|twilight sparkle,platinumfeather2002
2225670.jpg,https://derpicdn.net/img/view/2019/12/21/2225670.jpg,2,0.9712760448455808,0,456,367,832,367,376,princess celestia|twilight sparkle,platinumfeather2002
2227584.png,https://derpicdn.net/img/view/2019/12/23/2227584.png,0,0.9927541017532348,89,0,449,281,360,281,apple bloom|applejack|cutie mark crusaders|fluttershy|mane six|pinkie pie|rainbow dash|rarity|scootaloo|sweetie belle|twilight sparkle,twily-star
2227584.png,https://derpicdn.net/img/view/2019/12/23/2227584.png,1,0.986471712589264,69,257,361,549,292,292,apple bloom|applejack|cutie mark crusaders|fluttershy|mane six|pinkie pie|rainbow dash|rarity|scootaloo|sweetie belle|twilight sparkle,twily-star
2227584.png,https://derpicdn.net/img/view/2019/12/23/2227584.png,2,0.9772368669509888,649,258,943,552,294,294,apple bloom|applejack|cutie mark crusaders|fluttershy|mane six|pinkie pie|rainbow dash|rarity|scootaloo|sweetie belle|twilight sparkle,twily-star
2227584.png,https://derpicdn.net/img/view/2019/12/23/2227584.png,3,0.9118534326553344,587,0,807,210,220,210,apple bloom|applejack|cutie mark crusaders|fluttershy|mane six|pinkie pie|rainbow dash|rarity|scootaloo|sweetie belle|twilight sparkle,twily-star
2228115.jpg,https://derpicdn.net/img/view/2019/12/23/2228115.jpg,0,0.9628578424453736,1089,358,1727,996,638,638,trixie|twilight sparkle,appleneedle
2229613.jpg,https://derpicdn.net/img/view/2019/12/25/2229613.jpg,0,0.9911131858825684,0,104,937,1226,937,1122,applejack|fluttershy|mane six|pinkie pie|rainbow dash|rarity|twilight sparkle,liaaqila
2229613.jpg,https://derpicdn.net/img/view/2019/12/25/2229613.jpg,1,0.9908390045166016,1337,0,2322,914,985,914,applejack|fluttershy|mane six|pinkie pie|rainbow dash|rarity|twilight sparkle,liaaqila
2232008.jpg,https://derpicdn.net/img/view/2019/12/28/2232008.jpg,0,0.9984678626060486,0,175,344,581,344,406,applejack|fluttershy|mane six|pinkie pie|rainbow dash|rarity|twilight sparkle,smallhorses
2233612.png,https://derpicdn.net/img/view/2019/12/30/2233612.png,0,0.9597806334495544,0,441,617,1067,617,626,applejack|princess cadance|twilight sparkle,kittywoofers
2238266.png,https://derpicdn.net/img/view/2020/1/4/2238266.png,0,0.9927031993865968,1441,74,1853,486,412,412,applejack|fluttershy|mane six|pinkie pie|rainbow dash|rarity|twilight sparkle,loladotz
2238266.png,https://derpicdn.net/img/view/2020/1/4/2238266.png,1,0.9868534207344056,33,355,623,945,590,590,applejack|fluttershy|mane six|pinkie pie|rainbow dash|rarity|twilight sparkle,loladotz
2238332.jpg,https://derpicdn.net/img/view/2020/1/4/2238332.jpg,0,0.9157942533493042,225,0,985,717,760,717,starlight glimmer|twilight sparkle,creativecocoacookie
2242211.png,https://derpicdn.net/img/view/2020/1/8/2242211.png,0,0.999174416065216,372,797,806,1231,434,434,applejack|fluttershy|mane six|pinkie pie|rainbow dash|rarity|twilight sparkle,redquoz
2242211.png,https://derpicdn.net/img/view/2020/1/8/2242211.png,1,0.9984975457191468,1036,265,1458,687,422,422,applejack|fluttershy|mane six|pinkie pie|rainbow dash|rarity|twilight sparkle,redquoz
2242211.png,https://derpicdn.net/img/view/2020/1/8/2242211.png,2,0.9922601580619812,785,682,1171,1068,386,386,applejack|fluttershy|mane six|pinkie pie|rainbow dash|rarity|twilight sparkle,redquoz
2242211.png,https://derpicdn.net/img/view/2020/1/8/2242211.png,3,0.988662838935852,745,1158,1125,1538,380,380,applejack|fluttershy|mane six|pinkie pie|rainbow dash|rarity|twilight sparkle,redquoz
2242211.png,https://derpicdn.net/img/view/2020/1/8/2242211.png,4,0.952073335647583,454,349,860,755,406,406,applejack|fluttershy|mane six|pinkie pie|rainbow dash|rarity|twilight sparkle,redquoz
2242531.png,https://derpicdn.net/img/view/2020/1/9/2242531.png,0,0.9907504320144652,84,273,438,627,354,354,pinkie pie|twilight sparkle,bokkitoki
2242531.png,https://derpicdn.net/img/view/2020/1/9/2242531.png,1,0.9536941051483154,506,317,766,577,260,260,pinkie pie|twilight sparkle,bokkitoki
2244888.jpg,https://derpicdn.net/img/view/2020/1/11/2244888.jpg,0,0.9744752645492554,48,66,922,940,874,874,spike|twilight sparkle,sunshineshiny
2245967.png,https://derpicdn.net/img/view/2020/1/13/2245967.png,1,0.9270027279853821,16,871,340,1195,324,324,princess celestia|twilight sparkle,jargon scott
2248489.jpg,https://derpicdn.net/img/view/2020/1/15/2248489.jpg,0,0.9670798182487488,11,0,491,414,480,414,applejack|fluttershy|mane six|pinkie pie|rainbow dash|rarity|twilight sparkle,hino
2255711.jpg,https://derpicdn.net/img/view/2020/1/24/2255711.jpg,0,0.9918251037597656,251,211,587,547,336,336,apple bloom|applejack|cutie mark crusaders|fluttershy|mane six|pinkie pie|princess celestia|princess luna|rainbow dash|rarity|scootaloo|spike|sweetie belle|twilight sparkle,andypriceart
2256310.jpg,https://derpicdn.net/img/view/2020/1/25/2256310.jpg,0,0.90635883808136,185,0,983,693,798,693,applejack|fluttershy|mane six|pinkie pie|rainbow dash|rarity|twilight sparkle,leafywind
2262990.jpg,https://derpicdn.net/img/view/2020/2/1/2262990.jpg,0,0.9728918671607972,739,269,1113,643,374,374,applejack|fluttershy|mane six|pinkie pie|rainbow dash|rarity|twilight sparkle,hakkerman
2262990.jpg,https://derpicdn.net/img/view/2020/2/1/2262990.jpg,1,0.972681999206543,273,619,629,975,356,356,applejack|fluttershy|mane six|pinkie pie|rainbow dash|rarity|twilight sparkle,hakkerman
2264570.jpg,https://derpicdn.net/img/view/2020/2/3/2264570.jpg,0,0.9528183341026306,319,23,1269,973,950,950,princess celestia|twilight sparkle,tenebrousmelancholy
2267019.jpg,https://derpicdn.net/img/view/2020/2/6/2267019.jpg,0,0.9987648129463196,534,1057,814,1337,280,280,applejack|fluttershy|mane six|pinkie pie|rainbow dash|rarity|twilight sparkle,tonyfleecs
2267211.jpg,https://derpicdn.net/img/view/2020/2/6/2267211.jpg,0,0.9893837571144104,1736,0,2428,684,692,684,applejack|pinkie pie|rainbow dash|rarity|starlight glimmer|twilight sparkle,citi
2267364.png,https://derpicdn.net/img/view/2020/2/6/2267364.png,1,0.9806725978851318,531,464,937,870,406,406,applejack|fluttershy|mane six|pinkie pie|rainbow dash|rarity|twilight sparkle,uunicornicc
2267364.png,https://derpicdn.net/img/view/2020/2/6/2267364.png,2,0.9749100804328918,824,54,1410,640,586,586,applejack|fluttershy|mane six|pinkie pie|rainbow dash|rarity|twilight sparkle,uunicornicc
2267364.png,https://derpicdn.net/img/view/2020/2/6/2267364.png,3,0.9315032958984376,141,455,687,1001,546,546,applejack|fluttershy|mane six|pinkie pie|rainbow dash|rarity|twilight sparkle,uunicornicc
2267567.png,https://derpicdn.net/img/view/2020/2/7/2267567.png,0,0.992929995059967,449,0,1800,1463,1351,1463,fluttershy|twilight sparkle,docwario
2270414.png,https://derpicdn.net/img/view/2020/2/10/2270414.png,1,0.9000868201255798,2159,0,3203,914,1044,914,sunset shimmer|twilight sparkle,alicorntwilysparkle
2270728.png,https://derpicdn.net/img/view/2020/2/10/2270728.png,0,0.977814555168152,79,15,833,769,754,754,applejack|fluttershy|mane six|pinkie pie|rainbow dash|rarity|twilight sparkle,lrusu
2271599.png,https://derpicdn.net/img/view/2020/2/11/2271599.png,0,0.9978660345077516,404,16,610,222,206,206,applejack|fluttershy|mane six|pinkie pie|rainbow dash|rarity|twilight sparkle,mottiri-sakusaku
2271599.png,https://derpicdn.net/img/view/2020/2/11/2271599.png,1,0.9963422417640686,55,293,283,521,228,228,applejack|fluttershy|mane six|pinkie pie|rainbow dash|rarity|twilight sparkle,mottiri-sakusaku
2271951.jpg,https://derpicdn.net/img/view/2020/2/12/2271951.jpg,0,0.9596126675605774,1669,434,1907,672,238,238,starlight glimmer|twilight sparkle,yuyusunshine
2278096.jpg,https://derpicdn.net/img/view/2020/2/19/2278096.jpg,0,0.998307466506958,2108,1389,3076,2357,968,968,applejack|fluttershy|mane six|pinkie pie|rainbow dash|rarity|twilight sparkle,lilmeeseart
228357.jpg,https://derpicdn.net/img/view/2013/1/30/228357.jpg,0,0.9542175531387328,309,0,811,487,502,487,discord|fluttershy|twilight sparkle,
22913.jpg,https://derpicdn.net/img/view/2012/6/27/22913.jpg,1,0.9710693359375,701,78,907,284,206,206,applejack|fluttershy|mane six|pinkie pie|rainbow dash|rarity|twilight sparkle,mysticalpha
2291382.png,https://derpicdn.net/img/view/2020/3/6/2291382.png,0,0.9924041032791138,1473,470,2805,1802,1332,1332,queen chrysalis|twilight sparkle,groomlake
229651.jpg,https://derpicdn.net/img/view/2013/1/31/229651.jpg,0,0.974127233028412,19,212,285,478,266,266,rarity|twilight sparkle,remenbrand
229651.jpg,https://derpicdn.net/img/view/2013/1/31/229651.jpg,1,0.9569865465164183,409,11,630,233,221,222,rarity|twilight sparkle,remenbrand
2300030.png,https://derpicdn.net/img/view/2020/3/18/2300030.png,0,0.9466428756713868,391,38,949,596,558,558,applejack|fluttershy|mane six|pinkie pie|rainbow dash|rarity|twilight sparkle,rainbow eevee
2300030.png,https://derpicdn.net/img/view/2020/3/18/2300030.png,1,0.9202471375465392,1359,76,1783,500,424,424,applejack|fluttershy|mane six|pinkie pie|rainbow dash|rarity|twilight sparkle,rainbow eevee
2303595.jpg,https://derpicdn.net/img/view/2020/3/22/2303595.jpg,0,0.9979436993598938,827,0,1625,726,798,726,rarity|twilight sparkle,iimd|imd
2305282.png,https://derpicdn.net/img/view/2020/3/25/2305282.png,0,0.9908521771430968,1037,0,1775,674,738,674,applejack|fluttershy|mane six|pinkie pie|rainbow dash|rarity|spike|twilight sparkle,aleximusprime
2305282.png,https://derpicdn.net/img/view/2020/3/25/2305282.png,1,0.9855214953422546,2167,1108,2725,1666,558,558,applejack|fluttershy|mane six|pinkie pie|rainbow dash|rarity|spike|twilight sparkle,aleximusprime
2305282.png,https://derpicdn.net/img/view/2020/3/25/2305282.png,2,0.9825825691223145,1622,0,2506,844,884,844,applejack|fluttershy|mane six|pinkie pie|rainbow dash|rarity|spike|twilight sparkle,aleximusprime
2308000.png,https://derpicdn.net/img/view/2020/3/28/2308000.png,0,0.990635871887207,47,0,363,313,316,313,starlight glimmer|twilight sparkle,clairedaartiste444
2308000.png,https://derpicdn.net/img/view/2020/3/28/2308000.png,1,0.9584240317344666,502,144,856,498,354,354,starlight glimmer|twilight sparkle,clairedaartiste444
2308168.png,https://derpicdn.net/img/view/2020/3/28/2308168.png,0,0.9892985224723816,245,0,2035,1477,1790,1477,princess luna|twilight sparkle,fensu-san
2314998.jpg,https://derpicdn.net/img/view/2020/4/5/2314998.jpg,0,0.9992984533309937,827,30,1351,554,524,524,sunset shimmer|twilight sparkle,julunis14
2314998.jpg,https://derpicdn.net/img/view/2020/4/5/2314998.jpg,1,0.9684725999832152,344,0,906,509,562,509,sunset shimmer|twilight sparkle,julunis14
2321122.png,https://derpicdn.net/img/view/2020/4/13/2321122.png,1,0.9503076076507568,564,471,872,779,308,308,spike|twilight sparkle,poowndraww
2328058.jpg,https://derpicdn.net/img/view/2020/4/21/2328058.jpg,0,0.9969868063926696,23,0,717,570,694,570,applejack|fluttershy|mane six|pinkie pie|rainbow dash|rarity|twilight sparkle,pearl123_art
2328058.jpg,https://derpicdn.net/img/view/2020/4/21/2328058.jpg,3,0.9803498387336732,1312,669,2036,1393,724,724,applejack|fluttershy|mane six|pinkie pie|rainbow dash|rarity|twilight sparkle,pearl123_art
2330866.jpg,https://derpicdn.net/img/view/2020/4/24/2330866.jpg,0,0.9950269460678101,329,118,1059,848,730,730,rarity|twilight sparkle,citi
2330866.jpg,https://derpicdn.net/img/view/2020/4/24/2330866.jpg,1,0.993058145046234,1378,1136,2222,1980,844,844,rarity|twilight sparkle,citi
2335117.jpg,https://derpicdn.net/img/view/2020/4/29/2335117.jpg,0,0.9168018102645874,0,604,260,878,260,274,princess cadance|shining armor|twilight sparkle,kushina13
2337544.png,https://derpicdn.net/img/view/2020/5/2/2337544.png,0,0.9628108739852904,171,83,893,805,722,722,shining armor|twilight sparkle,provolonepone
2338195.jpg,https://derpicdn.net/img/view/2020/5/3/2338195.jpg,0,0.9990816116333008,367,346,651,630,284,284,starlight glimmer|twilight sparkle,leafywind
2338922.png,https://derpicdn.net/img/view/2020/5/4/2338922.png,0,0.998855471611023,836,646,1472,1282,636,636,starlight glimmer|twilight sparkle,crade
2338922.png,https://derpicdn.net/img/view/2020/5/4/2338922.png,1,0.9598971009254456,1216,780,1802,1366,586,586,starlight glimmer|twilight sparkle,crade
2339080.jpg,https://derpicdn.net/img/view/2020/5/4/2339080.jpg,0,0.9992176294326782,267,123,417,273,150,150,princess cadance|princess celestia|princess luna|twilight sparkle,wynnchi
2339080.jpg,https://derpicdn.net/img/view/2020/5/4/2339080.jpg,1,0.9542078971862792,381,60,563,242,182,182,princess cadance|princess celestia|princess luna|twilight sparkle,wynnchi
2340728.png,https://derpicdn.net/img/view/2020/5/6/2340728.png,0,0.9954057931900024,236,69,440,273,204,204,fluttershy|rainbow dash|starlight glimmer|trixie|twilight sparkle,esmeia
2343021.jpg,https://derpicdn.net/img/view/2020/5/8/2343021.jpg,0,0.9594734907150269,637,272,923,558,286,286,princess flurry heart|twilight sparkle,millieduboisart
2343783.jpg,https://derpicdn.net/img/view/2020/5/9/2343783.jpg,0,0.961518168449402,476,509,922,955,446,446,discord|twilight sparkle,riukime
2345058.png,https://derpicdn.net/img/view/2020/5/10/2345058.png,0,0.9959176778793336,41,0,825,746,784,746,rainbow dash|twilight sparkle,
2345086.png,https://derpicdn.net/img/view/2020/5/10/2345086.png,0,0.9958023428916932,44,0,822,743,778,743,rainbow dash|twilight sparkle,
2345779.jpg,https://derpicdn.net/img/view/2020/5/11/2345779.jpg,0,0.9782740473747252,964,75,1412,523,448,448,rainbow dash|twilight sparkle,dumddeer
2346686.png,https://derpicdn.net/img/view/2020/5/12/2346686.png,1,0.9450352191925048,975,226,1245,496,270,270,applejack|fluttershy|mane six|pinkie pie|rainbow dash|rarity|spike|starlight glimmer|sunset shimmer|trixie|twilight sparkle,emeraldblast63
2348005.png,https://derpicdn.net/img/view/2020/5/14/2348005.png,0,0.9505560994148254,300,19,592,311,292,292,spike|twilight sparkle,tsukisayu
2349005.png,https://derpicdn.net/img/view/2020/5/15/2349005.png,0,0.9751894474029541,2090,1853,2652,2415,562,562,applejack|fluttershy|pinkie pie|rainbow dash|rarity|sunset shimmer|twilight sparkle,polymercorgi|teepew|elementbases|nocturnal-moonlight|bunnari
2349051.png,https://derpicdn.net/img/view/2020/5/15/2349051.png,0,0.9997627139091492,494,521,942,969,448,448,applejack|fluttershy|mane six|pinkie pie|rainbow dash|rarity|spike|twilight sparkle,therainbowtroll
2349051.png,https://derpicdn.net/img/view/2020/5/15/2349051.png,1,0.9992280006408693,0,527,428,961,428,434,applejack|fluttershy|mane six|pinkie pie|rainbow dash|rarity|spike|twilight sparkle,therainbowtroll
2349051.png,https://derpicdn.net/img/view/2020/5/15/2349051.png,2,0.9990236163139344,294,0,860,505,566,505,applejack|fluttershy|mane six|pinkie pie|rainbow dash|rarity|spike|twilight sparkle,therainbowtroll
2349275.png,https://derpicdn.net/img/view/2020/5/15/2349275.png,0,0.9759878516197203,546,282,1306,1042,760,760,fluttershy|twilight sparkle,murmurrrart
2351151.png,https://derpicdn.net/img/view/2020/5/17/2351151.png,0,0.9943073391914368,481,0,1731,1243,1250,1243,apple bloom|twilight sparkle,dilarus
2351430.jpg,https://derpicdn.net/img/view/2020/5/17/2351430.jpg,0,0.998598039150238,617,130,1119,632,502,502,rarity|twilight sparkle,fwipfwop
2352568.png,https://derpicdn.net/img/view/2020/5/19/2352568.png,0,0.9580649137496948,373,1352,567,1546,194,194,discord|fluttershy|princess celestia|queen chrysalis|twilight sparkle,inuhoshi-to-darkpen
2352568.png,https://derpicdn.net/img/view/2020/5/19/2352568.png,1,0.9298328757286072,38,747,288,997,250,250,discord|fluttershy|princess celestia|queen chrysalis|twilight sparkle,inuhoshi-to-darkpen
2355648.png,https://derpicdn.net/img/view/2020/5/23/2355648.png,0,0.995697557926178,627,82,1443,898,816,816,fluttershy|rarity|twilight sparkle,lilliesinthegarden
2355648.png,https://derpicdn.net/img/view/2020/5/23/2355648.png,2,0.9904704689979552,1380,230,2232,1082,852,852,fluttershy|rarity|twilight sparkle,lilliesinthegarden
2356196.jpg,https://derpicdn.net/img/view/2020/5/23/2356196.jpg,0,0.9843076467514038,0,41,1254,1323,1254,1282,rarity|twilight sparkle,bloodatius
2356273.jpg,https://derpicdn.net/img/view/2020/5/23/2356273.jpg,1,0.998519241809845,0,32,614,656,614,624,applejack|fluttershy|mane six|pinkie pie|rainbow dash|rarity|twilight sparkle,ikuyimii|riukime
2356273.jpg,https://derpicdn.net/img/view/2020/5/23/2356273.jpg,2,0.9980493187904358,704,937,1246,1479,542,542,applejack|fluttershy|mane six|pinkie pie|rainbow dash|rarity|twilight sparkle,ikuyimii|riukime
2356273.jpg,https://derpicdn.net/img/view/2020/5/23/2356273.jpg,4,0.985135555267334,1310,1082,1796,1568,486,486,applejack|fluttershy|mane six|pinkie pie|rainbow dash|rarity|twilight sparkle,ikuyimii|riukime
2356460.png,https://derpicdn.net/img/view/2020/5/24/2356460.png,0,0.998417854309082,1036,0,1600,534,564,534,applejack|fluttershy|mane six|pinkie pie|rainbow dash|rarity|twilight sparkle,thegamblehorse
2356460.png,https://derpicdn.net/img/view/2020/5/24/2356460.png,1,0.9959799647331238,0,628,597,1248,597,620,applejack|fluttershy|mane six|pinkie pie|rainbow dash|rarity|twilight sparkle,thegamblehorse
2356460.png,https://derpicdn.net/img/view/2020/5/24/2356460.png,2,0.9921767115592957,1097,681,1591,1175,494,494,applejack|fluttershy|mane six|pinkie pie|rainbow dash|rarity|twilight sparkle,thegamblehorse
2356460.png,https://derpicdn.net/img/view/2020/5/24/2356460.png,3,0.9919692873954772,496,0,1074,511,578,511,applejack|fluttershy|mane six|pinkie pie|rainbow dash|rarity|twilight sparkle,thegamblehorse
2356460.png,https://derpicdn.net/img/view/2020/5/24/2356460.png,4,0.9847748279571532,519,582,1119,1182,600,600,applejack|fluttershy|mane six|pinkie pie|rainbow dash|rarity|twilight sparkle,thegamblehorse
2356460.png,https://derpicdn.net/img/view/2020/5/24/2356460.png,5,0.9383586645126344,78,0,578,484,500,484,applejack|fluttershy|mane six|pinkie pie|rainbow dash|rarity|twilight sparkle,thegamblehorse
241905.png,https://derpicdn.net/img/view/2013/2/13/241905.png,0,0.9853105545043944,264,352,446,534,182,182,applejack|fluttershy|mane six|pinkie pie|rainbow dash|rarity|twilight sparkle,pekou
243129.png,https://derpicdn.net/img/view/2013/2/14/243129.png,0,0.9995612502098083,41,155,245,359,204,204,pinkie pie|rainbow dash|twilight sparkle,que
243129.png,https://derpicdn.net/img/view/2013/2/14/243129.png,2,0.9379802942276,531,176,745,390,214,214,pinkie pie|rainbow dash|twilight sparkle,que
24479.png,https://derpicdn.net/img/view/2012/6/28/24479.png,1,0.967901647090912,525,31,693,199,168,168,pinkie pie|twilight sparkle,karzahnii
249094.png,https://derpicdn.net/img/view/2013/2/19/249094.png,1,0.983980357646942,0,120,570,852,570,732,applejack|big macintosh|fluttershy|mane six|pinkie pie|princess cadance|rainbow dash|rarity|shining armor|soarin'|spike|twilight sparkle,falleninthedark
249094.png,https://derpicdn.net/img/view/2013/2/19/249094.png,2,0.9775705337524414,2794,221,3579,1043,785,822,applejack|big macintosh|fluttershy|mane six|pinkie pie|princess cadance|rainbow dash|rarity|shining armor|soarin'|spike|twilight sparkle,falleninthedark
249094.png,https://derpicdn.net/img/view/2013/2/19/249094.png,4,0.9533258080482484,2615,784,3489,1658,874,874,applejack|big macintosh|fluttershy|mane six|pinkie pie|princess cadance|rainbow dash|rarity|shining armor|soarin'|spike|twilight sparkle,falleninthedark
249094.png,https://derpicdn.net/img/view/2013/2/19/249094.png,5,0.9260056018829346,2286,263,3198,1175,912,912,applejack|big macintosh|fluttershy|mane six|pinkie pie|princess cadance|rainbow dash|rarity|shining armor|soarin'|spike|twilight sparkle,falleninthedark
2499.jpg,https://derpicdn.net/img/view/2012/1/28/2499.jpg,0,0.9987910985946656,127,85,475,433,348,348,spike|twilight sparkle,soukitsubasa
26048.jpg,https://derpicdn.net/img/view/2012/6/30/26048.jpg,0,0.9927214980125428,265,340,557,632,292,292,princess cadance|twilight sparkle,spyrothefox
263325.png,https://derpicdn.net/img/view/2013/3/5/263325.png,2,0.971543550491333,44,0,764,599,720,599,fluttershy|rainbow dash|scootaloo|twilight sparkle,alasou
266239.png,https://derpicdn.net/img/view/2013/3/9/266239.png,0,0.9958799481391908,485,187,753,455,268,268,rarity|twilight sparkle,ponygoggles
266239.png,https://derpicdn.net/img/view/2013/3/9/266239.png,1,0.9947987198829652,171,257,455,541,284,284,rarity|twilight sparkle,ponygoggles
2691.png,https://derpicdn.net/img/view/2012/1/29/2691.png,0,0.98487788438797,1905,941,2293,1399,388,458,applejack|fluttershy|princess celestia|rainbow dash|twilight sparkle,reikomuffin
270706.png,https://derpicdn.net/img/view/2013/3/14/270706.png,0,0.9973635673522948,416,390,982,956,566,566,princess celestia|princess luna|twilight sparkle,funnyfany
278224.png,https://derpicdn.net/img/view/2013/3/24/278224.png,0,0.9909865856170654,256,0,1034,721,778,721,princess celestia|twilight sparkle,pastelflakes
281087.png,https://derpicdn.net/img/view/2013/3/27/281087.png,0,0.9986808896064758,679,84,1033,438,354,354,rainbow dash|twilight sparkle,slavedemorto
281087.png,https://derpicdn.net/img/view/2013/3/27/281087.png,1,0.9199201464653016,274,142,640,508,366,366,rainbow dash|twilight sparkle,slavedemorto
283295.png,https://derpicdn.net/img/view/2013/3/30/283295.png,0,0.937142550945282,6,0,586,547,580,547,pinkie pie|twilight sparkle,pokehidden
284224.png,https://derpicdn.net/img/view/2013/3/31/284224.png,0,0.9329347610473632,755,1484,1279,2102,524,618,fluttershy|pinkie pie|rainbow dash|rarity|twilight sparkle,terry
284299.jpg,https://derpicdn.net/img/view/2013/3/31/284299.jpg,1,0.9959781765937804,1069,0,1411,317,342,317,fluttershy|mane six|pinkie pie|rainbow dash|rarity|twilight sparkle,syotarobo
284299.jpg,https://derpicdn.net/img/view/2013/3/31/284299.jpg,3,0.9850220084190368,221,457,531,767,310,310,fluttershy|mane six|pinkie pie|rainbow dash|rarity|twilight sparkle,syotarobo
284299.jpg,https://derpicdn.net/img/view/2013/3/31/284299.jpg,4,0.9687466621398926,529,39,887,397,358,358,fluttershy|mane six|pinkie pie|rainbow dash|rarity|twilight sparkle,syotarobo
285371.png,https://derpicdn.net/img/view/2013/4/1/285371.png,2,0.9301047325134276,1088,230,1422,564,334,334,princess cadance|shining armor|spike|twilight sparkle,90sigma
2863.png,https://derpicdn.net/img/view/2012/2/2/2863.png,0,0.9683095812797546,504,195,898,589,394,394,applejack|fluttershy|mane six|pinkie pie|rainbow dash|rarity|twilight sparkle,karzahnii
2863.png,https://derpicdn.net/img/view/2012/2/2/2863.png,1,0.9600554704666138,1966,484,2370,888,404,404,applejack|fluttershy|mane six|pinkie pie|rainbow dash|rarity|twilight sparkle,karzahnii
2869.png,https://derpicdn.net/img/view/2012/2/2/2869.png,0,0.9481177926063538,493,0,1061,556,568,556,rainbow dash|twilight sparkle,karzahnii
292317.jpg,https://derpicdn.net/img/view/2013/4/9/292317.jpg,0,0.9322356581687928,201,0,683,499,482,499,applejack|fluttershy|mane six|pinkie pie|rainbow dash|rarity|twilight sparkle,amnk
295297.jpg,https://derpicdn.net/img/view/2013/4/12/295297.jpg,0,0.9991446137428284,61,154,541,634,480,480,applejack|fluttershy|mane six|pinkie pie|rainbow dash|rarity|twilight sparkle,mr.v
295297.jpg,https://derpicdn.net/img/view/2013/4/12/295297.jpg,1,0.9938859939575196,1268,67,1782,581,514,514,applejack|fluttershy|mane six|pinkie pie|rainbow dash|rarity|twilight sparkle,mr.v
295297.jpg,https://derpicdn.net/img/view/2013/4/12/295297.jpg,2,0.9599325656890868,2040,1758,2460,2178,420,420,applejack|fluttershy|mane six|pinkie pie|rainbow dash|rarity|twilight sparkle,mr.v
304536.png,https://derpicdn.net/img/view/2013/4/21/304536.png,0,0.9292979836463928,360,42,732,414,372,372,big macintosh|twilight sparkle,gaarasbabe2000
305803.png,https://derpicdn.net/img/view/2013/4/23/305803.png,1,0.9798463582992554,516,318,1492,1294,976,976,spike|twilight sparkle,amelie-ami-chan
309861.jpg,https://derpicdn.net/img/view/2013/4/27/309861.jpg,0,0.9003234505653381,668,21,886,239,218,218,fluttershy|rainbow dash|twilight sparkle,rigi
311192.png,https://derpicdn.net/img/view/2013/4/29/311192.png,1,0.9143695831298828,1785,176,2167,558,382,382,applejack|fluttershy|mane six|pinkie pie|rainbow dash|rarity|spike|twilight sparkle,bswprecious
311354.png,https://derpicdn.net/img/view/2013/4/29/311354.png,0,0.9970398545265198,385,343,897,855,512,512,trixie|twilight sparkle,theparagon|shawnyall
311354.png,https://derpicdn.net/img/view/2013/4/29/311354.png,1,0.9679889678955078,1171,362,1655,846,484,484,trixie|twilight sparkle,theparagon|shawnyall
313768.png,https://derpicdn.net/img/view/2013/5/1/313768.png,0,0.9879532456398008,997,678,1689,1370,692,692,applejack|fluttershy|mane six|pinkie pie|rainbow dash|rarity|spike|twilight sparkle,jowybean
313768.png,https://derpicdn.net/img/view/2013/5/1/313768.png,1,0.9652784466743468,346,966,860,1480,514,514,applejack|fluttershy|mane six|pinkie pie|rainbow dash|rarity|spike|twilight sparkle,jowybean
31704.jpg,https://derpicdn.net/img/view/2012/7/4/31704.jpg,0,0.9926829338073728,1484,1321,2102,1939,618,618,applejack|fluttershy|mane six|pinkie pie|princess celestia|princess luna|rainbow dash|rarity|spike|twilight sparkle,chibi-jen-hen
31704.jpg,https://derpicdn.net/img/view/2012/7/4/31704.jpg,1,0.9773303866386414,1084,576,1756,1248,672,672,applejack|fluttershy|mane six|pinkie pie|princess celestia|princess luna|rainbow dash|rarity|spike|twilight sparkle,chibi-jen-hen
31704.jpg,https://derpicdn.net/img/view/2012/7/4/31704.jpg,2,0.9506955146789552,2189,587,2825,1223,636,636,applejack|fluttershy|mane six|pinkie pie|princess celestia|princess luna|rainbow dash|rarity|spike|twilight sparkle,chibi-jen-hen
317644.png,https://derpicdn.net/img/view/2013/5/5/317644.png,0,0.9734342098236084,1607,536,2021,950,414,414,applejack|fluttershy|mane six|pinkie pie|rainbow dash|rarity|twilight sparkle,yakovlev-vad
317988.jpg,https://derpicdn.net/img/view/2013/5/6/317988.jpg,0,0.9549028873443604,21,430,419,828,398,398,fluttershy|rainbow dash|twilight sparkle,miokomata
317988.jpg,https://derpicdn.net/img/view/2013/5/6/317988.jpg,1,0.9038583636283876,901,416,1279,794,378,378,fluttershy|rainbow dash|twilight sparkle,miokomata
318286.png,https://derpicdn.net/img/view/2013/5/6/318286.png,0,0.9972112774848938,195,62,463,330,268,268,rainbow dash|twilight sparkle,angeldust99999
319690.png,https://derpicdn.net/img/view/2013/5/8/319690.png,0,0.9576312899589542,0,0,3329,3358,3329,3358,rainbow dash|twilight sparkle,yanoda
320868.png,https://derpicdn.net/img/view/2013/5/9/320868.png,0,0.9793453216552734,828,125,1470,767,642,642,princess celestia|princess luna|twilight sparkle,blackswhites
320868.png,https://derpicdn.net/img/view/2013/5/9/320868.png,1,0.97744220495224,1583,95,2369,881,786,786,princess celestia|princess luna|twilight sparkle,blackswhites
32173.png,https://derpicdn.net/img/view/2012/7/5/32173.png,1,0.9975144863128662,1459,361,2095,997,636,636,princess celestia|spike|twilight sparkle,geomancing
32183.jpg,https://derpicdn.net/img/view/2012/7/5/32183.jpg,0,0.9686582684516908,624,4,734,114,110,110,applejack|discord|fluttershy|pinkie pie|princess cadance|princess luna|rainbow dash|rarity|shining armor|soarin'|spike|spitfire|twilight sparkle,chibi-jen-hen
32183.jpg,https://derpicdn.net/img/view/2012/7/5/32183.jpg,1,0.9560285210609436,720,12,810,102,90,90,applejack|discord|fluttershy|pinkie pie|princess cadance|princess luna|rainbow dash|rarity|shining armor|soarin'|spike|spitfire|twilight sparkle,chibi-jen-hen
322115.png,https://derpicdn.net/img/view/2013/5/11/322115.png,0,0.9598559141159058,1206,827,1760,1381,554,554,princess cadance|twilight sparkle,tiffanymarsou
325254.png,https://derpicdn.net/img/view/2013/5/15/325254.png,0,0.9927456378936768,730,0,4374,2886,3644,2886,princess cadance|shining armor|twilight sparkle,beavernator
332045.jpg,https://derpicdn.net/img/view/2013/5/23/332045.jpg,1,0.9629434943199158,192,0,526,333,334,333,applejack|fluttershy|mane six|pinkie pie|rainbow dash|rarity|twilight sparkle,loverofscythe
332629.jpg,https://derpicdn.net/img/view/2013/5/24/332629.jpg,0,0.9291260838508606,452,384,1470,1402,1018,1018,trixie|twilight sparkle,twilightlimits
334146.jpg,https://derpicdn.net/img/view/2013/5/26/334146.jpg,0,0.9938026070594788,68,1525,988,2445,920,920,applejack|fluttershy|mane six|pinkie pie|rainbow dash|rarity|twilight sparkle,princesssilverglow
334146.jpg,https://derpicdn.net/img/view/2013/5/26/334146.jpg,2,0.9824516773223876,501,15,2427,1941,1926,1926,applejack|fluttershy|mane six|pinkie pie|rainbow dash|rarity|twilight sparkle,princesssilverglow
334146.jpg,https://derpicdn.net/img/view/2013/5/26/334146.jpg,4,0.9151610732078552,1122,2789,1810,3477,688,688,applejack|fluttershy|mane six|pinkie pie|rainbow dash|rarity|twilight sparkle,princesssilverglow
334402.jpg,https://derpicdn.net/img/view/2013/5/27/334402.jpg,0,0.9363365769386292,66,19,486,457,420,438,pinkie pie|twilight sparkle,
336585.png,https://derpicdn.net/img/view/2013/5/30/336585.png,0,0.9942699074745178,0,0,215,209,215,209,trixie|twilight sparkle,lulubell
346727.png,https://derpicdn.net/img/view/2013/6/12/346727.png,0,0.9947589039802552,654,102,958,406,304,304,rainbow dash|twilight sparkle,jykinturah
346758.jpg,https://derpicdn.net/img/view/2013/6/12/346758.jpg,0,0.9809687733650208,96,0,846,729,750,729,princess cadance|princess celestia|princess luna|shining armor|twilight sparkle,nancyksu
346758.jpg,https://derpicdn.net/img/view/2013/6/12/346758.jpg,1,0.9485709667205808,683,7,1391,715,708,708,princess cadance|princess celestia|princess luna|shining armor|twilight sparkle,nancyksu
347668.png,https://derpicdn.net/img/view/2013/6/13/347668.png,0,0.9977394342422484,75,352,279,556,204,204,applejack|fluttershy|mane six|pinkie pie|rainbow dash|rarity|twilight sparkle,jiayi
347668.png,https://derpicdn.net/img/view/2013/6/13/347668.png,1,0.985329270362854,354,0,550,187,196,187,applejack|fluttershy|mane six|pinkie pie|rainbow dash|rarity|twilight sparkle,jiayi
347668.png,https://derpicdn.net/img/view/2013/6/13/347668.png,2,0.9835197925567628,0,4,198,210,198,206,applejack|fluttershy|mane six|pinkie pie|rainbow dash|rarity|twilight sparkle,jiayi
347668.png,https://derpicdn.net/img/view/2013/6/13/347668.png,3,0.9735237956047058,582,328,782,528,200,200,applejack|fluttershy|mane six|pinkie pie|rainbow dash|rarity|twilight sparkle,jiayi
347668.png,https://derpicdn.net/img/view/2013/6/13/347668.png,4,0.9071272611618042,326,326,542,542,216,216,applejack|fluttershy|mane six|pinkie pie|rainbow dash|rarity|twilight sparkle,jiayi
350739.png,https://derpicdn.net/img/view/2013/6/17/350739.png,0,0.9963788390159608,548,895,804,1151,256,256,applejack|fluttershy|mane six|pinkie pie|rainbow dash|rarity|spike|twilight sparkle,cryptid-creations
350739.png,https://derpicdn.net/img/view/2013/6/17/350739.png,2,0.9884071350097656,12,1085,282,1355,270,270,applejack|fluttershy|mane six|pinkie pie|rainbow dash|rarity|spike|twilight sparkle,cryptid-creations
350739.png,https://derpicdn.net/img/view/2013/6/17/350739.png,4,0.9628518223762512,860,946,1250,1336,390,390,applejack|fluttershy|mane six|pinkie pie|rainbow dash|rarity|spike|twilight sparkle,cryptid-creations
352000.png,https://derpicdn.net/img/view/2013/6/19/352000.png,0,0.9968332648277284,340,249,854,763,514,514,spike|twilight sparkle,etiluos
352000.png,https://derpicdn.net/img/view/2013/6/19/352000.png,1,0.9654583930969238,1190,468,1620,898,430,430,spike|twilight sparkle,etiluos
360006.png,https://derpicdn.net/img/view/2013/6/29/360006.png,0,0.952742636203766,437,2,783,348,346,346,rarity|twilight sparkle,nekozneko
360874.png,https://derpicdn.net/img/view/2013/6/30/360874.png,0,0.9379132390022278,252,0,1044,783,792,783,pinkie pie|twilight sparkle,chiptoony
365475.png,https://derpicdn.net/img/view/2013/7/6/365475.png,0,0.9176235795021056,1558,128,2692,1262,1134,1134,trixie|twilight sparkle,redapropos
374288.png,https://derpicdn.net/img/view/2013/7/15/374288.png,1,0.9768107533454896,1889,114,2665,890,776,776,applejack|fluttershy|mane six|pinkie pie|rainbow dash|rarity|twilight sparkle,tourniquetmuffin
375790.png,https://derpicdn.net/img/view/2013/7/16/375790.png,1,0.9772663116455078,486,204,854,572,368,368,spike|twilight sparkle,tsurime
376102.png,https://derpicdn.net/img/view/2013/7/16/376102.png,0,0.9954707622528076,334,0,724,359,390,359,apple bloom|pinkie pie|rainbow dash|shining armor|soarin'|spike|spitfire|twilight sparkle,nickyv917
377824.png,https://derpicdn.net/img/view/2013/7/19/377824.png,0,0.9661880135536194,182,0,584,322,402,322,rarity|twilight sparkle,saturnspace
3801.png,https://derpicdn.net/img/view/2012/3/21/3801.png,0,0.9933779835700988,1012,0,1686,671,674,671,rainbow dash|twilight sparkle,grumblepluck
3801.png,https://derpicdn.net/img/view/2012/3/21/3801.png,1,0.967478334903717,445,87,1037,679,592,592,rainbow dash|twilight sparkle,grumblepluck
3810.png,https://derpicdn.net/img/view/2012/3/21/3810.png,0,0.9970983862876892,1902,1976,2688,2762,786,786,applejack|fluttershy|mane six|pinkie pie|rainbow dash|rarity|twilight sparkle,grumblepluck
3810.png,https://derpicdn.net/img/view/2012/3/21/3810.png,1,0.9885187149047852,525,1006,1019,1500,494,494,applejack|fluttershy|mane six|pinkie pie|rainbow dash|rarity|twilight sparkle,grumblepluck
3810.png,https://derpicdn.net/img/view/2012/3/21/3810.png,2,0.987837016582489,1951,982,2527,1558,576,576,applejack|fluttershy|mane six|pinkie pie|rainbow dash|rarity|twilight sparkle,grumblepluck
381006.png,https://derpicdn.net/img/view/2013/7/22/381006.png,0,0.992137372493744,3208,0,4820,1426,1612,1426,applejack|fluttershy|mane six|pinkie pie|rainbow dash|rarity|twilight sparkle,masem
381006.png,https://derpicdn.net/img/view/2013/7/22/381006.png,1,0.921403169631958,8629,0,10000,1494,1371,1494,applejack|fluttershy|mane six|pinkie pie|rainbow dash|rarity|twilight sparkle,masem
382230.png,https://derpicdn.net/img/view/2013/7/23/382230.png,0,0.993809700012207,0,14,209,252,209,238,applejack|fluttershy|pinkie pie|rainbow dash|rarity|twilight sparkle,flarities
387835.png,https://derpicdn.net/img/view/2013/7/31/387835.png,2,0.9863229393959044,294,6,462,174,168,168,applejack|fluttershy|pinkie pie|rainbow dash|rarity|twilight sparkle,sion
392389.png,https://derpicdn.net/img/view/2013/8/6/392389.png,2,0.9001688361167908,1077,2346,1761,3030,684,684,applejack|fluttershy|mane six|pinkie pie|rainbow dash|rarity|twilight sparkle,thebrokencog
398869.png,https://derpicdn.net/img/view/2013/8/13/398869.png,0,0.9986468553543092,640,0,1234,574,594,574,shining armor|twilight sparkle,artiecanvas
398869.png,https://derpicdn.net/img/view/2013/8/13/398869.png,1,0.9829872846603394,90,79,600,589,510,510,shining armor|twilight sparkle,artiecanvas
403222.jpg,https://derpicdn.net/img/view/2013/8/18/403222.jpg,0,0.95576411485672,341,2,495,156,154,154,trixie|twilight sparkle,pixelkitties
403222.jpg,https://derpicdn.net/img/view/2013/8/18/403222.jpg,1,0.9450845718383788,138,11,304,177,166,166,trixie|twilight sparkle,pixelkitties
403351.png,https://derpicdn.net/img/view/2013/8/18/403351.png,0,0.9990623593330384,362,259,574,471,212,212,fluttershy|twilight sparkle,daikaluff
403351.png,https://derpicdn.net/img/view/2013/8/18/403351.png,1,0.9951149225234984,118,287,316,485,198,198,fluttershy|twilight sparkle,daikaluff
406784.png,https://derpicdn.net/img/view/2013/8/22/406784.png,0,0.955232322216034,341,2,827,488,486,486,spike|twilight sparkle,flutterthrash
407719.png,https://derpicdn.net/img/view/2013/8/23/407719.png,0,0.9954974055290222,50,364,360,674,310,310,sunset shimmer|twilight sparkle,dvixie
407719.png,https://derpicdn.net/img/view/2013/8/23/407719.png,1,0.9948368668556212,336,506,552,722,216,216,sunset shimmer|twilight sparkle,dvixie
407719.png,https://derpicdn.net/img/view/2013/8/23/407719.png,3,0.9242495894432068,161,757,365,961,204,204,sunset shimmer|twilight sparkle,dvixie
410340.png,https://derpicdn.net/img/view/2013/8/25/410340.png,3,0.9332159161567688,431,0,603,159,172,159,applejack|fluttershy|mane six|pinkie pie|rainbow dash|rarity|twilight sparkle,crap-drawings
413297.png,https://derpicdn.net/img/view/2013/8/28/413297.png,0,0.9333266019821168,483,88,635,240,152,152,applejack|discord|fluttershy|mane six|pinkie pie|princess celestia|rainbow dash|rarity|spike|trixie|twilight sparkle,swanlullaby
414233.png,https://derpicdn.net/img/view/2013/8/30/414233.png,0,0.9973465204238892,1055,16,1675,636,620,620,applejack|fluttershy|mane six|pinkie pie|rainbow dash|rarity|twilight sparkle,rapidstrike
414233.png,https://derpicdn.net/img/view/2013/8/30/414233.png,1,0.9969835877418518,453,0,1133,605,680,605,applejack|fluttershy|mane six|pinkie pie|rainbow dash|rarity|twilight sparkle,rapidstrike
414732.png,https://derpicdn.net/img/view/2013/8/30/414732.png,0,0.9929475784301758,11,32,293,314,282,282,pinkie pie|twilight sparkle,ranban
415751.png,https://derpicdn.net/img/view/2013/8/31/415751.png,0,0.9951913952827454,433,170,713,450,280,280,applejack|fluttershy|mane six|pinkie pie|rainbow dash|rarity|twilight sparkle,aleximusprime
415751.png,https://derpicdn.net/img/view/2013/8/31/415751.png,1,0.988734245300293,824,255,1008,439,184,184,applejack|fluttershy|mane six|pinkie pie|rainbow dash|rarity|twilight sparkle,aleximusprime
417092.png,https://derpicdn.net/img/view/2013/9/2/417092.png,0,0.9984954595565796,58,61,390,393,332,332,princess cadance|shining armor|twilight sparkle,dm29
420583.png,https://derpicdn.net/img/view/2013/9/6/420583.png,1,0.9953458309173584,2090,69,3238,1217,1148,1148,rainbow dash|twilight sparkle,jykinturah
425076.png,https://derpicdn.net/img/view/2013/9/11/425076.png,0,0.992475152015686,457,1,947,491,490,490,trixie|twilight sparkle,jcking101
426649.jpg,https://derpicdn.net/img/view/2013/9/13/426649.jpg,0,0.9840230345726012,177,294,995,1112,818,818,big macintosh|twilight sparkle,zorbitas
4268.jpg,https://derpicdn.net/img/view/2012/6/3/4268.jpg,0,0.9979743361473083,576,4,946,374,370,370,pinkie pie|rainbow dash|twilight sparkle,sibsy
426810.png,https://derpicdn.net/img/view/2013/9/13/426810.png,0,0.9653537273406982,63,0,637,570,574,570,sunset shimmer|twilight sparkle,loyaldis
430369.jpg,https://derpicdn.net/img/view/2013/9/18/430369.jpg,0,0.9812019467353821,3,0,1785,1614,1782,1614,trixie|twilight sparkle,kaliptro
430767.png,https://derpicdn.net/img/view/2013/9/19/430767.png,0,0.9868709444999696,1874,1177,2372,1675,498,498,apple bloom|applejack|cutie mark crusaders|fluttershy|mane six|pinkie pie|princess luna|rainbow dash|rarity|scootaloo|sweetie belle|twilight sparkle,anticular
434494.png,https://derpicdn.net/img/view/2013/9/25/434494.png,0,0.9953380227088928,48,312,462,726,414,414,rainbow dash|twilight sparkle,aleximusprime
434494.png,https://derpicdn.net/img/view/2013/9/25/434494.png,1,0.9755578637123108,605,0,1109,441,504,441,rainbow dash|twilight sparkle,aleximusprime
435458.png,https://derpicdn.net/img/view/2013/9/26/435458.png,0,0.9909229278564452,324,46,1212,934,888,888,apple bloom|babs seed|cutie mark crusaders|scootaloo|sweetie belle|twilight sparkle,chokico
436303.png,https://derpicdn.net/img/view/2013/9/27/436303.png,1,0.9533561468124392,519,351,919,751,400,400,applejack|fluttershy|mane six|pinkie pie|rainbow dash|rarity|twilight sparkle,luvlymilk
441402.png,https://derpicdn.net/img/view/2013/10/4/441402.png,0,0.9859732389450072,584,61,1164,641,580,580,pinkie pie|twilight sparkle,roadsleadme
445875.png,https://derpicdn.net/img/view/2013/10/10/445875.png,0,0.9219018816947936,46,1,300,255,254,254,spike|twilight sparkle,muffinshire
447328.png,https://derpicdn.net/img/view/2013/10/12/447328.png,0,0.9906695485115052,2050,1337,2684,1971,634,634,rainbow dash|twilight sparkle,roadsleadme
447889.png,https://derpicdn.net/img/view/2013/10/13/447889.png,0,0.9773407578468324,641,26,1161,546,520,520,rainbow dash|twilight sparkle,puetsua
450580.png,https://derpicdn.net/img/view/2013/10/17/450580.png,0,0.9390724897384644,4,171,522,689,518,518,trixie|twilight sparkle,pixelkitties
453346.png,https://derpicdn.net/img/view/2013/10/21/453346.png,0,0.9897842407226562,719,270,965,516,246,246,princess cadance|shining armor|twilight sparkle,arteses-canvas
453346.png,https://derpicdn.net/img/view/2013/10/21/453346.png,2,0.9207770228385924,480,0,756,229,276,229,princess cadance|shining armor|twilight sparkle,arteses-canvas
454972.png,https://derpicdn.net/img/view/2013/10/23/454972.png,0,0.9951006174087524,2895,37,4117,1327,1222,1290,princess cadance|twilight sparkle,vector-brony
454972.png,https://derpicdn.net/img/view/2013/10/23/454972.png,1,0.9863008260726928,74,657,1028,1611,954,954,princess cadance|twilight sparkle,vector-brony
456240.png,https://derpicdn.net/img/view/2013/10/25/456240.png,0,0.9964815974235536,1515,221,2777,1483,1262,1262,applejack|discord|fluttershy|mane six|pinkie pie|princess cadance|princess celestia|princess luna|queen chrysalis|rainbow dash|rarity|twilight sparkle,beavernator
459104.png,https://derpicdn.net/img/view/2013/10/28/459104.png,0,0.980412483215332,370,209,602,441,232,232,princess celestia|princess luna|twilight sparkle,dotoriii
461247.png,https://derpicdn.net/img/view/2013/10/31/461247.png,0,0.9987817406654358,436,171,880,615,444,444,rainbow dash|twilight sparkle,ambris
461975.png,https://derpicdn.net/img/view/2013/11/1/461975.png,0,0.9985764026641846,1848,805,2460,1417,612,612,applejack|fluttershy|pinkie pie|princess celestia|princess luna|rainbow dash|rarity|twilight sparkle,sakuracheetah
461975.png,https://derpicdn.net/img/view/2013/11/1/461975.png,1,0.9977245330810548,10,862,444,1296,434,434,applejack|fluttershy|pinkie pie|princess celestia|princess luna|rainbow dash|rarity|twilight sparkle,sakuracheetah
461975.png,https://derpicdn.net/img/view/2013/11/1/461975.png,2,0.987045407295227,1154,273,1804,923,650,650,applejack|fluttershy|pinkie pie|princess celestia|princess luna|rainbow dash|rarity|twilight sparkle,sakuracheetah
462795.png,https://derpicdn.net/img/view/2013/11/2/462795.png,0,0.9958468675613404,1172,57,2320,1205,1148,1148,rainbow dash|twilight sparkle,crocelif
462925.png,https://derpicdn.net/img/view/2013/11/2/462925.png,0,0.9338780641555786,1336,570,1946,1180,610,610,applejack|discord|fluttershy|mane six|pinkie pie|rainbow dash|rarity|spike|twilight sparkle,aleximusprime
462925.png,https://derpicdn.net/img/view/2013/11/2/462925.png,1,0.9335018992424012,1959,531,2547,1119,588,588,applejack|discord|fluttershy|mane six|pinkie pie|rainbow dash|rarity|spike|twilight sparkle,aleximusprime
46375.png,https://derpicdn.net/img/view/2012/7/16/46375.png,0,0.9948578476905824,390,355,606,571,216,216,applejack|fluttershy|mane six|pinkie pie|rainbow dash|rarity|twilight sparkle,nyerpy
46375.png,https://derpicdn.net/img/view/2012/7/16/46375.png,1,0.9773613810539246,224,318,466,560,242,242,applejack|fluttershy|mane six|pinkie pie|rainbow dash|rarity|twilight sparkle,nyerpy
465052.jpg,https://derpicdn.net/img/view/2013/11/5/465052.jpg,0,0.9965378642082214,2198,1868,3162,2832,964,964,applejack|fluttershy|mane six|pinkie pie|queen chrysalis|rainbow dash|rarity|spike|twilight sparkle,athos01
465052.jpg,https://derpicdn.net/img/view/2013/11/5/465052.jpg,1,0.9960272908210754,1912,349,2616,1053,704,704,applejack|fluttershy|mane six|pinkie pie|queen chrysalis|rainbow dash|rarity|spike|twilight sparkle,athos01
465052.jpg,https://derpicdn.net/img/view/2013/11/5/465052.jpg,2,0.9902693033218384,421,2440,1235,3254,814,814,applejack|fluttershy|mane six|pinkie pie|queen chrysalis|rainbow dash|rarity|spike|twilight sparkle,athos01
465052.jpg,https://derpicdn.net/img/view/2013/11/5/465052.jpg,3,0.9148383140563964,3268,2615,3898,3245,630,630,applejack|fluttershy|mane six|pinkie pie|queen chrysalis|rainbow dash|rarity|spike|twilight sparkle,athos01
465459.png,https://derpicdn.net/img/view/2013/11/6/465459.png,0,0.9860866665840148,710,241,900,431,190,190,spike|twilight sparkle,pixelkitties
465461.png,https://derpicdn.net/img/view/2013/11/6/465461.png,0,0.9559180736541748,242,193,578,529,336,336,apple bloom|applejack|braeburn|cutie mark crusaders|fluttershy|granny smith|mane six|pinkie pie|princess celestia|princess luna|rainbow dash|rarity|scootaloo|spike|sweetie belle|trixie|twilight sparkle,
468067.jpg,https://derpicdn.net/img/view/2013/11/9/468067.jpg,0,0.9597152471542358,132,799,498,1165,366,366,princess cadance|princess celestia|princess luna|twilight sparkle,mn27
4697.jpg,https://derpicdn.net/img/view/2012/6/17/4697.jpg,0,0.9064419269561768,96,26,350,280,254,254,applejack|pinkie pie|princess luna|rainbow dash|twilight sparkle,andypriceart
478107.png,https://derpicdn.net/img/view/2013/11/22/478107.png,0,0.9234238266944884,579,135,1357,913,778,778,pinkie pie|twilight sparkle,jcosneverexisted
480929.png,https://derpicdn.net/img/view/2013/11/25/480929.png,0,0.9939138293266296,0,22,1159,1230,1159,1208,discord|twilight sparkle,jcosneverexisted
481754.png,https://derpicdn.net/img/view/2013/11/25/481754.png,0,0.9632920026779176,0,0,609,679,609,679,discord|twilight sparkle,
485066.png,https://derpicdn.net/img/view/2013/11/29/485066.png,0,0.9628176689147948,968,127,1420,579,452,452,spike|twilight sparkle,
486229.png,https://derpicdn.net/img/view/2013/11/30/486229.png,0,0.993569552898407,3776,104,5224,1552,1448,1448,princess celestia|princess luna|twilight sparkle,stabzor
487424.png,https://derpicdn.net/img/view/2013/12/2/487424.png,0,0.9891934394836426,321,249,603,531,282,282,applejack|fluttershy|mane six|pinkie pie|rainbow dash|rarity|twilight sparkle,thewhimsicalgoat
487570.png,https://derpicdn.net/img/view/2013/12/2/487570.png,0,0.9883558750152588,388,112,734,458,346,346,spike|twilight sparkle,
487681.png,https://derpicdn.net/img/view/2013/12/2/487681.png,0,0.9158948063850404,132,70,500,438,368,368,rarity|twilight sparkle,elslowmo|jessy
490024.png,https://derpicdn.net/img/view/2013/12/5/490024.png,0,0.9991320371627808,698,0,1222,432,524,432,pinkie pie|shining armor|spike|twilight sparkle,dm29
491819.png,https://derpicdn.net/img/view/2013/12/7/491819.png,0,0.9769487977027892,2798,0,3326,470,528,470,apple bloom|applejack|cutie mark crusaders|fluttershy|mane six|pinkie pie|rainbow dash|rarity|scootaloo|sweetie belle|twilight sparkle,zoiby
491819.png,https://derpicdn.net/img/view/2013/12/7/491819.png,1,0.9756554961204528,446,0,1084,559,638,559,apple bloom|applejack|cutie mark crusaders|fluttershy|mane six|pinkie pie|rainbow dash|rarity|scootaloo|sweetie belle|twilight sparkle,zoiby
491928.jpg,https://derpicdn.net/img/view/2013/12/7/491928.jpg,0,0.993264377117157,124,148,272,296,148,148,princess celestia|twilight sparkle,
493169.png,https://derpicdn.net/img/view/2013/12/8/493169.png,0,0.9924144744873048,1218,118,2378,1278,1160,1160,princess celestia|twilight sparkle,nadnerbd
493886.png,https://derpicdn.net/img/view/2013/12/10/493886.png,0,0.9844600558280944,187,34,571,418,384,384,trixie|twilight sparkle,pegacornss
493910.png,https://derpicdn.net/img/view/2013/12/10/493910.png,0,0.9576859474182128,209,68,425,284,216,216,princess luna|trixie|twilight sparkle,fauxsquared
497448.png,https://derpicdn.net/img/view/2013/12/15/497448.png,0,0.9979352951049804,848,342,1288,782,440,440,applejack|fluttershy|mane six|pinkie pie|rainbow dash|rarity|twilight sparkle,bobdude0
497448.png,https://derpicdn.net/img/view/2013/12/15/497448.png,1,0.994668185710907,684,31,1022,369,338,338,applejack|fluttershy|mane six|pinkie pie|rainbow dash|rarity|twilight sparkle,bobdude0
497448.png,https://derpicdn.net/img/view/2013/12/15/497448.png,3,0.9545834064483644,666,442,960,736,294,294,applejack|fluttershy|mane six|pinkie pie|rainbow dash|rarity|twilight sparkle,bobdude0
498522.jpg,https://derpicdn.net/img/view/2013/12/16/498522.jpg,0,0.9968277215957642,896,794,2256,2154,1360,1360,spike|twilight sparkle,bluntwhiskey
503368.png,https://derpicdn.net/img/view/2013/12/22/503368.png,0,0.9671151638031006,425,223,745,543,320,320,applejack|fluttershy|mane six|pinkie pie|rainbow dash|rarity|spike|twilight sparkle,tengami
506109.png,https://derpicdn.net/img/view/2013/12/25/506109.png,2,0.9864567518234252,81,1114,643,1676,562,562,applejack|fluttershy|mane six|pinkie pie|rainbow dash|rarity|twilight sparkle,thebatfang
508801.png,https://derpicdn.net/img/view/2013/12/29/508801.png,0,0.9687271714210508,323,437,725,839,402,402,applejack|fluttershy|twilight sparkle,
511054.png,https://derpicdn.net/img/view/2013/12/31/511054.png,0,0.9997630715370178,6063,3064,8319,5320,2256,2256,princess cadance|princess celestia|princess luna|twilight sparkle,90sigma
511054.png,https://derpicdn.net/img/view/2013/12/31/511054.png,1,0.9991986751556396,4000,0,6256,1874,2256,1874,princess cadance|princess celestia|princess luna|twilight sparkle,90sigma
511054.png,https://derpicdn.net/img/view/2013/12/31/511054.png,2,0.9970611333847046,1362,3079,3604,5321,2242,2242,princess cadance|princess celestia|princess luna|twilight sparkle,90sigma
511078.png,https://derpicdn.net/img/view/2013/12/31/511078.png,1,0.9030836224555968,644,501,1026,883,382,382,applejack|fluttershy|mane six|pinkie pie|princess cadance|princess celestia|princess luna|rainbow dash|rarity|shining armor|spike|twilight sparkle,dm29
511352.png,https://derpicdn.net/img/view/2013/12/31/511352.png,0,0.9084465503692628,1461,729,1731,999,270,270,apple bloom|applejack|fluttershy|pinkie pie|rainbow dash|rarity|scootaloo|sweetie belle|twilight sparkle,morningstar-1337
511839.jpg,https://derpicdn.net/img/view/2014/1/1/511839.jpg,0,0.995895266532898,530,150,750,370,220,220,spike|twilight sparkle,luciferamon
515718.jpg,https://derpicdn.net/img/view/2014/1/5/515718.jpg,0,0.9971107840538024,368,40,870,542,502,502,applejack|fluttershy|lightning dust|mane six|pinkie pie|rainbow dash|rarity|trixie|twilight sparkle,
515718.jpg,https://derpicdn.net/img/view/2014/1/5/515718.jpg,1,0.9923598170280457,478,636,918,1076,440,440,applejack|fluttershy|lightning dust|mane six|pinkie pie|rainbow dash|rarity|trixie|twilight sparkle,
515718.jpg,https://derpicdn.net/img/view/2014/1/5/515718.jpg,2,0.9894805550575256,1000,1200,1492,1692,492,492,applejack|fluttershy|lightning dust|mane six|pinkie pie|rainbow dash|rarity|trixie|twilight sparkle,
515718.jpg,https://derpicdn.net/img/view/2014/1/5/515718.jpg,3,0.9870195984840392,0,0,492,484,492,484,applejack|fluttershy|lightning dust|mane six|pinkie pie|rainbow dash|rarity|trixie|twilight sparkle,
515718.jpg,https://derpicdn.net/img/view/2014/1/5/515718.jpg,4,0.9728174805641174,1529,649,1921,1073,392,424,applejack|fluttershy|lightning dust|mane six|pinkie pie|rainbow dash|rarity|trixie|twilight sparkle,
515718.jpg,https://derpicdn.net/img/view/2014/1/5/515718.jpg,5,0.9725594520568848,0,672,340,1018,340,346,applejack|fluttershy|lightning dust|mane six|pinkie pie|rainbow dash|rarity|trixie|twilight sparkle,
523300.png,https://derpicdn.net/img/view/2014/1/13/523300.png,0,0.9209849834442142,128,25,538,435,410,410,shining armor|twilight sparkle,dm29
525944.png,https://derpicdn.net/img/view/2014/1/16/525944.png,0,0.9488041400909424,326,200,502,376,176,176,applejack|fluttershy|mane six|pinkie pie|princess celestia|rainbow dash|rarity|spike|twilight sparkle,
527624.jpg,https://derpicdn.net/img/view/2014/1/18/527624.jpg,0,0.9344690442085266,256,21,502,267,246,246,applejack|fluttershy|pinkie pie|rainbow dash|twilight sparkle,
52777.jpg,https://derpicdn.net/img/view/2012/7/22/52777.jpg,1,0.996610939502716,61,13,327,279,266,266,applejack|fluttershy|mane six|pinkie pie|rainbow dash|rarity|twilight sparkle,shepherd0821
52777.jpg,https://derpicdn.net/img/view/2012/7/22/52777.jpg,2,0.9950594305992126,365,284,561,480,196,196,applejack|fluttershy|mane six|pinkie pie|rainbow dash|rarity|twilight sparkle,shepherd0821
52777.jpg,https://derpicdn.net/img/view/2012/7/22/52777.jpg,3,0.993658185005188,199,398,425,624,226,226,applejack|fluttershy|mane six|pinkie pie|rainbow dash|rarity|twilight sparkle,shepherd0821
52777.jpg,https://derpicdn.net/img/view/2012/7/22/52777.jpg,5,0.966630518436432,208,188,420,400,212,212,applejack|fluttershy|mane six|pinkie pie|rainbow dash|rarity|twilight sparkle,shepherd0821
528749.png,https://derpicdn.net/img/view/2014/1/19/528749.png,1,0.9779943823814392,438,13,1258,833,820,820,applejack|fluttershy|mane six|pinkie pie|rainbow dash|rarity|spike|twilight sparkle,0riane0
528749.png,https://derpicdn.net/img/view/2014/1/19/528749.png,2,0.976443648338318,506,903,1290,1687,784,784,applejack|fluttershy|mane six|pinkie pie|rainbow dash|rarity|spike|twilight sparkle,0riane0
529036.png,https://derpicdn.net/img/view/2014/1/19/529036.png,0,0.9774904251098632,480,5,882,407,402,402,trixie|twilight sparkle,sircinnamon|rammbrony
529601.png,https://derpicdn.net/img/view/2014/1/20/529601.png,0,0.9919537901878356,434,135,934,635,500,500,rainbow dash|twilight sparkle,ambris
529601.png,https://derpicdn.net/img/view/2014/1/20/529601.png,1,0.9352176189422609,58,96,578,616,520,520,rainbow dash|twilight sparkle,ambris
53148.png,https://derpicdn.net/img/view/2012/7/22/53148.png,0,0.9416245222091676,216,13,572,369,356,356,princess cadance|twilight sparkle,awesomecoolwhip
532218.jpg,https://derpicdn.net/img/view/2014/1/23/532218.jpg,0,0.9973263740539552,261,32,681,452,420,420,pinkie pie|twilight sparkle,somescrub
532219.png,https://derpicdn.net/img/view/2014/1/23/532219.png,0,0.9859691858291626,2495,193,2885,583,390,390,applejack|fluttershy|mane six|pinkie pie|rainbow dash|rarity|twilight sparkle,lessue
532219.png,https://derpicdn.net/img/view/2014/1/23/532219.png,1,0.952703893184662,1895,133,2323,561,428,428,applejack|fluttershy|mane six|pinkie pie|rainbow dash|rarity|twilight sparkle,lessue
532219.png,https://derpicdn.net/img/view/2014/1/23/532219.png,2,0.9240825772285458,0,197,430,631,430,434,applejack|fluttershy|mane six|pinkie pie|rainbow dash|rarity|twilight sparkle,lessue
532997.png,https://derpicdn.net/img/view/2014/1/24/532997.png,0,0.9819496870040894,684,688,872,876,188,188,apple bloom|applejack|babs seed|big macintosh|cutie mark crusaders|diamond tiara|fluttershy|mane six|pinkie pie|princess celestia|princess luna|rainbow dash|rarity|scootaloo|silver spoon|soarin'|spike|spitfire|sweetie belle|trixie|twilight sparkle,yamada9000
532997.png,https://derpicdn.net/img/view/2014/1/24/532997.png,1,0.929911732673645,578,0,748,165,170,165,apple bloom|applejack|babs seed|big macintosh|cutie mark crusaders|diamond tiara|fluttershy|mane six|pinkie pie|princess celestia|princess luna|rainbow dash|rarity|scootaloo|silver spoon|soarin'|spike|spitfire|sweetie belle|trixie|twilight sparkle,yamada9000
533925.jpg,https://derpicdn.net/img/view/2014/1/25/533925.jpg,0,0.9531319737434388,973,473,1413,913,440,440,discord|princess cadance|twilight sparkle,
534373.png,https://derpicdn.net/img/view/2014/1/26/534373.png,0,0.9945847392082214,140,29,648,537,508,508,princess cadance|twilight sparkle,maexis
536102.png,https://derpicdn.net/img/view/2014/1/27/536102.png,0,0.9940348267555236,4803,0,8203,3164,3400,3164,princess cadance|twilight sparkle,gamemasterluna
536523.png,https://derpicdn.net/img/view/2014/1/28/536523.png,0,0.9991851449012756,544,64,1408,928,864,864,princess cadance|twilight sparkle,mykegreywolf
537147.png,https://derpicdn.net/img/view/2014/1/28/537147.png,0,0.9934974312782288,410,0,800,390,390,390,fluttershy|twilight sparkle,evehly
539855.jpg,https://derpicdn.net/img/view/2014/1/31/539855.jpg,0,0.9954403042793274,362,36,872,546,510,510,applejack|discord|fluttershy|lightning dust|mane six|pinkie pie|rainbow dash|rarity|trixie|twilight sparkle,
539855.jpg,https://derpicdn.net/img/view/2014/1/31/539855.jpg,1,0.993013560771942,1043,38,1529,524,486,486,applejack|discord|fluttershy|lightning dust|mane six|pinkie pie|rainbow dash|rarity|trixie|twilight sparkle,
539855.jpg,https://derpicdn.net/img/view/2014/1/31/539855.jpg,2,0.9929661750793456,474,631,922,1079,448,448,applejack|discord|fluttershy|lightning dust|mane six|pinkie pie|rainbow dash|rarity|trixie|twilight sparkle,
539855.jpg,https://derpicdn.net/img/view/2014/1/31/539855.jpg,3,0.9920416474342346,992,1194,1500,1702,508,508,applejack|discord|fluttershy|lightning dust|mane six|pinkie pie|rainbow dash|rarity|trixie|twilight sparkle,
539855.jpg,https://derpicdn.net/img/view/2014/1/31/539855.jpg,4,0.9875267148017884,0,0,491,480,491,480,applejack|discord|fluttershy|lightning dust|mane six|pinkie pie|rainbow dash|rarity|trixie|twilight sparkle,
539855.jpg,https://derpicdn.net/img/view/2014/1/31/539855.jpg,5,0.9798383116722108,129,1250,493,1614,364,364,applejack|discord|fluttershy|lightning dust|mane six|pinkie pie|rainbow dash|rarity|trixie|twilight sparkle,
539855.jpg,https://derpicdn.net/img/view/2014/1/31/539855.jpg,6,0.9757776260375975,0,672,341,1020,341,348,applejack|discord|fluttershy|lightning dust|mane six|pinkie pie|rainbow dash|rarity|trixie|twilight sparkle,
539855.jpg,https://derpicdn.net/img/view/2014/1/31/539855.jpg,8,0.955631673336029,1533,660,1921,1070,388,410,applejack|discord|fluttershy|lightning dust|mane six|pinkie pie|rainbow dash|rarity|trixie|twilight sparkle,
541598.png,https://derpicdn.net/img/view/2014/2/2/541598.png,0,0.976107895374298,587,0,1029,362,442,362,princess cadance|princess celestia|princess luna|twilight sparkle,zeldafan777
547778.png,https://derpicdn.net/img/view/2014/2/9/547778.png,1,0.966430127620697,360,290,558,488,198,198,fluttershy|pinkie pie|princess cadance|queen chrysalis|rarity|shining armor|twilight sparkle,
549707.png,https://derpicdn.net/img/view/2014/2/12/549707.png,0,0.9797639846801758,739,71,1385,717,646,646,applejack|fluttershy|pinkie pie|rainbow dash|rarity|spike|twilight sparkle,dragmodnotloc
550651.jpg,https://derpicdn.net/img/view/2014/2/13/550651.jpg,0,0.9301827549934388,0,197,350,600,350,403,princess cadance|twilight sparkle,elyses
552089.png,https://derpicdn.net/img/view/2014/2/15/552089.png,0,0.9904693961143494,716,560,950,794,234,234,applejack|big macintosh|braeburn|fluttershy|mane six|pinkie pie|rainbow dash|rarity|soarin'|spike|twilight sparkle,voltictail
552089.png,https://derpicdn.net/img/view/2014/2/15/552089.png,1,0.9734760522842408,199,658,399,858,200,200,applejack|big macintosh|braeburn|fluttershy|mane six|pinkie pie|rainbow dash|rarity|soarin'|spike|twilight sparkle,voltictail
552089.png,https://derpicdn.net/img/view/2014/2/15/552089.png,3,0.966935932636261,362,647,594,879,232,232,applejack|big macintosh|braeburn|fluttershy|mane six|pinkie pie|rainbow dash|rarity|soarin'|spike|twilight sparkle,voltictail
55230.png,https://derpicdn.net/img/view/2012/7/24/55230.png,0,0.9807809591293336,203,50,501,348,298,298,applejack|twilight sparkle,inuhoshi-to-darkpen
553616.jpg,https://derpicdn.net/img/view/2014/2/16/553616.jpg,0,0.9875731468200684,1021,770,1215,984,194,214,applejack|fluttershy|mane six|pinkie pie|rainbow dash|rarity|spike|twilight sparkle,caluriri
554601.png,https://derpicdn.net/img/view/2014/2/17/554601.png,0,0.9664655923843384,202,276,402,476,200,200,apple bloom|applejack|big macintosh|fluttershy|princess luna|rainbow dash|scootaloo|spike|twilight sparkle,yeendip
555883.png,https://derpicdn.net/img/view/2014/2/18/555883.png,0,0.9915522933006288,235,739,1343,1847,1108,1108,princess cadance|twilight sparkle,zeldafan777
561977.png,https://derpicdn.net/img/view/2014/2/26/561977.png,0,0.9862679243087769,22,354,204,536,182,182,applejack|fluttershy|mane six|pinkie pie|princess luna|rainbow dash|rarity|twilight sparkle,snacky-bites
561977.png,https://derpicdn.net/img/view/2014/2/26/561977.png,1,0.9785544872283936,22,86,200,264,178,178,applejack|fluttershy|mane six|pinkie pie|princess luna|rainbow dash|rarity|twilight sparkle,snacky-bites
564083.png,https://derpicdn.net/img/view/2014/3/1/564083.png,0,0.9940762519836426,969,187,1569,787,600,600,apple bloom|cutie mark crusaders|scootaloo|sweetie belle|twilight sparkle,hoyeechun
56431.jpg,https://derpicdn.net/img/view/2012/7/25/56431.jpg,0,0.9323814511299132,137,211,457,531,320,320,trixie|twilight sparkle,mysticalpha
565262.jpg,https://derpicdn.net/img/view/2014/3/2/565262.jpg,0,0.9960744380950928,72,15,384,327,312,312,applejack|fluttershy|mane six|pinkie pie|rainbow dash|rarity|twilight sparkle,twilite-sparkleplz
566822.jpg,https://derpicdn.net/img/view/2014/3/4/566822.jpg,0,0.9345906376838684,964,283,1130,449,166,166,applejack|queen chrysalis|rainbow dash|rarity|shining armor|twilight sparkle,dtkraus
569915.png,https://derpicdn.net/img/view/2014/3/9/569915.png,0,0.9955339431762696,503,530,749,776,246,246,applejack|twilight sparkle,metal-kitty
569915.png,https://derpicdn.net/img/view/2014/3/9/569915.png,1,0.9870542287826538,495,52,707,264,212,212,applejack|twilight sparkle,metal-kitty
570411.png,https://derpicdn.net/img/view/2014/3/9/570411.png,0,0.9956685304641724,1181,256,1423,544,242,288,applejack|fluttershy|pinkie pie|rainbow dash|rarity|trixie|twilight sparkle,
570411.png,https://derpicdn.net/img/view/2014/3/9/570411.png,2,0.9741137623786926,757,264,1027,534,270,270,applejack|fluttershy|pinkie pie|rainbow dash|rarity|trixie|twilight sparkle,
570411.png,https://derpicdn.net/img/view/2014/3/9/570411.png,3,0.9492903351783752,980,242,1252,514,272,272,applejack|fluttershy|pinkie pie|rainbow dash|rarity|trixie|twilight sparkle,
57279.png,https://derpicdn.net/img/view/2012/7/26/57279.png,0,0.9985613822937012,1040,280,1492,732,452,452,apple bloom|applejack|cutie mark crusaders|rainbow dash|rarity|scootaloo|sweetie belle|twilight sparkle,cartoonlion
57279.png,https://derpicdn.net/img/view/2012/7/26/57279.png,1,0.9966774582862854,439,305,965,831,526,526,apple bloom|applejack|cutie mark crusaders|rainbow dash|rarity|scootaloo|sweetie belle|twilight sparkle,cartoonlion
57279.png,https://derpicdn.net/img/view/2012/7/26/57279.png,2,0.925760805606842,1039,746,1437,1144,398,398,apple bloom|applejack|cutie mark crusaders|rainbow dash|rarity|scootaloo|sweetie belle|twilight sparkle,cartoonlion
572923.png,https://derpicdn.net/img/view/2014/3/12/572923.png,0,0.9931882619857788,192,223,1010,1041,818,818,rainbow dash|twilight sparkle,graphenescloset
572923.png,https://derpicdn.net/img/view/2014/3/12/572923.png,1,0.98654967546463,866,1607,1820,2561,954,954,rainbow dash|twilight sparkle,graphenescloset
573705.png,https://derpicdn.net/img/view/2014/3/13/573705.png,0,0.905013382434845,353,171,511,329,158,158,fluttershy|pinkie pie|rainbow dash|rarity|twilight sparkle,oscarndraw
575641.png,https://derpicdn.net/img/view/2014/3/15/575641.png,0,0.92952960729599,241,31,431,221,190,190,applejack|fluttershy|mane six|pinkie pie|rainbow dash|rarity|spike|twilight sparkle,dm29
577.jpg,https://derpicdn.net/img/view/2012/1/17/577.jpg,0,0.9774217009544371,70,268,400,598,330,330,rainbow dash|twilight sparkle,psychodikdik
577.jpg,https://derpicdn.net/img/view/2012/1/17/577.jpg,1,0.9724017381668092,638,0,1158,480,520,480,rainbow dash|twilight sparkle,psychodikdik
581029.png,https://derpicdn.net/img/view/2014/3/21/581029.png,0,0.9590530395507812,669,193,905,429,236,236,applejack|fluttershy|mane six|pinkie pie|princess celestia|princess luna|rainbow dash|rarity|twilight sparkle,eto
581029.png,https://derpicdn.net/img/view/2014/3/21/581029.png,1,0.9132834076881408,240,261,548,529,308,268,applejack|fluttershy|mane six|pinkie pie|princess celestia|princess luna|rainbow dash|rarity|twilight sparkle,eto
592554.png,https://derpicdn.net/img/view/2014/4/4/592554.png,0,0.9965688586235046,0,0,292,273,292,273,queen chrysalis|twilight sparkle,mixermike622
594720.png,https://derpicdn.net/img/view/2014/4/6/594720.png,0,0.9939229488372804,580,0,1148,549,568,549,princess celestia|twilight sparkle,earthsong9405|archonix
594720.png,https://derpicdn.net/img/view/2014/4/6/594720.png,1,0.9505877494812012,676,525,876,725,200,200,princess celestia|twilight sparkle,earthsong9405|archonix
595900.png,https://derpicdn.net/img/view/2014/4/8/595900.png,0,0.9855989813804626,0,0,303,308,303,308,fluttershy|spike|twilight sparkle,
596621.jpg,https://derpicdn.net/img/view/2014/4/9/596621.jpg,0,0.9973243474960328,502,300,706,504,204,204,apple bloom|applejack|cutie mark crusaders|fluttershy|mane six|pinkie pie|rainbow dash|rarity|scootaloo|spike|sweetie belle|trixie|twilight sparkle,abbystarling
599076.png,https://derpicdn.net/img/view/2014/4/13/599076.png,0,0.968276023864746,1003,262,1701,960,698,698,applejack|fluttershy|mane six|pinkie pie|rainbow dash|rarity|spike|twilight sparkle,hoyeechun
599076.png,https://derpicdn.net/img/view/2014/4/13/599076.png,1,0.9276918768882751,588,399,1258,1069,670,670,applejack|fluttershy|mane six|pinkie pie|rainbow dash|rarity|spike|twilight sparkle,hoyeechun
599076.png,https://derpicdn.net/img/view/2014/4/13/599076.png,2,0.9053456783294678,150,703,794,1347,644,644,applejack|fluttershy|mane six|pinkie pie|rainbow dash|rarity|spike|twilight sparkle,hoyeechun
601392.jpg,https://derpicdn.net/img/view/2014/4/15/601392.jpg,0,0.989721417427063,318,162,656,508,338,346,princess cadance|princess celestia|princess luna|twilight sparkle,donika-schovina
601392.jpg,https://derpicdn.net/img/view/2014/4/15/601392.jpg,1,0.9731488823890686,26,0,444,409,418,409,princess cadance|princess celestia|princess luna|twilight sparkle,donika-schovina
601392.jpg,https://derpicdn.net/img/view/2014/4/15/601392.jpg,2,0.9416208863258362,45,379,343,677,298,298,princess cadance|princess celestia|princess luna|twilight sparkle,donika-schovina
601599.png,https://derpicdn.net/img/view/2014/4/16/601599.png,0,0.9924616813659668,1180,0,2746,1468,1566,1468,spike|twilight sparkle,porygon2z
602546.png,https://derpicdn.net/img/view/2014/4/17/602546.png,0,0.9974688887596128,1967,251,2727,1011,760,760,shining armor|twilight sparkle,silfoe
602562.png,https://derpicdn.net/img/view/2014/4/17/602562.png,0,0.9981343746185304,3422,231,5730,2539,2308,2308,rarity|twilight sparkle,reneesdetermination
602562.png,https://derpicdn.net/img/view/2014/4/17/602562.png,1,0.9311697483062744,643,42,3179,2578,2536,2536,rarity|twilight sparkle,reneesdetermination
606916.png,https://derpicdn.net/img/view/2014/4/22/606916.png,0,0.9922398924827576,173,100,971,898,798,798,apple bloom|twilight sparkle,chiweee
613552.png,https://derpicdn.net/img/view/2014/4/30/613552.png,0,0.9719223380088806,942,6,1400,514,458,508,applejack|fluttershy|mane six|pinkie pie|rainbow dash|rarity|spike|twilight sparkle,andypriceart
613552.png,https://derpicdn.net/img/view/2014/4/30/613552.png,2,0.915604829788208,544,378,896,730,352,352,applejack|fluttershy|mane six|pinkie pie|rainbow dash|rarity|spike|twilight sparkle,andypriceart
613566.png,https://derpicdn.net/img/view/2014/4/30/613566.png,0,0.9937784075737,609,326,953,670,344,344,pinkie pie|princess celestia|princess luna|rainbow dash|rarity|twilight sparkle,andypriceart
613566.png,https://derpicdn.net/img/view/2014/4/30/613566.png,1,0.9813777208328248,462,0,852,319,390,319,pinkie pie|princess celestia|princess luna|rainbow dash|rarity|twilight sparkle,andypriceart
613578.png,https://derpicdn.net/img/view/2014/4/30/613578.png,1,0.988481879234314,342,923,666,1247,324,324,applejack|fluttershy|mane six|pinkie pie|rainbow dash|rarity|spike|twilight sparkle,andypriceart
613578.png,https://derpicdn.net/img/view/2014/4/30/613578.png,2,0.9807398319244384,736,967,1020,1251,284,284,applejack|fluttershy|mane six|pinkie pie|rainbow dash|rarity|spike|twilight sparkle,andypriceart
613578.png,https://derpicdn.net/img/view/2014/4/30/613578.png,3,0.9807381629943848,1026,882,1400,1274,374,392,applejack|fluttershy|mane six|pinkie pie|rainbow dash|rarity|spike|twilight sparkle,andypriceart
613581.png,https://derpicdn.net/img/view/2014/4/30/613581.png,1,0.9832028150558472,1116,156,1386,426,270,270,applejack|fluttershy|mane six|pinkie pie|rainbow dash|rarity|spike|twilight sparkle,andypriceart
613581.png,https://derpicdn.net/img/view/2014/4/30/613581.png,2,0.9794819355010986,0,582,208,836,208,254,applejack|fluttershy|mane six|pinkie pie|rainbow dash|rarity|spike|twilight sparkle,andypriceart
613590.png,https://derpicdn.net/img/view/2014/4/30/613590.png,0,0.930268943309784,32,0,432,383,400,383,rarity|twilight sparkle,goat train
614097.png,https://derpicdn.net/img/view/2014/4/30/614097.png,0,0.971107304096222,1110,909,1272,1071,162,162,applejack|fluttershy|mane six|pinkie pie|princess celestia|rainbow dash|rarity|spike|twilight sparkle,
614346.png,https://derpicdn.net/img/view/2014/5/1/614346.png,0,0.9679506421089172,63,151,353,441,290,290,applejack|fluttershy|mane six|pinkie pie|rainbow dash|rarity|sunset shimmer|trixie|twilight sparkle,miroslav46
615382.png,https://derpicdn.net/img/view/2014/5/2/615382.png,0,0.9405673146247864,340,52,644,356,304,304,trixie|twilight sparkle,jinyaranda
617305.png,https://derpicdn.net/img/view/2014/5/4/617305.png,0,0.995215117931366,1263,167,1535,439,272,272,princess cadance|princess celestia|princess luna|spitfire|twilight sparkle,snapai
617305.png,https://derpicdn.net/img/view/2014/5/4/617305.png,1,0.9897012710571288,244,35,532,323,288,288,princess cadance|princess celestia|princess luna|spitfire|twilight sparkle,snapai
618443.png,https://derpicdn.net/img/view/2014/5/5/618443.png,0,0.9590877890586852,559,136,941,518,382,382,trixie|twilight sparkle,fauxsquared
618443.png,https://derpicdn.net/img/view/2014/5/5/618443.png,1,0.9367904663085938,161,90,557,486,396,396,trixie|twilight sparkle,fauxsquared
619853.png,https://derpicdn.net/img/view/2014/5/7/619853.png,0,0.9529907703399658,411,32,711,332,300,300,fluttershy|shining armor|twilight sparkle,dm29
620958.png,https://derpicdn.net/img/view/2014/5/8/620958.png,0,0.966390073299408,504,609,952,1057,448,448,princess cadance|princess celestia|princess luna|twilight sparkle,jessy
624818.png,https://derpicdn.net/img/view/2014/5/12/624818.png,0,0.9703320264816284,444,331,598,485,154,154,applejack|fluttershy|mane six|pinkie pie|rainbow dash|rarity|twilight sparkle,askthefillies
626827.png,https://derpicdn.net/img/view/2014/5/14/626827.png,1,0.9853010773658752,1619,0,2647,922,1028,922,applejack|fluttershy|mane six|pinkie pie|rainbow dash|rarity|twilight sparkle,vector-brony
626827.png,https://derpicdn.net/img/view/2014/5/14/626827.png,2,0.9584648013114928,238,193,1110,1065,872,872,applejack|fluttershy|mane six|pinkie pie|rainbow dash|rarity|twilight sparkle,vector-brony
628290.jpg,https://derpicdn.net/img/view/2014/5/16/628290.jpg,0,0.9984476566314696,262,11,534,283,272,272,trixie|twilight sparkle,girlieginger
630078.jpg,https://derpicdn.net/img/view/2014/5/18/630078.jpg,0,0.9928645491600036,937,1550,1625,2238,688,688,applejack|fluttershy|mane six|pinkie pie|rainbow dash|rarity|spike|twilight sparkle,amostheartman
630078.jpg,https://derpicdn.net/img/view/2014/5/18/630078.jpg,2,0.982672154903412,624,821,1262,1459,638,638,applejack|fluttershy|mane six|pinkie pie|rainbow dash|rarity|spike|twilight sparkle,amostheartman
630078.jpg,https://derpicdn.net/img/view/2014/5/18/630078.jpg,3,0.9807282090187072,14,380,800,1166,786,786,applejack|fluttershy|mane six|pinkie pie|rainbow dash|rarity|spike|twilight sparkle,amostheartman
630078.jpg,https://derpicdn.net/img/view/2014/5/18/630078.jpg,4,0.9765440225601196,0,1361,512,1961,512,600,applejack|fluttershy|mane six|pinkie pie|rainbow dash|rarity|spike|twilight sparkle,amostheartman
632102.png,https://derpicdn.net/img/view/2014/5/20/632102.png,0,0.9951127171516418,121,0,477,350,356,350,spike|twilight sparkle,akaonic
634127.png,https://derpicdn.net/img/view/2014/5/23/634127.png,0,0.9865554571151732,1228,108,1412,292,184,184,rarity|spike|sunset shimmer|trixie|twilight sparkle,miroslav46
634285.png,https://derpicdn.net/img/view/2014/5/23/634285.png,0,0.9788807034492492,1219,2132,1633,2546,414,414,applejack|discord|fluttershy|mane six|pinkie pie|rainbow dash|rarity|spike|twilight sparkle,saturdaymorningproj|epulson
63433.png,https://derpicdn.net/img/view/2012/7/31/63433.png,0,0.967125117778778,2638,1198,3034,1594,396,396,applejack|fluttershy|pinkie pie|rainbow dash|rarity|twilight sparkle,
63433.png,https://derpicdn.net/img/view/2012/7/31/63433.png,2,0.9095860719680786,1598,416,2116,934,518,518,applejack|fluttershy|pinkie pie|rainbow dash|rarity|twilight sparkle,
635936.png,https://derpicdn.net/img/view/2014/5/25/635936.png,0,0.9234806299209596,668,506,1858,1696,1190,1190,applejack|fluttershy|mane six|pinkie pie|rainbow dash|rarity|twilight sparkle,thisismyphotoshoppin
638963.png,https://derpicdn.net/img/view/2014/5/28/638963.png,0,0.997191309928894,296,0,630,329,334,329,princess cadance|princess celestia|princess luna|twilight sparkle,arcadianphoenix
638963.png,https://derpicdn.net/img/view/2014/5/28/638963.png,1,0.9919846057891846,46,227,366,547,320,320,princess cadance|princess celestia|princess luna|twilight sparkle,arcadianphoenix
638963.png,https://derpicdn.net/img/view/2014/5/28/638963.png,2,0.9487990736961364,658,175,984,501,326,326,princess cadance|princess celestia|princess luna|twilight sparkle,arcadianphoenix
640438.png,https://derpicdn.net/img/view/2014/5/30/640438.png,0,0.9863913655281068,352,0,786,354,434,354,rainbow dash|twilight sparkle,the-chibster
640438.png,https://derpicdn.net/img/view/2014/5/30/640438.png,1,0.9850528240203856,87,56,473,442,386,386,rainbow dash|twilight sparkle,the-chibster
640895.png,https://derpicdn.net/img/view/2014/5/30/640895.png,0,0.9987068176269532,372,243,642,513,270,270,applejack|big macintosh|rainbow dash|twilight sparkle,metal-kitty
642619.png,https://derpicdn.net/img/view/2014/6/1/642619.png,1,0.9287728071212769,601,1778,1393,2570,792,792,rainbow dash|twilight sparkle,sonork91
645402.png,https://derpicdn.net/img/view/2014/6/5/645402.png,0,0.9958320260047911,175,163,501,489,326,326,big macintosh|twilight sparkle,aleximusprime
647319.png,https://derpicdn.net/img/view/2014/6/7/647319.png,0,0.9900604486465454,408,478,898,968,490,490,princess luna|twilight sparkle,huussii
648690.jpg,https://derpicdn.net/img/view/2014/6/9/648690.jpg,0,0.9937503337860109,25,28,295,298,270,270,applejack|fluttershy|mane six|pinkie pie|rainbow dash|rarity|spike|twilight sparkle,
648981.jpg,https://derpicdn.net/img/view/2014/6/9/648981.jpg,0,0.9333252906799316,58,144,172,258,114,114,rainbow dash|twilight sparkle,sweetsound
6530.png,https://derpicdn.net/img/view/2012/6/18/6530.png,0,0.9142791032791138,482,207,784,509,302,302,princess cadance|shining armor|twilight sparkle,dm29
653324.png,https://derpicdn.net/img/view/2014/6/14/653324.png,0,0.9893419742584229,460,1228,966,1734,506,506,trixie|twilight sparkle,misspolycysticovary
653944.png,https://derpicdn.net/img/view/2014/6/15/653944.png,0,0.9975231289863586,136,0,438,294,302,294,applejack|fluttershy|mane six|pinkie pie|rainbow dash|rarity|twilight sparkle,shellsweet
653944.png,https://derpicdn.net/img/view/2014/6/15/653944.png,1,0.991252601146698,417,576,693,852,276,276,applejack|fluttershy|mane six|pinkie pie|rainbow dash|rarity|twilight sparkle,shellsweet
654219.png,https://derpicdn.net/img/view/2014/6/16/654219.png,0,0.961555540561676,226,48,608,430,382,382,trixie|twilight sparkle,redflare500
6555.png,https://derpicdn.net/img/view/2012/6/18/6555.png,0,0.9968113899230956,1121,503,1485,867,364,364,applejack|fluttershy|mane six|pinkie pie|rainbow dash|rarity|spike|twilight sparkle,egophiliac
658704.png,https://derpicdn.net/img/view/2014/6/22/658704.png,0,0.9956632256507874,1,590,545,1134,544,544,applejack|fluttershy|mane six|pinkie pie|rainbow dash|rarity|twilight sparkle,linamomoko
658704.png,https://derpicdn.net/img/view/2014/6/22/658704.png,1,0.9642555117607116,71,1109,479,1517,408,408,applejack|fluttershy|mane six|pinkie pie|rainbow dash|rarity|twilight sparkle,linamomoko
661786.png,https://derpicdn.net/img/view/2014/6/26/661786.png,1,0.9276158809661864,317,673,494,851,177,178,applejack|fluttershy|mane six|pinkie pie|princess celestia|princess luna|rainbow dash|rarity|spike|twilight sparkle,kivwolf
6641.png,https://derpicdn.net/img/view/2012/6/18/6641.png,0,0.9333539009094238,887,99,1241,453,354,354,princess cadance|shining armor|twilight sparkle,dm29
66501.jpg,https://derpicdn.net/img/view/2012/8/4/66501.jpg,1,0.9935902953147888,16,111,460,555,444,444,applejack|fluttershy|princess celestia|princess luna|rarity|scootaloo|twilight sparkle,foxi-5
670482.png,https://derpicdn.net/img/view/2014/7/8/670482.png,0,0.9787779450416564,656,103,1162,609,506,506,pinkie pie|twilight sparkle,phyllismi
671065.png,https://derpicdn.net/img/view/2014/7/9/671065.png,0,0.9987919330596924,27,249,499,721,472,472,rainbow dash|twilight sparkle,poptart36
6720.png,https://derpicdn.net/img/view/2012/6/18/6720.png,0,0.9627294540405272,358,157,638,437,280,280,trixie|twilight sparkle,bamboodog
672082.png,https://derpicdn.net/img/view/2014/7/10/672082.png,0,0.9997771382331848,1499,0,2377,827,878,827,applejack|fluttershy|mane six|pinkie pie|rainbow dash|rarity|twilight sparkle,theshadowstone
672082.png,https://derpicdn.net/img/view/2014/7/10/672082.png,2,0.9875410199165344,347,1086,1113,1852,766,766,applejack|fluttershy|mane six|pinkie pie|rainbow dash|rarity|twilight sparkle,theshadowstone
678345.jpg,https://derpicdn.net/img/view/2014/7/19/678345.jpg,0,0.9991804957389832,0,0,172,155,172,155,applejack|fluttershy|mane six|pinkie pie|rainbow dash|rarity|twilight sparkle,chi-hayu
680108.png,https://derpicdn.net/img/view/2014/7/21/680108.png,1,0.9771415591239928,551,1243,1179,1871,628,628,applejack|fluttershy|mane six|pinkie pie|rainbow dash|rarity|twilight sparkle,junkyardgypsy
681666.png,https://derpicdn.net/img/view/2014/7/23/681666.png,0,0.9881846308708192,43,701,257,915,214,214,applejack|fluttershy|pinkie pie|rainbow dash|rarity|spike|twilight sparkle,nanook123
681666.png,https://derpicdn.net/img/view/2014/7/23/681666.png,1,0.914851725101471,211,533,535,857,324,324,applejack|fluttershy|pinkie pie|rainbow dash|rarity|spike|twilight sparkle,nanook123
682292.png,https://derpicdn.net/img/view/2014/7/24/682292.png,0,0.970666229724884,600,472,986,858,386,386,spike|twilight sparkle,darkkodkod
682411.jpg,https://derpicdn.net/img/view/2014/7/24/682411.jpg,0,0.9510956406593324,439,162,803,526,364,364,applejack|spike|twilight sparkle,dtkraus
686883.png,https://derpicdn.net/img/view/2014/7/30/686883.png,0,0.999437153339386,468,177,692,401,224,224,fluttershy|twilight sparkle,metal-kitty
688201.png,https://derpicdn.net/img/view/2014/8/1/688201.png,1,0.9857027530670166,311,71,585,345,274,274,applejack|fluttershy|mane six|pinkie pie|rainbow dash|rarity|twilight sparkle,jorobro
688201.png,https://derpicdn.net/img/view/2014/8/1/688201.png,2,0.9669649600982666,922,486,1262,826,340,340,applejack|fluttershy|mane six|pinkie pie|rainbow dash|rarity|twilight sparkle,jorobro
690195.png,https://derpicdn.net/img/view/2014/8/3/690195.png,0,0.9848882555961608,1211,87,1966,885,755,798,pinkie pie|twilight sparkle,zacatron94
690743.png,https://derpicdn.net/img/view/2014/8/4/690743.png,0,0.997898280620575,914,4,1240,330,326,326,applejack|fluttershy|mane six|pinkie pie|rainbow dash|rarity|twilight sparkle,misspolycysticovary
690743.png,https://derpicdn.net/img/view/2014/8/4/690743.png,1,0.9928060173988342,427,461,789,823,362,362,applejack|fluttershy|mane six|pinkie pie|rainbow dash|rarity|twilight sparkle,misspolycysticovary
690743.png,https://derpicdn.net/img/view/2014/8/4/690743.png,2,0.9871466755867004,99,62,371,334,272,272,applejack|fluttershy|mane six|pinkie pie|rainbow dash|rarity|twilight sparkle,misspolycysticovary
691194.jpg,https://derpicdn.net/img/view/2014/8/4/691194.jpg,0,0.917965292930603,1166,383,1462,679,296,296,apple bloom|applejack|cutie mark crusaders|discord|fluttershy|mane six|pinkie pie|princess celestia|princess luna|rainbow dash|rarity|scootaloo|spike|sweetie belle|twilight sparkle,kushina13
694244.png,https://derpicdn.net/img/view/2014/8/8/694244.png,0,0.9219110012054444,385,1037,857,1509,472,472,applejack|twilight sparkle,alumx
695588.jpg,https://derpicdn.net/img/view/2014/8/9/695588.jpg,0,0.9988130927085876,593,494,853,754,260,260,applejack|discord|fluttershy|mane six|pinkie pie|rainbow dash|rarity|trixie|twilight sparkle,kuang-han
695588.jpg,https://derpicdn.net/img/view/2014/8/9/695588.jpg,1,0.9913650155067444,382,752,586,956,204,204,applejack|discord|fluttershy|mane six|pinkie pie|rainbow dash|rarity|trixie|twilight sparkle,kuang-han
702001.jpg,https://derpicdn.net/img/view/2014/8/17/702001.jpg,0,0.9859911799430848,1832,1089,2134,1391,302,302,discord|fluttershy|twilight sparkle,bluntwhiskey
703608.png,https://derpicdn.net/img/view/2014/8/19/703608.png,0,0.962188720703125,667,1264,1579,2176,912,912,discord|trixie|twilight sparkle,navitaserussirus
703646.png,https://derpicdn.net/img/view/2014/8/19/703646.png,0,0.99954754114151,587,2392,2575,4380,1988,1988,princess cadance|princess celestia|princess luna|queen chrysalis|trixie|twilight sparkle,ambassad0r|kp-shadowsquirrel
703646.png,https://derpicdn.net/img/view/2014/8/19/703646.png,2,0.9881924390792848,436,4810,2174,6548,1738,1738,princess cadance|princess celestia|princess luna|queen chrysalis|trixie|twilight sparkle,ambassad0r|kp-shadowsquirrel
703758.png,https://derpicdn.net/img/view/2014/8/20/703758.png,0,0.9978562593460084,0,0,792,644,792,644,pinkie pie|twilight sparkle,jullamox
705071.png,https://derpicdn.net/img/view/2014/8/21/705071.png,0,0.9739437103271484,115,98,475,458,360,360,pinkie pie|rainbow dash|spike|twilight sparkle,ctb-36
705071.png,https://derpicdn.net/img/view/2014/8/21/705071.png,1,0.9722052812576294,709,332,1047,670,338,338,pinkie pie|rainbow dash|spike|twilight sparkle,ctb-36
705401.jpg,https://derpicdn.net/img/view/2014/8/22/705401.jpg,0,0.982373595237732,3463,532,3993,1062,530,530,applejack|discord|fluttershy|mane six|pinkie pie|princess cadance|princess celestia|princess luna|rainbow dash|rarity|spike|twilight sparkle,arrockansate
705401.jpg,https://derpicdn.net/img/view/2014/8/22/705401.jpg,1,0.9254109263420104,1559,81,2387,909,828,828,applejack|discord|fluttershy|mane six|pinkie pie|princess cadance|princess celestia|princess luna|rainbow dash|rarity|spike|twilight sparkle,arrockansate
705401.jpg,https://derpicdn.net/img/view/2014/8/22/705401.jpg,3,0.9066885113716124,2769,178,3309,718,540,540,applejack|discord|fluttershy|mane six|pinkie pie|princess cadance|princess celestia|princess luna|rainbow dash|rarity|spike|twilight sparkle,arrockansate
708270.png,https://derpicdn.net/img/view/2014/8/26/708270.png,0,0.992132306098938,2267,75,3437,1245,1170,1170,applejack|fluttershy|mane six|pinkie pie|rainbow dash|rarity|twilight sparkle,theshadowstone
708270.png,https://derpicdn.net/img/view/2014/8/26/708270.png,1,0.9890413880348206,1190,1472,1970,2252,780,780,applejack|fluttershy|mane six|pinkie pie|rainbow dash|rarity|twilight sparkle,theshadowstone
711008.png,https://derpicdn.net/img/view/2014/8/30/711008.png,0,0.9629201889038086,592,416,1352,1176,760,760,princess celestia|twilight sparkle,hoyeechun
713890.png,https://derpicdn.net/img/view/2014/9/3/713890.png,2,0.9770469069480896,748,922,1244,1418,496,496,applejack|fluttershy|mane six|pinkie pie|rainbow dash|rarity|twilight sparkle,sutexii
713890.png,https://derpicdn.net/img/view/2014/9/3/713890.png,3,0.9763631224632264,24,1736,448,2160,424,424,applejack|fluttershy|mane six|pinkie pie|rainbow dash|rarity|twilight sparkle,sutexii
714005.png,https://derpicdn.net/img/view/2014/9/3/714005.png,1,0.9866184592247008,196,1157,892,1853,696,696,applejack|fluttershy|mane six|pinkie pie|rainbow dash|rarity|twilight sparkle,aleximusprime
714005.png,https://derpicdn.net/img/view/2014/9/3/714005.png,2,0.9202481508255004,2075,1197,2689,1811,614,614,applejack|fluttershy|mane six|pinkie pie|rainbow dash|rarity|twilight sparkle,aleximusprime
718815.png,https://derpicdn.net/img/view/2014/9/9/718815.png,0,0.9987327456474304,483,0,775,268,292,268,rainbow dash|twilight sparkle,keyfeathers
718815.png,https://derpicdn.net/img/view/2014/9/9/718815.png,1,0.9455549120903016,163,0,405,242,242,242,rainbow dash|twilight sparkle,keyfeathers
720634.png,https://derpicdn.net/img/view/2014/9/12/720634.png,0,0.9972930550575256,307,38,725,456,418,418,trixie|twilight sparkle,tracymod
721841.png,https://derpicdn.net/img/view/2014/9/14/721841.png,0,0.998583436012268,358,0,746,370,388,370,applejack|fluttershy|mane six|pinkie pie|rainbow dash|rarity|spike|twilight sparkle,pixiedot9
72191.jpg,https://derpicdn.net/img/view/2012/8/11/72191.jpg,0,0.9569489359855652,309,256,505,452,196,196,applejack|fluttershy|mane six|pinkie pie|rainbow dash|rarity|twilight sparkle,cobracookies
723155.png,https://derpicdn.net/img/view/2014/9/16/723155.png,0,0.9841963052749634,1062,122,1338,398,276,276,applejack|fluttershy|mane six|pinkie pie|rainbow dash|rarity|soarin'|spike|twilight sparkle,dm29
725775.png,https://derpicdn.net/img/view/2014/9/20/725775.png,0,0.9908668398857116,630,206,964,540,334,334,princess cadance|princess celestia|princess luna|twilight sparkle,tricolorarts
726415.png,https://derpicdn.net/img/view/2014/9/21/726415.png,0,0.9995517134666444,2728,893,3844,2009,1116,1116,applejack|fluttershy|mane six|pinkie pie|rainbow dash|rarity|twilight sparkle,mephysta
726415.png,https://derpicdn.net/img/view/2014/9/21/726415.png,1,0.9974161386489868,0,845,988,1865,988,1020,applejack|fluttershy|mane six|pinkie pie|rainbow dash|rarity|twilight sparkle,mephysta
726415.png,https://derpicdn.net/img/view/2014/9/21/726415.png,2,0.9950862526893616,2308,273,3052,1017,744,744,applejack|fluttershy|mane six|pinkie pie|rainbow dash|rarity|twilight sparkle,mephysta
726415.png,https://derpicdn.net/img/view/2014/9/21/726415.png,3,0.9914416074752808,926,409,1592,1075,666,666,applejack|fluttershy|mane six|pinkie pie|rainbow dash|rarity|twilight sparkle,mephysta
728783.png,https://derpicdn.net/img/view/2014/9/24/728783.png,1,0.9815008640289308,956,1309,1128,1481,172,172,apple bloom|applejack|fluttershy|pinkie pie|rainbow dash|rarity|scootaloo|spike|sweetie belle|trixie|twilight sparkle,inlucidreverie|ulyssesgrant|facade|kalemon|hombre cerdo|plain|itspencilguy|sabsy|starlessnight22|jetwave|mrlolcats17|captainhoers|penby|cazra|vector-brony|ralek|thatdarnpony|neuro|brisineo|madmax|pantzar|piesarts|starryoak|yenamuffin|whydomenhavenipples|demon-keychain|olafski|erthilo|outlawedtofu|lulubell
728783.png,https://derpicdn.net/img/view/2014/9/24/728783.png,4,0.9678810238838196,592,360,752,520,160,160,apple bloom|applejack|fluttershy|pinkie pie|rainbow dash|rarity|scootaloo|spike|sweetie belle|trixie|twilight sparkle,inlucidreverie|ulyssesgrant|facade|kalemon|hombre cerdo|plain|itspencilguy|sabsy|starlessnight22|jetwave|mrlolcats17|captainhoers|penby|cazra|vector-brony|ralek|thatdarnpony|neuro|brisineo|madmax|pantzar|piesarts|starryoak|yenamuffin|whydomenhavenipples|demon-keychain|olafski|erthilo|outlawedtofu|lulubell
728783.png,https://derpicdn.net/img/view/2014/9/24/728783.png,7,0.9576041698455808,1329,383,1489,543,160,160,apple bloom|applejack|fluttershy|pinkie pie|rainbow dash|rarity|scootaloo|spike|sweetie belle|trixie|twilight sparkle,inlucidreverie|ulyssesgrant|facade|kalemon|hombre cerdo|plain|itspencilguy|sabsy|starlessnight22|jetwave|mrlolcats17|captainhoers|penby|cazra|vector-brony|ralek|thatdarnpony|neuro|brisineo|madmax|pantzar|piesarts|starryoak|yenamuffin|whydomenhavenipples|demon-keychain|olafski|erthilo|outlawedtofu|lulubell
728783.png,https://derpicdn.net/img/view/2014/9/24/728783.png,8,0.9573988914489746,558,0,734,172,176,172,apple bloom|applejack|fluttershy|pinkie pie|rainbow dash|rarity|scootaloo|spike|sweetie belle|trixie|twilight sparkle,inlucidreverie|ulyssesgrant|facade|kalemon|hombre cerdo|plain|itspencilguy|sabsy|starlessnight22|jetwave|mrlolcats17|captainhoers|penby|cazra|vector-brony|ralek|thatdarnpony|neuro|brisineo|madmax|pantzar|piesarts|starryoak|yenamuffin|whydomenhavenipples|demon-keychain|olafski|erthilo|outlawedtofu|lulubell
728783.png,https://derpicdn.net/img/view/2014/9/24/728783.png,11,0.9356971979141236,588,200,754,366,166,166,apple bloom|applejack|fluttershy|pinkie pie|rainbow dash|rarity|scootaloo|spike|sweetie belle|trixie|twilight sparkle,inlucidreverie|ulyssesgrant|facade|kalemon|hombre cerdo|plain|itspencilguy|sabsy|starlessnight22|jetwave|mrlolcats17|captainhoers|penby|cazra|vector-brony|ralek|thatdarnpony|neuro|brisineo|madmax|pantzar|piesarts|starryoak|yenamuffin|whydomenhavenipples|demon-keychain|olafski|erthilo|outlawedtofu|lulubell
728783.png,https://derpicdn.net/img/view/2014/9/24/728783.png,12,0.9338393211364746,39,561,201,723,162,162,apple bloom|applejack|fluttershy|pinkie pie|rainbow dash|rarity|scootaloo|spike|sweetie belle|trixie|twilight sparkle,inlucidreverie|ulyssesgrant|facade|kalemon|hombre cerdo|plain|itspencilguy|sabsy|starlessnight22|jetwave|mrlolcats17|captainhoers|penby|cazra|vector-brony|ralek|thatdarnpony|neuro|brisineo|madmax|pantzar|piesarts|starryoak|yenamuffin|whydomenhavenipples|demon-keychain|olafski|erthilo|outlawedtofu|lulubell
728783.png,https://derpicdn.net/img/view/2014/9/24/728783.png,13,0.9320509433746338,1521,1325,1669,1473,148,148,apple bloom|applejack|fluttershy|pinkie pie|rainbow dash|rarity|scootaloo|spike|sweetie belle|trixie|twilight sparkle,inlucidreverie|ulyssesgrant|facade|kalemon|hombre cerdo|plain|itspencilguy|sabsy|starlessnight22|jetwave|mrlolcats17|captainhoers|penby|cazra|vector-brony|ralek|thatdarnpony|neuro|brisineo|madmax|pantzar|piesarts|starryoak|yenamuffin|whydomenhavenipples|demon-keychain|olafski|erthilo|outlawedtofu|lulubell
728783.png,https://derpicdn.net/img/view/2014/9/24/728783.png,14,0.9262160658836364,192,368,380,556,188,188,apple bloom|applejack|fluttershy|pinkie pie|rainbow dash|rarity|scootaloo|spike|sweetie belle|trixie|twilight sparkle,inlucidreverie|ulyssesgrant|facade|kalemon|hombre cerdo|plain|itspencilguy|sabsy|starlessnight22|jetwave|mrlolcats17|captainhoers|penby|cazra|vector-brony|ralek|thatdarnpony|neuro|brisineo|madmax|pantzar|piesarts|starryoak|yenamuffin|whydomenhavenipples|demon-keychain|olafski|erthilo|outlawedtofu|lulubell
728783.png,https://derpicdn.net/img/view/2014/9/24/728783.png,15,0.9177771210670472,395,1517,545,1667,150,150,apple bloom|applejack|fluttershy|pinkie pie|rainbow dash|rarity|scootaloo|spike|sweetie belle|trixie|twilight sparkle,inlucidreverie|ulyssesgrant|facade|kalemon|hombre cerdo|plain|itspencilguy|sabsy|starlessnight22|jetwave|mrlolcats17|captainhoers|penby|cazra|vector-brony|ralek|thatdarnpony|neuro|brisineo|madmax|pantzar|piesarts|starryoak|yenamuffin|whydomenhavenipples|demon-keychain|olafski|erthilo|outlawedtofu|lulubell
728783.png,https://derpicdn.net/img/view/2014/9/24/728783.png,16,0.9078834652900696,950,0,1118,163,168,163,apple bloom|applejack|fluttershy|pinkie pie|rainbow dash|rarity|scootaloo|spike|sweetie belle|trixie|twilight sparkle,inlucidreverie|ulyssesgrant|facade|kalemon|hombre cerdo|plain|itspencilguy|sabsy|starlessnight22|jetwave|mrlolcats17|captainhoers|penby|cazra|vector-brony|ralek|thatdarnpony|neuro|brisineo|madmax|pantzar|piesarts|starryoak|yenamuffin|whydomenhavenipples|demon-keychain|olafski|erthilo|outlawedtofu|lulubell
728783.png,https://derpicdn.net/img/view/2014/9/24/728783.png,17,0.9072821736335754,1145,1494,1325,1674,180,180,apple bloom|applejack|fluttershy|pinkie pie|rainbow dash|rarity|scootaloo|spike|sweetie belle|trixie|twilight sparkle,inlucidreverie|ulyssesgrant|facade|kalemon|hombre cerdo|plain|itspencilguy|sabsy|starlessnight22|jetwave|mrlolcats17|captainhoers|penby|cazra|vector-brony|ralek|thatdarnpony|neuro|brisineo|madmax|pantzar|piesarts|starryoak|yenamuffin|whydomenhavenipples|demon-keychain|olafski|erthilo|outlawedtofu|lulubell
728783.png,https://derpicdn.net/img/view/2014/9/24/728783.png,18,0.9032081365585328,776,397,918,539,142,142,apple bloom|applejack|fluttershy|pinkie pie|rainbow dash|rarity|scootaloo|spike|sweetie belle|trixie|twilight sparkle,inlucidreverie|ulyssesgrant|facade|kalemon|hombre cerdo|plain|itspencilguy|sabsy|starlessnight22|jetwave|mrlolcats17|captainhoers|penby|cazra|vector-brony|ralek|thatdarnpony|neuro|brisineo|madmax|pantzar|piesarts|starryoak|yenamuffin|whydomenhavenipples|demon-keychain|olafski|erthilo|outlawedtofu|lulubell
728783.png,https://derpicdn.net/img/view/2014/9/24/728783.png,19,0.9029557108879088,584,1139,740,1295,156,156,apple bloom|applejack|fluttershy|pinkie pie|rainbow dash|rarity|scootaloo|spike|sweetie belle|trixie|twilight sparkle,inlucidreverie|ulyssesgrant|facade|kalemon|hombre cerdo|plain|itspencilguy|sabsy|starlessnight22|jetwave|mrlolcats17|captainhoers|penby|cazra|vector-brony|ralek|thatdarnpony|neuro|brisineo|madmax|pantzar|piesarts|starryoak|yenamuffin|whydomenhavenipples|demon-keychain|olafski|erthilo|outlawedtofu|lulubell
729817.jpg,https://derpicdn.net/img/view/2014/9/26/729817.jpg,0,0.9748698472976683,518,56,684,222,166,166,applejack|big macintosh|fluttershy|mane six|pinkie pie|princess celestia|princess luna|rainbow dash|rarity|spike|twilight sparkle,
729817.jpg,https://derpicdn.net/img/view/2014/9/26/729817.jpg,1,0.9491238594055176,0,34,173,232,173,198,applejack|big macintosh|fluttershy|mane six|pinkie pie|princess celestia|princess luna|rainbow dash|rarity|spike|twilight sparkle,
729924.png,https://derpicdn.net/img/view/2014/9/26/729924.png,0,0.997205913066864,513,237,899,623,386,386,princess celestia|princess luna|twilight sparkle,dreamyartcosplay
729924.png,https://derpicdn.net/img/view/2014/9/26/729924.png,1,0.9854581952095032,6,0,480,394,474,394,princess celestia|princess luna|twilight sparkle,dreamyartcosplay
729924.png,https://derpicdn.net/img/view/2014/9/26/729924.png,2,0.9689976572990416,1054,16,1500,472,446,456,princess celestia|princess luna|twilight sparkle,dreamyartcosplay
740095.png,https://derpicdn.net/img/view/2014/10/10/740095.png,0,0.9915003776550292,171,523,439,791,268,268,applejack|fluttershy|mane six|pinkie pie|rainbow dash|rarity|spike|twilight sparkle,dm29
740095.png,https://derpicdn.net/img/view/2014/10/10/740095.png,1,0.987675130367279,832,649,1060,877,228,228,applejack|fluttershy|mane six|pinkie pie|rainbow dash|rarity|spike|twilight sparkle,dm29
741428.png,https://derpicdn.net/img/view/2014/10/12/741428.png,0,0.9900608062744141,0,0,381,334,381,334,applejack|fluttershy|mane six|pinkie pie|rainbow dash|rarity|twilight sparkle,tobias1997
743121.png,https://derpicdn.net/img/view/2014/10/14/743121.png,0,0.9446369409561156,1776,62,2680,966,904,904,trixie|twilight sparkle,meowing-ghost
7444.jpg,https://derpicdn.net/img/view/2012/6/18/7444.jpg,0,0.9899634122848512,225,209,439,423,214,214,princess celestia|princess luna|trixie|twilight sparkle,yamino
7444.jpg,https://derpicdn.net/img/view/2012/6/18/7444.jpg,1,0.9201063513755798,415,195,655,435,240,240,princess celestia|princess luna|trixie|twilight sparkle,yamino
745894.png,https://derpicdn.net/img/view/2014/10/19/745894.png,0,0.9939445257186892,186,0,1470,997,1284,997,trixie|twilight sparkle,wolfy-pony
747600.png,https://derpicdn.net/img/view/2014/10/21/747600.png,0,0.9905043840408324,310,55,546,291,236,236,spike|twilight sparkle,tailzkipzigona
748980.png,https://derpicdn.net/img/view/2014/10/23/748980.png,0,0.9806896448135376,422,320,1300,1216,878,896,trixie|twilight sparkle,neko3240
750932.png,https://derpicdn.net/img/view/2014/10/26/750932.png,0,0.9939860105514526,369,531,921,1083,552,552,applejack|fluttershy|mane six|pinkie pie|rainbow dash|rarity|twilight sparkle,kikirrikitiki
750932.png,https://derpicdn.net/img/view/2014/10/26/750932.png,3,0.9377892017364502,29,544,467,982,438,438,applejack|fluttershy|mane six|pinkie pie|rainbow dash|rarity|twilight sparkle,kikirrikitiki
754100.png,https://derpicdn.net/img/view/2014/10/30/754100.png,1,0.9847899675369264,97,351,289,543,192,192,big macintosh|twilight sparkle,metal-kitty
754100.png,https://derpicdn.net/img/view/2014/10/30/754100.png,2,0.976032018661499,329,15,579,265,250,250,big macintosh|twilight sparkle,metal-kitty
755149.png,https://derpicdn.net/img/view/2014/11/1/755149.png,0,0.9212964773178101,125,106,741,722,616,616,rainbow dash|twilight sparkle,shikimaakemi
755202.png,https://derpicdn.net/img/view/2014/11/1/755202.png,0,0.9975610971450806,1549,163,1973,587,424,424,applejack|fluttershy|mane six|pinkie pie|rainbow dash|rarity|twilight sparkle,rainbowsprinklesart
755202.png,https://derpicdn.net/img/view/2014/11/1/755202.png,2,0.9619678854942322,1112,101,1552,541,440,440,applejack|fluttershy|mane six|pinkie pie|rainbow dash|rarity|twilight sparkle,rainbowsprinklesart
757802.png,https://derpicdn.net/img/view/2014/11/4/757802.png,0,0.9935809373855592,0,0,552,581,552,581,spike|twilight sparkle,turbulosus
757987.png,https://derpicdn.net/img/view/2014/11/4/757987.png,0,0.9957439303398132,197,165,603,571,406,406,fluttershy|twilight sparkle,keterok
757987.png,https://derpicdn.net/img/view/2014/11/4/757987.png,1,0.9839369058609008,679,261,1111,693,432,432,fluttershy|twilight sparkle,keterok
758185.png,https://derpicdn.net/img/view/2014/11/5/758185.png,0,0.9996621608734132,0,2,478,500,478,498,rarity|twilight sparkle,port-pup
758265.png,https://derpicdn.net/img/view/2014/11/5/758265.png,0,0.9093986749649048,1016,1519,1468,1971,452,452,applejack|fluttershy|mane six|pinkie pie|rainbow dash|rarity|spike|twilight sparkle,spacekitty
762272.png,https://derpicdn.net/img/view/2014/11/11/762272.png,0,0.9877686500549316,6,138,416,548,410,410,fluttershy|twilight sparkle,coggler
774344.png,https://derpicdn.net/img/view/2014/11/29/774344.png,0,0.9987779259681702,1359,396,2145,1182,786,786,rarity|twilight sparkle,reimon-master-ii|ponyguy67
775319.png,https://derpicdn.net/img/view/2014/11/30/775319.png,1,0.9846751093864441,981,3473,2087,4579,1106,1106,applejack|fluttershy|mane six|pinkie pie|rainbow dash|rarity|twilight sparkle,hirurux
775319.png,https://derpicdn.net/img/view/2014/11/30/775319.png,2,0.9431041479110718,515,2146,1513,3144,998,998,applejack|fluttershy|mane six|pinkie pie|rainbow dash|rarity|twilight sparkle,hirurux
775319.png,https://derpicdn.net/img/view/2014/11/30/775319.png,4,0.9019217491149902,858,2901,1552,3595,694,694,applejack|fluttershy|mane six|pinkie pie|rainbow dash|rarity|twilight sparkle,hirurux
775664.png,https://derpicdn.net/img/view/2014/12/1/775664.png,1,0.9883955717086792,854,0,1422,455,568,455,applejack|fluttershy|mane six|pinkie pie|rainbow dash|rarity|twilight sparkle,dashiemlpfim|kaylathehedgehog
776720.png,https://derpicdn.net/img/view/2014/12/2/776720.png,1,0.9813110828399658,515,261,863,609,348,348,pinkie pie|twilight sparkle,whatsapokemon
777239.png,https://derpicdn.net/img/view/2014/12/3/777239.png,0,0.9214747548103333,72,0,474,350,402,350,sunset shimmer|twilight sparkle,catlover1672
779870.png,https://derpicdn.net/img/view/2014/12/7/779870.png,0,0.9945378303527832,292,53,839,615,547,562,princess cadance|shining armor|twilight sparkle,dm29
779870.png,https://derpicdn.net/img/view/2014/12/7/779870.png,2,0.976693332195282,182,763,518,1099,336,336,princess cadance|shining armor|twilight sparkle,dm29
785087.png,https://derpicdn.net/img/view/2014/12/14/785087.png,0,0.9969558715820312,2023,90,3423,1490,1400,1400,princess celestia|twilight sparkle,neko-me
785424.png,https://derpicdn.net/img/view/2014/12/15/785424.png,0,0.9236128330230712,17,0,277,249,260,249,sunset shimmer|twilight sparkle,ciscoql
785922.jpg,https://derpicdn.net/img/view/2014/12/16/785922.jpg,0,0.9961293935775756,41,45,531,535,490,490,applejack|pinkie pie|rainbow dash|twilight sparkle,ladyanidraws
785922.jpg,https://derpicdn.net/img/view/2014/12/16/785922.jpg,1,0.9603405594825744,514,584,728,798,214,214,applejack|pinkie pie|rainbow dash|twilight sparkle,ladyanidraws
788559.jpg,https://derpicdn.net/img/view/2014/12/20/788559.jpg,1,0.9937593936920166,373,357,617,601,244,244,applejack|fluttershy|pinkie pie|rainbow dash|rarity|twilight sparkle,s-bis
791002.png,https://derpicdn.net/img/view/2014/12/23/791002.png,0,0.9946295022964478,549,97,803,351,254,254,princess cadance|princess celestia|princess luna|twilight sparkle,varemia
791762.png,https://derpicdn.net/img/view/2014/12/24/791762.png,0,0.9448490738868712,5443,4416,7277,6250,1834,1834,applejack|fluttershy|mane six|pinkie pie|rainbow dash|rarity|twilight sparkle,starlessnight22
79314.png,https://derpicdn.net/img/view/2012/8/21/79314.png,1,0.9923094511032104,228,0,434,185,206,185,big macintosh|fluttershy|pinkie pie|rainbow dash|spike|twilight sparkle,stupjam
794176.png,https://derpicdn.net/img/view/2014/12/28/794176.png,0,0.9970892667770386,1118,499,1662,1043,544,544,applejack|fluttershy|mane six|pinkie pie|rainbow dash|rarity|twilight sparkle,shinodage
794176.png,https://derpicdn.net/img/view/2014/12/28/794176.png,1,0.9897469282150269,2353,0,2861,460,508,460,applejack|fluttershy|mane six|pinkie pie|rainbow dash|rarity|twilight sparkle,shinodage
794176.png,https://derpicdn.net/img/view/2014/12/28/794176.png,2,0.9793368577957152,977,1457,1637,2117,660,660,applejack|fluttershy|mane six|pinkie pie|rainbow dash|rarity|twilight sparkle,shinodage
799666.png,https://derpicdn.net/img/view/2015/1/4/799666.png,1,0.9721537828445436,1715,0,2261,542,546,542,applejack|fluttershy|mane six|pinkie pie|rainbow dash|rarity|sunset shimmer|twilight sparkle,silent-shadow-wolf
800198.png,https://derpicdn.net/img/view/2015/1/5/800198.png,0,0.989027202129364,767,565,1515,1313,748,748,discord|princess cadance|shining armor|twilight sparkle,silcybell
801219.png,https://derpicdn.net/img/view/2015/1/7/801219.png,0,0.990581214427948,635,0,1749,1064,1114,1064,sunset shimmer|twilight sparkle,dazed-and-wandering
80277.png,https://derpicdn.net/img/view/2012/8/22/80277.png,0,0.9640669226646424,94,317,248,471,154,154,applejack|fluttershy|mane six|pinkie pie|rainbow dash|rarity|spike|twilight sparkle,suikuzu
80277.png,https://derpicdn.net/img/view/2012/8/22/80277.png,1,0.9299326539039612,241,336,421,516,180,180,applejack|fluttershy|mane six|pinkie pie|rainbow dash|rarity|spike|twilight sparkle,suikuzu
80277.png,https://derpicdn.net/img/view/2012/8/22/80277.png,2,0.9256414771080016,284,0,468,176,184,176,applejack|fluttershy|mane six|pinkie pie|rainbow dash|rarity|spike|twilight sparkle,suikuzu
803754.png,https://derpicdn.net/img/view/2015/1/11/803754.png,0,0.9944356083869934,382,0,882,461,500,461,applejack|fluttershy|mane six|pinkie pie|rainbow dash|rarity|twilight sparkle,equestria-election
803754.png,https://derpicdn.net/img/view/2015/1/11/803754.png,1,0.9784277677536012,836,0,1262,403,426,403,applejack|fluttershy|mane six|pinkie pie|rainbow dash|rarity|twilight sparkle,equestria-election
803754.png,https://derpicdn.net/img/view/2015/1/11/803754.png,3,0.9048609137535096,9,481,521,993,512,512,applejack|fluttershy|mane six|pinkie pie|rainbow dash|rarity|twilight sparkle,equestria-election
805751.png,https://derpicdn.net/img/view/2015/1/13/805751.png,0,0.9875144958496094,194,577,442,825,248,248,applejack|pinkie pie|princess luna|rainbow dash|rarity|spike|twilight sparkle,kkitsu
806627.png,https://derpicdn.net/img/view/2015/1/14/806627.png,0,0.9953699707984924,891,820,1391,1320,500,500,fluttershy|pinkie pie|twilight sparkle,
806627.png,https://derpicdn.net/img/view/2015/1/14/806627.png,1,0.9761906266212464,14,263,264,513,250,250,fluttershy|pinkie pie|twilight sparkle,
806715.png,https://derpicdn.net/img/view/2015/1/14/806715.png,0,0.9978328943252563,575,743,1831,1999,1256,1256,trixie|twilight sparkle,yaaaco
806715.png,https://derpicdn.net/img/view/2015/1/14/806715.png,1,0.974777340888977,2938,800,4046,1908,1108,1108,trixie|twilight sparkle,yaaaco
808055.png,https://derpicdn.net/img/view/2015/1/16/808055.png,0,0.912315845489502,361,201,939,779,578,578,trixie|twilight sparkle,navitaserussirus
813300.jpg,https://derpicdn.net/img/view/2015/1/24/813300.jpg,0,0.9861336946487428,362,47,718,403,356,356,sunset shimmer|trixie|twilight sparkle,feather
813731.png,https://derpicdn.net/img/view/2015/1/24/813731.png,0,0.9952222108840942,182,105,464,387,282,282,sunset shimmer|twilight sparkle,lekelbel
813731.png,https://derpicdn.net/img/view/2015/1/24/813731.png,1,0.9601887464523317,492,248,858,614,366,366,sunset shimmer|twilight sparkle,lekelbel
814473.png,https://derpicdn.net/img/view/2015/1/25/814473.png,0,0.9249969124794006,122,0,394,272,272,272,applejack|fluttershy|mane six|pinkie pie|princess celestia|princess luna|queen chrysalis|rainbow dash|rarity|trixie|twilight sparkle,karzahnii
822695.png,https://derpicdn.net/img/view/2015/2/6/822695.png,0,0.9186668992042542,427,273,593,439,166,166,applejack|fluttershy|pinkie pie|princess cadance|princess celestia|queen chrysalis|rainbow dash|rarity|shining armor|twilight sparkle,mixermike622
826027.png,https://derpicdn.net/img/view/2015/2/11/826027.png,0,0.9405571818351746,416,45,1240,973,824,928,princess celestia|twilight sparkle,plainoasis
830953.png,https://derpicdn.net/img/view/2015/2/17/830953.png,0,0.9944375157356262,1092,379,1438,725,346,346,applejack|discord|fluttershy|mane six|pinkie pie|princess cadance|princess celestia|princess luna|queen chrysalis|rainbow dash|rarity|spike|sunset shimmer|trixie|twilight sparkle,yang0
830953.png,https://derpicdn.net/img/view/2015/2/17/830953.png,3,0.96872740983963,1368,556,1600,790,232,234,applejack|discord|fluttershy|mane six|pinkie pie|princess cadance|princess celestia|princess luna|queen chrysalis|rainbow dash|rarity|spike|sunset shimmer|trixie|twilight sparkle,yang0
830953.png,https://derpicdn.net/img/view/2015/2/17/830953.png,5,0.9409085512161256,49,469,329,749,280,280,applejack|discord|fluttershy|mane six|pinkie pie|princess cadance|princess celestia|princess luna|queen chrysalis|rainbow dash|rarity|spike|sunset shimmer|trixie|twilight sparkle,yang0
830953.png,https://derpicdn.net/img/view/2015/2/17/830953.png,6,0.9232531189918518,196,550,574,928,378,378,applejack|discord|fluttershy|mane six|pinkie pie|princess cadance|princess celestia|princess luna|queen chrysalis|rainbow dash|rarity|spike|sunset shimmer|trixie|twilight sparkle,yang0
832490.jpg,https://derpicdn.net/img/view/2015/2/19/832490.jpg,0,0.9971852898597716,819,15,1251,447,432,432,applejack|fluttershy|mane six|pinkie pie|rainbow dash|rarity|sunset shimmer|twilight sparkle,daikoku
832490.jpg,https://derpicdn.net/img/view/2015/2/19/832490.jpg,1,0.994064450263977,339,0,799,439,460,439,applejack|fluttershy|mane six|pinkie pie|rainbow dash|rarity|sunset shimmer|twilight sparkle,daikoku
832685.jpg,https://derpicdn.net/img/view/2015/2/19/832685.jpg,1,0.9672715067863464,335,0,651,288,316,288,apple bloom|applejack|cutie mark crusaders|fluttershy|mane six|pinkie pie|rainbow dash|rarity|scootaloo|spike|sweetie belle|twilight sparkle,ponygoddess
832685.jpg,https://derpicdn.net/img/view/2015/2/19/832685.jpg,2,0.9641427993774414,700,0,1002,267,302,267,apple bloom|applejack|cutie mark crusaders|fluttershy|mane six|pinkie pie|rainbow dash|rarity|scootaloo|spike|sweetie belle|twilight sparkle,ponygoddess
832685.jpg,https://derpicdn.net/img/view/2015/2/19/832685.jpg,3,0.9277696013450624,0,51,204,267,204,216,apple bloom|applejack|cutie mark crusaders|fluttershy|mane six|pinkie pie|rainbow dash|rarity|scootaloo|spike|sweetie belle|twilight sparkle,ponygoddess
833632.png,https://derpicdn.net/img/view/2015/2/21/833632.png,0,0.9055083394050598,150,0,466,291,316,291,princess luna|twilight sparkle,lulubell
833760.png,https://derpicdn.net/img/view/2015/2/21/833760.png,0,0.9981561303138732,108,136,454,482,346,346,trixie|twilight sparkle,collaredginger
835976.png,https://derpicdn.net/img/view/2015/2/23/835976.png,0,0.9808270931243896,34,0,588,497,554,497,applejack|big macintosh|fluttershy|mane six|pinkie pie|princess celestia|princess luna|rainbow dash|rarity|spike|spitfire|trixie|twilight sparkle,blackm3sh|moongazeponies|atomicgreymon|binaryninj4|alicehumansacrifice0|yoome
836212.png,https://derpicdn.net/img/view/2015/2/24/836212.png,0,0.9910808205604552,99,12,289,202,190,190,applejack|fluttershy|mane six|pinkie pie|rainbow dash|rarity|spike|twilight sparkle,batlover800
836732.png,https://derpicdn.net/img/view/2015/2/24/836732.png,0,0.9989702105522156,400,23,634,257,234,234,princess luna|twilight sparkle,theparagon
837566.png,https://derpicdn.net/img/view/2015/2/26/837566.png,0,0.9802083969116212,99,167,985,1053,886,886,spike|twilight sparkle,aleximusprime
837952.jpg,https://derpicdn.net/img/view/2015/2/26/837952.jpg,0,0.9753971695899964,627,148,1039,560,412,412,shining armor|twilight sparkle,silfoe
842246.png,https://derpicdn.net/img/view/2015/3/4/842246.png,0,0.9956641197204592,721,702,1265,1246,544,544,discord|twilight sparkle,silcybell
842734.png,https://derpicdn.net/img/view/2015/3/5/842734.png,0,0.9976699948310852,692,0,838,142,146,142,applejack|fluttershy|mane six|pinkie pie|rainbow dash|rarity|spike|twilight sparkle,yoonny92
842734.png,https://derpicdn.net/img/view/2015/3/5/842734.png,1,0.9955341219902042,290,0,450,156,160,156,applejack|fluttershy|mane six|pinkie pie|rainbow dash|rarity|spike|twilight sparkle,yoonny92
842734.png,https://derpicdn.net/img/view/2015/3/5/842734.png,2,0.9876143932342528,12,0,170,146,158,146,applejack|fluttershy|mane six|pinkie pie|rainbow dash|rarity|spike|twilight sparkle,yoonny92
842734.png,https://derpicdn.net/img/view/2015/3/5/842734.png,3,0.9060989022254944,281,217,441,377,160,160,applejack|fluttershy|mane six|pinkie pie|rainbow dash|rarity|spike|twilight sparkle,yoonny92
842736.png,https://derpicdn.net/img/view/2015/3/5/842736.png,0,0.9959600567817688,2087,1455,2831,2199,744,744,applejack|fluttershy|mane six|pinkie pie|rainbow dash|rarity|sunset shimmer|twilight sparkle,nintendash
842736.png,https://derpicdn.net/img/view/2015/3/5/842736.png,1,0.9939121007919312,2065,229,2821,985,756,756,applejack|fluttershy|mane six|pinkie pie|rainbow dash|rarity|sunset shimmer|twilight sparkle,nintendash
842736.png,https://derpicdn.net/img/view/2015/3/5/842736.png,2,0.9392769932746888,1468,998,2206,1736,738,738,applejack|fluttershy|mane six|pinkie pie|rainbow dash|rarity|sunset shimmer|twilight sparkle,nintendash
843738.jpg,https://derpicdn.net/img/view/2015/3/6/843738.jpg,0,0.9883852601051332,118,0,696,472,578,472,pinkie pie|twilight sparkle,fromamida
849512.png,https://derpicdn.net/img/view/2015/3/14/849512.png,0,0.9986647963523864,4,0,438,389,434,389,fluttershy|sunset shimmer|twilight sparkle,lustrous-dreams
849512.png,https://derpicdn.net/img/view/2015/3/14/849512.png,2,0.9954172968864441,698,0,1108,359,410,359,fluttershy|sunset shimmer|twilight sparkle,lustrous-dreams
849512.png,https://derpicdn.net/img/view/2015/3/14/849512.png,3,0.9896804094314576,102,672,502,1072,400,400,fluttershy|sunset shimmer|twilight sparkle,lustrous-dreams
850935.jpg,https://derpicdn.net/img/view/2015/3/16/850935.jpg,0,0.9911342859268188,1236,1301,2144,2209,908,908,applejack|fluttershy|mane six|pinkie pie|rainbow dash|rarity|twilight sparkle,catseyeart
850935.jpg,https://derpicdn.net/img/view/2015/3/16/850935.jpg,1,0.963005781173706,2239,78,3355,1194,1116,1116,applejack|fluttershy|mane six|pinkie pie|rainbow dash|rarity|twilight sparkle,catseyeart
850935.jpg,https://derpicdn.net/img/view/2015/3/16/850935.jpg,2,0.9530872106552124,0,0,1038,1025,1038,1025,applejack|fluttershy|mane six|pinkie pie|rainbow dash|rarity|twilight sparkle,catseyeart
852201.jpg,https://derpicdn.net/img/view/2015/3/18/852201.jpg,0,0.995107114315033,3694,1458,4872,2636,1178,1178,applejack|fluttershy|mane six|pinkie pie|rainbow dash|rarity|twilight sparkle,catseyeart
852201.jpg,https://derpicdn.net/img/view/2015/3/18/852201.jpg,1,0.9740656018257141,1333,116,2383,1166,1050,1050,applejack|fluttershy|mane six|pinkie pie|rainbow dash|rarity|twilight sparkle,catseyeart
852831.jpg,https://derpicdn.net/img/view/2015/3/19/852831.jpg,0,0.9770305752754213,216,453,432,669,216,216,applejack|fluttershy|pinkie pie|rainbow dash|rarity|twilight sparkle,
854599.png,https://derpicdn.net/img/view/2015/3/22/854599.png,0,0.9758381247520448,563,933,1001,1371,438,438,sunset shimmer|trixie|twilight sparkle,cloureed
855217.png,https://derpicdn.net/img/view/2015/3/22/855217.png,2,0.9201615452766418,151,2,767,618,616,616,applejack|fluttershy|mane six|pinkie pie|rainbow dash|rarity|twilight sparkle,fuyusfox
855877.png,https://derpicdn.net/img/view/2015/3/23/855877.png,0,0.98460590839386,6038,138,7620,1720,1582,1582,applejack|fluttershy|mane six|pinkie pie|rainbow dash|rarity|spike|twilight sparkle,infinitewarlock
855877.png,https://derpicdn.net/img/view/2015/3/23/855877.png,1,0.9614056348800659,3006,18,4708,1720,1702,1702,applejack|fluttershy|mane six|pinkie pie|rainbow dash|rarity|spike|twilight sparkle,infinitewarlock
856741.png,https://derpicdn.net/img/view/2015/3/25/856741.png,0,0.9788712859153748,182,14,504,336,322,322,applejack|fluttershy|mane six|pinkie pie|rainbow dash|rarity|twilight sparkle,ahmonaeatchu123
859764.png,https://derpicdn.net/img/view/2015/3/29/859764.png,0,0.9699226021766664,314,6,1024,756,710,750,starlight glimmer|twilight sparkle,ayachiichan
859827.png,https://derpicdn.net/img/view/2015/3/29/859827.png,0,0.9373812675476074,1421,328,1703,610,282,282,applejack|big macintosh|pinkie pie|rainbow dash|rarity|shining armor|twilight sparkle,bonbrony
863134.png,https://derpicdn.net/img/view/2015/4/2/863134.png,0,0.9855204820632936,345,585,627,867,282,282,sunset shimmer|trixie|twilight sparkle,cloureed
863210.png,https://derpicdn.net/img/view/2015/4/2/863210.png,0,0.9956849217414856,457,1823,1191,2557,734,734,applejack|fluttershy|mane six|pinkie pie|rainbow dash|rarity|spike|twilight sparkle,davidcurser
863210.png,https://derpicdn.net/img/view/2015/4/2/863210.png,1,0.9737876057624816,1479,884,2245,1650,766,766,applejack|fluttershy|mane six|pinkie pie|rainbow dash|rarity|spike|twilight sparkle,davidcurser
863210.png,https://derpicdn.net/img/view/2015/4/2/863210.png,2,0.9396249055862428,18,2589,926,3497,908,908,applejack|fluttershy|mane six|pinkie pie|rainbow dash|rarity|spike|twilight sparkle,davidcurser
863529.png,https://derpicdn.net/img/view/2015/4/3/863529.png,1,0.946330726146698,330,1283,636,1589,306,306,applejack|fluttershy|mane six|pinkie pie|rainbow dash|rarity|spike|twilight sparkle,dstears
863529.png,https://derpicdn.net/img/view/2015/4/3/863529.png,2,0.9344544410705566,612,1041,990,1419,378,378,applejack|fluttershy|mane six|pinkie pie|rainbow dash|rarity|spike|twilight sparkle,dstears
865115.png,https://derpicdn.net/img/view/2015/4/4/865115.png,0,0.9658789038658142,609,32,845,268,236,236,trixie|twilight sparkle,jamescorck
865202.jpg,https://derpicdn.net/img/view/2015/4/4/865202.jpg,0,0.9892239570617676,73,280,337,544,264,264,applejack|fluttershy|mane six|pinkie pie|rainbow dash|rarity|twilight sparkle,
865202.jpg,https://derpicdn.net/img/view/2015/4/4/865202.jpg,1,0.9161331653594972,941,231,1143,499,202,268,applejack|fluttershy|mane six|pinkie pie|rainbow dash|rarity|twilight sparkle,
86522.png,https://derpicdn.net/img/view/2012/8/30/86522.png,0,0.9381897449493408,955,154,1147,346,192,192,applejack|fluttershy|mane six|pinkie pie|rainbow dash|rarity|spike|twilight sparkle,da-goddamn-batguy
865372.png,https://derpicdn.net/img/view/2015/4/5/865372.png,0,0.9862541556358336,1081,1692,1799,2410,718,718,pinkie pie|rainbow dash|scootaloo|sunset shimmer|twilight sparkle,yellowrobin
865408.png,https://derpicdn.net/img/view/2015/4/5/865408.png,0,0.9713017344474792,774,0,1200,392,426,392,applejack|fluttershy|mane six|pinkie pie|rainbow dash|rarity|twilight sparkle,zz-angelfox
866005.png,https://derpicdn.net/img/view/2015/4/5/866005.png,0,0.994911015033722,438,0,1268,868,830,868,rarity|twilight sparkle,
866227.png,https://derpicdn.net/img/view/2015/4/5/866227.png,0,0.979354202747345,218,24,588,394,370,370,starlight glimmer|twilight sparkle,pekou
866348.png,https://derpicdn.net/img/view/2015/4/5/866348.png,0,0.9542787075042723,8,47,542,581,534,534,trixie|twilight sparkle,pegacornss
866969.png,https://derpicdn.net/img/view/2015/4/6/866969.png,3,0.9331166744232178,148,510,430,792,282,282,applejack|fluttershy|mane six|pinkie pie|rainbow dash|rarity|twilight sparkle,nabebuta
867130.png,https://derpicdn.net/img/view/2015/4/6/867130.png,0,0.9887736439704896,191,40,471,320,280,280,rarity|twilight sparkle,lillynya
870422.png,https://derpicdn.net/img/view/2015/4/10/870422.png,0,0.9766592383384703,52,121,362,431,310,310,applejack|fluttershy|mane six|pinkie pie|rainbow dash|rarity|sunset shimmer|twilight sparkle,majkashinoda626
870422.png,https://derpicdn.net/img/view/2015/4/10/870422.png,1,0.9392212629318236,885,161,1181,457,296,296,applejack|fluttershy|mane six|pinkie pie|rainbow dash|rarity|sunset shimmer|twilight sparkle,majkashinoda626
871196.png,https://derpicdn.net/img/view/2015/4/11/871196.png,0,0.9091891050338744,17,555,413,951,396,396,pinkie pie|twilight sparkle,cold-blooded-twilight
871197.png,https://derpicdn.net/img/view/2015/4/11/871197.png,0,0.9949869513511658,387,0,973,489,586,489,applejack|twilight sparkle,multiponi
871214.png,https://derpicdn.net/img/view/2015/4/11/871214.png,0,0.9982315301895142,481,747,1069,1335,588,588,princess celestia|twilight sparkle,catzino
874272.jpg,https://derpicdn.net/img/view/2015/4/15/874272.jpg,0,0.9814788103103638,0,0,368,309,368,309,shining armor|twilight sparkle,
87541.png,https://derpicdn.net/img/view/2012/9/1/87541.png,0,0.9698609113693236,161,44,275,158,114,114,applejack|fluttershy|mane six|pinkie pie|rainbow dash|rarity|twilight sparkle,mt
876715.png,https://derpicdn.net/img/view/2015/4/18/876715.png,0,0.9188560247421264,298,0,706,401,408,401,sunset shimmer|twilight sparkle,catlover1672
881770.png,https://derpicdn.net/img/view/2015/4/24/881770.png,0,0.9986671805381776,558,180,946,568,388,388,pinkie pie|twilight sparkle,spikedmauler
881770.png,https://derpicdn.net/img/view/2015/4/24/881770.png,1,0.987349271774292,0,0,361,366,361,366,pinkie pie|twilight sparkle,spikedmauler
883339.jpg,https://derpicdn.net/img/view/2015/4/26/883339.jpg,0,0.9840901494026184,471,206,767,502,296,296,applejack|pinkie pie|twilight sparkle,tyuubatu
883464.png,https://derpicdn.net/img/view/2015/4/26/883464.png,0,0.9974552989006042,91,304,297,510,206,206,applejack|fluttershy|mane six|pinkie pie|rainbow dash|rarity|spike|spitfire|twilight sparkle,johnjoseco
883464.png,https://derpicdn.net/img/view/2015/4/26/883464.png,1,0.9816822409629822,257,313,435,491,178,178,applejack|fluttershy|mane six|pinkie pie|rainbow dash|rarity|spike|spitfire|twilight sparkle,johnjoseco
88629.png,https://derpicdn.net/img/view/2012/9/2/88629.png,0,0.9913368225097656,249,0,521,271,272,271,applejack|fluttershy|mane six|pinkie pie|rainbow dash|rarity|twilight sparkle,skykain
88629.png,https://derpicdn.net/img/view/2012/9/2/88629.png,1,0.991283655166626,21,16,261,256,240,240,applejack|fluttershy|mane six|pinkie pie|rainbow dash|rarity|twilight sparkle,skykain
88629.png,https://derpicdn.net/img/view/2012/9/2/88629.png,2,0.9904127717018129,751,0,1049,284,298,284,applejack|fluttershy|mane six|pinkie pie|rainbow dash|rarity|twilight sparkle,skykain
88629.png,https://derpicdn.net/img/view/2012/9/2/88629.png,4,0.9642919898033142,992,0,1280,272,288,272,applejack|fluttershy|mane six|pinkie pie|rainbow dash|rarity|twilight sparkle,skykain
887449.png,https://derpicdn.net/img/view/2015/5/2/887449.png,0,0.9956265687942504,1860,238,2572,950,712,712,fluttershy|twilight sparkle,drakxs
887449.png,https://derpicdn.net/img/view/2015/5/2/887449.png,1,0.9795945286750792,1389,230,1987,828,598,598,fluttershy|twilight sparkle,drakxs
889984.png,https://derpicdn.net/img/view/2015/5/5/889984.png,0,0.9554502964019777,144,996,1698,2550,1554,1554,sunset shimmer|twilight sparkle,fuzzbird
891649.png,https://derpicdn.net/img/view/2015/5/8/891649.png,0,0.9927040934562684,60,0,516,428,456,428,sunset shimmer|twilight sparkle,
892605.png,https://derpicdn.net/img/view/2015/5/10/892605.png,0,0.9698659777641296,703,123,2511,1931,1808,1808,pinkie pie|twilight sparkle,illumnious|dfectivedvice
893580.png,https://derpicdn.net/img/view/2015/5/11/893580.png,0,0.9894476532936096,1454,226,1868,640,414,414,applejack|fluttershy|mane six|pinkie pie|rainbow dash|rarity|spike|twilight sparkle,koviry
893694.png,https://derpicdn.net/img/view/2015/5/11/893694.png,2,0.9447813034057616,380,1680,812,2112,432,432,applejack|fluttershy|pinkie pie|rainbow dash|rarity|twilight sparkle,viwrastupr
897451.png,https://derpicdn.net/img/view/2015/5/16/897451.png,0,0.9820619821548462,230,170,534,474,304,304,applejack|discord|fluttershy|mane six|pinkie pie|princess celestia|rainbow dash|rarity|twilight sparkle,keterok
897558.png,https://derpicdn.net/img/view/2015/5/16/897558.png,0,0.9837868809700012,1059,399,1483,823,424,424,pinkie pie|princess celestia|rainbow dash|rarity|twilight sparkle,
898204.jpg,https://derpicdn.net/img/view/2015/5/17/898204.jpg,0,0.9907066226005554,271,15,623,367,352,352,princess celestia|twilight sparkle,
8995.png,https://derpicdn.net/img/view/2012/6/19/8995.png,0,0.9713795185089112,774,97,1148,471,374,374,rainbow dash|twilight sparkle,nyuuchandiannepie
901730.png,https://derpicdn.net/img/view/2015/5/22/901730.png,0,0.9743491411209106,315,1472,1885,3042,1570,1570,applejack|fluttershy|mane six|pinkie pie|rainbow dash|rarity|twilight sparkle,ambassad0r
901730.png,https://derpicdn.net/img/view/2015/5/22/901730.png,1,0.904551088809967,4120,213,5026,1119,906,906,applejack|fluttershy|mane six|pinkie pie|rainbow dash|rarity|twilight sparkle,ambassad0r
903972.png,https://derpicdn.net/img/view/2015/5/25/903972.png,0,0.99067223072052,185,3,339,157,154,154,applejack|fluttershy|mane six|pinkie pie|rainbow dash|rarity|twilight sparkle,buttercupbabyppg
903972.png,https://derpicdn.net/img/view/2015/5/25/903972.png,1,0.9370663166046144,86,275,234,423,148,148,applejack|fluttershy|mane six|pinkie pie|rainbow dash|rarity|twilight sparkle,buttercupbabyppg
903972.png,https://derpicdn.net/img/view/2015/5/25/903972.png,2,0.933488667011261,540,229,678,367,138,138,applejack|fluttershy|mane six|pinkie pie|rainbow dash|rarity|twilight sparkle,buttercupbabyppg
907184.png,https://derpicdn.net/img/view/2015/5/30/907184.png,0,0.9866923093795776,2940,893,4500,2453,1560,1560,shining armor|twilight sparkle,greenpony32
907184.png,https://derpicdn.net/img/view/2015/5/30/907184.png,1,0.981931746006012,1472,1104,2948,2580,1476,1476,shining armor|twilight sparkle,greenpony32
908262.png,https://derpicdn.net/img/view/2015/6/1/908262.png,0,0.9982123970985411,364,0,730,350,366,350,princess celestia|princess luna|queen chrysalis|shining armor|twilight sparkle,unity
908262.png,https://derpicdn.net/img/view/2015/6/1/908262.png,1,0.9973143935203552,733,299,1099,665,366,366,princess celestia|princess luna|queen chrysalis|shining armor|twilight sparkle,unity
908262.png,https://derpicdn.net/img/view/2015/6/1/908262.png,2,0.9874367117881776,1,335,325,659,324,324,princess celestia|princess luna|queen chrysalis|shining armor|twilight sparkle,unity
910497.png,https://derpicdn.net/img/view/2015/6/5/910497.png,0,0.9587023258209229,693,190,979,476,286,286,sunset shimmer|trixie|twilight sparkle,novaspark
910497.png,https://derpicdn.net/img/view/2015/6/5/910497.png,1,0.9336597919464112,291,99,687,495,396,396,sunset shimmer|trixie|twilight sparkle,novaspark
918286.png,https://derpicdn.net/img/view/2015/6/16/918286.png,0,0.9982069730758668,12,126,332,446,320,320,fluttershy|twilight sparkle,silverscarf
920447.png,https://derpicdn.net/img/view/2015/6/20/920447.png,0,0.9888906478881836,722,67,978,323,256,256,princess cadance|spike|twilight sparkle,esuka
923796.png,https://derpicdn.net/img/view/2015/6/25/923796.png,0,0.9729345440864564,320,256,740,722,420,466,applejack|twilight sparkle,deusexequus
923796.png,https://derpicdn.net/img/view/2015/6/25/923796.png,1,0.9650077223777772,0,599,282,909,282,310,applejack|twilight sparkle,deusexequus
924453.png,https://derpicdn.net/img/view/2015/6/27/924453.png,0,0.9872750639915466,102,485,356,739,254,254,applejack|fluttershy|mane six|pinkie pie|rainbow dash|rarity|spike|twilight sparkle,tonyfleecs
924453.png,https://derpicdn.net/img/view/2015/6/27/924453.png,1,0.9470786452293396,119,194,335,410,216,216,applejack|fluttershy|mane six|pinkie pie|rainbow dash|rarity|spike|twilight sparkle,tonyfleecs
924453.png,https://derpicdn.net/img/view/2015/6/27/924453.png,2,0.9307831525802612,231,145,469,383,238,238,applejack|fluttershy|mane six|pinkie pie|rainbow dash|rarity|spike|twilight sparkle,tonyfleecs
924875.jpg,https://derpicdn.net/img/view/2015/6/27/924875.jpg,0,0.99095356464386,1145,420,1449,724,304,304,applejack|fluttershy|rainbow dash|rarity|twilight sparkle,
92682.png,https://derpicdn.net/img/view/2012/9/8/92682.png,1,0.9504944682121276,25,0,357,324,332,324,big macintosh|twilight sparkle,sandwich-anomaly
927751.png,https://derpicdn.net/img/view/2015/7/1/927751.png,0,0.9977583289146424,590,0,1130,572,540,572,pinkie pie|twilight sparkle,verappp
927952.png,https://derpicdn.net/img/view/2015/7/2/927952.png,0,0.9995079040527344,1995,428,2769,1202,774,774,applejack|rainbow dash|rarity|twilight sparkle,
927952.png,https://derpicdn.net/img/view/2015/7/2/927952.png,1,0.9992169141769408,302,313,1110,1121,808,808,applejack|rainbow dash|rarity|twilight sparkle,
932596.jpg,https://derpicdn.net/img/view/2015/7/8/932596.jpg,0,0.9609439969062804,1055,1849,1877,2671,822,822,spike|twilight sparkle,yasmin sheikh
933592.jpg,https://derpicdn.net/img/view/2015/7/9/933592.jpg,0,0.9245550036430359,605,463,854,721,249,258,princess celestia|spike|twilight sparkle,
934049.png,https://derpicdn.net/img/view/2015/7/10/934049.png,0,0.965682864189148,549,167,801,419,252,252,fluttershy|rarity|twilight sparkle,palolabg
934049.png,https://derpicdn.net/img/view/2015/7/10/934049.png,1,0.9389007687568665,59,46,293,280,234,234,fluttershy|rarity|twilight sparkle,palolabg
934730.png,https://derpicdn.net/img/view/2015/7/11/934730.png,0,0.9944106936454772,0,413,480,925,480,512,applejack|fluttershy|mane six|pinkie pie|rainbow dash|rarity|twilight sparkle,kmwolf
934730.png,https://derpicdn.net/img/view/2015/7/11/934730.png,1,0.922618567943573,457,390,991,924,534,534,applejack|fluttershy|mane six|pinkie pie|rainbow dash|rarity|twilight sparkle,kmwolf
934833.png,https://derpicdn.net/img/view/2015/7/11/934833.png,1,0.9296604990959167,1572,607,1878,913,306,306,applejack|fluttershy|mane six|pinkie pie|rainbow dash|rarity|twilight sparkle,
935650.png,https://derpicdn.net/img/view/2015/7/12/935650.png,0,0.9976420998573304,414,0,1004,538,590,538,rainbow dash|twilight sparkle,johnnoz
938390.jpg,https://derpicdn.net/img/view/2015/7/17/938390.jpg,0,0.9842313528060912,504,541,872,909,368,368,sunset shimmer|twilight sparkle,
938390.jpg,https://derpicdn.net/img/view/2015/7/17/938390.jpg,1,0.9762006402015686,0,457,613,980,613,523,sunset shimmer|twilight sparkle,
938390.jpg,https://derpicdn.net/img/view/2015/7/17/938390.jpg,2,0.90413635969162,155,126,383,354,228,228,sunset shimmer|twilight sparkle,
939168.png,https://derpicdn.net/img/view/2015/7/18/939168.png,0,0.9996180534362792,318,1526,704,1912,386,386,applejack|big macintosh|fluttershy|mane six|pinkie pie|princess celestia|rainbow dash|rarity|sweetie belle|twilight sparkle,katiecandraw|madmax|mewball|lulubell|michos|furrgroup|lavender1983|whitediamonds|gsphere|johnjoseco|mrw32|explosivegent|verulence|tetrapony|karpet-shark|faith-wolff|dm29|lance|kryptchild|megasweet|deadiifoozgo|jaquelindreamz
939168.png,https://derpicdn.net/img/view/2015/7/18/939168.png,1,0.9990260004997252,1277,346,1600,732,323,386,applejack|big macintosh|fluttershy|mane six|pinkie pie|princess celestia|rainbow dash|rarity|sweetie belle|twilight sparkle,katiecandraw|madmax|mewball|lulubell|michos|furrgroup|lavender1983|whitediamonds|gsphere|johnjoseco|mrw32|explosivegent|verulence|tetrapony|karpet-shark|faith-wolff|dm29|lance|kryptchild|megasweet|deadiifoozgo|jaquelindreamz
939168.png,https://derpicdn.net/img/view/2015/7/18/939168.png,3,0.9950942993164062,0,409,235,687,235,278,applejack|big macintosh|fluttershy|mane six|pinkie pie|princess celestia|rainbow dash|rarity|sweetie belle|twilight sparkle,katiecandraw|madmax|mewball|lulubell|michos|furrgroup|lavender1983|whitediamonds|gsphere|johnjoseco|mrw32|explosivegent|verulence|tetrapony|karpet-shark|faith-wolff|dm29|lance|kryptchild|megasweet|deadiifoozgo|jaquelindreamz
939168.png,https://derpicdn.net/img/view/2015/7/18/939168.png,4,0.9947296380996704,740,1537,1130,1927,390,390,applejack|big macintosh|fluttershy|mane six|pinkie pie|princess celestia|rainbow dash|rarity|sweetie belle|twilight sparkle,katiecandraw|madmax|mewball|lulubell|michos|furrgroup|lavender1983|whitediamonds|gsphere|johnjoseco|mrw32|explosivegent|verulence|tetrapony|karpet-shark|faith-wolff|dm29|lance|kryptchild|megasweet|deadiifoozgo|jaquelindreamz
939168.png,https://derpicdn.net/img/view/2015/7/18/939168.png,8,0.9731021523475648,0,1916,365,2362,365,446,applejack|big macintosh|fluttershy|mane six|pinkie pie|princess celestia|rainbow dash|rarity|sweetie belle|twilight sparkle,katiecandraw|madmax|mewball|lulubell|michos|furrgroup|lavender1983|whitediamonds|gsphere|johnjoseco|mrw32|explosivegent|verulence|tetrapony|karpet-shark|faith-wolff|dm29|lance|kryptchild|megasweet|deadiifoozgo|jaquelindreamz
939168.png,https://derpicdn.net/img/view/2015/7/18/939168.png,10,0.945347011089325,19,38,279,298,260,260,applejack|big macintosh|fluttershy|mane six|pinkie pie|princess celestia|rainbow dash|rarity|sweetie belle|twilight sparkle,katiecandraw|madmax|mewball|lulubell|michos|furrgroup|lavender1983|whitediamonds|gsphere|johnjoseco|mrw32|explosivegent|verulence|tetrapony|karpet-shark|faith-wolff|dm29|lance|kryptchild|megasweet|deadiifoozgo|jaquelindreamz
93953.jpg,https://derpicdn.net/img/view/2012/9/10/93953.jpg,0,0.9946719408035278,129,45,299,215,170,170,applejack|fluttershy|mane six|pinkie pie|rainbow dash|rarity|twilight sparkle,andreatamme
93953.jpg,https://derpicdn.net/img/view/2012/9/10/93953.jpg,1,0.9926631450653076,225,459,389,623,164,164,applejack|fluttershy|mane six|pinkie pie|rainbow dash|rarity|twilight sparkle,andreatamme
93953.jpg,https://derpicdn.net/img/view/2012/9/10/93953.jpg,2,0.9705606698989868,260,181,458,379,198,198,applejack|fluttershy|mane six|pinkie pie|rainbow dash|rarity|twilight sparkle,andreatamme
940122.png,https://derpicdn.net/img/view/2015/7/20/940122.png,0,0.9877685904502868,1027,198,1317,488,290,290,sunset shimmer|twilight sparkle,shutterflyeqd
940871.png,https://derpicdn.net/img/view/2015/7/21/940871.png,1,0.9606152772903442,1629,136,2009,516,380,380,applejack|fluttershy|rainbow dash|rarity|twilight sparkle,9de-light6
940871.png,https://derpicdn.net/img/view/2015/7/21/940871.png,2,0.927977979183197,1503,660,1929,1086,426,426,applejack|fluttershy|rainbow dash|rarity|twilight sparkle,9de-light6
943702.png,https://derpicdn.net/img/view/2015/7/25/943702.png,0,0.998294234275818,589,60,931,402,342,342,pinkie pie|twilight sparkle,avante92
943702.png,https://derpicdn.net/img/view/2015/7/25/943702.png,1,0.9008626341819764,366,124,674,432,308,308,pinkie pie|twilight sparkle,avante92
946545.png,https://derpicdn.net/img/view/2015/7/29/946545.png,1,0.9835060238838196,0,0,365,365,365,365,apple bloom|applejack|big macintosh|cutie mark crusaders|fluttershy|mane six|pinkie pie|princess celestia|princess luna|rainbow dash|rarity|scootaloo|spike|sweetie belle|trixie|twilight sparkle,blue-paint-sea
946545.png,https://derpicdn.net/img/view/2015/7/29/946545.png,2,0.9690173268318176,1020,286,1372,638,352,352,apple bloom|applejack|big macintosh|cutie mark crusaders|fluttershy|mane six|pinkie pie|princess celestia|princess luna|rainbow dash|rarity|scootaloo|spike|sweetie belle|trixie|twilight sparkle,blue-paint-sea
946545.png,https://derpicdn.net/img/view/2015/7/29/946545.png,3,0.9330710172653198,1160,722,1452,1014,292,292,apple bloom|applejack|big macintosh|cutie mark crusaders|fluttershy|mane six|pinkie pie|princess celestia|princess luna|rainbow dash|rarity|scootaloo|spike|sweetie belle|trixie|twilight sparkle,blue-paint-sea
947552.png,https://derpicdn.net/img/view/2015/7/30/947552.png,2,0.9538597464561462,1482,402,1798,718,316,316,applejack|fluttershy|mane six|pinkie pie|rainbow dash|rarity|twilight sparkle,skyeypony
947552.png,https://derpicdn.net/img/view/2015/7/30/947552.png,3,0.9287617206573486,731,344,1079,692,348,348,applejack|fluttershy|mane six|pinkie pie|rainbow dash|rarity|twilight sparkle,skyeypony
949593.jpg,https://derpicdn.net/img/view/2015/8/3/949593.jpg,0,0.9985731840133668,308,62,546,300,238,238,spike|twilight sparkle,symplefable
949978.png,https://derpicdn.net/img/view/2015/8/3/949978.png,0,0.9989267587661744,659,197,1019,557,360,360,sunset shimmer|twilight sparkle,christophr1
957441.png,https://derpicdn.net/img/view/2015/8/14/957441.png,0,0.9874308705329896,1426,125,2234,933,808,808,trixie|twilight sparkle,novaspark
957441.png,https://derpicdn.net/img/view/2015/8/14/957441.png,1,0.909035325050354,466,254,1150,938,684,684,trixie|twilight sparkle,novaspark
959763.png,https://derpicdn.net/img/view/2015/8/17/959763.png,2,0.956388294696808,272,373,496,597,224,224,applejack|fluttershy|mane six|pinkie pie|rainbow dash|rarity|twilight sparkle,tsurukinoki
964061.png,https://derpicdn.net/img/view/2015/8/23/964061.png,0,0.997592270374298,51,0,469,395,418,395,sunset shimmer|twilight sparkle,twirity
964067.png,https://derpicdn.net/img/view/2015/8/23/964067.png,0,0.9979187250137328,1300,1715,1840,2269,540,554,applejack|fluttershy|mane six|pinkie pie|rainbow dash|rarity|twilight sparkle,buljong
964067.png,https://derpicdn.net/img/view/2015/8/23/964067.png,1,0.9961891770362854,392,1601,1132,2341,740,740,applejack|fluttershy|mane six|pinkie pie|rainbow dash|rarity|twilight sparkle,buljong
964067.png,https://derpicdn.net/img/view/2015/8/23/964067.png,2,0.963556706905365,889,881,1387,1379,498,498,applejack|fluttershy|mane six|pinkie pie|rainbow dash|rarity|twilight sparkle,buljong
964067.png,https://derpicdn.net/img/view/2015/8/23/964067.png,3,0.9122779965400696,725,0,1279,551,554,551,applejack|fluttershy|mane six|pinkie pie|rainbow dash|rarity|twilight sparkle,buljong
968566.png,https://derpicdn.net/img/view/2015/8/30/968566.png,1,0.9882177710533142,640,967,1758,2085,1118,1118,applejack|discord|fluttershy|pinkie pie|princess celestia|princess luna|rainbow dash|rarity|twilight sparkle,lucy-tan
968871.png,https://derpicdn.net/img/view/2015/8/30/968871.png,1,0.9427544474601746,2225,1301,2749,1825,524,524,applejack|discord|fluttershy|mane six|pinkie pie|queen chrysalis|rainbow dash|rarity|starlight glimmer|twilight sparkle,alskylark
969103.png,https://derpicdn.net/img/view/2015/8/30/969103.png,0,0.9978986382484436,1796,665,2500,1391,704,726,applejack|fluttershy|mane six|pinkie pie|princess celestia|princess luna|rainbow dash|rarity|spike|twilight sparkle,trishabeakens
969103.png,https://derpicdn.net/img/view/2015/8/30/969103.png,2,0.9957303404808044,1280,28,2052,800,772,772,applejack|fluttershy|mane six|pinkie pie|princess celestia|princess luna|rainbow dash|rarity|spike|twilight sparkle,trishabeakens
969103.png,https://derpicdn.net/img/view/2015/8/30/969103.png,3,0.9930800199508668,632,0,1242,608,610,608,applejack|fluttershy|mane six|pinkie pie|princess celestia|princess luna|rainbow dash|rarity|spike|twilight sparkle,trishabeakens
969103.png,https://derpicdn.net/img/view/2015/8/30/969103.png,4,0.978208601474762,986,555,1550,1119,564,564,applejack|fluttershy|mane six|pinkie pie|princess celestia|princess luna|rainbow dash|rarity|spike|twilight sparkle,trishabeakens
97228.png,https://derpicdn.net/img/view/2012/9/13/97228.png,0,0.9463680982589722,4841,3424,5803,4386,962,962,spike|twilight sparkle,mamandil|joey darkmeat
973145.png,https://derpicdn.net/img/view/2015/9/5/973145.png,0,0.9994028210639954,2155,0,3374,1022,1219,1022,applejack|fluttershy|mane six|pinkie pie|rainbow dash|rarity|twilight sparkle,oblivionheart13
973145.png,https://derpicdn.net/img/view/2015/9/5/973145.png,1,0.9885912537574768,2340,1262,3374,2340,1034,1078,applejack|fluttershy|mane six|pinkie pie|rainbow dash|rarity|twilight sparkle,oblivionheart13
974545.png,https://derpicdn.net/img/view/2015/9/7/974545.png,1,0.9218552112579346,494,0,864,365,370,365,sunset shimmer|twilight sparkle,foxenawolf
975789.png,https://derpicdn.net/img/view/2015/9/9/975789.png,1,0.9082719683647156,205,251,595,641,390,390,spike|twilight sparkle,tehflah
978025.png,https://derpicdn.net/img/view/2015/9/12/978025.png,0,0.9870539903640748,1235,127,1753,707,518,580,applejack|fluttershy|mane six|pinkie pie|rainbow dash|rarity|twilight sparkle,commissarbu
978442.png,https://derpicdn.net/img/view/2015/9/12/978442.png,0,0.9925872087478638,158,26,374,242,216,216,applejack|big macintosh|fluttershy|mane six|pinkie pie|rainbow dash|rarity|twilight sparkle,dm29
980982.png,https://derpicdn.net/img/view/2015/9/16/980982.png,0,0.983753263950348,502,0,1184,543,682,543,applejack|fluttershy|mane six|pinkie pie|rainbow dash|rarity|twilight sparkle,blah23z
980982.png,https://derpicdn.net/img/view/2015/9/16/980982.png,2,0.9207881093025208,17,6,515,504,498,498,applejack|fluttershy|mane six|pinkie pie|rainbow dash|rarity|twilight sparkle,blah23z
981083.png,https://derpicdn.net/img/view/2015/9/16/981083.png,0,0.9847735762596128,233,1087,645,1499,412,412,spike|twilight sparkle,carnivorouscaribou
984556.jpg,https://derpicdn.net/img/view/2015/9/21/984556.jpg,0,0.9866077899932858,268,0,1258,841,990,841,applejack|rainbow dash|twilight sparkle,neondion60
986081.png,https://derpicdn.net/img/view/2015/9/23/986081.png,0,0.9952561259269714,767,64,895,192,128,128,applejack|fluttershy|mane six|pinkie pie|rainbow dash|rarity|twilight sparkle,metal-kitty
986081.png,https://derpicdn.net/img/view/2015/9/23/986081.png,1,0.9817959070205688,896,18,1132,254,236,236,applejack|fluttershy|mane six|pinkie pie|rainbow dash|rarity|twilight sparkle,metal-kitty
986764.png,https://derpicdn.net/img/view/2015/9/24/986764.png,0,0.9882248044013976,15,226,171,382,156,156,applejack|fluttershy|mane six|pinkie pie|rainbow dash|rarity|twilight sparkle,lemonheart
986947.png,https://derpicdn.net/img/view/2015/9/24/986947.png,0,0.9470551013946532,480,0,1194,608,714,608,spike|twilight sparkle,dsana
986947.png,https://derpicdn.net/img/view/2015/9/24/986947.png,1,0.9076321721076964,258,0,716,417,458,417,spike|twilight sparkle,dsana
987322.png,https://derpicdn.net/img/view/2015/9/25/987322.png,1,0.9957748651504515,46,267,458,679,412,412,applejack|fluttershy|mane six|pinkie pie|rainbow dash|rarity|twilight sparkle,zowieblaze
987711.png,https://derpicdn.net/img/view/2015/9/25/987711.png,0,0.9934754371643066,952,0,1334,342,382,342,applejack|fluttershy|mane six|pinkie pie|rainbow dash|rarity|twilight sparkle,9de-light6
987711.png,https://derpicdn.net/img/view/2015/9/25/987711.png,1,0.9866556525230408,57,396,501,840,444,444,applejack|fluttershy|mane six|pinkie pie|rainbow dash|rarity|twilight sparkle,9de-light6
987711.png,https://derpicdn.net/img/view/2015/9/25/987711.png,2,0.9647690057754515,1513,0,1883,345,370,345,applejack|fluttershy|mane six|pinkie pie|rainbow dash|rarity|twilight sparkle,9de-light6
989534.png,https://derpicdn.net/img/view/2015/9/27/989534.png,0,0.9642305970191956,3024,363,5434,2773,2410,2410,pinkie pie|rarity|twilight sparkle,corsairsedge
989534.png,https://derpicdn.net/img/view/2015/9/27/989534.png,1,0.9090718030929564,5656,578,7648,2570,1992,1992,pinkie pie|rarity|twilight sparkle,corsairsedge
990968.png,https://derpicdn.net/img/view/2015/9/29/990968.png,1,0.9982345104217528,165,0,1203,795,1038,795,applejack|fluttershy|mane six|pinkie pie|rainbow dash|rarity|twilight sparkle,taaffeiite
990968.png,https://derpicdn.net/img/view/2015/9/29/990968.png,2,0.9975135922431946,1704,439,2376,1111,672,672,applejack|fluttershy|mane six|pinkie pie|rainbow dash|rarity|twilight sparkle,taaffeiite
990968.png,https://derpicdn.net/img/view/2015/9/29/990968.png,3,0.9844013452529908,835,428,1507,1100,672,672,applejack|fluttershy|mane six|pinkie pie|rainbow dash|rarity|twilight sparkle,taaffeiite
993548.png,https://derpicdn.net/img/view/2015/10/3/993548.png,0,0.9936547279357908,144,231,668,755,524,524,sunset shimmer|twilight sparkle,suenden-hund
993548.png,https://derpicdn.net/img/view/2015/10/3/993548.png,1,0.9827671647071838,601,21,1141,561,540,540,sunset shimmer|twilight sparkle,suenden-hund
99451.jpg,https://derpicdn.net/img/view/2012/9/16/99451.jpg,0,0.9946393966674804,568,0,912,305,344,305,fluttershy|pinkie pie|twilight sparkle,moyamoya kuroi
995452.png,https://derpicdn.net/img/view/2015/10/5/995452.png,0,0.9956489205360411,649,19,841,211,192,192,applejack|fluttershy|mane six|pinkie pie|rainbow dash|rarity|scootaloo|spike|sweetie belle|twilight sparkle,octanbearcat
995452.png,https://derpicdn.net/img/view/2015/10/5/995452.png,1,0.9941510558128356,663,527,847,711,184,184,applejack|fluttershy|mane six|pinkie pie|rainbow dash|rarity|scootaloo|spike|sweetie belle|twilight sparkle,octanbearcat
995452.png,https://derpicdn.net/img/view/2015/10/5/995452.png,2,0.9573277831077576,42,676,226,860,184,184,applejack|fluttershy|mane six|pinkie pie|rainbow dash|rarity|scootaloo|spike|sweetie belle|twilight sparkle,octanbearcat
997166.png,https://derpicdn.net/img/view/2015/10/8/997166.png,0,0.9852548837661744,846,0,1770,810,924,810,rainbow dash|twilight sparkle,seleeger|vinylscratchcooler
997166.png,https://derpicdn.net/img/view/2015/10/8/997166.png,1,0.9213032126426696,293,44,813,564,520,520,rainbow dash|twilight sparkle,seleeger|vinylscratchcooler
997710.png,https://derpicdn.net/img/view/2015/10/9/997710.png,0,0.998356819152832,284,124,594,434,310,310,sunset shimmer|twilight sparkle,faeizumine
997710.png,https://derpicdn.net/img/view/2015/10/9/997710.png,1,0.9612147808074952,568,104,880,416,312,312,sunset shimmer|twilight sparkle,faeizumine
1000136.png,https://derpicdn.net/img/view/2015/10/11/1000136.png,0,0.9994009733200072,1342,40,2338,1036,996,996,apple bloom|applejack|cutie mark crusaders|fluttershy|mane six|pinkie pie|princess cadance|princess celestia|princess luna|rainbow dash|rarity|scootaloo|sweetie belle|twilight sparkle,vasillium
1000136.png,https://derpicdn.net/img/view/2015/10/11/1000136.png,1,0.9976651072502136,134,57,1064,987,930,930,apple bloom|applejack|cutie mark crusaders|fluttershy|mane six|pinkie pie|princess cadance|princess celestia|princess luna|rainbow dash|rarity|scootaloo|sweetie belle|twilight sparkle,vasillium
1000136.png,https://derpicdn.net/img/view/2015/10/11/1000136.png,2,0.9938564896583556,2236,2714,3500,4102,1264,1388,apple bloom|applejack|cutie mark crusaders|fluttershy|mane six|pinkie pie|princess cadance|princess celestia|princess luna|rainbow dash|rarity|scootaloo|sweetie belle|twilight sparkle,vasillium
1000136.png,https://derpicdn.net/img/view/2015/10/11/1000136.png,3,0.993415594100952,2466,155,3372,1061,906,906,apple bloom|applejack|cutie mark crusaders|fluttershy|mane six|pinkie pie|princess cadance|princess celestia|princess luna|rainbow dash|rarity|scootaloo|sweetie belle|twilight sparkle,vasillium
1000136.png,https://derpicdn.net/img/view/2015/10/11/1000136.png,7,0.9649874567985536,144,4266,1256,5378,1112,1112,apple bloom|applejack|cutie mark crusaders|fluttershy|mane six|pinkie pie|princess cadance|princess celestia|princess luna|rainbow dash|rarity|scootaloo|sweetie belle|twilight sparkle,vasillium
1008288.png,https://derpicdn.net/img/view/2015/10/23/1008288.png,0,0.9506099224090576,194,57,682,545,488,488,applejack|fluttershy|mane six|pinkie pie|rainbow dash|rarity|starlight glimmer|twilight sparkle,pillonchou
1013044.png,https://derpicdn.net/img/view/2015/10/31/1013044.png,1,0.9932600259780884,331,75,673,417,342,342,applejack|fluttershy|mane six|pinkie pie|rainbow dash|rarity|twilight sparkle,mkogwheel
1014385.png,https://derpicdn.net/img/view/2015/11/1/1014385.png,0,0.9975084066390992,750,55,1058,363,308,308,pinkie pie|twilight sparkle,rwl
1016176.png,https://derpicdn.net/img/view/2015/11/4/1016176.png,0,0.997428059577942,806,227,1132,553,326,326,applejack|fluttershy|mane six|pinkie pie|rainbow dash|rarity|twilight sparkle,tinuleaf
1016176.png,https://derpicdn.net/img/view/2015/11/4/1016176.png,1,0.9950225949287416,265,538,557,830,292,292,applejack|fluttershy|mane six|pinkie pie|rainbow dash|rarity|twilight sparkle,tinuleaf
1016176.png,https://derpicdn.net/img/view/2015/11/4/1016176.png,2,0.9933859705924988,86,56,384,354,298,298,applejack|fluttershy|mane six|pinkie pie|rainbow dash|rarity|twilight sparkle,tinuleaf
1016176.png,https://derpicdn.net/img/view/2015/11/4/1016176.png,3,0.9931274056434632,599,522,907,830,308,308,applejack|fluttershy|mane six|pinkie pie|rainbow dash|rarity|twilight sparkle,tinuleaf
1016176.png,https://derpicdn.net/img/view/2015/11/4/1016176.png,5,0.9673020243644714,451,808,705,1062,254,254,applejack|fluttershy|mane six|pinkie pie|rainbow dash|rarity|twilight sparkle,tinuleaf
1016176.png,https://derpicdn.net/img/view/2015/11/4/1016176.png,7,0.9589207768440248,1355,545,1652,847,297,302,applejack|fluttershy|mane six|pinkie pie|rainbow dash|rarity|twilight sparkle,tinuleaf
1016176.png,https://derpicdn.net/img/view/2015/11/4/1016176.png,8,0.9380258917808532,793,757,1145,1109,352,352,applejack|fluttershy|mane six|pinkie pie|rainbow dash|rarity|twilight sparkle,tinuleaf
1016911.png,https://derpicdn.net/img/view/2015/11/5/1016911.png,0,0.9980120658874512,108,256,334,482,226,226,applejack|pinkie pie|rainbow dash|rarity|spike|twilight sparkle,
1018142.png,https://derpicdn.net/img/view/2015/11/7/1018142.png,0,0.9817663431167604,744,1718,1306,2280,562,562,discord|rainbow dash|twilight sparkle,aleximusprime
1018142.png,https://derpicdn.net/img/view/2015/11/7/1018142.png,1,0.9759957194328308,544,276,1230,962,686,686,discord|rainbow dash|twilight sparkle,aleximusprime
1020012.png,https://derpicdn.net/img/view/2015/11/10/1020012.png,0,0.9827979207038879,0,0,794,850,794,850,spike|twilight sparkle,red4567
1020109.png,https://derpicdn.net/img/view/2015/11/10/1020109.png,0,0.9673126935958862,759,167,997,405,238,238,rainbow dash|twilight sparkle,stationmaster2002
1022575.png,https://derpicdn.net/img/view/2015/11/14/1022575.png,0,0.9136203527450562,3586,2024,4532,2970,946,946,applejack|fluttershy|mane six|pinkie pie|rainbow dash|rarity|twilight sparkle,rarityforever
1024093.png,https://derpicdn.net/img/view/2015/11/16/1024093.png,0,0.961696445941925,709,194,963,448,254,254,applejack|fluttershy|twilight sparkle,
1024113.png,https://derpicdn.net/img/view/2015/11/16/1024113.png,0,0.9847267866134644,389,447,859,917,470,470,sunset shimmer|twilight sparkle,ayanokorohama|fluidty
1029758.png,https://derpicdn.net/img/view/2015/11/25/1029758.png,0,0.9806775450706482,813,187,1389,763,576,576,princess celestia|twilight sparkle,rustyscreech
1029928.png,https://derpicdn.net/img/view/2015/11/25/1029928.png,0,0.9913502931594848,774,432,1086,744,312,312,applejack|fluttershy|mane six|pinkie pie|rainbow dash|rarity|twilight sparkle,rockset
1029928.png,https://derpicdn.net/img/view/2015/11/25/1029928.png,1,0.9814876317977904,1381,406,1695,720,314,314,applejack|fluttershy|mane six|pinkie pie|rainbow dash|rarity|twilight sparkle,rockset
1029928.png,https://derpicdn.net/img/view/2015/11/25/1029928.png,3,0.9469353556632996,1060,459,1338,737,278,278,applejack|fluttershy|mane six|pinkie pie|rainbow dash|rarity|twilight sparkle,rockset
103094.jpg,https://derpicdn.net/img/view/2012/9/21/103094.jpg,0,0.9337498545646667,465,11,831,377,366,366,fluttershy|spike|twilight sparkle,cobracookies
1034360.png,https://derpicdn.net/img/view/2015/12/1/1034360.png,0,0.955734133720398,173,0,653,437,480,437,rainbow dash|twilight sparkle,
1034547.png,https://derpicdn.net/img/view/2015/12/1/1034547.png,0,0.9824837446212769,462,0,670,185,208,185,applejack|fluttershy|mane six|pinkie pie|princess celestia|queen chrysalis|rainbow dash|rarity|spike|starlight glimmer|twilight sparkle,canterlotroyalty
1034571.png,https://derpicdn.net/img/view/2015/12/1/1034571.png,1,0.936501145362854,868,416,1058,606,190,190,rainbow dash|spike|twilight sparkle,
1035023.png,https://derpicdn.net/img/view/2015/12/2/1035023.png,0,0.9884504675865172,58,69,334,345,276,276,spike|twilight sparkle,
1036387.jpg,https://derpicdn.net/img/view/2015/12/4/1036387.jpg,0,0.921700954437256,732,202,940,410,208,208,applejack|fluttershy|mane six|pinkie pie|rainbow dash|rarity|spike|starlight glimmer|twilight sparkle,rockingscorpion
1036759.png,https://derpicdn.net/img/view/2015/12/4/1036759.png,0,0.9070425629615784,823,124,1299,600,476,476,applejack|fluttershy|mane six|pinkie pie|rainbow dash|rarity|twilight sparkle,jack27121
1036841.png,https://derpicdn.net/img/view/2015/12/4/1036841.png,0,0.988835871219635,500,20,1300,820,800,800,starlight glimmer|twilight sparkle,nevaylin
1037381.jpg,https://derpicdn.net/img/view/2015/12/5/1037381.jpg,0,0.9994645714759828,0,2082,712,2932,712,850,starlight glimmer|twilight sparkle,carson marain
1039170.png,https://derpicdn.net/img/view/2015/12/7/1039170.png,0,0.9985858201980592,763,525,967,729,204,204,rainbow dash|twilight sparkle,jykinturah
1039170.png,https://derpicdn.net/img/view/2015/12/7/1039170.png,1,0.9980173707008362,232,488,438,694,206,206,rainbow dash|twilight sparkle,jykinturah
1040509.png,https://derpicdn.net/img/view/2015/12/9/1040509.png,0,0.9729110598564148,388,442,796,850,408,408,applejack|fluttershy|mane six|pinkie pie|rainbow dash|rarity|twilight sparkle,lyricjam
1040509.png,https://derpicdn.net/img/view/2015/12/9/1040509.png,1,0.951162815093994,171,1237,633,1699,462,462,applejack|fluttershy|mane six|pinkie pie|rainbow dash|rarity|twilight sparkle,lyricjam
10413.png,https://derpicdn.net/img/view/2012/6/19/10413.png,0,0.9960442185401917,664,580,912,828,248,248,shining armor|twilight sparkle,
1041748.png,https://derpicdn.net/img/view/2015/12/11/1041748.png,0,0.9916772842407228,787,749,1229,1191,442,442,applejack|fluttershy|mane six|pinkie pie|rainbow dash|rarity|twilight sparkle,das_leben
1041748.png,https://derpicdn.net/img/view/2015/12/11/1041748.png,1,0.9712485074996948,645,396,921,672,276,276,applejack|fluttershy|mane six|pinkie pie|rainbow dash|rarity|twilight sparkle,das_leben
1042674.jpg,https://derpicdn.net/img/view/2015/12/12/1042674.jpg,1,0.97734135389328,0,901,656,1665,656,764,spike|starlight glimmer|twilight sparkle,pims1978
1044893.png,https://derpicdn.net/img/view/2015/12/15/1044893.png,1,0.9959675073623656,42,412,380,750,338,338,shining armor|twilight sparkle,paperlover
1044893.png,https://derpicdn.net/img/view/2015/12/15/1044893.png,2,0.9899706840515136,521,783,775,1037,254,254,shining armor|twilight sparkle,paperlover
1050440.png,https://derpicdn.net/img/view/2015/12/22/1050440.png,0,0.990336000919342,986,173,1280,513,294,340,princess cadance|princess celestia|princess luna|twilight sparkle,jbond
1050440.png,https://derpicdn.net/img/view/2015/12/22/1050440.png,1,0.96810382604599,36,0,574,417,538,417,princess cadance|princess celestia|princess luna|twilight sparkle,jbond
1053774.png,https://derpicdn.net/img/view/2015/12/27/1053774.png,0,0.9485980272293092,1557,0,3593,1951,2036,1951,starlight glimmer|sunset shimmer|twilight sparkle,rarityforever
1054288.png,https://derpicdn.net/img/view/2015/12/28/1054288.png,0,0.9604305624961852,20,170,536,686,516,516,starlight glimmer|twilight sparkle,
105489.png,https://derpicdn.net/img/view/2012/9/24/105489.png,0,0.9145102500915528,1761,0,2221,352,460,352,apple bloom|applejack|cutie mark crusaders|fluttershy|mane six|pinkie pie|princess celestia|princess luna|rainbow dash|rarity|scootaloo|soarin'|spitfire|sweetie belle|trixie|twilight sparkle,bronybiscuitbites
1056301.png,https://derpicdn.net/img/view/2015/12/31/1056301.png,0,0.9817764163017272,549,0,1143,565,594,565,sunset shimmer|twilight sparkle,slimegrave
1056723.png,https://derpicdn.net/img/view/2015/12/31/1056723.png,0,0.9950222373008728,227,0,875,539,648,539,rainbow dash|twilight sparkle,nightmaremoons
1059013.png,https://derpicdn.net/img/view/2016/1/3/1059013.png,0,0.9920384883880616,150,630,394,874,244,244,applejack|fluttershy|mane six|pinkie pie|princess celestia|rainbow dash|rarity|shining armor|spike|twilight sparkle,commissarbu
1059013.png,https://derpicdn.net/img/view/2016/1/3/1059013.png,1,0.9783473014831544,435,0,737,292,302,292,applejack|fluttershy|mane six|pinkie pie|princess celestia|rainbow dash|rarity|shining armor|spike|twilight sparkle,commissarbu
1059013.png,https://derpicdn.net/img/view/2016/1/3/1059013.png,5,0.9046542644500732,563,604,752,822,189,218,applejack|fluttershy|mane six|pinkie pie|princess celestia|rainbow dash|rarity|shining armor|spike|twilight sparkle,commissarbu
1061251.jpg,https://derpicdn.net/img/view/2016/1/7/1061251.jpg,1,0.9927855730056764,0,650,183,848,183,198,apple bloom|applejack|big macintosh|cutie mark crusaders|discord|fluttershy|mane six|pinkie pie|princess cadance|princess celestia|princess luna|queen chrysalis|rainbow dash|rarity|scootaloo|shining armor|sweetie belle|twilight sparkle,christadoodles
1061251.jpg,https://derpicdn.net/img/view/2016/1/7/1061251.jpg,2,0.9925950765609741,507,0,647,140,140,140,apple bloom|applejack|big macintosh|cutie mark crusaders|discord|fluttershy|mane six|pinkie pie|princess cadance|princess celestia|princess luna|queen chrysalis|rainbow dash|rarity|scootaloo|shining armor|sweetie belle|twilight sparkle,christadoodles
1061251.jpg,https://derpicdn.net/img/view/2016/1/7/1061251.jpg,3,0.9921835064888,452,898,624,1070,172,172,apple bloom|applejack|big macintosh|cutie mark crusaders|discord|fluttershy|mane six|pinkie pie|princess cadance|princess celestia|princess luna|queen chrysalis|rainbow dash|rarity|scootaloo|shining armor|sweetie belle|twilight sparkle,christadoodles
1061251.jpg,https://derpicdn.net/img/view/2016/1/7/1061251.jpg,4,0.9886954426765442,312,0,480,162,168,162,apple bloom|applejack|big macintosh|cutie mark crusaders|discord|fluttershy|mane six|pinkie pie|princess cadance|princess celestia|princess luna|queen chrysalis|rainbow dash|rarity|scootaloo|shining armor|sweetie belle|twilight sparkle,christadoodles
1061251.jpg,https://derpicdn.net/img/view/2016/1/7/1061251.jpg,5,0.9787963628768921,608,438,800,646,192,208,apple bloom|applejack|big macintosh|cutie mark crusaders|discord|fluttershy|mane six|pinkie pie|princess cadance|princess celestia|princess luna|queen chrysalis|rainbow dash|rarity|scootaloo|shining armor|sweetie belle|twilight sparkle,christadoodles
1061251.jpg,https://derpicdn.net/img/view/2016/1/7/1061251.jpg,6,0.9772131443023682,454,187,674,407,220,220,apple bloom|applejack|big macintosh|cutie mark crusaders|discord|fluttershy|mane six|pinkie pie|princess cadance|princess celestia|princess luna|queen chrysalis|rainbow dash|rarity|scootaloo|shining armor|sweetie belle|twilight sparkle,christadoodles
1064011.png,https://derpicdn.net/img/view/2016/1/10/1064011.png,0,0.9667354226112366,1437,307,1885,755,448,448,sunset shimmer|twilight sparkle,woogiegirl
1065128.png,https://derpicdn.net/img/view/2016/1/12/1065128.png,0,0.9911110401153564,0,446,404,910,404,464,applejack|fluttershy|mane six|pinkie pie|rainbow dash|rarity|twilight sparkle,furima
1065908.png,https://derpicdn.net/img/view/2016/1/13/1065908.png,0,0.9369680285453796,969,64,1413,508,444,444,starlight glimmer|twilight sparkle,makercedes
106603.png,https://derpicdn.net/img/view/2012/9/26/106603.png,0,0.9642356634140016,1067,0,1713,632,646,632,trixie|twilight sparkle,zelc-face
1068750.png,https://derpicdn.net/img/view/2016/1/18/1068750.png,2,0.963167369365692,696,577,900,781,204,204,applejack|fluttershy|mane six|pinkie pie|rainbow dash|rarity|starlight glimmer|twilight sparkle,swanlullaby
1076226.png,https://derpicdn.net/img/view/2016/1/29/1076226.png,0,0.945794641971588,354,160,936,742,582,582,applejack|fluttershy|mane six|pinkie pie|rainbow dash|rarity|twilight sparkle,asika-aida
1077873.png,https://derpicdn.net/img/view/2016/2/1/1077873.png,0,0.99683278799057,1019,909,1587,1477,568,568,apple bloom|applejack|cutie mark crusaders|fluttershy|princess cadance|rainbow dash|rarity|scootaloo|shining armor|starlight glimmer|sunset shimmer|sweetie belle|twilight sparkle,mofetafrombrooklyn
1079685.png,https://derpicdn.net/img/view/2016/2/3/1079685.png,2,0.9833756685256958,855,11,1201,357,346,346,princess cadance|spike|twilight sparkle,variant
1081234.png,https://derpicdn.net/img/view/2016/2/6/1081234.png,0,0.9879573583602904,62,413,286,637,224,224,applejack|fluttershy|mane six|pinkie pie|rainbow dash|rarity|twilight sparkle,kallarmo
1081234.png,https://derpicdn.net/img/view/2016/2/6/1081234.png,1,0.971969723701477,375,12,607,244,232,232,applejack|fluttershy|mane six|pinkie pie|rainbow dash|rarity|twilight sparkle,kallarmo
1081234.png,https://derpicdn.net/img/view/2016/2/6/1081234.png,2,0.9384687542915344,728,11,976,259,248,248,applejack|fluttershy|mane six|pinkie pie|rainbow dash|rarity|twilight sparkle,kallarmo
1083636.png,https://derpicdn.net/img/view/2016/2/9/1083636.png,0,0.9638165235519408,331,464,557,690,226,226,discord|twilight sparkle,unlocked-shenanigans
1083983.png,https://derpicdn.net/img/view/2016/2/9/1083983.png,0,0.9860190153121948,3078,1681,5068,3671,1990,1990,applejack|fluttershy|mane six|pinkie pie|rainbow dash|rarity|twilight sparkle,cutepencilcase
1083983.png,https://derpicdn.net/img/view/2016/2/9/1083983.png,1,0.9803088903427124,1485,5473,3019,7007,1534,1534,applejack|fluttershy|mane six|pinkie pie|rainbow dash|rarity|twilight sparkle,cutepencilcase
1091754.png,https://derpicdn.net/img/view/2016/2/19/1091754.png,0,0.9269774556159972,370,65,650,345,280,280,applejack|twilight sparkle,sutexii
1092866.png,https://derpicdn.net/img/view/2016/2/20/1092866.png,0,0.9879492521286012,1110,1728,1726,2344,616,616,applejack|fluttershy|mane six|pinkie pie|rainbow dash|rarity|scootaloo|spike|starlight glimmer|sunset shimmer|twilight sparkle,majkashinoda626
1092866.png,https://derpicdn.net/img/view/2016/2/20/1092866.png,1,0.9558162689208984,576,0,1122,537,546,537,applejack|fluttershy|mane six|pinkie pie|rainbow dash|rarity|scootaloo|spike|starlight glimmer|sunset shimmer|twilight sparkle,majkashinoda626
1092866.png,https://derpicdn.net/img/view/2016/2/20/1092866.png,2,0.9301587343215942,35,5,549,519,514,514,applejack|fluttershy|mane six|pinkie pie|rainbow dash|rarity|scootaloo|spike|starlight glimmer|sunset shimmer|twilight sparkle,majkashinoda626
1093686.jpg,https://derpicdn.net/img/view/2016/2/21/1093686.jpg,0,0.9951217770576476,0,92,530,632,530,540,pinkie pie|twilight sparkle,^
1093686.jpg,https://derpicdn.net/img/view/2016/2/21/1093686.jpg,1,0.9186229705810548,521,43,1195,717,674,674,pinkie pie|twilight sparkle,^
1094208.jpg,https://derpicdn.net/img/view/2016/2/22/1094208.jpg,0,0.9423304200172424,581,0,737,150,156,150,applejack|fluttershy|mane six|pinkie pie|rainbow dash|rarity|twilight sparkle,
1096338.png,https://derpicdn.net/img/view/2016/2/25/1096338.png,0,0.996214747428894,1167,1304,1563,1700,396,396,applejack|fluttershy|mane six|pinkie pie|rainbow dash|rarity|twilight sparkle,duskie-06
1096338.png,https://derpicdn.net/img/view/2016/2/25/1096338.png,1,0.9936685562133788,321,312,671,662,350,350,applejack|fluttershy|mane six|pinkie pie|rainbow dash|rarity|twilight sparkle,duskie-06
1096338.png,https://derpicdn.net/img/view/2016/2/25/1096338.png,2,0.9842787384986876,791,719,1173,1101,382,382,applejack|fluttershy|mane six|pinkie pie|rainbow dash|rarity|twilight sparkle,duskie-06
1096582.png,https://derpicdn.net/img/view/2016/2/25/1096582.png,0,0.9986730813980104,47,0,683,581,636,581,applejack|fluttershy|mane six|pinkie pie|rainbow dash|rarity|starlight glimmer|sunset shimmer|trixie|twilight sparkle,mioumi-kiwaii
1100315.png,https://derpicdn.net/img/view/2016/3/2/1100315.png,0,0.998955488204956,395,361,657,623,262,262,applejack|fluttershy|mane six|pinkie pie|rainbow dash|rarity|twilight sparkle,kankryvantas
1100315.png,https://derpicdn.net/img/view/2016/3/2/1100315.png,1,0.995140552520752,705,0,961,245,256,245,applejack|fluttershy|mane six|pinkie pie|rainbow dash|rarity|twilight sparkle,kankryvantas
1100315.png,https://derpicdn.net/img/view/2016/3/2/1100315.png,2,0.9930244088172911,672,649,928,905,256,256,applejack|fluttershy|mane six|pinkie pie|rainbow dash|rarity|twilight sparkle,kankryvantas
1100315.png,https://derpicdn.net/img/view/2016/3/2/1100315.png,3,0.9879531264305116,135,509,397,771,262,262,applejack|fluttershy|mane six|pinkie pie|rainbow dash|rarity|twilight sparkle,kankryvantas
1100315.png,https://derpicdn.net/img/view/2016/3/2/1100315.png,4,0.9866045117378236,336,744,600,1008,264,264,applejack|fluttershy|mane six|pinkie pie|rainbow dash|rarity|twilight sparkle,kankryvantas
1100315.png,https://derpicdn.net/img/view/2016/3/2/1100315.png,5,0.93835186958313,222,118,494,390,272,272,applejack|fluttershy|mane six|pinkie pie|rainbow dash|rarity|twilight sparkle,kankryvantas
1102605.png,https://derpicdn.net/img/view/2016/3/5/1102605.png,0,0.9121895432472228,126,0,714,583,588,583,starlight glimmer|twilight sparkle,
1109687.png,https://derpicdn.net/img/view/2016/3/15/1109687.png,0,0.980131447315216,609,260,1391,1042,782,782,apple bloom|applejack|rainbow dash|spike|twilight sparkle,cuttledreams
1109687.png,https://derpicdn.net/img/view/2016/3/15/1109687.png,1,0.9492228627204896,2762,322,3666,1226,904,904,apple bloom|applejack|rainbow dash|spike|twilight sparkle,cuttledreams
1109738.png,https://derpicdn.net/img/view/2016/3/15/1109738.png,0,0.9918746948242188,526,0,982,399,456,399,princess celestia|twilight sparkle,atariboy2600
1113315.jpg,https://derpicdn.net/img/view/2016/3/20/1113315.jpg,0,0.9876026511192322,287,7,467,187,180,180,applejack|fluttershy|mane six|pinkie pie|rainbow dash|rarity|twilight sparkle,edcom02|krynos79
1113315.jpg,https://derpicdn.net/img/view/2016/3/20/1113315.jpg,1,0.9104721546173096,361,571,817,1027,456,456,applejack|fluttershy|mane six|pinkie pie|rainbow dash|rarity|twilight sparkle,edcom02|krynos79
11134.png,https://derpicdn.net/img/view/2012/6/20/11134.png,0,0.9138358235359192,382,159,916,693,534,534,fluttershy|twilight sparkle,megasweet|ashesg
1116105.png,https://derpicdn.net/img/view/2016/3/24/1116105.png,0,0.9957619905471802,2769,4460,3851,5542,1082,1082,applejack|fluttershy|mane six|pinkie pie|rainbow dash|rarity|twilight sparkle,emera33
1116105.png,https://derpicdn.net/img/view/2016/3/24/1116105.png,1,0.9939587712287904,195,653,1193,1651,998,998,applejack|fluttershy|mane six|pinkie pie|rainbow dash|rarity|twilight sparkle,emera33
1116105.png,https://derpicdn.net/img/view/2016/3/24/1116105.png,2,0.9662722945213318,2763,1219,3993,2449,1230,1230,applejack|fluttershy|mane six|pinkie pie|rainbow dash|rarity|twilight sparkle,emera33
1116105.png,https://derpicdn.net/img/view/2016/3/24/1116105.png,3,0.9541999101638794,498,3442,1580,4524,1082,1082,applejack|fluttershy|mane six|pinkie pie|rainbow dash|rarity|twilight sparkle,emera33
1116105.png,https://derpicdn.net/img/view/2016/3/24/1116105.png,4,0.9225234389305116,4596,3275,6392,5071,1796,1796,applejack|fluttershy|mane six|pinkie pie|rainbow dash|rarity|twilight sparkle,emera33
111733.jpg,https://derpicdn.net/img/view/2012/10/2/111733.jpg,0,0.9906416535377502,208,142,442,376,234,234,fluttershy|pinkie pie|rainbow dash|twilight sparkle,
111733.jpg,https://derpicdn.net/img/view/2012/10/2/111733.jpg,1,0.9838747382164,771,92,960,302,189,210,fluttershy|pinkie pie|rainbow dash|twilight sparkle,
111733.jpg,https://derpicdn.net/img/view/2012/10/2/111733.jpg,2,0.927745759487152,7,93,245,331,238,238,fluttershy|pinkie pie|rainbow dash|twilight sparkle,
1117418.jpg,https://derpicdn.net/img/view/2016/3/26/1117418.jpg,0,0.976143717765808,427,689,609,871,182,182,pinkie pie|princess flurry heart|twilight sparkle,
1118588.png,https://derpicdn.net/img/view/2016/3/27/1118588.png,0,0.9952678680419922,233,276,461,504,228,228,applejack|fluttershy|mane six|pinkie pie|rainbow dash|rarity|twilight sparkle,10art1
1118722.png,https://derpicdn.net/img/view/2016/3/28/1118722.png,0,0.9330281019210817,878,52,1144,318,266,266,apple bloom|applejack|big macintosh|cutie mark crusaders|fluttershy|granny smith|mane six|pinkie pie|rainbow dash|rarity|scootaloo|spike|starlight glimmer|sweetie belle|twilight sparkle,
111878.png,https://derpicdn.net/img/view/2012/10/2/111878.png,0,0.99299818277359,556,0,1250,591,694,591,big macintosh|twilight sparkle,dm29
1121529.png,https://derpicdn.net/img/view/2016/4/1/1121529.png,0,0.9996777772903442,769,20,1655,906,886,886,applejack|fluttershy|mane six|pinkie pie|rainbow dash|rarity|twilight sparkle,stormtwirl|emberkaese
1121529.png,https://derpicdn.net/img/view/2016/4/1/1121529.png,1,0.9948732852935792,861,1063,1561,1763,700,700,applejack|fluttershy|mane six|pinkie pie|rainbow dash|rarity|twilight sparkle,stormtwirl|emberkaese
1121529.png,https://derpicdn.net/img/view/2016/4/1/1121529.png,2,0.9946923851966858,145,116,895,866,750,750,applejack|fluttershy|mane six|pinkie pie|rainbow dash|rarity|twilight sparkle,stormtwirl|emberkaese
1121529.png,https://derpicdn.net/img/view/2016/4/1/1121529.png,3,0.9752684235572816,1654,1019,2448,1813,794,794,applejack|fluttershy|mane six|pinkie pie|rainbow dash|rarity|twilight sparkle,stormtwirl|emberkaese
1121956.png,https://derpicdn.net/img/view/2016/4/1/1121956.png,0,0.991909384727478,698,129,1536,967,838,838,trixie|twilight sparkle,spellboundcanvas
1121956.png,https://derpicdn.net/img/view/2016/4/1/1121956.png,1,0.9857536554336548,1243,0,2471,1199,1228,1199,trixie|twilight sparkle,spellboundcanvas
1124250.png,https://derpicdn.net/img/view/2016/4/4/1124250.png,0,0.964942753314972,672,69,958,355,286,286,princess luna|twilight sparkle,phyllismi
1124815.jpg,https://derpicdn.net/img/view/2016/4/5/1124815.jpg,3,0.9541897177696228,274,264,440,430,166,166,princess celestia|princess luna|twilight sparkle,kerydarling
1126662.png,https://derpicdn.net/img/view/2016/4/7/1126662.png,0,0.9859068393707277,546,144,790,388,244,244,rainbow dash|twilight sparkle,falldust
1131847.png,https://derpicdn.net/img/view/2016/4/14/1131847.png,0,0.9942192435264589,380,251,1454,1325,1074,1074,starlight glimmer|twilight sparkle,hfinder
1133467.png,https://derpicdn.net/img/view/2016/4/16/1133467.png,0,0.9441038370132446,5,0,937,895,932,895,rarity|twilight sparkle,
1137294.png,https://derpicdn.net/img/view/2016/4/21/1137294.png,0,0.9718228578567504,0,5,675,687,675,682,applejack|rainbow dash|twilight sparkle,neondion60
1137294.png,https://derpicdn.net/img/view/2016/4/21/1137294.png,1,0.9084206819534302,725,0,1731,924,1006,924,applejack|rainbow dash|twilight sparkle,neondion60
1140423.jpg,https://derpicdn.net/img/view/2016/4/26/1140423.jpg,0,0.990057647228241,176,0,1100,753,924,753,rainbow dash|twilight sparkle,mylittlelevi64
1140448.png,https://derpicdn.net/img/view/2016/4/26/1140448.png,0,0.9858269095420836,833,494,1261,922,428,428,fluttershy|twilight sparkle,tarana10
1141064.png,https://derpicdn.net/img/view/2016/4/27/1141064.png,0,0.961655616760254,20,203,274,457,254,254,princess cadance|princess celestia|princess luna|twilight sparkle,princessfaeron
1141069.jpg,https://derpicdn.net/img/view/2016/4/27/1141069.jpg,1,0.9430304169654846,0,0,378,323,378,323,applejack|fluttershy|mane six|pinkie pie|rainbow dash|rarity|twilight sparkle,ellesdoodlebox
1142073.jpg,https://derpicdn.net/img/view/2016/4/29/1142073.jpg,0,0.9964652061462402,174,1050,580,1456,406,406,applejack|fluttershy|mane six|pinkie pie|rainbow dash|rarity|twilight sparkle,phoenixperegrine
1145025.png,https://derpicdn.net/img/view/2016/5/2/1145025.png,0,0.9858980774879456,305,715,693,1103,388,388,starlight glimmer|trixie|twilight sparkle,samey90
1145384.png,https://derpicdn.net/img/view/2016/5/3/1145384.png,0,0.97565358877182,31,24,439,432,408,408,rainbow dash|rarity|twilight sparkle,star-lightstarbright
1145384.png,https://derpicdn.net/img/view/2016/5/3/1145384.png,2,0.9242106080055236,1601,484,1920,892,319,408,rainbow dash|rarity|twilight sparkle,star-lightstarbright
1145638.png,https://derpicdn.net/img/view/2016/5/3/1145638.png,0,0.9665480852127076,25,0,775,723,750,723,trixie|twilight sparkle,sion
1145638.png,https://derpicdn.net/img/view/2016/5/3/1145638.png,1,0.9098844528198242,721,104,1377,760,656,656,trixie|twilight sparkle,sion
1147.png,https://derpicdn.net/img/view/2012/1/22/1147.png,1,0.9110304117202759,502,0,906,396,404,396,trixie|twilight sparkle,c0nker
1147263.png,https://derpicdn.net/img/view/2016/5/5/1147263.png,0,0.9633095264434814,33,121,459,547,426,426,rarity|twilight sparkle,senaelik
1147750.jpg,https://derpicdn.net/img/view/2016/5/6/1147750.jpg,0,0.9066293239593506,724,108,1264,648,540,540,princess cadance|princess celestia|princess luna|twilight sparkle,princessrosemcmitten
1148489.jpg,https://derpicdn.net/img/view/2016/5/7/1148489.jpg,1,0.9313940405845642,1054,0,1280,240,226,240,apple bloom|applejack|fluttershy|rarity|sweetie belle|twilight sparkle,
1148489.jpg,https://derpicdn.net/img/view/2016/5/7/1148489.jpg,2,0.9126620888710022,0,337,331,679,331,342,apple bloom|applejack|fluttershy|rarity|sweetie belle|twilight sparkle,
1148549.jpg,https://derpicdn.net/img/view/2016/5/7/1148549.jpg,0,0.9617551565170288,0,0,675,705,675,705,trixie|twilight sparkle,joakaha
1149397.png,https://derpicdn.net/img/view/2016/5/8/1149397.png,0,0.9992953538894652,3786,27,5712,1953,1926,1926,trixie|twilight sparkle,osipush
1149397.png,https://derpicdn.net/img/view/2016/5/8/1149397.png,1,0.9981223344802856,1263,0,3867,2283,2604,2283,trixie|twilight sparkle,osipush
1150593.png,https://derpicdn.net/img/view/2016/5/10/1150593.png,0,0.9885748028755188,2309,537,6539,4767,4230,4230,princess cadance|twilight sparkle,decprincess
1153016.png,https://derpicdn.net/img/view/2016/5/13/1153016.png,0,0.9309712648391724,534,33,998,497,464,464,sunset shimmer|twilight sparkle,razvimorar5
1155411.png,https://derpicdn.net/img/view/2016/5/16/1155411.png,2,0.9620482921600342,379,710,849,1180,470,470,applejack|fluttershy|mane six|pinkie pie|rainbow dash|rarity|twilight sparkle,silent-shadow-wolf
1155411.png,https://derpicdn.net/img/view/2016/5/16/1155411.png,3,0.9141086339950562,1877,595,2461,1179,584,584,applejack|fluttershy|mane six|pinkie pie|rainbow dash|rarity|twilight sparkle,silent-shadow-wolf
1157540.png,https://derpicdn.net/img/view/2016/5/19/1157540.png,0,0.9809511303901672,14,587,654,1227,640,640,rarity|twilight sparkle,acesrockz
1157540.png,https://derpicdn.net/img/view/2016/5/19/1157540.png,1,0.9762598276138306,188,13,568,393,380,380,rarity|twilight sparkle,acesrockz
1158817.png,https://derpicdn.net/img/view/2016/5/21/1158817.png,0,0.9924485087394714,323,0,833,478,510,478,fluttershy|rainbow dash|twilight sparkle,kawaiicutie-chan
1158817.png,https://derpicdn.net/img/view/2016/5/21/1158817.png,1,0.9697919487953186,37,33,375,371,338,338,fluttershy|rainbow dash|twilight sparkle,kawaiicutie-chan
1159356.png,https://derpicdn.net/img/view/2016/5/21/1159356.png,0,0.9021114110946656,117,0,1205,712,1088,712,rarity|twilight sparkle,
1159399.png,https://derpicdn.net/img/view/2016/5/21/1159399.png,0,0.9246422052383424,594,1056,986,1448,392,392,applejack|fluttershy|mane six|pinkie pie|rainbow dash|rarity|twilight sparkle,
1167739.png,https://derpicdn.net/img/view/2016/6/1/1167739.png,0,0.9983565211296082,1593,0,2447,751,854,751,applejack|fluttershy|mane six|pinkie pie|rainbow dash|rarity|spike|twilight sparkle,vird-gi
1167739.png,https://derpicdn.net/img/view/2016/6/1/1167739.png,1,0.9873672127723694,1301,1132,2167,1998,866,866,applejack|fluttershy|mane six|pinkie pie|rainbow dash|rarity|spike|twilight sparkle,vird-gi
1167739.png,https://derpicdn.net/img/view/2016/6/1/1167739.png,2,0.9814450144767758,2383,960,3067,1644,684,684,applejack|fluttershy|mane six|pinkie pie|rainbow dash|rarity|spike|twilight sparkle,vird-gi
1167739.png,https://derpicdn.net/img/view/2016/6/1/1167739.png,4,0.914492964744568,2974,1185,3598,1809,624,624,applejack|fluttershy|mane six|pinkie pie|rainbow dash|rarity|spike|twilight sparkle,vird-gi
1169996.png,https://derpicdn.net/img/view/2016/6/4/1169996.png,0,0.9896971583366394,216,0,707,436,491,436,fluttershy|twilight sparkle,
1170024.png,https://derpicdn.net/img/view/2016/6/4/1170024.png,1,0.9431183934211732,183,0,431,219,248,219,fluttershy|twilight sparkle,
1170823.png,https://derpicdn.net/img/view/2016/6/5/1170823.png,0,0.9943820238113404,580,397,540,558,-40,161,rarity|twilight sparkle,sehad
1172873.png,https://derpicdn.net/img/view/2016/6/7/1172873.png,0,0.9572491645812988,2145,486,2579,920,434,434,big macintosh|soarin'|spike|twilight sparkle,shutterflyeqd
1172873.png,https://derpicdn.net/img/view/2016/6/7/1172873.png,1,0.9520915746688844,1437,366,1867,796,430,430,big macintosh|soarin'|spike|twilight sparkle,shutterflyeqd
1173298.png,https://derpicdn.net/img/view/2016/6/8/1173298.png,0,0.9561355710029602,119,162,485,528,366,366,applejack|fluttershy|mane six|pinkie pie|rainbow dash|rarity|twilight sparkle,legally-psychotic
1175689.jpg,https://derpicdn.net/img/view/2016/6/11/1175689.jpg,0,0.9391715526580808,48,264,600,816,552,552,spike|twilight sparkle,toonbat
1178024.jpg,https://derpicdn.net/img/view/2016/6/14/1178024.jpg,2,0.9630164504051208,85,62,345,322,260,260,rainbow dash|twilight sparkle,linedraweer
1178229.png,https://derpicdn.net/img/view/2016/6/14/1178229.png,0,0.9993141889572144,152,842,1150,1840,998,998,pinkie pie|rarity|twilight sparkle,befishproductions
1178229.png,https://derpicdn.net/img/view/2016/6/14/1178229.png,1,0.997085452079773,1772,78,3616,1922,1844,1844,pinkie pie|rarity|twilight sparkle,befishproductions
1178229.png,https://derpicdn.net/img/view/2016/6/14/1178229.png,2,0.9433204531669616,1071,794,2053,1776,982,982,pinkie pie|rarity|twilight sparkle,befishproductions
1178784.png,https://derpicdn.net/img/view/2016/6/15/1178784.png,0,0.9981728196144104,586,244,978,636,392,392,rainbow dash|twilight sparkle,essel
1179289.jpg,https://derpicdn.net/img/view/2016/6/15/1179289.jpg,0,0.9741681814193726,0,0,946,837,946,837,spike|twilight sparkle,mlp-silver-quill
1179445.jpg,https://derpicdn.net/img/view/2016/6/16/1179445.jpg,0,0.9975658655166626,64,0,474,352,410,352,applejack|fluttershy|rainbow dash|twilight sparkle,mittsies
1179445.jpg,https://derpicdn.net/img/view/2016/6/16/1179445.jpg,1,0.9935505986213684,606,177,1024,599,418,422,applejack|fluttershy|rainbow dash|twilight sparkle,mittsies
1184735.png,https://derpicdn.net/img/view/2016/6/23/1184735.png,0,0.9936844110488892,211,0,615,352,404,352,rainbow dash|twilight sparkle,deep mystery
1185786.png,https://derpicdn.net/img/view/2016/6/24/1185786.png,0,0.9828564524650574,0,738,1320,2098,1320,1360,applejack|rainbow dash|rarity|twilight sparkle,geraritydevillefort
1185786.png,https://derpicdn.net/img/view/2016/6/24/1185786.png,1,0.9798275828361512,1075,1178,1765,1868,690,690,applejack|rainbow dash|rarity|twilight sparkle,geraritydevillefort
1188562.png,https://derpicdn.net/img/view/2016/6/28/1188562.png,0,0.9887160062789916,0,749,819,1577,819,828,applejack|fluttershy|mane six|pinkie pie|rainbow dash|rarity|twilight sparkle,mordecairigbylover
1188562.png,https://derpicdn.net/img/view/2016/6/28/1188562.png,1,0.9695095419883728,2564,2627,3360,3423,796,796,applejack|fluttershy|mane six|pinkie pie|rainbow dash|rarity|twilight sparkle,mordecairigbylover
1188562.png,https://derpicdn.net/img/view/2016/6/28/1188562.png,3,0.9309404492378236,1646,1402,2454,2210,808,808,applejack|fluttershy|mane six|pinkie pie|rainbow dash|rarity|twilight sparkle,mordecairigbylover
1188562.png,https://derpicdn.net/img/view/2016/6/28/1188562.png,4,0.9307339191436768,1724,229,2552,1057,828,828,applejack|fluttershy|mane six|pinkie pie|rainbow dash|rarity|twilight sparkle,mordecairigbylover
118861.jpg,https://derpicdn.net/img/view/2012/10/10/118861.jpg,1,0.9889739751815796,0,692,351,1044,351,352,applejack|fluttershy|mane six|pinkie pie|rainbow dash|rarity|twilight sparkle,merionminor
118861.jpg,https://derpicdn.net/img/view/2012/10/10/118861.jpg,2,0.9842525124549866,902,13,1182,293,280,280,applejack|fluttershy|mane six|pinkie pie|rainbow dash|rarity|twilight sparkle,merionminor
118861.jpg,https://derpicdn.net/img/view/2012/10/10/118861.jpg,3,0.973321259021759,479,192,807,520,328,328,applejack|fluttershy|mane six|pinkie pie|rainbow dash|rarity|twilight sparkle,merionminor
118861.jpg,https://derpicdn.net/img/view/2012/10/10/118861.jpg,4,0.957865834236145,932,710,1210,988,278,278,applejack|fluttershy|mane six|pinkie pie|rainbow dash|rarity|twilight sparkle,merionminor
118861.jpg,https://derpicdn.net/img/view/2012/10/10/118861.jpg,5,0.9115716218948364,6,0,362,349,356,349,applejack|fluttershy|mane six|pinkie pie|rainbow dash|rarity|twilight sparkle,merionminor
1189420.png,https://derpicdn.net/img/view/2016/6/29/1189420.png,0,0.9997114539146424,1721,2212,2480,3056,759,844,applejack|fluttershy|mane six|pinkie pie|rainbow dash|rarity|twilight sparkle,corelle-vairel
1189420.png,https://derpicdn.net/img/view/2016/6/29/1189420.png,1,0.9994613528251648,1473,1102,2371,2000,898,898,applejack|fluttershy|mane six|pinkie pie|rainbow dash|rarity|twilight sparkle,corelle-vairel
1189420.png,https://derpicdn.net/img/view/2016/6/29/1189420.png,2,0.9981588125228882,54,1130,958,2034,904,904,applejack|fluttershy|mane six|pinkie pie|rainbow dash|rarity|twilight sparkle,corelle-vairel
1189420.png,https://derpicdn.net/img/view/2016/6/29/1189420.png,3,0.9924677014350892,114,0,952,813,838,813,applejack|fluttershy|mane six|pinkie pie|rainbow dash|rarity|twilight sparkle,corelle-vairel
1189420.png,https://derpicdn.net/img/view/2016/6/29/1189420.png,4,0.981520175933838,0,2208,972,3250,972,1042,applejack|fluttershy|mane six|pinkie pie|rainbow dash|rarity|twilight sparkle,corelle-vairel
1189420.png,https://derpicdn.net/img/view/2016/6/29/1189420.png,5,0.9745562672615052,1585,78,2259,752,674,674,applejack|fluttershy|mane six|pinkie pie|rainbow dash|rarity|twilight sparkle,corelle-vairel
1190709.png,https://derpicdn.net/img/view/2016/7/1/1190709.png,0,0.964358389377594,698,376,1098,776,400,400,princess cadance|twilight sparkle,kuromi
1191067.png,https://derpicdn.net/img/view/2016/7/1/1191067.png,0,0.9630462527275084,252,445,1710,1903,1458,1458,pinkie pie|spike|twilight sparkle,joemasterpencil
1193580.png,https://derpicdn.net/img/view/2016/7/4/1193580.png,0,0.9843757748603821,41,0,221,178,180,178,princess celestia|princess luna|twilight sparkle,haydee
1194005.png,https://derpicdn.net/img/view/2016/7/5/1194005.png,3,0.960536777973175,743,502,1024,816,281,314,applejack|fluttershy|mane six|pinkie pie|rainbow dash|rarity|twilight sparkle,chiakitasso
1194404.png,https://derpicdn.net/img/view/2016/7/6/1194404.png,0,0.9994779825210572,3646,183,5000,1543,1354,1360,princess cadance|princess celestia|princess luna|twilight sparkle,kurochhi
1194404.png,https://derpicdn.net/img/view/2016/7/6/1194404.png,1,0.9569810032844543,79,503,1273,1697,1194,1194,princess cadance|princess celestia|princess luna|twilight sparkle,kurochhi
1197703.png,https://derpicdn.net/img/view/2016/7/10/1197703.png,0,0.9848138689994812,2900,0,5534,2599,2634,2599,shining armor|twilight sparkle,mississippikite
1197703.png,https://derpicdn.net/img/view/2016/7/10/1197703.png,1,0.9010408520698548,19,1045,2281,3307,2262,2262,shining armor|twilight sparkle,mississippikite
1198946.png,https://derpicdn.net/img/view/2016/7/12/1198946.png,0,0.9985524415969848,1376,662,2200,1486,824,824,applejack|fluttershy|pinkie pie|rainbow dash|rarity|twilight sparkle,ikasama
1199365.png,https://derpicdn.net/img/view/2016/7/12/1199365.png,0,0.9658809304237366,0,747,507,1265,507,518,fluttershy|pinkie pie|princess luna|trixie|twilight sparkle,deathpwny
1199365.png,https://derpicdn.net/img/view/2016/7/12/1199365.png,1,0.9245226979255676,2236,768,2720,1262,484,494,fluttershy|pinkie pie|princess luna|trixie|twilight sparkle,deathpwny
1201514.png,https://derpicdn.net/img/view/2016/7/15/1201514.png,1,0.9561564326286316,1786,762,2412,1388,626,626,applejack|fluttershy|pinkie pie|rainbow dash|rarity|twilight sparkle,babero
1203908.png,https://derpicdn.net/img/view/2016/7/18/1203908.png,0,0.9963018894195556,1675,777,2500,1605,825,828,applejack|fluttershy|mane six|pinkie pie|rainbow dash|rarity|starlight glimmer|sunset shimmer|twilight sparkle,datapony
1203908.png,https://derpicdn.net/img/view/2016/7/18/1203908.png,1,0.996250569820404,8,0,830,784,822,784,applejack|fluttershy|mane six|pinkie pie|rainbow dash|rarity|starlight glimmer|sunset shimmer|twilight sparkle,datapony
1204140.png,https://derpicdn.net/img/view/2016/7/19/1204140.png,0,0.9928115606307985,256,683,564,991,308,308,apple bloom|applejack|big macintosh|fluttershy|mane six|pinkie pie|rainbow dash|rarity|twilight sparkle,28gooddays
1204140.png,https://derpicdn.net/img/view/2016/7/19/1204140.png,1,0.9633491635322572,1222,903,1548,1229,326,326,apple bloom|applejack|big macintosh|fluttershy|mane six|pinkie pie|rainbow dash|rarity|twilight sparkle,28gooddays
1204140.png,https://derpicdn.net/img/view/2016/7/19/1204140.png,2,0.925595223903656,1409,671,1741,1003,332,332,apple bloom|applejack|big macintosh|fluttershy|mane six|pinkie pie|rainbow dash|rarity|twilight sparkle,28gooddays
1209041.png,https://derpicdn.net/img/view/2016/7/25/1209041.png,0,0.9792874455451964,853,16,1280,504,427,488,starlight glimmer|twilight sparkle,
1209989.png,https://derpicdn.net/img/view/2016/7/27/1209989.png,0,0.9630036950111388,4452,0,8192,3687,3740,3687,spike|twilight sparkle,thorinair
1213738.png,https://derpicdn.net/img/view/2016/7/31/1213738.png,0,0.9685637950897216,131,0,1047,848,916,848,rainbow dash|twilight sparkle,
1214883.png,https://derpicdn.net/img/view/2016/8/1/1214883.png,0,0.9970200657844543,390,323,856,789,466,466,princess cadance|twilight sparkle,shiromidorii
1217433.png,https://derpicdn.net/img/view/2016/8/5/1217433.png,0,0.9341146945953368,0,0,311,240,311,240,trixie|twilight sparkle,xxmissteaxx
1220741.png,https://derpicdn.net/img/view/2016/8/9/1220741.png,0,0.9983392357826232,712,125,1150,563,438,438,starlight glimmer|sunset shimmer|trixie|twilight sparkle,not-ordinary-pony
1220741.png,https://derpicdn.net/img/view/2016/8/9/1220741.png,3,0.9958120584487916,1011,775,1400,1229,389,454,starlight glimmer|sunset shimmer|trixie|twilight sparkle,not-ordinary-pony
1220741.png,https://derpicdn.net/img/view/2016/8/9/1220741.png,4,0.9943676590919496,281,811,747,1277,466,466,starlight glimmer|sunset shimmer|trixie|twilight sparkle,not-ordinary-pony
1220741.png,https://derpicdn.net/img/view/2016/8/9/1220741.png,5,0.9930869340896606,357,101,755,499,398,398,starlight glimmer|sunset shimmer|trixie|twilight sparkle,not-ordinary-pony
1220741.png,https://derpicdn.net/img/view/2016/8/9/1220741.png,7,0.9894466996192932,5,0,483,452,478,452,starlight glimmer|sunset shimmer|trixie|twilight sparkle,not-ordinary-pony
1224537.png,https://derpicdn.net/img/view/2016/8/13/1224537.png,0,0.9283244609832764,611,34,948,430,337,396,apple bloom|applejack|cutie mark crusaders|fluttershy|pinkie pie|rarity|scootaloo|spike|sweetie belle|twilight sparkle,
1225086.png,https://derpicdn.net/img/view/2016/8/14/1225086.png,0,0.926182746887207,6690,0,12784,5571,6094,5571,starlight glimmer|twilight sparkle,tardifice
1226751.png,https://derpicdn.net/img/view/2016/8/16/1226751.png,0,0.9266337156295776,80,46,566,532,486,486,applejack|fluttershy|rainbow dash|rarity|spike|twilight sparkle,xxmissteaxx
1227761.png,https://derpicdn.net/img/view/2016/8/18/1227761.png,0,0.9673459529876708,368,78,842,552,474,474,pinkie pie|twilight sparkle,pabbley
1229080.png,https://derpicdn.net/img/view/2016/8/19/1229080.png,1,0.980547308921814,1244,749,2044,1549,800,800,big macintosh|fluttershy|granny smith|pinkie pie|spike|twilight sparkle,dashiesparkle
1229642.png,https://derpicdn.net/img/view/2016/8/20/1229642.png,0,0.9607269167900084,419,0,887,419,468,419,starlight glimmer|twilight sparkle,
1229719.png,https://derpicdn.net/img/view/2016/8/20/1229719.png,0,0.9571043848991394,280,0,608,306,328,306,starlight glimmer|twilight sparkle,
1232047.png,https://derpicdn.net/img/view/2016/8/23/1232047.png,0,0.9776597619056702,41,351,673,983,632,632,trixie|twilight sparkle,trixeed
1232372.png,https://derpicdn.net/img/view/2016/8/23/1232372.png,0,0.9934496283531188,618,628,1246,1256,628,628,applejack|big macintosh|fluttershy|mane six|pinkie pie|rainbow dash|rarity|sunset shimmer|twilight sparkle,chiweee
1232372.png,https://derpicdn.net/img/view/2016/8/23/1232372.png,1,0.9195562601089478,867,161,1159,453,292,292,applejack|big macintosh|fluttershy|mane six|pinkie pie|rainbow dash|rarity|sunset shimmer|twilight sparkle,chiweee
1234614.png,https://derpicdn.net/img/view/2016/8/27/1234614.png,0,0.9913609623908995,428,736,1168,1476,740,740,apple bloom|applejack|babs seed|big macintosh|cutie mark crusaders|discord|fluttershy|granny smith|mane six|pinkie pie|princess cadance|princess celestia|princess luna|rainbow dash|rarity|scootaloo|shining armor|spike|starlight glimmer|sweetie belle|trixie|twilight sparkle,dreadmaster231
1234614.png,https://derpicdn.net/img/view/2016/8/27/1234614.png,2,0.9070827960968018,2496,1050,3014,1568,518,518,apple bloom|applejack|babs seed|big macintosh|cutie mark crusaders|discord|fluttershy|granny smith|mane six|pinkie pie|princess cadance|princess celestia|princess luna|rainbow dash|rarity|scootaloo|shining armor|spike|starlight glimmer|sweetie belle|trixie|twilight sparkle,dreadmaster231
1239057.png,https://derpicdn.net/img/view/2016/9/1/1239057.png,0,0.978507936000824,0,446,694,1162,694,716,princess flurry heart|shining armor|twilight sparkle,little-tweenframes
1239165.png,https://derpicdn.net/img/view/2016/9/1/1239165.png,0,0.9902706742286682,47,0,2203,1671,2156,1671,applejack|fluttershy|mane six|pinkie pie|rainbow dash|rarity|twilight sparkle,gen-ma
1239165.png,https://derpicdn.net/img/view/2016/9/1/1239165.png,2,0.9509419202804564,2005,619,3915,2529,1910,1910,applejack|fluttershy|mane six|pinkie pie|rainbow dash|rarity|twilight sparkle,gen-ma
1242150.png,https://derpicdn.net/img/view/2016/9/5/1242150.png,0,0.994705080986023,48,20,316,288,268,268,applejack|fluttershy|mane six|pinkie pie|rainbow dash|rarity|twilight sparkle,starsketchmeh
1243534.png,https://derpicdn.net/img/view/2016/9/7/1243534.png,0,0.9719805121421814,448,12,912,476,464,464,applejack|twilight sparkle,haretrinity
1246083.png,https://derpicdn.net/img/view/2016/9/10/1246083.png,0,0.9152911901474,0,0,783,694,783,694,apple bloom|twilight sparkle,
1247013.png,https://derpicdn.net/img/view/2016/9/11/1247013.png,0,0.9933570027351379,32,0,308,248,276,248,princess celestia|rainbow dash|twilight sparkle,nopeys
1247013.png,https://derpicdn.net/img/view/2016/9/11/1247013.png,1,0.96699196100235,779,25,967,213,188,188,princess celestia|rainbow dash|twilight sparkle,nopeys
1248642.png,https://derpicdn.net/img/view/2016/9/13/1248642.png,0,0.9846940636634828,618,1193,1240,1815,622,622,applejack|fluttershy|mane six|pinkie pie|rainbow dash|rarity|twilight sparkle,olivecow
1255015.png,https://derpicdn.net/img/view/2016/9/21/1255015.png,0,0.9671552181243896,82,61,390,369,308,308,pinkie pie|twilight sparkle,bluemoonlightflower
1255015.png,https://derpicdn.net/img/view/2016/9/21/1255015.png,1,0.9163807034492492,260,44,612,396,352,352,pinkie pie|twilight sparkle,bluemoonlightflower
1256929.png,https://derpicdn.net/img/view/2016/9/24/1256929.png,0,0.9792845249176024,1255,784,2123,1652,868,868,applejack|fluttershy|mane six|pinkie pie|rainbow dash|rarity|twilight sparkle,lrusu
1257151.png,https://derpicdn.net/img/view/2016/9/24/1257151.png,1,0.9935867786407472,927,107,1411,591,484,484,spike|starlight glimmer|twilight sparkle,
1264676.png,https://derpicdn.net/img/view/2016/10/4/1264676.png,0,0.9380233287811279,745,185,1237,677,492,492,fluttershy|pinkie pie|rarity|twilight sparkle,benja
1267937.png,https://derpicdn.net/img/view/2016/10/8/1267937.png,0,0.9923709034919742,159,20,297,158,138,138,trixie|twilight sparkle,liliumena
1271905.png,https://derpicdn.net/img/view/2016/10/13/1271905.png,0,0.929569125175476,1196,0,2694,1215,1498,1215,applejack|fluttershy|mane six|pinkie pie|rainbow dash|rarity|twilight sparkle,imafutureguitarhero
1275968.png,https://derpicdn.net/img/view/2016/10/18/1275968.png,0,0.9993228912353516,1494,350,2880,1736,1386,1386,fluttershy|twilight sparkle,docwario
1278669.png,https://derpicdn.net/img/view/2016/10/22/1278669.png,0,0.9943483471870422,0,378,582,968,582,590,fluttershy|twilight sparkle,silviasilvar
1281990.png,https://derpicdn.net/img/view/2016/10/26/1281990.png,0,0.99175626039505,577,1458,1561,2442,984,984,sunset shimmer|trixie|twilight sparkle,cloureed
12827.jpg,https://derpicdn.net/img/view/2012/6/20/12827.jpg,0,0.9859471321105956,2050,279,2396,625,346,346,applejack|fluttershy|mane six|pinkie pie|rainbow dash|rarity|twilight sparkle,equestria-prevails
1285246.png,https://derpicdn.net/img/view/2016/10/31/1285246.png,0,0.995927095413208,1908,564,2886,1542,978,978,applejack|fluttershy|mane six|pinkie pie|rainbow dash|rarity|twilight sparkle,twiddletwist
1285246.png,https://derpicdn.net/img/view/2016/10/31/1285246.png,3,0.9251293540000916,1127,815,1919,1607,792,792,applejack|fluttershy|mane six|pinkie pie|rainbow dash|rarity|twilight sparkle,twiddletwist
1288937.png,https://derpicdn.net/img/view/2016/11/5/1288937.png,0,0.9846119284629822,741,12,1121,392,380,380,applejack|fluttershy|mane six|pinkie pie|rainbow dash|rarity|twilight sparkle,blackgryph0n|luckreza8|intbrony|greywander87|alexiy777|stabzor|embersatdawn|dashiesparkle|thedarksatanicorn
1288937.png,https://derpicdn.net/img/view/2016/11/5/1288937.png,1,0.9836763143539428,682,495,1222,1035,540,540,applejack|fluttershy|mane six|pinkie pie|rainbow dash|rarity|twilight sparkle,blackgryph0n|luckreza8|intbrony|greywander87|alexiy777|stabzor|embersatdawn|dashiesparkle|thedarksatanicorn
1288937.png,https://derpicdn.net/img/view/2016/11/5/1288937.png,2,0.9785457849502563,115,332,731,948,616,616,applejack|fluttershy|mane six|pinkie pie|rainbow dash|rarity|twilight sparkle,blackgryph0n|luckreza8|intbrony|greywander87|alexiy777|stabzor|embersatdawn|dashiesparkle|thedarksatanicorn
1288937.png,https://derpicdn.net/img/view/2016/11/5/1288937.png,3,0.9385653734207152,1102,286,1736,920,634,634,applejack|fluttershy|mane six|pinkie pie|rainbow dash|rarity|twilight sparkle,blackgryph0n|luckreza8|intbrony|greywander87|alexiy777|stabzor|embersatdawn|dashiesparkle|thedarksatanicorn
1289987.png,https://derpicdn.net/img/view/2016/11/6/1289987.png,0,0.9982215762138368,1162,11,1782,631,620,620,applejack|rarity|twilight sparkle,geraritydevillefort
1289987.png,https://derpicdn.net/img/view/2016/11/6/1289987.png,1,0.9968741536140442,579,232,1269,922,690,690,applejack|rarity|twilight sparkle,geraritydevillefort
1292478.png,https://derpicdn.net/img/view/2016/11/10/1292478.png,0,0.9913750290870668,224,0,676,445,452,445,scootaloo|twilight sparkle,squipycheetah
1304918.png,https://derpicdn.net/img/view/2016/11/27/1304918.png,0,0.9807942509651184,2291,1220,3365,2294,1074,1074,applejack|fluttershy|mane six|pinkie pie|rainbow dash|rarity|twilight sparkle,mississippikite
1304918.png,https://derpicdn.net/img/view/2016/11/27/1304918.png,1,0.9597136974334716,4660,926,5342,1608,682,682,applejack|fluttershy|mane six|pinkie pie|rainbow dash|rarity|twilight sparkle,mississippikite
1304918.png,https://derpicdn.net/img/view/2016/11/27/1304918.png,3,0.9276566505432128,1629,847,2205,1423,576,576,applejack|fluttershy|mane six|pinkie pie|rainbow dash|rarity|twilight sparkle,mississippikite
1307002.png,https://derpicdn.net/img/view/2016/11/30/1307002.png,2,0.9900634288787842,2671,1807,3411,2547,740,740,applejack|fluttershy|mane six|pinkie pie|rainbow dash|rarity|twilight sparkle,themarquisofdorks
1307002.png,https://derpicdn.net/img/view/2016/11/30/1307002.png,3,0.9297547936439514,363,1978,1071,2686,708,708,applejack|fluttershy|mane six|pinkie pie|rainbow dash|rarity|twilight sparkle,themarquisofdorks
1308136.png,https://derpicdn.net/img/view/2016/12/2/1308136.png,0,0.9401711821556092,832,25,1152,345,320,320,sunset shimmer|twilight sparkle,little-tweenframes
1309372.png,https://derpicdn.net/img/view/2016/12/4/1309372.png,0,0.994769811630249,606,21,864,279,258,258,applejack|fluttershy|mane six|pinkie pie|rainbow dash|rarity|twilight sparkle,brandonale
1311643.png,https://derpicdn.net/img/view/2016/12/7/1311643.png,0,0.996407151222229,819,118,1119,418,300,300,rarity|twilight sparkle,rwl
1311643.png,https://derpicdn.net/img/view/2016/12/7/1311643.png,1,0.97700035572052,19,85,355,421,336,336,rarity|twilight sparkle,rwl
1313601.png,https://derpicdn.net/img/view/2016/12/9/1313601.png,0,0.9535778164863586,811,102,1235,526,424,424,trixie|twilight sparkle,dekomaru
1323944.png,https://derpicdn.net/img/view/2016/12/24/1323944.png,0,0.9302713871002196,228,71,604,447,376,376,sunset shimmer|twilight sparkle,flourret
1326304.png,https://derpicdn.net/img/view/2016/12/27/1326304.png,0,0.9890217185020448,4334,3006,5374,3880,1040,874,applejack|fluttershy|mane six|pinkie pie|rainbow dash|rarity|spike|starlight glimmer|twilight sparkle,oinktweetstudios
1326524.png,https://derpicdn.net/img/view/2016/12/27/1326524.png,0,0.9915324449539183,2481,0,4331,1813,1850,1813,spike|twilight sparkle,cloudyglow
1327161.png,https://derpicdn.net/img/view/2016/12/28/1327161.png,2,0.9351771473884584,3829,699,5113,1983,1284,1284,applejack|fluttershy|mane six|pinkie pie|rainbow dash|rarity|twilight sparkle,sawkssombercircus
1329767.png,https://derpicdn.net/img/view/2017/1/1/1329767.png,0,0.9886106848716736,0,0,1200,1325,1200,1325,rarity|twilight sparkle,
1337484.png,https://derpicdn.net/img/view/2017/1/11/1337484.png,0,0.9859108924865724,950,513,1480,1043,530,530,applejack|fluttershy|mane six|pinkie pie|rainbow dash|rarity|twilight sparkle,sourcerabbit
1347381.png,https://derpicdn.net/img/view/2017/1/25/1347381.png,0,0.9773516654968262,57,75,317,317,260,242,fluttershy|pinkie pie|spike|twilight sparkle,
1350125.png,https://derpicdn.net/img/view/2017/1/29/1350125.png,0,0.9987491369247437,512,71,768,373,256,302,applejack|fluttershy|mane six|pinkie pie|rainbow dash|rarity|twilight sparkle,zukiq314
1350125.png,https://derpicdn.net/img/view/2017/1/29/1350125.png,1,0.9644588232040404,153,457,519,823,366,366,applejack|fluttershy|mane six|pinkie pie|rainbow dash|rarity|twilight sparkle,zukiq314
1352153.png,https://derpicdn.net/img/view/2017/1/31/1352153.png,0,0.9943165779113772,440,25,776,361,336,336,sunset shimmer|twilight sparkle,castaspellliana
135548.png,https://derpicdn.net/img/view/2012/10/29/135548.png,0,0.9889707565307616,525,143,811,429,286,286,fluttershy|pinkie pie|twilight sparkle,skykain|xcopyen002
135548.png,https://derpicdn.net/img/view/2012/10/29/135548.png,1,0.9232572317123412,833,106,1009,282,176,176,fluttershy|pinkie pie|twilight sparkle,skykain|xcopyen002
1357408.png,https://derpicdn.net/img/view/2017/2/7/1357408.png,1,0.9804577231407166,676,80,1278,682,602,602,shining armor|twilight sparkle,jay-kuro
1358351.png,https://derpicdn.net/img/view/2017/2/8/1358351.png,0,0.9918240308761596,1773,401,3525,2153,1752,1752,applejack|fluttershy|mane six|pinkie pie|rainbow dash|rarity|twilight sparkle,amazing-artsong
1358351.png,https://derpicdn.net/img/view/2017/2/8/1358351.png,1,0.931560754776001,3038,2227,4604,3793,1566,1566,applejack|fluttershy|mane six|pinkie pie|rainbow dash|rarity|twilight sparkle,amazing-artsong
1360249.png,https://derpicdn.net/img/view/2017/2/11/1360249.png,0,0.9911569952964784,3747,2360,5761,4374,2014,2014,pinkie pie|twilight sparkle,livehotsun
136339.jpg,https://derpicdn.net/img/view/2012/10/30/136339.jpg,0,0.9821885824203492,128,104,528,504,400,400,spike|twilight sparkle,ss2sonic
136339.jpg,https://derpicdn.net/img/view/2012/10/30/136339.jpg,1,0.9722812175750732,650,54,1142,546,492,492,spike|twilight sparkle,ss2sonic
1366171.png,https://derpicdn.net/img/view/2017/2/18/1366171.png,0,0.9766122698783876,60,611,364,915,304,304,apple bloom|applejack|cutie mark crusaders|fluttershy|pinkie pie|rainbow dash|rarity|scootaloo|sweetie belle|trixie|twilight sparkle,
1367849.png,https://derpicdn.net/img/view/2017/2/19/1367849.png,0,0.9944383502006532,66,455,342,731,276,276,applejack|fluttershy|mane six|pinkie pie|rainbow dash|rarity|starlight glimmer|twilight sparkle,alvh-omega
1370550.png,https://derpicdn.net/img/view/2017/2/23/1370550.png,1,0.9741562008857728,557,142,873,458,316,316,applejack|fluttershy|mane six|pinkie pie|princess celestia|rainbow dash|rarity|spike|twilight sparkle,alvh-omega
1374385.png,https://derpicdn.net/img/view/2017/2/27/1374385.png,0,0.9985215663909912,1325,761,1931,1367,606,606,spike|twilight sparkle,pony quarantine
1374615.png,https://derpicdn.net/img/view/2017/2/27/1374615.png,0,0.9105363488197328,228,151,594,517,366,366,pinkie pie|spike|twilight sparkle,lytlethelemur
137749.jpg,https://derpicdn.net/img/view/2012/10/31/137749.jpg,0,0.9985446333885192,0,208,264,496,264,288,princess cadance|twilight sparkle,coin-trip39
1378842.png,https://derpicdn.net/img/view/2017/3/4/1378842.png,0,0.9846152663230896,621,118,1107,604,486,486,applejack|fluttershy|mane six|pinkie pie|rainbow dash|rarity|twilight sparkle,pizzakladd
1378842.png,https://derpicdn.net/img/view/2017/3/4/1378842.png,1,0.9585777521133424,112,254,454,596,342,342,applejack|fluttershy|mane six|pinkie pie|rainbow dash|rarity|twilight sparkle,pizzakladd
1378842.png,https://derpicdn.net/img/view/2017/3/4/1378842.png,2,0.9522777199745178,401,181,769,549,368,368,applejack|fluttershy|mane six|pinkie pie|rainbow dash|rarity|twilight sparkle,pizzakladd
1380214.png,https://derpicdn.net/img/view/2017/3/5/1380214.png,0,0.9990400671958924,1569,108,2505,1044,936,936,rainbow dash|twilight sparkle,ruushiicz
1380214.png,https://derpicdn.net/img/view/2017/3/5/1380214.png,1,0.9912369847297668,873,266,1911,1304,1038,1038,rainbow dash|twilight sparkle,ruushiicz
1381750.png,https://derpicdn.net/img/view/2017/3/7/1381750.png,1,0.9666609168052672,1671,932,2979,2240,1308,1308,applejack|fluttershy|mane six|pinkie pie|rainbow dash|rarity|twilight sparkle,ra1nb0wk1tty
1381750.png,https://derpicdn.net/img/view/2017/3/7/1381750.png,2,0.9509816169738772,626,43,1934,1351,1308,1308,applejack|fluttershy|mane six|pinkie pie|rainbow dash|rarity|twilight sparkle,ra1nb0wk1tty
1381879.png,https://derpicdn.net/img/view/2017/3/8/1381879.png,0,0.9351970553398132,122,670,380,928,258,258,sunset shimmer|twilight sparkle,little-tweenframes
1381879.png,https://derpicdn.net/img/view/2017/3/8/1381879.png,1,0.922934353351593,613,780,819,986,206,206,sunset shimmer|twilight sparkle,little-tweenframes
1382033.png,https://derpicdn.net/img/view/2017/3/8/1382033.png,0,0.99009770154953,0,1110,801,1942,801,832,sunset shimmer|twilight sparkle,misteraibo|culu-bluebeaver|dashiemlpfim
1382033.png,https://derpicdn.net/img/view/2017/3/8/1382033.png,1,0.9679845571517944,878,1074,1816,2012,938,938,sunset shimmer|twilight sparkle,misteraibo|culu-bluebeaver|dashiemlpfim
1382650.png,https://derpicdn.net/img/view/2017/3/9/1382650.png,0,0.9655106663703918,1904,3,2306,405,402,402,apple bloom|applejack|cutie mark crusaders|fluttershy|mane six|pinkie pie|princess cadance|princess celestia|princess flurry heart|princess luna|rainbow dash|rarity|scootaloo|starlight glimmer|sunset shimmer|sweetie belle|trixie|twilight sparkle,andoanimalia
1385598.png,https://derpicdn.net/img/view/2017/3/12/1385598.png,0,0.9932743310928344,764,154,2570,1960,1806,1806,rainbow dash|twilight sparkle,saintthunder
1385598.png,https://derpicdn.net/img/view/2017/3/12/1385598.png,1,0.985262393951416,2723,78,4589,1944,1866,1866,rainbow dash|twilight sparkle,saintthunder
1386766.png,https://derpicdn.net/img/view/2017/3/14/1386766.png,0,0.95585298538208,665,0,1427,818,762,818,spike|twilight sparkle,dsana
1387812.png,https://derpicdn.net/img/view/2017/3/15/1387812.png,0,0.99290132522583,946,1360,1380,1794,434,434,pinkie pie|princess celestia|rainbow dash|twilight sparkle,zingiber
1387812.png,https://derpicdn.net/img/view/2017/3/15/1387812.png,3,0.9036501049995422,1261,70,2031,840,770,770,pinkie pie|princess celestia|rainbow dash|twilight sparkle,zingiber
1389475.png,https://derpicdn.net/img/view/2017/3/17/1389475.png,0,0.9941404461860656,0,8,272,298,272,290,starlight glimmer|twilight sparkle,dedonnerwolke
1393458.png,https://derpicdn.net/img/view/2017/3/22/1393458.png,0,0.9095070958137512,673,0,1646,838,973,838,rainbow dash|twilight sparkle,zogzor
1401607.png,https://derpicdn.net/img/view/2017/4/1/1401607.png,1,0.9731177091598512,313,37,1687,1411,1374,1374,rainbow dash|twilight sparkle,das_leben
1403588.png,https://derpicdn.net/img/view/2017/4/4/1403588.png,0,0.9416240453720092,209,123,331,245,122,122,fluttershy|pinkie pie|rainbow dash|twilight sparkle,mousu
1403588.png,https://derpicdn.net/img/view/2017/4/4/1403588.png,1,0.9387755393981934,252,10,388,146,136,136,fluttershy|pinkie pie|rainbow dash|twilight sparkle,mousu
1407178.png,https://derpicdn.net/img/view/2017/4/9/1407178.png,0,0.9962247014045716,579,454,865,740,286,286,princess celestia|princess luna|twilight sparkle,ravenpuff
1407178.png,https://derpicdn.net/img/view/2017/4/9/1407178.png,1,0.983673095703125,966,351,1256,641,290,290,princess celestia|princess luna|twilight sparkle,ravenpuff
1407178.png,https://derpicdn.net/img/view/2017/4/9/1407178.png,2,0.9480899572372437,144,361,404,621,260,260,princess celestia|princess luna|twilight sparkle,ravenpuff
1407877.png,https://derpicdn.net/img/view/2017/4/9/1407877.png,1,0.9924856424331664,549,33,1103,587,554,554,applejack|fluttershy|mane six|pinkie pie|rainbow dash|rarity|starlight glimmer|twilight sparkle,katakiuchi4u
1409116.png,https://derpicdn.net/img/view/2017/4/11/1409116.png,0,0.9645726084709167,295,453,829,987,534,534,spike|twilight sparkle,katakiuchi4u
1410049.png,https://derpicdn.net/img/view/2017/4/12/1410049.png,0,0.9907527565956116,556,106,764,314,208,208,applejack|fluttershy|mane six|pinkie pie|rainbow dash|rarity|twilight sparkle,
14129.png,https://derpicdn.net/img/view/2012/6/21/14129.png,0,0.9777063131332396,1702,865,2858,2021,1156,1156,rarity|twilight sparkle,zutheskunk traces
1415018.png,https://derpicdn.net/img/view/2017/4/18/1415018.png,0,0.9873111844062804,0,0,572,527,572,527,applejack|fluttershy|mane six|pinkie pie|rainbow dash|rarity|twilight sparkle,
1415472.png,https://derpicdn.net/img/view/2017/4/18/1415472.png,0,0.974904477596283,347,463,615,731,268,268,applejack|fluttershy|mane six|pinkie pie|rainbow dash|rarity|twilight sparkle,jeatz-axl
1415472.png,https://derpicdn.net/img/view/2017/4/18/1415472.png,1,0.960912823677063,704,0,964,213,260,213,applejack|fluttershy|mane six|pinkie pie|rainbow dash|rarity|twilight sparkle,jeatz-axl
1415472.png,https://derpicdn.net/img/view/2017/4/18/1415472.png,2,0.9129005074501038,109,472,499,862,390,390,applejack|fluttershy|mane six|pinkie pie|rainbow dash|rarity|twilight sparkle,jeatz-axl
1418948.png,https://derpicdn.net/img/view/2017/4/22/1418948.png,0,0.998277485370636,154,0,588,373,434,373,princess flurry heart|twilight sparkle,thenornonthego
1418948.png,https://derpicdn.net/img/view/2017/4/22/1418948.png,1,0.9862461090087892,479,0,859,356,380,356,princess flurry heart|twilight sparkle,thenornonthego
1419366.png,https://derpicdn.net/img/view/2017/4/23/1419366.png,0,0.997339129447937,550,0,784,202,234,202,spike|twilight sparkle,jayrockin
1419366.png,https://derpicdn.net/img/view/2017/4/23/1419366.png,1,0.965693473815918,713,15,1009,311,296,296,spike|twilight sparkle,jayrockin
1419946.png,https://derpicdn.net/img/view/2017/4/23/1419946.png,0,0.9987971782684326,868,461,1594,1187,726,726,princess flurry heart|twilight sparkle,shamy-crist
1420067.png,https://derpicdn.net/img/view/2017/4/23/1420067.png,0,0.9849227666854858,51,0,1357,1099,1306,1099,princess flurry heart|twilight sparkle,sonofaskywalker
1420519.png,https://derpicdn.net/img/view/2017/4/24/1420519.png,0,0.9917320013046264,1105,0,2583,1442,1478,1442,applejack|fluttershy|mane six|pinkie pie|rainbow dash|rarity|twilight sparkle,sketchmcreations
1420519.png,https://derpicdn.net/img/view/2017/4/24/1420519.png,1,0.9696319103240968,1908,37,3300,1429,1392,1392,applejack|fluttershy|mane six|pinkie pie|rainbow dash|rarity|twilight sparkle,sketchmcreations
1420770.png,https://derpicdn.net/img/view/2017/4/24/1420770.png,0,0.9565411806106568,308,0,804,454,496,454,sunset shimmer|twilight sparkle,
1426904.png,https://derpicdn.net/img/view/2017/5/2/1426904.png,0,0.9914092421531676,506,267,744,505,238,238,sunset shimmer|twilight sparkle,uniquecolorchaos
1427149.png,https://derpicdn.net/img/view/2017/5/2/1427149.png,0,0.9496713876724244,294,0,768,380,474,380,sunset shimmer|twilight sparkle,wintaura|wintaura-art
1427981.png,https://derpicdn.net/img/view/2017/5/3/1427981.png,0,0.9932399988174438,25,1382,1441,2798,1416,1416,applejack|fluttershy|mane six|pinkie pie|rainbow dash|rarity|twilight sparkle,wolfchen999
1427981.png,https://derpicdn.net/img/view/2017/5/3/1427981.png,1,0.9677995443344116,2571,0,4092,1302,1521,1302,applejack|fluttershy|mane six|pinkie pie|rainbow dash|rarity|twilight sparkle,wolfchen999
1427981.png,https://derpicdn.net/img/view/2017/5/3/1427981.png,3,0.944668173789978,1482,1366,2644,2528,1162,1162,applejack|fluttershy|mane six|pinkie pie|rainbow dash|rarity|twilight sparkle,wolfchen999
1429912.png,https://derpicdn.net/img/view/2017/5/6/1429912.png,0,0.9929450154304504,1900,0,4112,2119,2212,2119,pinkie pie|twilight sparkle,magister39
1430189.png,https://derpicdn.net/img/view/2017/5/6/1430189.png,0,0.9990867376327516,0,0,726,671,726,671,rainbow dash|twilight sparkle,spicybrowniemix|shadow-nights
1432227.png,https://derpicdn.net/img/view/2017/5/9/1432227.png,0,0.9995038509368896,130,155,424,449,294,294,princess celestia|princess luna|twilight sparkle,bastianmage
1432227.png,https://derpicdn.net/img/view/2017/5/9/1432227.png,1,0.9966840744018556,610,112,882,384,272,272,princess celestia|princess luna|twilight sparkle,bastianmage
1439777.png,https://derpicdn.net/img/view/2017/5/18/1439777.png,0,0.997707724571228,620,18,1194,592,574,574,spike|twilight sparkle,joan-grace
1445348.png,https://derpicdn.net/img/view/2017/5/25/1445348.png,0,0.9445078372955322,193,0,467,261,274,261,applejack|fluttershy|mane six|pinkie pie|rainbow dash|rarity|twilight sparkle,yukandasama
1445670.png,https://derpicdn.net/img/view/2017/5/25/1445670.png,0,0.9927566647529602,1138,1,1498,361,360,360,apple bloom|applejack|cutie mark crusaders|fluttershy|mane six|pinkie pie|princess celestia|rainbow dash|rarity|scootaloo|starlight glimmer|sweetie belle|twilight sparkle,windymils
1445670.png,https://derpicdn.net/img/view/2017/5/25/1445670.png,1,0.9686826467514038,211,534,475,798,264,264,apple bloom|applejack|cutie mark crusaders|fluttershy|mane six|pinkie pie|princess celestia|rainbow dash|rarity|scootaloo|starlight glimmer|sweetie belle|twilight sparkle,windymils
1445879.png,https://derpicdn.net/img/view/2017/5/25/1445879.png,0,0.9953346252441406,768,594,1730,1556,962,962,applejack|fluttershy|pinkie pie|rainbow dash|rarity|starlight glimmer|twilight sparkle,skyflys
1449802.png,https://derpicdn.net/img/view/2017/5/30/1449802.png,0,0.9908414483070374,1168,447,1412,691,244,244,applejack|fluttershy|mane six|pinkie pie|rainbow dash|rarity|twilight sparkle,
1449802.png,https://derpicdn.net/img/view/2017/5/30/1449802.png,1,0.9565494656562804,925,422,1203,700,278,278,applejack|fluttershy|mane six|pinkie pie|rainbow dash|rarity|twilight sparkle,
1449811.png,https://derpicdn.net/img/view/2017/5/30/1449811.png,0,0.9904503226280212,1455,416,1755,716,300,300,applejack|fluttershy|mane six|pinkie pie|rainbow dash|rarity|twilight sparkle,
1449811.png,https://derpicdn.net/img/view/2017/5/30/1449811.png,1,0.9762222170829772,647,317,955,625,308,308,applejack|fluttershy|mane six|pinkie pie|rainbow dash|rarity|twilight sparkle,
1449811.png,https://derpicdn.net/img/view/2017/5/30/1449811.png,2,0.9573310017585754,430,368,710,648,280,280,applejack|fluttershy|mane six|pinkie pie|rainbow dash|rarity|twilight sparkle,
1449969.png,https://derpicdn.net/img/view/2017/5/30/1449969.png,0,0.932208776473999,0,0,525,464,525,464,rainbow dash|twilight sparkle,paint-pot
1450012.png,https://derpicdn.net/img/view/2017/5/30/1450012.png,0,0.9955516457557678,392,128,800,542,408,414,starlight glimmer|twilight sparkle,trini-mite
1451263.png,https://derpicdn.net/img/view/2017/6/1/1451263.png,0,0.9845441579818726,4578,1275,6212,2909,1634,1634,applejack|fluttershy|mane six|pinkie pie|rainbow dash|rarity|twilight sparkle,frownfactory
1451263.png,https://derpicdn.net/img/view/2017/6/1/1451263.png,1,0.9773786067962646,2491,1143,3933,2585,1442,1442,applejack|fluttershy|mane six|pinkie pie|rainbow dash|rarity|twilight sparkle,frownfactory
1451263.png,https://derpicdn.net/img/view/2017/6/1/1451263.png,2,0.9162193536758424,676,1662,1816,2802,1140,1140,applejack|fluttershy|mane six|pinkie pie|rainbow dash|rarity|twilight sparkle,frownfactory
1454915.png,https://derpicdn.net/img/view/2017/6/5/1454915.png,0,0.9830440282821656,989,321,1321,653,332,332,princess celestia|twilight sparkle,hierozaki
1455432.png,https://derpicdn.net/img/view/2017/6/6/1455432.png,0,0.9884840846061708,682,97,970,385,288,288,applejack|fluttershy|mane six|pinkie pie|rainbow dash|rarity|twilight sparkle,fimflamfilosophy
146044.jpg,https://derpicdn.net/img/view/2012/11/8/146044.jpg,0,0.9732605814933776,25,0,431,344,406,344,applejack|fluttershy|mane six|pinkie pie|rainbow dash|rarity|twilight sparkle,swomswom
1462341.png,https://derpicdn.net/img/view/2017/6/15/1462341.png,0,0.9918498396873474,156,417,366,627,210,210,applejack|discord|fluttershy|pinkie pie|princess celestia|princess flurry heart|princess luna|rarity|spike|sunset shimmer|sweetie belle|twilight sparkle,fallenangel5414
1463808.png,https://derpicdn.net/img/view/2017/6/17/1463808.png,0,0.99222594499588,1904,608,3215,1936,1311,1328,princess celestia|twilight sparkle,starlightglummer
1470977.png,https://derpicdn.net/img/view/2017/6/25/1470977.png,0,0.9440909028053284,41,61,267,287,226,226,fluttershy|rainbow dash|twilight sparkle,xenon
1471217.png,https://derpicdn.net/img/view/2017/6/25/1471217.png,0,0.9979011416435242,301,239,457,395,156,156,applejack|fluttershy|mane six|pinkie pie|rainbow dash|rarity|spike|twilight sparkle,victorydanceofficial
1473255.png,https://derpicdn.net/img/view/2017/6/28/1473255.png,1,0.9104984402656556,32,0,474,411,442,411,starlight glimmer|twilight sparkle,
1476246.png,https://derpicdn.net/img/view/2017/7/1/1476246.png,0,0.9941790103912354,887,0,1961,1062,1074,1062,princess flurry heart|twilight sparkle,jennieoo
1476246.png,https://derpicdn.net/img/view/2017/7/1/1476246.png,1,0.9742975234985352,1796,563,2898,1665,1102,1102,princess flurry heart|twilight sparkle,jennieoo
1490137.png,https://derpicdn.net/img/view/2017/7/19/1490137.png,0,0.9943093061447144,639,113,883,357,244,244,spike|twilight sparkle,tigra0118
1490137.png,https://derpicdn.net/img/view/2017/7/19/1490137.png,1,0.9860351085662842,168,63,472,367,304,304,spike|twilight sparkle,tigra0118
1493570.png,https://derpicdn.net/img/view/2017/7/24/1493570.png,0,0.9093425273895264,167,110,511,500,344,390,starlight glimmer|twilight sparkle,heartwarmer-mlp|lil-lovey|comfydove
1497698.png,https://derpicdn.net/img/view/2017/7/29/1497698.png,0,0.9974606037139891,1170,0,1842,558,672,558,applejack|fluttershy|mane six|pinkie pie|rainbow dash|rarity|twilight sparkle,vird-gi
1497732.png,https://derpicdn.net/img/view/2017/7/29/1497732.png,0,0.9929109215736388,0,580,1213,1846,1213,1266,applejack|fluttershy|mane six|pinkie pie|rainbow dash|rarity|twilight sparkle,drawntildawn
1497732.png,https://derpicdn.net/img/view/2017/7/29/1497732.png,1,0.989762544631958,196,1736,1414,2954,1218,1218,applejack|fluttershy|mane six|pinkie pie|rainbow dash|rarity|twilight sparkle,drawntildawn
1497732.png,https://derpicdn.net/img/view/2017/7/29/1497732.png,2,0.9847251772880554,2463,418,3928,1922,1465,1504,applejack|fluttershy|mane six|pinkie pie|rainbow dash|rarity|twilight sparkle,drawntildawn
1499702.png,https://derpicdn.net/img/view/2017/7/31/1499702.png,0,0.9955260157585144,615,65,917,367,302,302,applejack|fluttershy|mane six|pinkie pie|rainbow dash|rarity|twilight sparkle,meownimator
1499702.png,https://derpicdn.net/img/view/2017/7/31/1499702.png,1,0.9762352108955384,498,421,816,739,318,318,applejack|fluttershy|mane six|pinkie pie|rainbow dash|rarity|twilight sparkle,meownimator
1499702.png,https://derpicdn.net/img/view/2017/7/31/1499702.png,2,0.9101467132568359,85,71,417,403,332,332,applejack|fluttershy|mane six|pinkie pie|rainbow dash|rarity|twilight sparkle,meownimator
1500334.png,https://derpicdn.net/img/view/2017/8/1/1500334.png,0,0.9793925285339355,0,869,730,1685,730,816,sunset shimmer|twilight sparkle,little-tweenframes
1503331.png,https://derpicdn.net/img/view/2017/8/5/1503331.png,0,0.9760507345199584,174,1067,438,1331,264,264,discord|sunset shimmer|twilight sparkle,little-tweenframes
1506468.png,https://derpicdn.net/img/view/2017/8/9/1506468.png,0,0.986528754234314,1738,210,2772,1244,1034,1034,sunset shimmer|twilight sparkle,little-tweenframes
1506633.png,https://derpicdn.net/img/view/2017/8/9/1506633.png,0,0.9966672658920288,210,914,626,1330,416,416,rarity|twilight sparkle,
1510800.png,https://derpicdn.net/img/view/2017/8/14/1510800.png,1,0.949871301651001,1727,1232,2143,1648,416,416,apple bloom|applejack|big macintosh|cutie mark crusaders|fluttershy|granny smith|mane six|pinkie pie|rainbow dash|rarity|scootaloo|spike|starlight glimmer|sweetie belle|twilight sparkle,arteses-canvas
1511582.png,https://derpicdn.net/img/view/2017/8/15/1511582.png,0,0.98926043510437,303,133,571,401,268,268,spike|twilight sparkle,sleepydemonmonster
1513679.png,https://derpicdn.net/img/view/2017/8/18/1513679.png,0,0.967398464679718,616,138,2480,2396,1864,2258,rainbow dash|twilight sparkle,twidasher
1515577.png,https://derpicdn.net/img/view/2017/8/20/1515577.png,0,0.983146607875824,102,54,616,568,514,514,starlight glimmer|twilight sparkle,
1515577.png,https://derpicdn.net/img/view/2017/8/20/1515577.png,1,0.9251839518547058,559,98,1080,698,521,600,starlight glimmer|twilight sparkle,
1518244.png,https://derpicdn.net/img/view/2017/8/23/1518244.png,1,0.9963935613632202,1975,830,2785,1640,810,810,applejack|fluttershy|mane six|pinkie pie|rainbow dash|rarity|twilight sparkle,tjpones
1518244.png,https://derpicdn.net/img/view/2017/8/23/1518244.png,2,0.9093404412269592,1309,945,1869,1505,560,560,applejack|fluttershy|mane six|pinkie pie|rainbow dash|rarity|twilight sparkle,tjpones
1519384.png,https://derpicdn.net/img/view/2017/8/25/1519384.png,0,0.9772703051567078,723,1769,1673,2719,950,950,rainbow dash|twilight sparkle,twidasher
1519384.png,https://derpicdn.net/img/view/2017/8/25/1519384.png,1,0.94511216878891,0,157,787,1065,787,908,rainbow dash|twilight sparkle,twidasher
1523070.png,https://derpicdn.net/img/view/2017/8/29/1523070.png,0,0.9723777174949646,492,165,690,363,198,198,trixie|twilight sparkle,velgarn
1523914.png,https://derpicdn.net/img/view/2017/8/30/1523914.png,0,0.9317419528961182,235,0,729,435,494,435,princess celestia|starlight glimmer|sunset shimmer|trixie|twilight sparkle,sunsetshimmer1987
1524223.png,https://derpicdn.net/img/view/2017/8/31/1524223.png,0,0.9620509147644044,7511,2805,10085,5379,2574,2574,applejack|fluttershy|mane six|pinkie pie|rainbow dash|rarity|starlight glimmer|twilight sparkle,babyshy
1524223.png,https://derpicdn.net/img/view/2017/8/31/1524223.png,1,0.9133308529853821,9354,3294,11000,5078,1646,1784,applejack|fluttershy|mane six|pinkie pie|rainbow dash|rarity|starlight glimmer|twilight sparkle,babyshy
1525085.png,https://derpicdn.net/img/view/2017/9/1/1525085.png,0,0.9569425582885742,547,335,913,701,366,366,spike|twilight sparkle,joy-ang
1529323.png,https://derpicdn.net/img/view/2017/9/6/1529323.png,0,0.9838738441467284,0,164,891,1000,891,836,applejack|fluttershy|mane six|pinkie pie|rainbow dash|rarity|twilight sparkle,zouyugi
1532451.png,https://derpicdn.net/img/view/2017/9/10/1532451.png,0,0.9822303652763368,1015,0,1881,744,866,744,starlight glimmer|twilight sparkle,/d/non
1532491.png,https://derpicdn.net/img/view/2017/9/10/1532491.png,0,0.9849558472633362,1003,0,1885,766,882,766,starlight glimmer|twilight sparkle,/d/non
1533494.png,https://derpicdn.net/img/view/2017/9/12/1533494.png,2,0.9225425124168396,1578,332,1920,688,342,356,applejack|fluttershy|pinkie pie|rainbow dash|rarity|sunset shimmer|twilight sparkle,sourcerabbit
1533852.png,https://derpicdn.net/img/view/2017/9/12/1533852.png,0,0.9937542080879213,375,189,679,493,304,304,princess celestia|twilight sparkle,spectralunicorn
1534590.png,https://derpicdn.net/img/view/2017/9/13/1534590.png,0,0.9973782896995544,2306,0,3734,1336,1428,1336,princess celestia|twilight sparkle,shine-aqua-absol
1534590.png,https://derpicdn.net/img/view/2017/9/13/1534590.png,1,0.9473673701286316,1300,947,2132,1779,832,832,princess celestia|twilight sparkle,shine-aqua-absol
1534608.png,https://derpicdn.net/img/view/2017/9/13/1534608.png,0,0.9977866411209106,286,1032,1092,1838,806,806,applejack|fluttershy|mane six|pinkie pie|rainbow dash|rarity|starlight glimmer|twilight sparkle,porygon2z
1534608.png,https://derpicdn.net/img/view/2017/9/13/1534608.png,1,0.992875337600708,719,0,1493,652,774,652,applejack|fluttershy|mane six|pinkie pie|rainbow dash|rarity|starlight glimmer|twilight sparkle,porygon2z
1534608.png,https://derpicdn.net/img/view/2017/9/13/1534608.png,3,0.9344595074653624,2148,294,2922,1068,774,774,applejack|fluttershy|mane six|pinkie pie|rainbow dash|rarity|starlight glimmer|twilight sparkle,porygon2z
1534608.png,https://derpicdn.net/img/view/2017/9/13/1534608.png,4,0.9179370403289796,1859,1107,2637,1885,778,778,applejack|fluttershy|mane six|pinkie pie|rainbow dash|rarity|starlight glimmer|twilight sparkle,porygon2z
1535307.png,https://derpicdn.net/img/view/2017/9/14/1535307.png,0,0.916641891002655,1069,626,1459,1016,390,390,applejack|fluttershy|mane six|pinkie pie|rainbow dash|rarity|twilight sparkle,vamponylovers
1537839.png,https://derpicdn.net/img/view/2017/9/17/1537839.png,0,0.9937415719032288,2345,375,2767,797,422,422,applejack|fluttershy|mane six|pinkie pie|rainbow dash|rarity|twilight sparkle,sinrar
1539086.png,https://derpicdn.net/img/view/2017/9/18/1539086.png,0,0.9758068919181824,0,0,1641,1353,1641,1353,fluttershy|twilight sparkle,
1542653.png,https://derpicdn.net/img/view/2017/9/23/1542653.png,0,0.9266963601112366,78,49,862,833,784,784,fluttershy|twilight sparkle,
1545933.png,https://derpicdn.net/img/view/2017/9/27/1545933.png,0,0.9721084833145142,27,558,539,1070,512,512,pinkie pie|rainbow dash|twilight sparkle,rupertbluefox
1547990.png,https://derpicdn.net/img/view/2017/9/30/1547990.png,0,0.9980183243751526,216,468,506,758,290,290,applejack|fluttershy|mane six|pinkie pie|rainbow dash|rarity|spike|twilight sparkle,jublin
1547990.png,https://derpicdn.net/img/view/2017/9/30/1547990.png,1,0.997991979122162,768,998,1020,1280,252,282,applejack|fluttershy|mane six|pinkie pie|rainbow dash|rarity|spike|twilight sparkle,jublin
1547990.png,https://derpicdn.net/img/view/2017/9/30/1547990.png,2,0.9968241453170776,317,0,501,181,184,181,applejack|fluttershy|mane six|pinkie pie|rainbow dash|rarity|spike|twilight sparkle,jublin
1547990.png,https://derpicdn.net/img/view/2017/9/30/1547990.png,4,0.9684708714485168,6,20,190,204,184,184,applejack|fluttershy|mane six|pinkie pie|rainbow dash|rarity|spike|twilight sparkle,jublin
1548378.png,https://derpicdn.net/img/view/2017/9/30/1548378.png,1,0.9794914722442628,1178,463,2700,2333,1522,1870,fluttershy|twilight sparkle,mailner
1549218.png,https://derpicdn.net/img/view/2017/10/1/1549218.png,0,0.9941346049308776,850,286,2310,1746,1460,1460,sunset shimmer|twilight sparkle,hyperion-jack
1549823.png,https://derpicdn.net/img/view/2017/10/1/1549823.png,0,0.9763880372047424,301,29,613,341,312,312,fluttershy|twilight sparkle,trini-mite
1549998.png,https://derpicdn.net/img/view/2017/10/2/1549998.png,0,0.990705132484436,0,1734,324,2058,324,324,pinkie pie|twilight sparkle,
1551866.png,https://derpicdn.net/img/view/2017/10/4/1551866.png,1,0.9936450719833374,0,1470,786,2292,786,822,applejack|fluttershy|mane six|pinkie pie|rainbow dash|rarity|twilight sparkle,yaaaco
1551866.png,https://derpicdn.net/img/view/2017/10/4/1551866.png,2,0.9885343909263612,2146,1590,3048,2492,902,902,applejack|fluttershy|mane six|pinkie pie|rainbow dash|rarity|twilight sparkle,yaaaco
1554421.png,https://derpicdn.net/img/view/2017/10/7/1554421.png,0,0.9907679557800292,778,0,1522,714,744,714,princess cadance|twilight sparkle,
1554455.png,https://derpicdn.net/img/view/2017/10/7/1554455.png,0,0.9586085081100464,413,59,1000,671,587,612,rarity|twilight sparkle,puffpink
1556288.png,https://derpicdn.net/img/view/2017/10/9/1556288.png,0,0.99011892080307,667,0,1191,456,524,456,starlight glimmer|trixie|twilight sparkle,
1556334.png,https://derpicdn.net/img/view/2017/10/9/1556334.png,0,0.9933663010597228,867,52,1141,326,274,274,princess cadance|princess flurry heart|shining armor|twilight sparkle,
1556334.png,https://derpicdn.net/img/view/2017/10/9/1556334.png,1,0.986995816230774,1018,205,1280,507,262,302,princess cadance|princess flurry heart|shining armor|twilight sparkle,
1557454.png,https://derpicdn.net/img/view/2017/10/10/1557454.png,0,0.9773561954498292,257,319,453,515,196,196,applejack|fluttershy|mane six|pinkie pie|rainbow dash|rarity|spike|starlight glimmer|twilight sparkle,
1557454.png,https://derpicdn.net/img/view/2017/10/10/1557454.png,2,0.9074851870536804,168,363,304,499,136,136,applejack|fluttershy|mane six|pinkie pie|rainbow dash|rarity|spike|starlight glimmer|twilight sparkle,
1557964.png,https://derpicdn.net/img/view/2017/10/11/1557964.png,0,0.9915961623191832,528,643,898,1013,370,370,applejack|fluttershy|mane six|pinkie pie|rainbow dash|rarity|starlight glimmer|twilight sparkle,spellboundcanvas
1557964.png,https://derpicdn.net/img/view/2017/10/11/1557964.png,1,0.9879627823829652,1134,317,1492,675,358,358,applejack|fluttershy|mane six|pinkie pie|rainbow dash|rarity|starlight glimmer|twilight sparkle,spellboundcanvas
1558586.png,https://derpicdn.net/img/view/2017/10/11/1558586.png,0,0.9899240136146544,0,1012,1274,2350,1274,1338,applejack|fluttershy|pinkie pie|rainbow dash|rarity|twilight sparkle,pink1ejack
1558586.png,https://derpicdn.net/img/view/2017/10/11/1558586.png,1,0.9305300116539,2347,741,3741,2135,1394,1394,applejack|fluttershy|pinkie pie|rainbow dash|rarity|twilight sparkle,pink1ejack
1558586.png,https://derpicdn.net/img/view/2017/10/11/1558586.png,2,0.9133378863334656,2510,2534,3608,3632,1098,1098,applejack|fluttershy|pinkie pie|rainbow dash|rarity|twilight sparkle,pink1ejack
1558586.png,https://derpicdn.net/img/view/2017/10/11/1558586.png,3,0.9061892032623292,1081,509,2539,1967,1458,1458,applejack|fluttershy|pinkie pie|rainbow dash|rarity|twilight sparkle,pink1ejack
1560175.png,https://derpicdn.net/img/view/2017/10/13/1560175.png,0,0.9838883280754088,753,0,1523,673,770,673,applejack|fluttershy|mane six|pinkie pie|rainbow dash|rarity|twilight sparkle,iheartjapan789
1563.png,https://derpicdn.net/img/view/2012/1/23/1563.png,0,0.9900670647621156,507,39,1043,575,536,536,trixie|twilight sparkle,darkdp
1565461.png,https://derpicdn.net/img/view/2017/10/19/1565461.png,0,0.9988768696784972,1083,1948,1747,2612,664,664,applejack|fluttershy|mane six|pinkie pie|princess celestia|princess luna|rainbow dash|rarity|twilight sparkle,evil-dec0y
1565461.png,https://derpicdn.net/img/view/2017/10/19/1565461.png,1,0.9962379932403564,343,2712,1053,3422,710,710,applejack|fluttershy|mane six|pinkie pie|princess celestia|princess luna|rainbow dash|rarity|twilight sparkle,evil-dec0y
1565461.png,https://derpicdn.net/img/view/2017/10/19/1565461.png,2,0.9547845721244812,1862,2856,2480,3474,618,618,applejack|fluttershy|mane six|pinkie pie|princess celestia|princess luna|rainbow dash|rarity|twilight sparkle,evil-dec0y
1569796.png,https://derpicdn.net/img/view/2017/10/25/1569796.png,1,0.9911773800849916,274,343,682,751,408,408,applejack|fluttershy|mane six|pinkie pie|princess cadance|rainbow dash|rarity|shining armor|spike|starlight glimmer|trixie|twilight sparkle,shinhoffman
1570655.png,https://derpicdn.net/img/view/2017/10/26/1570655.png,0,0.9964892864227296,1305,602,2453,1750,1148,1148,rainbow dash|twilight sparkle,twidasher
1571324.png,https://derpicdn.net/img/view/2017/10/27/1571324.png,0,0.9755128622055054,267,926,1327,1986,1060,1060,rainbow dash|scootaloo|spike|twilight sparkle,twidasher
1573907.png,https://derpicdn.net/img/view/2017/10/30/1573907.png,0,0.9448807239532472,356,573,612,829,256,256,spike|twilight sparkle,dsana
1575045.png,https://derpicdn.net/img/view/2017/11/1/1575045.png,1,0.9848976731300354,1343,966,2045,1668,702,702,pinkie pie|rainbow dash|twilight sparkle,jesterbells
1576183.png,https://derpicdn.net/img/view/2017/11/2/1576183.png,0,0.9855549335479736,486,0,926,399,440,399,sunset shimmer|twilight sparkle,little-tweenframes
1582302.png,https://derpicdn.net/img/view/2017/11/9/1582302.png,2,0.9091992378234864,676,930,996,1250,320,320,applejack|princess cadance|rainbow dash|rarity|scootaloo|sunset shimmer|twilight sparkle,lotte
1582317.png,https://derpicdn.net/img/view/2017/11/9/1582317.png,0,0.9976234436035156,1398,418,2094,1114,696,696,apple bloom|princess celestia|twilight sparkle,heart-of-stitches
1582317.png,https://derpicdn.net/img/view/2017/11/9/1582317.png,1,0.9969589114189148,2054,642,2773,1374,719,732,apple bloom|princess celestia|twilight sparkle,heart-of-stitches
1585044.png,https://derpicdn.net/img/view/2017/11/13/1585044.png,0,0.9468929171562196,298,225,730,657,432,432,sunset shimmer|twilight sparkle,nattyvelvet
1591087.png,https://derpicdn.net/img/view/2017/11/21/1591087.png,0,0.99820476770401,136,6,972,842,836,836,princess flurry heart|twilight sparkle,shadeila|djspark3
1592282.png,https://derpicdn.net/img/view/2017/11/22/1592282.png,0,0.9946577548980712,339,276,511,448,172,172,applejack|fluttershy|mane six|pinkie pie|rainbow dash|rarity|spike|twilight sparkle,
1592282.png,https://derpicdn.net/img/view/2017/11/22/1592282.png,1,0.9745459556579592,365,39,545,219,180,180,applejack|fluttershy|mane six|pinkie pie|rainbow dash|rarity|spike|twilight sparkle,
1592282.png,https://derpicdn.net/img/view/2017/11/22/1592282.png,2,0.9479454159736632,593,390,783,580,190,190,applejack|fluttershy|mane six|pinkie pie|rainbow dash|rarity|spike|twilight sparkle,
1593460.png,https://derpicdn.net/img/view/2017/11/24/1593460.png,0,0.9461292624473572,469,2254,773,2558,304,304,applejack|fluttershy|rainbow dash|rarity|spike|twilight sparkle,sketch-shepherd
1597074.png,https://derpicdn.net/img/view/2017/11/29/1597074.png,0,0.9297958016395568,0,47,488,621,488,574,starlight glimmer|twilight sparkle,
1597610.png,https://derpicdn.net/img/view/2017/11/30/1597610.png,0,0.9948374032974244,653,197,957,501,304,304,princess celestia|twilight sparkle,niniibear
1597610.png,https://derpicdn.net/img/view/2017/11/30/1597610.png,1,0.992500066757202,378,38,770,430,392,392,princess celestia|twilight sparkle,niniibear
1599949.png,https://derpicdn.net/img/view/2017/12/3/1599949.png,0,0.9989789128303528,131,143,1065,1077,934,934,applejack|fluttershy|mane six|pinkie pie|rainbow dash|rarity|twilight sparkle,saphi-boo
1599949.png,https://derpicdn.net/img/view/2017/12/3/1599949.png,2,0.9937546849250792,2169,664,2799,1294,630,630,applejack|fluttershy|mane six|pinkie pie|rainbow dash|rarity|twilight sparkle,saphi-boo
1599949.png,https://derpicdn.net/img/view/2017/12/3/1599949.png,5,0.9190856218338012,1415,452,2351,1388,936,936,applejack|fluttershy|mane six|pinkie pie|rainbow dash|rarity|twilight sparkle,saphi-boo
1604193.png,https://derpicdn.net/img/view/2017/12/10/1604193.png,0,0.9310168027877808,129,99,343,313,214,214,rarity|twilight sparkle,lilfunkman
1610689.png,https://derpicdn.net/img/view/2017/12/18/1610689.png,0,0.9800123572349548,154,0,744,551,590,551,sunset shimmer|twilight sparkle,tigra0118
1611003.png,https://derpicdn.net/img/view/2017/12/19/1611003.png,0,0.9992001056671144,295,742,519,966,224,224,rarity|twilight sparkle,jykinturah
1614201.png,https://derpicdn.net/img/view/2017/12/23/1614201.png,0,0.9891701936721802,121,206,711,796,590,590,rainbow dash|rarity|twilight sparkle,helioseusebio
1614915.png,https://derpicdn.net/img/view/2017/12/24/1614915.png,0,0.933131217956543,1424,426,2224,1226,800,800,pinkie pie|twilight sparkle,ruushiicz
1621274.png,https://derpicdn.net/img/view/2018/1/1/1621274.png,1,0.9939342141151428,1099,1376,1711,1988,612,612,applejack|fluttershy|mane six|pinkie pie|rainbow dash|rarity|twilight sparkle,alexi148
1621274.png,https://derpicdn.net/img/view/2018/1/1/1621274.png,2,0.9853311777114868,1038,848,1534,1344,496,496,applejack|fluttershy|mane six|pinkie pie|rainbow dash|rarity|twilight sparkle,alexi148
1621274.png,https://derpicdn.net/img/view/2018/1/1/1621274.png,3,0.9699499011039734,558,75,1262,779,704,704,applejack|fluttershy|mane six|pinkie pie|rainbow dash|rarity|twilight sparkle,alexi148
1621274.png,https://derpicdn.net/img/view/2018/1/1/1621274.png,4,0.9105680584907532,465,1274,883,1692,418,418,applejack|fluttershy|mane six|pinkie pie|rainbow dash|rarity|twilight sparkle,alexi148
1624605.png,https://derpicdn.net/img/view/2018/1/5/1624605.png,0,0.9929986000061036,41,0,453,351,412,351,trixie|twilight sparkle,mrrowboat
1624608.png,https://derpicdn.net/img/view/2018/1/5/1624608.png,0,0.9929986000061036,41,0,453,351,412,351,trixie|twilight sparkle,mrrowboat
1627443.png,https://derpicdn.net/img/view/2018/1/8/1627443.png,0,0.999737560749054,34,0,620,490,586,490,applejack|fluttershy|mane six|pinkie pie|rainbow dash|rarity|twilight sparkle,shad0w-galaxy
1627443.png,https://derpicdn.net/img/view/2018/1/8/1627443.png,3,0.9875596165657043,660,0,1154,441,494,441,applejack|fluttershy|mane six|pinkie pie|rainbow dash|rarity|twilight sparkle,shad0w-galaxy
1627443.png,https://derpicdn.net/img/view/2018/1/8/1627443.png,4,0.9194782376289368,1389,852,1943,1406,554,554,applejack|fluttershy|mane six|pinkie pie|rainbow dash|rarity|twilight sparkle,shad0w-galaxy
1632795.png,https://derpicdn.net/img/view/2018/1/15/1632795.png,0,0.9763880968093872,547,0,1699,921,1152,921,applejack|fluttershy|twilight sparkle,9centschange
1633447.png,https://derpicdn.net/img/view/2018/1/16/1633447.png,0,0.9976551532745358,1189,23,1721,555,532,532,applejack|fluttershy|mane six|pinkie pie|rainbow dash|rarity|twilight sparkle,liniitadash23
1633447.png,https://derpicdn.net/img/view/2018/1/16/1633447.png,3,0.9664631485939026,1497,827,2019,1349,522,522,applejack|fluttershy|mane six|pinkie pie|rainbow dash|rarity|twilight sparkle,liniitadash23
1633447.png,https://derpicdn.net/img/view/2018/1/16/1633447.png,4,0.9638388156890868,728,747,1206,1225,478,478,applejack|fluttershy|mane six|pinkie pie|rainbow dash|rarity|twilight sparkle,liniitadash23
1633447.png,https://derpicdn.net/img/view/2018/1/16/1633447.png,5,0.9213550686836244,302,0,930,621,628,621,applejack|fluttershy|mane six|pinkie pie|rainbow dash|rarity|twilight sparkle,liniitadash23
1636885.png,https://derpicdn.net/img/view/2018/1/20/1636885.png,0,0.9948757886886596,261,254,545,538,284,284,rarity|twilight sparkle,animechristy
1641272.png,https://derpicdn.net/img/view/2018/1/26/1641272.png,0,0.9254898428916932,378,0,1174,766,796,766,fluttershy|twilight sparkle,maaronn
1647457.png,https://derpicdn.net/img/view/2018/2/3/1647457.png,0,0.9925637245178224,3,0,525,466,522,466,starlight glimmer|twilight sparkle,briannacherrygarcia
1647457.png,https://derpicdn.net/img/view/2018/2/3/1647457.png,1,0.9839802980422974,792,0,1286,383,494,383,starlight glimmer|twilight sparkle,briannacherrygarcia
1650594.png,https://derpicdn.net/img/view/2018/2/7/1650594.png,1,0.9963129162788392,426,274,1222,1070,796,796,sunset shimmer|twilight sparkle,uunicornicc
1652626.png,https://derpicdn.net/img/view/2018/2/10/1652626.png,1,0.9904212951660156,1025,1043,1533,1551,508,508,applejack|fluttershy|pinkie pie|rainbow dash|rarity|sunset shimmer|twilight sparkle,basykail
1653844.png,https://derpicdn.net/img/view/2018/2/12/1653844.png,1,0.9859530329704284,2398,870,2930,1402,532,532,applejack|fluttershy|mane six|pinkie pie|rainbow dash|rarity|twilight sparkle,pabbley
1656230.png,https://derpicdn.net/img/view/2018/2/14/1656230.png,0,0.9149909019470216,166,0,1086,802,920,802,applejack|twilight sparkle,lxxjunebugxxl
1657601.png,https://derpicdn.net/img/view/2018/2/16/1657601.png,0,0.9916560053825378,101,479,443,821,342,342,spike|twilight sparkle,tiffanymarsou
166165.jpg,https://derpicdn.net/img/view/2012/11/28/166165.jpg,1,0.9874396324157716,488,300,1528,1340,1040,1040,applejack|fluttershy|mane six|pinkie pie|rainbow dash|rarity|spike|twilight sparkle,kman-studio
166165.jpg,https://derpicdn.net/img/view/2012/11/28/166165.jpg,2,0.9851571321487428,0,446,571,1068,571,622,applejack|fluttershy|mane six|pinkie pie|rainbow dash|rarity|spike|twilight sparkle,kman-studio
1665768.png,https://derpicdn.net/img/view/2018/2/25/1665768.png,1,0.912306010723114,244,941,1018,1715,774,774,starlight glimmer|sunset shimmer|trixie|twilight sparkle,
1665960.png,https://derpicdn.net/img/view/2018/2/25/1665960.png,1,0.9333597421646118,480,0,1800,1127,1320,1127,princess cadance|princess celestia|princess flurry heart|princess luna|twilight sparkle,goatcanon
1666371.png,https://derpicdn.net/img/view/2018/2/26/1666371.png,0,0.9963672161102296,2175,0,4749,2094,2574,2094,sunset shimmer|twilight sparkle,jhayarr23
1666371.png,https://derpicdn.net/img/view/2018/2/26/1666371.png,1,0.9755784869194032,1009,0,3093,1646,2084,1646,sunset shimmer|twilight sparkle,jhayarr23
1668274.png,https://derpicdn.net/img/view/2018/2/28/1668274.png,0,0.96559476852417,154,25,656,527,502,502,sunset shimmer|twilight sparkle,horsegirlpodcast
1671843.png,https://derpicdn.net/img/view/2018/3/5/1671843.png,0,0.9881049990653992,3,0,547,541,544,541,fluttershy|pinkie pie|rarity|starlight glimmer|twilight sparkle,
1672617.png,https://derpicdn.net/img/view/2018/3/5/1672617.png,0,0.902189075946808,1207,1843,2351,2987,1144,1144,princess cadance|shining armor|starlight glimmer|twilight sparkle,latia122
1674693.png,https://derpicdn.net/img/view/2018/3/8/1674693.png,0,0.9873151779174804,683,878,977,1172,294,294,apple bloom|applejack|cutie mark crusaders|fluttershy|mane six|pinkie pie|princess cadance|princess celestia|princess flurry heart|princess luna|rainbow dash|rarity|scootaloo|starlight glimmer|sunset shimmer|sweetie belle|twilight sparkle,infinitewarlock|chrzanek97|pilot231|dashiesparkle|ebontopaz|mlp-vector-collabs|yanoda|deratrox|timeimpact|andoanimalia|cloudyglow|jhayarr23|cheezedoodle96|8-notes|cultleaderfluttershy|remcmaximus
1674693.png,https://derpicdn.net/img/view/2018/3/8/1674693.png,2,0.9165377020835876,1134,494,1540,900,406,406,apple bloom|applejack|cutie mark crusaders|fluttershy|mane six|pinkie pie|princess cadance|princess celestia|princess flurry heart|princess luna|rainbow dash|rarity|scootaloo|starlight glimmer|sunset shimmer|sweetie belle|twilight sparkle,infinitewarlock|chrzanek97|pilot231|dashiesparkle|ebontopaz|mlp-vector-collabs|yanoda|deratrox|timeimpact|andoanimalia|cloudyglow|jhayarr23|cheezedoodle96|8-notes|cultleaderfluttershy|remcmaximus
1674693.png,https://derpicdn.net/img/view/2018/3/8/1674693.png,3,0.9157937169075012,900,881,1178,1159,278,278,apple bloom|applejack|cutie mark crusaders|fluttershy|mane six|pinkie pie|princess cadance|princess celestia|princess flurry heart|princess luna|rainbow dash|rarity|scootaloo|starlight glimmer|sunset shimmer|sweetie belle|twilight sparkle,infinitewarlock|chrzanek97|pilot231|dashiesparkle|ebontopaz|mlp-vector-collabs|yanoda|deratrox|timeimpact|andoanimalia|cloudyglow|jhayarr23|cheezedoodle96|8-notes|cultleaderfluttershy|remcmaximus
1675500.png,https://derpicdn.net/img/view/2018/3/9/1675500.png,0,0.9891204237937928,104,3,490,389,386,386,rainbow dash|twilight sparkle,kipaki
1681110.png,https://derpicdn.net/img/view/2018/3/15/1681110.png,0,0.9942956566810608,1778,99,2524,845,746,746,princess celestia|sunset shimmer|twilight sparkle,nightpaint12
1681110.png,https://derpicdn.net/img/view/2018/3/15/1681110.png,2,0.9367704391479492,2809,790,3951,1932,1142,1142,princess celestia|sunset shimmer|twilight sparkle,nightpaint12
1684350.png,https://derpicdn.net/img/view/2018/3/18/1684350.png,0,0.9898456931114196,481,0,1027,383,546,383,applejack|rainbow dash|twilight sparkle,
1685725.png,https://derpicdn.net/img/view/2018/3/20/1685725.png,0,0.9804440140724182,84,554,890,1360,806,806,princess cadance|princess celestia|princess flurry heart|princess luna|twilight sparkle,annajewel
1688584.png,https://derpicdn.net/img/view/2018/3/24/1688584.png,0,0.9941916465759276,888,484,1388,984,500,500,princess celestia|princess luna|queen chrysalis|rainbow dash|soarin'|spitfire|starlight glimmer|sunset shimmer|trixie|twilight sparkle,captainloafnugget
1688584.png,https://derpicdn.net/img/view/2018/3/24/1688584.png,1,0.9921160340309144,1781,0,2261,465,480,465,princess celestia|princess luna|queen chrysalis|rainbow dash|soarin'|spitfire|starlight glimmer|sunset shimmer|trixie|twilight sparkle,captainloafnugget
1689718.png,https://derpicdn.net/img/view/2018/3/25/1689718.png,0,0.9923684000968932,282,75,772,565,490,490,starlight glimmer|twilight sparkle,
1690018.png,https://derpicdn.net/img/view/2018/3/25/1690018.png,0,0.9912611842155457,62,284,1048,1270,986,986,rarity|twilight sparkle,lilfunkman
1691135.png,https://derpicdn.net/img/view/2018/3/26/1691135.png,0,0.9079105854034424,224,0,2038,1721,1814,1721,starlight glimmer|twilight sparkle,yumomochan
1695223.png,https://derpicdn.net/img/view/2018/3/31/1695223.png,0,0.996599018573761,946,561,1372,987,426,426,applejack|fluttershy|mane six|pinkie pie|rainbow dash|rarity|starlight glimmer|trixie|twilight sparkle,whiskyice
1696226.png,https://derpicdn.net/img/view/2018/4/1/1696226.png,0,0.9295722246170044,1147,0,1920,582,773,582,applejack|starlight glimmer|twilight sparkle,
1698177.png,https://derpicdn.net/img/view/2018/4/3/1698177.png,0,0.9226924180984496,1303,1103,2055,1855,752,752,applejack|princess celestia|princess luna|rarity|spike|starlight glimmer|twilight sparkle,stinkehund|pirill|iknowpony|almostfictional|parclytaxel|zacatron94|scrimpeh|illumnious
1699115.png,https://derpicdn.net/img/view/2018/4/4/1699115.png,0,0.9783828258514404,362,656,870,1164,508,508,rarity|twilight sparkle,bbbhuey
169958.png,https://derpicdn.net/img/view/2012/12/2/169958.png,0,0.9757251739501952,67,101,439,456,372,355,rarity|twilight sparkle,
1700771.png,https://derpicdn.net/img/view/2018/4/6/1700771.png,0,0.991418719291687,22,0,374,320,352,320,pinkie pie|twilight sparkle,cheshiregalaxi
1700771.png,https://derpicdn.net/img/view/2018/4/6/1700771.png,1,0.9900838136672974,0,503,662,1183,662,680,pinkie pie|twilight sparkle,cheshiregalaxi
1700771.png,https://derpicdn.net/img/view/2018/4/6/1700771.png,2,0.9846357107162476,903,2,1271,370,368,368,pinkie pie|twilight sparkle,cheshiregalaxi
1700902.png,https://derpicdn.net/img/view/2018/4/6/1700902.png,0,0.978753387928009,42,156,476,590,434,434,starlight glimmer|twilight sparkle,verumtee
1702726.png,https://derpicdn.net/img/view/2018/4/8/1702726.png,0,0.972034990787506,0,25,534,663,534,638,starlight glimmer|twilight sparkle,
1705154.png,https://derpicdn.net/img/view/2018/4/11/1705154.png,0,0.962068259716034,890,0,1726,656,836,656,princess celestia|princess luna|twilight sparkle,agrol
1706469.png,https://derpicdn.net/img/view/2018/4/13/1706469.png,0,0.9580559134483336,2939,0,4837,1707,1898,1707,applejack|rarity|twilight sparkle,sergeant16bit
1706964.png,https://derpicdn.net/img/view/2018/4/13/1706964.png,0,0.9767051339149476,684,32,822,170,138,138,applejack|fluttershy|pinkie pie|rainbow dash|rarity|sunset shimmer|trixie|twilight sparkle,flinksea
1707099.png,https://derpicdn.net/img/view/2018/4/14/1707099.png,0,0.9883647561073304,1366,0,2000,634,634,634,applejack|fluttershy|mane six|pinkie pie|rainbow dash|rarity|twilight sparkle,zefirka
1707099.png,https://derpicdn.net/img/view/2018/4/14/1707099.png,1,0.9882458448410034,0,1022,635,1696,635,674,applejack|fluttershy|mane six|pinkie pie|rainbow dash|rarity|twilight sparkle,zefirka
1707099.png,https://derpicdn.net/img/view/2018/4/14/1707099.png,2,0.9790585041046144,83,35,645,597,562,562,applejack|fluttershy|mane six|pinkie pie|rainbow dash|rarity|twilight sparkle,zefirka
1707099.png,https://derpicdn.net/img/view/2018/4/14/1707099.png,3,0.9573285579681396,569,0,1367,769,798,769,applejack|fluttershy|mane six|pinkie pie|rainbow dash|rarity|twilight sparkle,zefirka
1708688.png,https://derpicdn.net/img/view/2018/4/15/1708688.png,0,0.9638461470603944,901,0,1445,454,544,454,applejack|twilight sparkle,prismspark|foreman
1710113.png,https://derpicdn.net/img/view/2018/4/17/1710113.png,0,0.9794418215751648,2209,749,2855,1395,646,646,applejack|twilight sparkle,theprince
1711466.png,https://derpicdn.net/img/view/2018/4/19/1711466.png,0,0.9414687752723694,95,604,927,1436,832,832,princess cadance|princess celestia|princess luna|twilight sparkle,uunicornicc
1712412.png,https://derpicdn.net/img/view/2018/4/20/1712412.png,0,0.9565046429634094,693,45,871,223,178,178,applejack|fluttershy|pinkie pie|rainbow dash|spike|twilight sparkle,
1712996.png,https://derpicdn.net/img/view/2018/4/20/1712996.png,0,0.9993484616279602,822,712,1552,1442,730,730,princess celestia|twilight sparkle,saturdaymorningproj
1714760.png,https://derpicdn.net/img/view/2018/4/22/1714760.png,0,0.9983571171760559,0,208,360,570,360,362,fluttershy|pinkie pie|twilight sparkle,lazynore
1715834.png,https://derpicdn.net/img/view/2018/4/24/1715834.png,0,0.9812337160110474,2,231,302,531,300,300,applejack|fluttershy|mane six|pinkie pie|rainbow dash|rarity|starlight glimmer|sunset shimmer|trixie|twilight sparkle,zekrom-9|theshadowstone
1715834.png,https://derpicdn.net/img/view/2018/4/24/1715834.png,1,0.9738296866416932,970,0,1328,303,358,303,applejack|fluttershy|mane six|pinkie pie|rainbow dash|rarity|starlight glimmer|sunset shimmer|trixie|twilight sparkle,zekrom-9|theshadowstone
1718128.png,https://derpicdn.net/img/view/2018/4/27/1718128.png,0,0.9810000061988832,458,509,688,739,230,230,applejack|fluttershy|pinkie pie|rainbow dash|rarity|twilight sparkle,coinpo|mimicpony|idrawwhatiwant|kidkaizer|rhorse|sawhorse
171839.jpg,https://derpicdn.net/img/view/2012/12/3/171839.jpg,0,0.9531127214431764,831,40,1024,294,193,254,apple bloom|applejack|cutie mark crusaders|fluttershy|mane six|pinkie pie|rainbow dash|rarity|sweetie belle|twilight sparkle,ajin|miu|leche
171839.jpg,https://derpicdn.net/img/view/2012/12/3/171839.jpg,1,0.9283390641212464,10,488,214,692,204,204,apple bloom|applejack|cutie mark crusaders|fluttershy|mane six|pinkie pie|rainbow dash|rarity|sweetie belle|twilight sparkle,ajin|miu|leche
1719801.png,https://derpicdn.net/img/view/2018/4/29/1719801.png,0,0.9185751676559448,489,155,653,319,164,164,applejack|fluttershy|rainbow dash|rarity|spike|starlight glimmer|trixie|twilight sparkle,
1720337.png,https://derpicdn.net/img/view/2018/4/29/1720337.png,0,0.9987779259681702,121,2441,845,3165,724,724,applejack|fluttershy|mane six|pinkie pie|rainbow dash|rarity|twilight sparkle,roscoethepotatoman
1720337.png,https://derpicdn.net/img/view/2018/4/29/1720337.png,1,0.9962288141250608,125,3,827,705,702,702,applejack|fluttershy|mane six|pinkie pie|rainbow dash|rarity|twilight sparkle,roscoethepotatoman
1720337.png,https://derpicdn.net/img/view/2018/4/29/1720337.png,2,0.9941251873970032,2155,1307,2831,1983,676,676,applejack|fluttershy|mane six|pinkie pie|rainbow dash|rarity|twilight sparkle,roscoethepotatoman
1720621.png,https://derpicdn.net/img/view/2018/4/30/1720621.png,0,0.9760709404945374,529,154,933,558,404,404,starlight glimmer|twilight sparkle,zouyugi
1726974.png,https://derpicdn.net/img/view/2018/5/7/1726974.png,0,0.9864481091499328,29,881,433,1285,404,404,princess cadance|princess celestia|princess luna|twilight sparkle,thesmall-artist
1726974.png,https://derpicdn.net/img/view/2018/5/7/1726974.png,2,0.9617308974266052,1548,593,2030,1075,482,482,princess cadance|princess celestia|princess luna|twilight sparkle,thesmall-artist
1740077.png,https://derpicdn.net/img/view/2018/5/24/1740077.png,0,0.9327647686004642,17,0,427,399,410,399,spike|twilight sparkle,
1742034.png,https://derpicdn.net/img/view/2018/5/26/1742034.png,0,0.9949542284011841,2709,2832,3569,3692,860,860,applejack|fluttershy|mane six|pinkie pie|rainbow dash|rarity|twilight sparkle,harmony134
1742034.png,https://derpicdn.net/img/view/2018/5/26/1742034.png,1,0.985692024230957,1949,2127,2755,2933,806,806,applejack|fluttershy|mane six|pinkie pie|rainbow dash|rarity|twilight sparkle,harmony134
1744258.png,https://derpicdn.net/img/view/2018/5/29/1744258.png,0,0.9074074625968932,544,339,962,757,418,418,spike|twilight sparkle,castaspellliana
1748350.png,https://derpicdn.net/img/view/2018/6/3/1748350.png,0,0.96010160446167,289,787,835,1333,546,546,starlight glimmer|twilight sparkle,
1748350.png,https://derpicdn.net/img/view/2018/6/3/1748350.png,1,0.940244436264038,479,130,735,386,256,256,starlight glimmer|twilight sparkle,
1749910.png,https://derpicdn.net/img/view/2018/6/4/1749910.png,0,0.997825026512146,212,0,1808,1351,1596,1351,shining armor|twilight sparkle,skyflys
1749910.png,https://derpicdn.net/img/view/2018/6/4/1749910.png,1,0.9924486875534058,1399,415,2587,1603,1188,1188,shining armor|twilight sparkle,skyflys
1752413.png,https://derpicdn.net/img/view/2018/6/8/1752413.png,1,0.9915035963058472,781,1589,1797,2605,1016,1016,applejack|fluttershy|mane six|pinkie pie|rainbow dash|rarity|twilight sparkle,donnie-moon
1752413.png,https://derpicdn.net/img/view/2018/6/8/1752413.png,2,0.9843851923942566,2936,1272,3814,2150,878,878,applejack|fluttershy|mane six|pinkie pie|rainbow dash|rarity|twilight sparkle,donnie-moon
1757538.png,https://derpicdn.net/img/view/2018/6/14/1757538.png,0,0.983975887298584,0,72,531,616,531,544,starlight glimmer|twilight sparkle,ficklepickle9421
1759520.png,https://derpicdn.net/img/view/2018/6/17/1759520.png,0,0.9370768666267396,1831,782,3033,1984,1202,1202,princess celestia|twilight sparkle,setup1337
1762298.png,https://derpicdn.net/img/view/2018/6/20/1762298.png,0,0.990228533744812,1227,0,3489,1716,2262,1716,starlight glimmer|twilight sparkle,mr.rexy
1765823.png,https://derpicdn.net/img/view/2018/6/25/1765823.png,0,0.996662437915802,287,0,499,210,212,210,applejack|rarity|trixie|twilight sparkle,
1767600.png,https://derpicdn.net/img/view/2018/6/27/1767600.png,2,0.9922468662261964,115,0,491,375,376,375,applejack|fluttershy|mane six|pinkie pie|rainbow dash|rarity|twilight sparkle,karzii
1767600.png,https://derpicdn.net/img/view/2018/6/27/1767600.png,3,0.9856933355331421,366,797,768,1199,402,402,applejack|fluttershy|mane six|pinkie pie|rainbow dash|rarity|twilight sparkle,karzii
1767603.png,https://derpicdn.net/img/view/2018/6/27/1767603.png,0,0.9986773133277892,761,627,1333,1199,572,572,applejack|fluttershy|mane six|pinkie pie|rainbow dash|rarity|twilight sparkle,karzii
1767603.png,https://derpicdn.net/img/view/2018/6/27/1767603.png,1,0.9981433153152466,840,0,1404,540,564,540,applejack|fluttershy|mane six|pinkie pie|rainbow dash|rarity|twilight sparkle,karzii
1767603.png,https://derpicdn.net/img/view/2018/6/27/1767603.png,2,0.988121211528778,708,1253,1404,1949,696,696,applejack|fluttershy|mane six|pinkie pie|rainbow dash|rarity|twilight sparkle,karzii
1767603.png,https://derpicdn.net/img/view/2018/6/27/1767603.png,3,0.9466999769210817,44,701,552,1209,508,508,applejack|fluttershy|mane six|pinkie pie|rainbow dash|rarity|twilight sparkle,karzii
1767603.png,https://derpicdn.net/img/view/2018/6/27/1767603.png,4,0.9438736438751221,0,1325,610,2009,610,684,applejack|fluttershy|mane six|pinkie pie|rainbow dash|rarity|twilight sparkle,karzii
1772426.png,https://derpicdn.net/img/view/2018/7/4/1772426.png,1,0.9147676229476928,55,38,467,450,412,412,fluttershy|twilight sparkle,pink-pone
1773646.png,https://derpicdn.net/img/view/2018/7/5/1773646.png,0,0.9959470629692078,3061,0,5981,2655,2920,2655,starlight glimmer|twilight sparkle,famousmari5
1786295.png,https://derpicdn.net/img/view/2018/7/21/1786295.png,0,0.99572092294693,989,738,1363,1112,374,374,spike|twilight sparkle,pencil bolt
1786295.png,https://derpicdn.net/img/view/2018/7/21/1786295.png,1,0.9940218329429626,458,122,894,558,436,436,spike|twilight sparkle,pencil bolt
1787825.png,https://derpicdn.net/img/view/2018/7/23/1787825.png,0,0.9762425422668456,3,13,407,417,404,404,sunset shimmer|twilight sparkle,php77
1787825.png,https://derpicdn.net/img/view/2018/7/23/1787825.png,1,0.9522491693496704,748,5,1194,451,446,446,sunset shimmer|twilight sparkle,php77
1788397.png,https://derpicdn.net/img/view/2018/7/24/1788397.png,0,0.9764740467071532,23,0,1201,720,1178,720,starlight glimmer|twilight sparkle,agrol
1791485.png,https://derpicdn.net/img/view/2018/7/28/1791485.png,0,0.9975904822349548,402,0,768,321,366,321,fluttershy|rainbow dash|twilight sparkle,artiks
1791485.png,https://derpicdn.net/img/view/2018/7/28/1791485.png,1,0.993867039680481,682,197,1116,631,434,434,fluttershy|rainbow dash|twilight sparkle,artiks
1791791.png,https://derpicdn.net/img/view/2018/7/28/1791791.png,0,0.9985961318016052,1318,118,2214,1014,896,896,applejack|fluttershy|mane six|pinkie pie|rainbow dash|rarity|twilight sparkle,erkythehero23
1795236.png,https://derpicdn.net/img/view/2018/8/1/1795236.png,0,0.9669566750526428,814,415,1136,737,322,322,spike|twilight sparkle,
1795845.png,https://derpicdn.net/img/view/2018/8/2/1795845.png,0,0.988792896270752,1336,986,2572,2222,1236,1236,rainbow dash|twilight sparkle,moon-rose-rosie
1796171.png,https://derpicdn.net/img/view/2018/8/2/1796171.png,0,0.9977545142173768,541,0,923,357,382,357,sunset shimmer|twilight sparkle,php77|sugar-loop
1797258.png,https://derpicdn.net/img/view/2018/8/3/1797258.png,0,0.9969580173492432,526,39,1436,949,910,910,applejack|fluttershy|mane six|pinkie pie|rainbow dash|rarity|twilight sparkle,taurson
1798984.png,https://derpicdn.net/img/view/2018/8/5/1798984.png,0,0.9911529421806335,0,0,488,527,488,527,fluttershy|twilight sparkle,waterz-colrxz
1798984.png,https://derpicdn.net/img/view/2018/8/5/1798984.png,1,0.9763740301132202,510,13,996,499,486,486,fluttershy|twilight sparkle,waterz-colrxz
1800563.png,https://derpicdn.net/img/view/2018/8/7/1800563.png,0,0.9906207323074341,15,152,651,788,636,636,starlight glimmer|sunset shimmer|twilight sparkle,chautung
1800563.png,https://derpicdn.net/img/view/2018/8/7/1800563.png,1,0.9819492697715759,1234,178,1872,816,638,638,starlight glimmer|sunset shimmer|twilight sparkle,chautung
1802563.png,https://derpicdn.net/img/view/2018/8/9/1802563.png,0,0.9994553923606871,113,209,389,485,276,276,applejack|fluttershy|mane six|pinkie pie|rainbow dash|rarity|twilight sparkle,envygirl95
1802563.png,https://derpicdn.net/img/view/2018/8/9/1802563.png,3,0.97175931930542,750,199,1000,449,250,250,applejack|fluttershy|mane six|pinkie pie|rainbow dash|rarity|twilight sparkle,envygirl95
1802563.png,https://derpicdn.net/img/view/2018/8/9/1802563.png,4,0.9500076770782472,13,104,213,304,200,200,applejack|fluttershy|mane six|pinkie pie|rainbow dash|rarity|twilight sparkle,envygirl95
1802918.png,https://derpicdn.net/img/view/2018/8/10/1802918.png,0,0.997913420200348,2,365,194,557,192,192,applejack|big macintosh|fluttershy|mane six|pinkie pie|rainbow dash|rarity|soarin'|twilight sparkle,malinraf1615
1802918.png,https://derpicdn.net/img/view/2018/8/10/1802918.png,2,0.9507304430007936,394,397,592,595,198,198,applejack|big macintosh|fluttershy|mane six|pinkie pie|rainbow dash|rarity|soarin'|twilight sparkle,malinraf1615
1803703.png,https://derpicdn.net/img/view/2018/8/11/1803703.png,0,0.9912448525428772,87,96,771,780,684,684,spike|twilight sparkle,artiks
1803958.png,https://derpicdn.net/img/view/2018/8/11/1803958.png,0,0.996855080127716,0,88,315,426,315,338,rainbow dash|twilight sparkle,4th
1803958.png,https://derpicdn.net/img/view/2018/8/11/1803958.png,1,0.9934863448143004,381,81,783,483,402,402,rainbow dash|twilight sparkle,4th
1809789.png,https://derpicdn.net/img/view/2018/8/18/1809789.png,0,0.9675124883651732,1087,95,1381,389,294,294,applejack|fluttershy|mane six|pinkie pie|rainbow dash|rarity|spike|twilight sparkle,
1813268.png,https://derpicdn.net/img/view/2018/8/22/1813268.png,0,0.9987462759017944,74,272,510,708,436,436,princess celestia|twilight sparkle,mylittlegodzilla
1813477.png,https://derpicdn.net/img/view/2018/8/22/1813477.png,1,0.9845719933509828,37,340,367,670,330,330,fluttershy|rainbow dash|twilight sparkle,check3256
1813477.png,https://derpicdn.net/img/view/2018/8/22/1813477.png,2,0.9833313226699828,375,0,685,287,310,287,fluttershy|rainbow dash|twilight sparkle,check3256
1816825.png,https://derpicdn.net/img/view/2018/8/26/1816825.png,0,0.9962959885597228,232,0,1734,1426,1502,1426,rainbow dash|twilight sparkle,fensu-san
1818354.png,https://derpicdn.net/img/view/2018/8/28/1818354.png,0,0.9294431209564208,238,18,476,256,238,238,princess celestia|twilight sparkle,shiiazu
1818398.png,https://derpicdn.net/img/view/2018/8/28/1818398.png,0,0.9701561927795408,1286,202,2814,1730,1528,1528,spike|twilight sparkle,uunicornicc
1818398.png,https://derpicdn.net/img/view/2018/8/28/1818398.png,1,0.9523392915725708,2492,585,3532,1625,1040,1040,spike|twilight sparkle,uunicornicc
1820419.png,https://derpicdn.net/img/view/2018/8/30/1820419.png,2,0.9801280498504642,362,1204,1842,2684,1480,1480,princess cadance|princess flurry heart|shining armor|spike|twilight sparkle,mundschenk85
1821794.png,https://derpicdn.net/img/view/2018/9/1/1821794.png,0,0.9995800852775574,2378,687,3294,1603,916,916,applejack|fluttershy|mane six|pinkie pie|rainbow dash|rarity|twilight sparkle,donnie-moon
1821794.png,https://derpicdn.net/img/view/2018/9/1/1821794.png,1,0.987947165966034,842,177,1530,865,688,688,applejack|fluttershy|mane six|pinkie pie|rainbow dash|rarity|twilight sparkle,donnie-moon
1821794.png,https://derpicdn.net/img/view/2018/9/1/1821794.png,2,0.9872220754623412,0,760,800,1566,800,806,applejack|fluttershy|mane six|pinkie pie|rainbow dash|rarity|twilight sparkle,donnie-moon
1821794.png,https://derpicdn.net/img/view/2018/9/1/1821794.png,3,0.9645751118659972,1508,0,2196,649,688,649,applejack|fluttershy|mane six|pinkie pie|rainbow dash|rarity|twilight sparkle,donnie-moon
18226.jpg,https://derpicdn.net/img/view/2012/6/24/18226.jpg,0,0.9290614128112792,32,0,706,567,674,567,rarity|trixie|twilight sparkle,katiramoon
1822707.png,https://derpicdn.net/img/view/2018/9/2/1822707.png,1,0.9698283672332764,329,0,599,258,270,258,applejack|fluttershy|mane six|pinkie pie|rainbow dash|rarity|twilight sparkle,waterz-colrxz
1822935.png,https://derpicdn.net/img/view/2018/9/2/1822935.png,0,0.9121005535125732,577,0,1203,600,626,600,rainbow dash|twilight sparkle,lielie
1827202.png,https://derpicdn.net/img/view/2018/9/7/1827202.png,0,0.9891184568405152,154,0,970,747,816,747,fluttershy|rarity|sunset shimmer|twilight sparkle,nichroniclesvsart
1827202.png,https://derpicdn.net/img/view/2018/9/7/1827202.png,1,0.9885939955711364,301,1008,723,1430,422,422,fluttershy|rarity|sunset shimmer|twilight sparkle,nichroniclesvsart
1827202.png,https://derpicdn.net/img/view/2018/9/7/1827202.png,2,0.9805562496185304,0,983,436,1423,436,440,fluttershy|rarity|sunset shimmer|twilight sparkle,nichroniclesvsart
1827202.png,https://derpicdn.net/img/view/2018/9/7/1827202.png,3,0.9717135429382324,860,924,1280,1394,420,470,fluttershy|rarity|sunset shimmer|twilight sparkle,nichroniclesvsart
1827920.png,https://derpicdn.net/img/view/2018/9/8/1827920.png,0,0.9871698021888732,0,0,3000,3139,3000,3139,pinkie pie|rainbow dash|twilight sparkle,smallhorses
1829232.png,https://derpicdn.net/img/view/2018/9/10/1829232.png,0,0.9980958700180054,515,336,1161,982,646,646,rainbow dash|twilight sparkle,neko-luvz
1832605.png,https://derpicdn.net/img/view/2018/9/14/1832605.png,0,0.998079776763916,503,174,861,532,358,358,starlight glimmer|sunset shimmer|twilight sparkle,celestialardor
1832605.png,https://derpicdn.net/img/view/2018/9/14/1832605.png,2,0.9508283734321594,761,174,1091,504,330,330,starlight glimmer|sunset shimmer|twilight sparkle,celestialardor
1832762.png,https://derpicdn.net/img/view/2018/9/14/1832762.png,0,0.9963707327842712,719,39,947,267,228,228,applejack|fluttershy|mane six|pinkie pie|rainbow dash|rarity|twilight sparkle,nederside
1832762.png,https://derpicdn.net/img/view/2018/9/14/1832762.png,1,0.9822985529899596,27,598,363,934,336,336,applejack|fluttershy|mane six|pinkie pie|rainbow dash|rarity|twilight sparkle,nederside
1832762.png,https://derpicdn.net/img/view/2018/9/14/1832762.png,2,0.9751892685890198,19,26,233,240,214,214,applejack|fluttershy|mane six|pinkie pie|rainbow dash|rarity|twilight sparkle,nederside
1832762.png,https://derpicdn.net/img/view/2018/9/14/1832762.png,3,0.974377989768982,886,36,1130,280,244,244,applejack|fluttershy|mane six|pinkie pie|rainbow dash|rarity|twilight sparkle,nederside
1834765.png,https://derpicdn.net/img/view/2018/9/17/1834765.png,0,0.980777621269226,515,0,977,394,462,394,trixie|twilight sparkle,
18405.jpg,https://derpicdn.net/img/view/2012/6/24/18405.jpg,0,0.9761283993721008,97,257,339,499,242,242,applejack|twilight sparkle,don-ko
185236.png,https://derpicdn.net/img/view/2012/12/17/185236.png,0,0.9944223761558532,126,0,3758,3055,3632,3055,princess cadance|twilight sparkle,90sigma
1852823.png,https://derpicdn.net/img/view/2018/10/10/1852823.png,0,0.939720332622528,0,0,366,377,366,377,fluttershy|twilight sparkle,
1852960.png,https://derpicdn.net/img/view/2018/10/10/1852960.png,0,0.9978658556938172,1589,75,2531,1017,942,942,applejack|fluttershy|mane six|pinkie pie|rainbow dash|rarity|twilight sparkle,spellboundcanvas
1852960.png,https://derpicdn.net/img/view/2018/10/10/1852960.png,1,0.985118329524994,1735,824,2661,1750,926,926,applejack|fluttershy|mane six|pinkie pie|rainbow dash|rarity|twilight sparkle,spellboundcanvas
1852963.png,https://derpicdn.net/img/view/2018/10/10/1852963.png,0,0.9282353520393372,1008,427,1530,872,522,445,applejack|fluttershy|mane six|pinkie pie|rainbow dash|rarity|spike|starlight glimmer|sunset shimmer|twilight sparkle,
1854245.png,https://derpicdn.net/img/view/2018/10/12/1854245.png,0,0.9945530295372008,1115,1113,2295,2293,1180,1180,applejack|fluttershy|mane six|pinkie pie|rainbow dash|rarity|twilight sparkle,xstillwatersrundeep
1854245.png,https://derpicdn.net/img/view/2018/10/12/1854245.png,1,0.9940776228904724,325,14,1015,704,690,690,applejack|fluttershy|mane six|pinkie pie|rainbow dash|rarity|twilight sparkle,xstillwatersrundeep
1854245.png,https://derpicdn.net/img/view/2018/10/12/1854245.png,2,0.9698407053947448,249,1006,1273,2030,1024,1024,applejack|fluttershy|mane six|pinkie pie|rainbow dash|rarity|twilight sparkle,xstillwatersrundeep
18582.jpg,https://derpicdn.net/img/view/2012/6/24/18582.jpg,0,0.9505571126937866,64,620,344,900,280,280,princess cadance|princess luna|twilight sparkle,johnjoseco
1859034.png,https://derpicdn.net/img/view/2018/10/17/1859034.png,0,0.9821655154228208,274,0,1060,627,786,627,rarity|sunset shimmer|twilight sparkle,nichroniclesvsart
1859727.png,https://derpicdn.net/img/view/2018/10/18/1859727.png,0,0.990065336227417,340,0,876,535,536,535,sunset shimmer|twilight sparkle,nichroniclesvsart
1865102.png,https://derpicdn.net/img/view/2018/10/24/1865102.png,0,0.9148485064506532,1085,172,1920,1012,835,840,princess celestia|sunset shimmer|twilight sparkle,
1868050.png,https://derpicdn.net/img/view/2018/10/28/1868050.png,0,0.9957486391067504,1141,585,2519,1963,1378,1378,princess cadance|princess celestia|princess flurry heart|princess luna|twilight sparkle,those kids in the corner|kids-in-the-corner
1868050.png,https://derpicdn.net/img/view/2018/10/28/1868050.png,1,0.9034534096717834,4843,702,6035,1894,1192,1192,princess cadance|princess celestia|princess flurry heart|princess luna|twilight sparkle,those kids in the corner|kids-in-the-corner
1875819.png,https://derpicdn.net/img/view/2018/11/5/1875819.png,0,0.9898015260696412,196,153,496,453,300,300,spike|twilight sparkle,sentireaeris
1875819.png,https://derpicdn.net/img/view/2018/11/5/1875819.png,1,0.9379703402519226,593,223,947,577,354,354,spike|twilight sparkle,sentireaeris
1875943.png,https://derpicdn.net/img/view/2018/11/5/1875943.png,0,0.9985603094100952,736,318,1844,1426,1108,1108,spike|twilight sparkle,sentireaeris
1875943.png,https://derpicdn.net/img/view/2018/11/5/1875943.png,1,0.9164506196975708,2097,679,3131,1713,1034,1034,spike|twilight sparkle,sentireaeris
187638.png,https://derpicdn.net/img/view/2012/12/19/187638.png,0,0.9844700694084167,37,462,459,884,422,422,trixie|twilight sparkle,adcoon
187638.png,https://derpicdn.net/img/view/2012/12/19/187638.png,1,0.9178086519241332,1422,410,1888,876,466,466,trixie|twilight sparkle,adcoon
1882537.png,https://derpicdn.net/img/view/2018/11/15/1882537.png,0,0.945514976978302,325,0,2217,1704,1892,1704,rainbow dash|twilight sparkle,radioactive nero
1883784.png,https://derpicdn.net/img/view/2018/11/16/1883784.png,0,0.9995408654212952,0,0,926,873,926,873,applejack|fluttershy|mane six|pinkie pie|rainbow dash|rarity|twilight sparkle,jolliapplegirl
1883784.png,https://derpicdn.net/img/view/2018/11/16/1883784.png,1,0.9974853992462158,3151,0,4077,924,926,924,applejack|fluttershy|mane six|pinkie pie|rainbow dash|rarity|twilight sparkle,jolliapplegirl
1883784.png,https://derpicdn.net/img/view/2018/11/16/1883784.png,2,0.9848297238349916,1877,96,2621,840,744,744,applejack|fluttershy|mane six|pinkie pie|rainbow dash|rarity|twilight sparkle,jolliapplegirl
1883784.png,https://derpicdn.net/img/view/2018/11/16/1883784.png,3,0.902129590511322,219,1732,1123,2636,904,904,applejack|fluttershy|mane six|pinkie pie|rainbow dash|rarity|twilight sparkle,jolliapplegirl
1885322.png,https://derpicdn.net/img/view/2018/11/18/1885322.png,0,0.9721558094024658,795,70,981,256,186,186,apple bloom|applejack|big macintosh|discord|fluttershy|pinkie pie|princess cadance|princess celestia|princess flurry heart|princess luna|rainbow dash|rarity|scootaloo|shining armor|sweetie belle|twilight sparkle,nivimonster
1885322.png,https://derpicdn.net/img/view/2018/11/18/1885322.png,2,0.935032069683075,572,108,774,310,202,202,apple bloom|applejack|big macintosh|discord|fluttershy|pinkie pie|princess cadance|princess celestia|princess flurry heart|princess luna|rainbow dash|rarity|scootaloo|shining armor|sweetie belle|twilight sparkle,nivimonster
1887859.png,https://derpicdn.net/img/view/2018/11/21/1887859.png,1,0.9690504670143129,40,0,894,719,854,719,princess cadance|princess celestia|princess luna|twilight sparkle,cuddlelamb
1888601.png,https://derpicdn.net/img/view/2018/11/22/1888601.png,0,0.9983028769493104,1629,142,2520,1090,891,948,sunset shimmer|twilight sparkle,rockleerocks77
1888601.png,https://derpicdn.net/img/view/2018/11/22/1888601.png,1,0.9404522180557252,501,101,1359,959,858,858,sunset shimmer|twilight sparkle,rockleerocks77
1889777.png,https://derpicdn.net/img/view/2018/11/24/1889777.png,0,0.9820635318756104,0,192,292,498,292,306,sunset shimmer|twilight sparkle,
1890845.png,https://derpicdn.net/img/view/2018/11/25/1890845.png,0,0.9984608292579652,568,562,822,816,254,254,rarity|twilight sparkle,kingkero
1894692.png,https://derpicdn.net/img/view/2018/11/30/1894692.png,2,0.9587785005569458,378,1166,830,1618,452,452,applejack|fluttershy|mane six|pinkie pie|rainbow dash|rarity|spike|twilight sparkle,hiyori-yamada
1894692.png,https://derpicdn.net/img/view/2018/11/30/1894692.png,3,0.9325668811798096,1059,1151,1493,1585,434,434,applejack|fluttershy|mane six|pinkie pie|rainbow dash|rarity|spike|twilight sparkle,hiyori-yamada
1896569.png,https://derpicdn.net/img/view/2018/12/2/1896569.png,0,0.9845870733261108,432,692,1832,2092,1400,1400,applejack|fluttershy|mane six|pinkie pie|rainbow dash|rarity|twilight sparkle,aleximusprime
1896569.png,https://derpicdn.net/img/view/2018/12/2/1896569.png,1,0.966121792793274,4380,908,5332,1860,952,952,applejack|fluttershy|mane six|pinkie pie|rainbow dash|rarity|twilight sparkle,aleximusprime
190065.png,https://derpicdn.net/img/view/2012/12/22/190065.png,0,0.9267580509185792,1394,532,1704,842,310,310,princess cadance|shining armor|spike|twilight sparkle,godzilla3092
1900867.png,https://derpicdn.net/img/view/2018/12/7/1900867.png,0,0.9818769693374634,346,300,562,516,216,216,applejack|fluttershy|pinkie pie|princess celestia|princess luna|rainbow dash|rarity|starlight glimmer|twilight sparkle,valemjj
1900867.png,https://derpicdn.net/img/view/2018/12/7/1900867.png,1,0.9803754687309264,284,73,532,321,248,248,applejack|fluttershy|pinkie pie|princess celestia|princess luna|rainbow dash|rarity|starlight glimmer|twilight sparkle,valemjj
1900867.png,https://derpicdn.net/img/view/2018/12/7/1900867.png,2,0.9774224758148192,297,496,579,778,282,282,applejack|fluttershy|pinkie pie|princess celestia|princess luna|rainbow dash|rarity|starlight glimmer|twilight sparkle,valemjj
1908018.png,https://derpicdn.net/img/view/2018/12/14/1908018.png,0,0.9826714396476746,91,226,669,804,578,578,sunset shimmer|twilight sparkle,
1913713.png,https://derpicdn.net/img/view/2018/12/20/1913713.png,1,0.9835003018379213,280,101,866,687,586,586,pinkie pie|twilight sparkle,saturdaymorningproj
1915481.png,https://derpicdn.net/img/view/2018/12/22/1915481.png,0,0.9863529801368712,662,20,1036,394,374,374,starlight glimmer|twilight sparkle,
191885.png,https://derpicdn.net/img/view/2012/12/24/191885.png,0,0.9685025215148926,16,100,370,454,354,354,rarity|twilight sparkle,ziemniax
1920474.png,https://derpicdn.net/img/view/2018/12/28/1920474.png,0,0.9619632363319396,684,31,1028,375,344,344,starlight glimmer|twilight sparkle,
1920485.png,https://derpicdn.net/img/view/2018/12/28/1920485.png,0,0.9257692098617554,160,0,514,295,354,295,applejack|fluttershy|mane six|pinkie pie|rainbow dash|rarity|spike|twilight sparkle,raystar-draws
19220.png,https://derpicdn.net/img/view/2012/6/24/19220.png,0,0.9093089699745178,142,171,742,771,600,600,spike|twilight sparkle,imalou
1922040.png,https://derpicdn.net/img/view/2018/12/30/1922040.png,0,0.9920043349266052,1651,1259,1999,1607,348,348,applejack|fluttershy|mane six|pinkie pie|rainbow dash|rarity|twilight sparkle,cckittycreative
1924984.png,https://derpicdn.net/img/view/2019/1/2/1924984.png,0,0.9997368454933168,1018,307,1710,999,692,692,rainbow dash|twilight sparkle,yarugreat
1932144.png,https://derpicdn.net/img/view/2019/1/11/1932144.png,0,0.9872939586639404,147,0,787,610,640,610,sunset shimmer|twilight sparkle,plinkie_poi
1937975.png,https://derpicdn.net/img/view/2019/1/17/1937975.png,0,0.989408791065216,0,0,460,509,460,509,fluttershy|twilight sparkle,
1941438.png,https://derpicdn.net/img/view/2019/1/22/1941438.png,1,0.9801061749458312,1666,902,2296,1532,630,630,applejack|fluttershy|mane six|pinkie pie|rainbow dash|rarity|twilight sparkle,whitehershey
1941438.png,https://derpicdn.net/img/view/2019/1/22/1941438.png,2,0.964035987854004,604,951,1138,1485,534,534,applejack|fluttershy|mane six|pinkie pie|rainbow dash|rarity|twilight sparkle,whitehershey
1941438.png,https://derpicdn.net/img/view/2019/1/22/1941438.png,3,0.9358049631118774,2175,857,2631,1313,456,456,applejack|fluttershy|mane six|pinkie pie|rainbow dash|rarity|twilight sparkle,whitehershey
1950885.png,https://derpicdn.net/img/view/2019/2/2/1950885.png,0,0.983782172203064,189,492,651,954,462,462,pinkie pie|rainbow dash|rarity|twilight sparkle,
1950885.png,https://derpicdn.net/img/view/2019/2/2/1950885.png,1,0.960618495941162,828,178,1864,1059,1036,881,pinkie pie|rainbow dash|rarity|twilight sparkle,
1956186.png,https://derpicdn.net/img/view/2019/2/7/1956186.png,0,0.9100064635276794,997,150,1197,350,200,200,applejack|fluttershy|mane six|pinkie pie|rainbow dash|rarity|spike|twilight sparkle,
1958525.png,https://derpicdn.net/img/view/2019/2/10/1958525.png,0,0.9998538494110109,558,0,798,215,240,215,applejack|fluttershy|mane six|pinkie pie|rainbow dash|rarity|twilight sparkle,云观雾里
1958525.png,https://derpicdn.net/img/view/2019/2/10/1958525.png,1,0.9893766045570374,12,247,232,467,220,220,applejack|fluttershy|mane six|pinkie pie|rainbow dash|rarity|twilight sparkle,云观雾里
1958525.png,https://derpicdn.net/img/view/2019/2/10/1958525.png,2,0.9414846301078796,584,396,790,602,206,206,applejack|fluttershy|mane six|pinkie pie|rainbow dash|rarity|twilight sparkle,云观雾里
1958526.png,https://derpicdn.net/img/view/2019/2/10/1958526.png,0,0.9997796416282654,555,0,799,217,244,217,applejack|fluttershy|mane six|pinkie pie|rainbow dash|rarity|twilight sparkle,云观雾里
1958526.png,https://derpicdn.net/img/view/2019/2/10/1958526.png,1,0.9924324154853821,10,236,246,472,236,236,applejack|fluttershy|mane six|pinkie pie|rainbow dash|rarity|twilight sparkle,云观雾里
1958526.png,https://derpicdn.net/img/view/2019/2/10/1958526.png,2,0.9245383143424988,592,394,800,602,208,208,applejack|fluttershy|mane six|pinkie pie|rainbow dash|rarity|twilight sparkle,云观雾里
1962108.png,https://derpicdn.net/img/view/2019/2/14/1962108.png,0,0.9795827865600586,1291,1964,1701,2374,410,410,applejack|fluttershy|mane six|pinkie pie|rainbow dash|rarity|spike|twilight sparkle,28gooddays
1964919.png,https://derpicdn.net/img/view/2019/2/18/1964919.png,0,0.939731240272522,234,153,622,541,388,388,rarity|twilight sparkle,its-gloomy
1965424.png,https://derpicdn.net/img/view/2019/2/18/1965424.png,0,0.9375483393669128,17,0,497,459,480,459,spike|twilight sparkle,
1965430.png,https://derpicdn.net/img/view/2019/2/18/1965430.png,0,0.9848281145095824,45,29,349,333,304,304,spike|twilight sparkle,
1965524.png,https://derpicdn.net/img/view/2019/2/18/1965524.png,1,0.9881736636161804,143,217,4891,4965,4748,4748,sunset shimmer|twilight sparkle,famousmari5
1966246.png,https://derpicdn.net/img/view/2019/2/19/1966246.png,0,0.983403742313385,4,0,892,729,888,729,pinkie pie|starlight glimmer|twilight sparkle,
1966776.png,https://derpicdn.net/img/view/2019/2/20/1966776.png,1,0.9984095096588136,2409,166,3681,1438,1272,1272,starlight glimmer|sunset shimmer|trixie|twilight sparkle,kiwiscribbles
1966784.png,https://derpicdn.net/img/view/2019/2/20/1966784.png,0,0.9272962808609008,932,32,1560,660,628,628,pinkie pie|twilight sparkle,
1968838.png,https://derpicdn.net/img/view/2019/2/22/1968838.png,0,0.9989868998527528,1611,178,2923,1490,1312,1312,spike|starlight glimmer|sunset shimmer|trixie|twilight sparkle,kiwiscribbles
1972888.png,https://derpicdn.net/img/view/2019/2/27/1972888.png,0,0.98115074634552,2208,1063,3644,2499,1436,1436,applejack|fluttershy|pinkie pie|rainbow dash|rarity|sunset shimmer|twilight sparkle,pencil bolt
1972888.png,https://derpicdn.net/img/view/2019/2/27/1972888.png,1,0.961231768131256,1475,2221,2911,3657,1436,1436,applejack|fluttershy|pinkie pie|rainbow dash|rarity|sunset shimmer|twilight sparkle,pencil bolt
1976206.png,https://derpicdn.net/img/view/2019/3/3/1976206.png,0,0.9003087878227234,32,0,266,224,234,224,princess celestia|twilight sparkle,akeahi
1977630.png,https://derpicdn.net/img/view/2019/3/4/1977630.png,0,0.9895777702331544,1217,446,1775,1004,558,558,spike|twilight sparkle,percy-mcmurphy
1977845.png,https://derpicdn.net/img/view/2019/3/5/1977845.png,0,0.9751802682876588,165,31,781,647,616,616,rainbow dash|twilight sparkle,wanderingpegasus
1980135.png,https://derpicdn.net/img/view/2019/3/8/1980135.png,0,0.9900798201560974,145,0,819,680,674,680,rainbow dash|twilight sparkle,
1980464.png,https://derpicdn.net/img/view/2019/3/8/1980464.png,0,0.9923628568649292,324,79,646,401,322,322,pinkie pie|rainbow dash|twilight sparkle,wanderingpegasus
1983832.png,https://derpicdn.net/img/view/2019/3/12/1983832.png,0,0.9954553246498108,101,0,646,543,545,543,applejack|pinkie pie|twilight sparkle,
1984567.png,https://derpicdn.net/img/view/2019/3/13/1984567.png,0,0.9251480698585508,292,0,4236,2981,3944,2981,rainbow dash|twilight sparkle,mundschenk85
1990022.png,https://derpicdn.net/img/view/2019/3/19/1990022.png,0,0.998703956604004,471,0,747,229,276,229,applejack|fluttershy|mane six|pinkie pie|rainbow dash|rarity|starlight glimmer|sunset shimmer|twilight sparkle,empyu
1990022.png,https://derpicdn.net/img/view/2019/3/19/1990022.png,1,0.9952828288078308,769,435,1029,695,260,260,applejack|fluttershy|mane six|pinkie pie|rainbow dash|rarity|starlight glimmer|sunset shimmer|twilight sparkle,empyu
1990022.png,https://derpicdn.net/img/view/2019/3/19/1990022.png,3,0.9916847348213196,237,113,481,357,244,244,applejack|fluttershy|mane six|pinkie pie|rainbow dash|rarity|starlight glimmer|sunset shimmer|twilight sparkle,empyu
1990022.png,https://derpicdn.net/img/view/2019/3/19/1990022.png,4,0.9875330328941344,488,149,730,391,242,242,applejack|fluttershy|mane six|pinkie pie|rainbow dash|rarity|starlight glimmer|sunset shimmer|twilight sparkle,empyu
1990022.png,https://derpicdn.net/img/view/2019/3/19/1990022.png,5,0.9753244519233704,224,380,486,642,262,262,applejack|fluttershy|mane six|pinkie pie|rainbow dash|rarity|starlight glimmer|sunset shimmer|twilight sparkle,empyu
1990022.png,https://derpicdn.net/img/view/2019/3/19/1990022.png,6,0.939473032951355,397,400,677,680,280,280,applejack|fluttershy|mane six|pinkie pie|rainbow dash|rarity|starlight glimmer|sunset shimmer|twilight sparkle,empyu
1992992.png,https://derpicdn.net/img/view/2019/3/23/1992992.png,1,0.9939234852790833,209,110,937,838,728,728,pinkie pie|rainbow dash|twilight sparkle,eeelt
1992992.png,https://derpicdn.net/img/view/2019/3/23/1992992.png,2,0.9413493871688844,1204,290,1896,982,692,692,pinkie pie|rainbow dash|twilight sparkle,eeelt
1993506.png,https://derpicdn.net/img/view/2019/3/24/1993506.png,0,0.9901914596557616,848,0,2572,1672,1724,1672,sunset shimmer|twilight sparkle,malachitebases|winter-scarf
1994560.png,https://derpicdn.net/img/view/2019/3/25/1994560.png,0,0.9908871054649352,2341,507,2985,1151,644,644,princess cadance|princess celestia|princess luna|twilight sparkle,wilt|amelia-bases
1995824.png,https://derpicdn.net/img/view/2019/3/27/1995824.png,0,0.9912081956863404,0,2,421,450,421,448,applejack|twilight sparkle,
1995958.png,https://derpicdn.net/img/view/2019/3/27/1995958.png,1,0.9588120579719543,2528,0,3840,1069,1312,1069,applejack|fluttershy|mane six|pinkie pie|rainbow dash|rarity|twilight sparkle,apexpredator923
1999966.png,https://derpicdn.net/img/view/2019/4/1/1999966.png,0,0.9870291352272034,1453,250,1831,628,378,378,rainbow dash|sunset shimmer|twilight sparkle,
1999977.png,https://derpicdn.net/img/view/2019/4/1/1999977.png,0,0.974862813949585,400,134,856,590,456,456,big macintosh|rainbow dash|sunset shimmer|twilight sparkle,
1999998.png,https://derpicdn.net/img/view/2019/4/1/1999998.png,0,0.984783947467804,1554,467,1920,847,366,380,pinkie pie|rainbow dash|sunset shimmer|twilight sparkle,
2000597.png,https://derpicdn.net/img/view/2019/4/2/2000597.png,1,0.9968199729919434,906,452,1254,800,348,348,applejack|fluttershy|mane six|pinkie pie|rainbow dash|rarity|twilight sparkle,sgtscribbles
2000597.png,https://derpicdn.net/img/view/2019/4/2/2000597.png,3,0.9877113699913024,13,0,427,347,414,347,applejack|fluttershy|mane six|pinkie pie|rainbow dash|rarity|twilight sparkle,sgtscribbles
2000597.png,https://derpicdn.net/img/view/2019/4/2/2000597.png,4,0.9523881077766418,0,425,383,825,383,400,applejack|fluttershy|mane six|pinkie pie|rainbow dash|rarity|twilight sparkle,sgtscribbles
2001846.png,https://derpicdn.net/img/view/2019/4/3/2001846.png,0,0.9965772032737732,67,5,515,453,448,448,rainbow dash|twilight sparkle,
2003149.png,https://derpicdn.net/img/view/2019/4/5/2003149.png,0,0.9843525886535645,788,54,1218,484,430,430,applejack|fluttershy|mane six|pinkie pie|rainbow dash|rarity|twilight sparkle,sweets-and-giggles
2003886.png,https://derpicdn.net/img/view/2019/4/5/2003886.png,0,0.9674867987632751,603,104,1295,796,692,692,applejack|fluttershy|mane six|pinkie pie|rainbow dash|rarity|twilight sparkle,flysouldragon
2005501.png,https://derpicdn.net/img/view/2019/4/7/2005501.png,0,0.9605657458305359,215,55,623,463,408,408,starlight glimmer|twilight sparkle,starstation
2009885.png,https://derpicdn.net/img/view/2019/4/12/2009885.png,0,0.990523397922516,535,0,819,257,284,257,fluttershy|pinkie pie|rainbow dash|twilight sparkle,musicfirewind
2009885.png,https://derpicdn.net/img/view/2019/4/12/2009885.png,1,0.9755495190620422,49,422,331,704,282,282,fluttershy|pinkie pie|rainbow dash|twilight sparkle,musicfirewind
2015185.png,https://derpicdn.net/img/view/2019/4/17/2015185.png,0,0.9388503432273864,3830,1419,5414,3003,1584,1584,applejack|fluttershy|mane six|pinkie pie|rainbow dash|rarity|twilight sparkle,greenbrothersart
2015185.png,https://derpicdn.net/img/view/2019/4/17/2015185.png,1,0.932830810546875,0,0,1222,1536,1222,1536,applejack|fluttershy|mane six|pinkie pie|rainbow dash|rarity|twilight sparkle,greenbrothersart
2016297.png,https://derpicdn.net/img/view/2019/4/19/2016297.png,0,0.9732168316841124,1007,641,1613,1247,606,606,applejack|fluttershy|mane six|pinkie pie|rainbow dash|rarity|spike|twilight sparkle,banquo0
2016297.png,https://derpicdn.net/img/view/2019/4/19/2016297.png,1,0.9652617573738098,1534,795,2154,1415,620,620,applejack|fluttershy|mane six|pinkie pie|rainbow dash|rarity|spike|twilight sparkle,banquo0
2016864.png,https://derpicdn.net/img/view/2019/4/19/2016864.png,1,0.9047558903694152,2472,722,3186,1436,714,714,applejack|fluttershy|mane six|pinkie pie|rainbow dash|rarity|twilight sparkle,wintah33
2026270.png,https://derpicdn.net/img/view/2019/4/29/2026270.png,0,0.9897601008415222,0,54,857,948,857,894,spike|twilight sparkle,
2028536.png,https://derpicdn.net/img/view/2019/5/1/2028536.png,1,0.9858240485191344,198,1,628,431,430,430,spike|twilight sparkle,glitterstar2000
2032823.png,https://derpicdn.net/img/view/2019/5/6/2032823.png,0,0.9788908362388612,3057,583,4713,2239,1656,1656,spike|twilight sparkle,aleximusprime|disneymarvel96
2033929.png,https://derpicdn.net/img/view/2019/5/8/2033929.png,0,0.9961550831794742,545,296,1067,818,522,522,applejack|fluttershy|mane six|pinkie pie|rainbow dash|rarity|twilight sparkle,chopsticks
2033929.png,https://derpicdn.net/img/view/2019/5/8/2033929.png,1,0.9855181574821472,3051,301,3583,833,532,532,applejack|fluttershy|mane six|pinkie pie|rainbow dash|rarity|twilight sparkle,chopsticks
2033929.png,https://derpicdn.net/img/view/2019/5/8/2033929.png,2,0.9786956906318665,1034,393,1604,963,570,570,applejack|fluttershy|mane six|pinkie pie|rainbow dash|rarity|twilight sparkle,chopsticks
2033929.png,https://derpicdn.net/img/view/2019/5/8/2033929.png,5,0.9361790418624878,1811,502,2369,1060,558,558,applejack|fluttershy|mane six|pinkie pie|rainbow dash|rarity|twilight sparkle,chopsticks
2043066.png,https://derpicdn.net/img/view/2019/5/19/2043066.png,0,0.9665672183036804,0,0,616,618,616,618,fluttershy|rainbow dash|twilight sparkle,
2047103.png,https://derpicdn.net/img/view/2019/5/23/2047103.png,0,0.9991843104362488,533,569,1003,1039,470,470,princess cadance|princess celestia|princess luna|twilight sparkle,envygirl95
2047103.png,https://derpicdn.net/img/view/2019/5/23/2047103.png,1,0.9958134293556212,1003,430,1483,910,480,480,princess cadance|princess celestia|princess luna|twilight sparkle,envygirl95
2047103.png,https://derpicdn.net/img/view/2019/5/23/2047103.png,2,0.9893829822540284,21,6,653,638,632,632,princess cadance|princess celestia|princess luna|twilight sparkle,envygirl95
2047103.png,https://derpicdn.net/img/view/2019/5/23/2047103.png,3,0.9682600498199464,1437,0,1901,462,464,462,princess cadance|princess celestia|princess luna|twilight sparkle,envygirl95
2049734.png,https://derpicdn.net/img/view/2019/5/26/2049734.png,0,0.9989205002784728,1008,0,2712,1464,1704,1464,pinkie pie|twilight sparkle,shutterflyyay
2053602.png,https://derpicdn.net/img/view/2019/5/30/2053602.png,0,0.95442134141922,1093,347,1453,707,360,360,princess cadance|princess celestia|princess flurry heart|princess luna|twilight sparkle,iheyyasyfox
2053602.png,https://derpicdn.net/img/view/2019/5/30/2053602.png,1,0.9429861307144164,549,396,979,826,430,430,princess cadance|princess celestia|princess flurry heart|princess luna|twilight sparkle,iheyyasyfox
2068618.png,https://derpicdn.net/img/view/2019/6/18/2068618.png,0,0.95065838098526,0,1478,1131,2762,1131,1284,applejack|fluttershy|mane six|pinkie pie|rainbow dash|rarity|starlight glimmer|trixie|twilight sparkle,evilfrenzy
2071878.png,https://derpicdn.net/img/view/2019/6/22/2071878.png,0,0.9314807057380676,65,0,1637,1080,1572,1080,applejack|fluttershy|rainbow dash|rarity|spike|twilight sparkle,brutalweather studio
2073183.png,https://derpicdn.net/img/view/2019/6/23/2073183.png,0,0.9821687340736388,28,0,602,473,574,473,applejack|fluttershy|princess celestia|rainbow dash|spike|twilight sparkle,
2074922.png,https://derpicdn.net/img/view/2019/6/25/2074922.png,0,0.9858443737030028,179,0,1653,1422,1474,1422,rainbow dash|twilight sparkle,fensu-san
2076304.png,https://derpicdn.net/img/view/2019/6/27/2076304.png,0,0.9806416034698486,273,26,1268,940,995,914,spike|twilight sparkle,
2077659.png,https://derpicdn.net/img/view/2019/6/28/2077659.png,0,0.991809606552124,0,0,671,747,671,747,starlight glimmer|twilight sparkle,
2078378.png,https://derpicdn.net/img/view/2019/6/29/2078378.png,0,0.9906916618347168,12,0,168,188,156,188,applejack|fluttershy|rainbow dash|twilight sparkle,
2078378.png,https://derpicdn.net/img/view/2019/6/29/2078378.png,1,0.948065459728241,0,0,162,198,162,198,applejack|fluttershy|rainbow dash|twilight sparkle,
2078577.png,https://derpicdn.net/img/view/2019/6/29/2078577.png,0,0.9835594892501832,4630,165,5202,737,572,572,applejack|fluttershy|mane six|pinkie pie|rainbow dash|rarity|twilight sparkle,darlyjay
2083434.png,https://derpicdn.net/img/view/2019/7/5/2083434.png,0,0.9984014630317688,0,117,517,689,517,572,rarity|spike|twilight sparkle,xeviousgreenii
2083434.png,https://derpicdn.net/img/view/2019/7/5/2083434.png,1,0.9941053986549376,1259,1481,2249,2471,990,990,rarity|spike|twilight sparkle,xeviousgreenii
2083434.png,https://derpicdn.net/img/view/2019/7/5/2083434.png,2,0.9641492366790771,541,70,1055,584,514,514,rarity|spike|twilight sparkle,xeviousgreenii
2083546.png,https://derpicdn.net/img/view/2019/7/5/2083546.png,1,0.9722699522972108,765,0,1920,953,1155,953,sunset shimmer|twilight sparkle,
2085915.png,https://derpicdn.net/img/view/2019/7/8/2085915.png,0,0.9990729689598083,913,123,2457,1667,1544,1544,pinkie pie|twilight sparkle,dragoon32|majo32
2086874.png,https://derpicdn.net/img/view/2019/7/9/2086874.png,0,0.905093252658844,551,137,777,363,226,226,applejack|fluttershy|mane six|pinkie pie|rainbow dash|rarity|spike|twilight sparkle,porygon2z
2097008.png,https://derpicdn.net/img/view/2019/7/20/2097008.png,0,0.9722609519958496,60,297,398,635,338,338,applejack|fluttershy|mane six|pinkie pie|rainbow dash|rarity|twilight sparkle,santamouse23
2097008.png,https://derpicdn.net/img/view/2019/7/20/2097008.png,1,0.9706933498382568,141,8,401,268,260,260,applejack|fluttershy|mane six|pinkie pie|rainbow dash|rarity|twilight sparkle,santamouse23
2097008.png,https://derpicdn.net/img/view/2019/7/20/2097008.png,3,0.9222519993782043,153,691,563,1101,410,410,applejack|fluttershy|mane six|pinkie pie|rainbow dash|rarity|twilight sparkle,santamouse23
2097124.png,https://derpicdn.net/img/view/2019/7/20/2097124.png,0,0.942442774772644,0,32,341,448,341,416,pinkie pie|twilight sparkle,
2097754.png,https://derpicdn.net/img/view/2019/7/21/2097754.png,0,0.9277513027191162,574,138,834,398,260,260,starlight glimmer|twilight sparkle,agrol
2097847.png,https://derpicdn.net/img/view/2019/7/21/2097847.png,0,0.9832354187965392,367,152,699,484,332,332,starlight glimmer|twilight sparkle,agrol
2098457.png,https://derpicdn.net/img/view/2019/7/22/2098457.png,0,0.9974716305732728,644,0,1064,336,420,336,princess cadance|princess celestia|princess luna|sunset shimmer|twilight sparkle,jamescorck
2101618.png,https://derpicdn.net/img/view/2019/7/26/2101618.png,0,0.9896590113639832,287,0,1601,1205,1314,1205,rainbow dash|twilight sparkle,sheeppony
2104475.png,https://derpicdn.net/img/view/2019/7/30/2104475.png,0,0.9892880320549012,117,581,551,1015,434,434,rainbow dash|twilight sparkle,stuwor-art|stupid works-stuwor
2104475.png,https://derpicdn.net/img/view/2019/7/30/2104475.png,1,0.9873738288879396,475,62,953,540,478,478,rainbow dash|twilight sparkle,stuwor-art|stupid works-stuwor
2104609.png,https://derpicdn.net/img/view/2019/7/30/2104609.png,1,0.9718055129051208,38,0,194,151,156,151,apple bloom|applejack|fluttershy|mane six|pinkie pie|rainbow dash|rarity|scootaloo|sweetie belle|twilight sparkle,flash equestria photography
2104609.png,https://derpicdn.net/img/view/2019/7/30/2104609.png,2,0.915879487991333,840,5,996,161,156,156,apple bloom|applejack|fluttershy|mane six|pinkie pie|rainbow dash|rarity|scootaloo|sweetie belle|twilight sparkle,flash equestria photography
2108387.png,https://derpicdn.net/img/view/2019/8/3/2108387.png,0,0.9992758631706238,994,167,1590,763,596,596,applejack|fluttershy|mane six|pinkie pie|rainbow dash|rarity|twilight sparkle,wintah33
2108387.png,https://derpicdn.net/img/view/2019/8/3/2108387.png,1,0.995305597782135,2187,828,2779,1420,592,592,applejack|fluttershy|mane six|pinkie pie|rainbow dash|rarity|twilight sparkle,wintah33
2116220.png,https://derpicdn.net/img/view/2019/8/12/2116220.png,0,0.9329481720924376,0,0,611,633,611,633,pinkie pie|twilight sparkle,
2116571.png,https://derpicdn.net/img/view/2019/8/12/2116571.png,1,0.9917735457420348,412,425,810,823,398,398,rainbow dash|twilight sparkle,stuwor-art|stupid works-stuwor
2124460.png,https://derpicdn.net/img/view/2019/8/22/2124460.png,0,0.979972004890442,2217,1067,3087,1937,870,870,applejack|fluttershy|mane six|pinkie pie|rainbow dash|rarity|twilight sparkle,
2129072.png,https://derpicdn.net/img/view/2019/8/27/2129072.png,2,0.9839575290679932,704,312,962,570,258,258,applejack|fluttershy|mane six|pinkie pie|rainbow dash|rarity|twilight sparkle,eve-of-halloween|lui-akita
2134287.png,https://derpicdn.net/img/view/2019/9/2/2134287.png,0,0.9666450023651124,918,620,1280,982,362,362,applejack|pinkie pie|rainbow dash|rarity|starlight glimmer|twilight sparkle,soulcentinel
2140900.png,https://derpicdn.net/img/view/2019/9/10/2140900.png,0,0.9119654893875122,1230,151,1622,543,392,392,applejack|fluttershy|mane six|pinkie pie|rainbow dash|rarity|spike|twilight sparkle,
2141052.png,https://derpicdn.net/img/view/2019/9/10/2141052.png,0,0.9991936087608336,958,21,1874,937,916,916,rarity|twilight sparkle,leslers
2141052.png,https://derpicdn.net/img/view/2019/9/10/2141052.png,1,0.982712745666504,97,39,1065,1007,968,968,rarity|twilight sparkle,leslers
2142481.png,https://derpicdn.net/img/view/2019/9/12/2142481.png,0,0.993926167488098,376,39,770,433,394,394,applejack|twilight sparkle,occultusion
2144503.png,https://derpicdn.net/img/view/2019/9/15/2144503.png,0,0.9907796382904052,0,0,576,552,576,552,rarity|twilight sparkle,
2145560.png,https://derpicdn.net/img/view/2019/9/16/2145560.png,0,0.9850350618362428,26,0,434,400,408,400,spike|starlight glimmer|twilight sparkle,
2146481.png,https://derpicdn.net/img/view/2019/9/17/2146481.png,0,0.9917038083076476,183,272,629,718,446,446,apple bloom|rarity|scootaloo|spike|sweetie belle|twilight sparkle,andromedasparkz
2146895.png,https://derpicdn.net/img/view/2019/9/18/2146895.png,0,0.9832723736763,582,330,780,528,198,198,applejack|fluttershy|mane six|pinkie pie|rainbow dash|rarity|twilight sparkle,winxflorabloomroxy
2146895.png,https://derpicdn.net/img/view/2019/9/18/2146895.png,2,0.9240983128547668,103,0,315,209,212,209,applejack|fluttershy|mane six|pinkie pie|rainbow dash|rarity|twilight sparkle,winxflorabloomroxy
2148078.png,https://derpicdn.net/img/view/2019/9/19/2148078.png,0,0.9433197379112244,296,221,442,367,146,146,applejack|fluttershy|mane six|pinkie pie|rainbow dash|rarity|spike|twilight sparkle,
2151133.png,https://derpicdn.net/img/view/2019/9/23/2151133.png,0,0.99154394865036,0,0,1599,1517,1599,1517,applejack|twilight sparkle,fensu-san
2151673.png,https://derpicdn.net/img/view/2019/9/24/2151673.png,0,0.99714332818985,67,111,371,415,304,304,rarity|twilight sparkle,cyan-six
21587.jpg,https://derpicdn.net/img/view/2012/6/26/21587.jpg,0,0.9977220296859741,1324,543,1968,1187,644,644,applejack|fluttershy|mane six|pinkie pie|rainbow dash|rarity|twilight sparkle,kittiara
2158830.png,https://derpicdn.net/img/view/2019/10/3/2158830.png,0,0.9836964607238772,452,0,1136,662,684,662,applejack|fluttershy|mane six|pinkie pie|rainbow dash|rarity|spike|twilight sparkle,
2160298.png,https://derpicdn.net/img/view/2019/10/4/2160298.png,0,0.9770659804344176,133,0,661,469,528,469,spike|twilight sparkle,dm29
2161125.png,https://derpicdn.net/img/view/2019/10/5/2161125.png,0,0.9980667233467102,4379,1051,5789,2461,1410,1410,applejack|fluttershy|mane six|pinkie pie|rainbow dash|rarity|starlight glimmer|twilight sparkle,mrkat7214
2164980.png,https://derpicdn.net/img/view/2019/10/10/2164980.png,0,0.954748809337616,960,1881,1474,2395,514,514,princess cadance|twilight sparkle,livitoza
2165317.png,https://derpicdn.net/img/view/2019/10/11/2165317.png,1,0.9724527597427368,813,816,1379,1382,566,566,applejack|fluttershy|mane six|pinkie pie|rainbow dash|rarity|twilight sparkle,melodiousmarci
2165317.png,https://derpicdn.net/img/view/2019/10/11/2165317.png,2,0.9458654522895812,1305,643,2137,1475,832,832,applejack|fluttershy|mane six|pinkie pie|rainbow dash|rarity|twilight sparkle,melodiousmarci
2166549.png,https://derpicdn.net/img/view/2019/10/12/2166549.png,0,0.9878934025764464,149,1629,529,2009,380,380,applejack|fluttershy|mane six|pinkie pie|rainbow dash|rarity|twilight sparkle,silentwolf-oficial
2166549.png,https://derpicdn.net/img/view/2019/10/12/2166549.png,1,0.9818289279937744,54,28,466,440,412,412,applejack|fluttershy|mane six|pinkie pie|rainbow dash|rarity|twilight sparkle,silentwolf-oficial
2166549.png,https://derpicdn.net/img/view/2019/10/12/2166549.png,2,0.956561803817749,27,1045,419,1437,392,392,applejack|fluttershy|mane six|pinkie pie|rainbow dash|rarity|twilight sparkle,silentwolf-oficial
2166549.png,https://derpicdn.net/img/view/2019/10/12/2166549.png,3,0.9162417054176332,537,1144,903,1510,366,366,applejack|fluttershy|mane six|pinkie pie|rainbow dash|rarity|twilight sparkle,silentwolf-oficial
2167147.png,https://derpicdn.net/img/view/2019/10/13/2167147.png,0,0.9005789756774902,133,680,265,812,132,132,applejack|fluttershy|mane six|pinkie pie|rainbow dash|rarity|spike|twilight sparkle,
2167632.png,https://derpicdn.net/img/view/2019/10/13/2167632.png,0,0.959933876991272,60,0,952,775,892,775,fluttershy|rainbow dash|twilight sparkle,
2167658.png,https://derpicdn.net/img/view/2019/10/13/2167658.png,0,0.9124419689178468,1425,464,1807,846,382,382,applejack|fluttershy|mane six|pinkie pie|rainbow dash|rarity|twilight sparkle,
2167658.png,https://derpicdn.net/img/view/2019/10/13/2167658.png,1,0.9075109362602234,1730,570,2088,928,358,358,applejack|fluttershy|mane six|pinkie pie|rainbow dash|rarity|twilight sparkle,
2168021.png,https://derpicdn.net/img/view/2019/10/13/2168021.png,0,0.9969689846038818,0,136,430,592,430,456,applejack|fluttershy|mane six|pinkie pie|rainbow dash|rarity|twilight sparkle,kingkero
2168021.png,https://derpicdn.net/img/view/2019/10/13/2168021.png,2,0.9782979488372804,423,216,707,500,284,284,applejack|fluttershy|mane six|pinkie pie|rainbow dash|rarity|twilight sparkle,kingkero
2168021.png,https://derpicdn.net/img/view/2019/10/13/2168021.png,3,0.9745197892189026,700,742,940,982,240,240,applejack|fluttershy|mane six|pinkie pie|rainbow dash|rarity|twilight sparkle,kingkero
2168021.png,https://derpicdn.net/img/view/2019/10/13/2168021.png,4,0.9666399955749512,785,560,995,770,210,210,applejack|fluttershy|mane six|pinkie pie|rainbow dash|rarity|twilight sparkle,kingkero
2169339.png,https://derpicdn.net/img/view/2019/10/15/2169339.png,0,0.9945743083953856,1136,1537,1602,2003,466,466,applejack|fluttershy|mane six|pinkie pie|rainbow dash|rarity|twilight sparkle,threetwotwo32232
2170244.png,https://derpicdn.net/img/view/2019/10/16/2170244.png,0,0.949869692325592,1,32,709,740,708,708,rainbow dash|twilight sparkle,
2170673.png,https://derpicdn.net/img/view/2019/10/16/2170673.png,0,0.9985081553459167,151,210,417,476,266,266,shining armor|twilight sparkle,shieldgenerator7
2171933.png,https://derpicdn.net/img/view/2019/10/17/2171933.png,0,0.9505178332328796,1031,0,1669,532,638,532,rarity|twilight sparkle,
2174333.png,https://derpicdn.net/img/view/2019/10/20/2174333.png,0,0.9730544090270996,144,664,906,1426,762,762,applejack|fluttershy|mane six|pinkie pie|rainbow dash|rarity|twilight sparkle,freasaloz
2174333.png,https://derpicdn.net/img/view/2019/10/20/2174333.png,2,0.95892596244812,984,708,1678,1402,694,694,applejack|fluttershy|mane six|pinkie pie|rainbow dash|rarity|twilight sparkle,freasaloz
2175270.png,https://derpicdn.net/img/view/2019/10/21/2175270.png,0,0.9538428783416748,507,0,1141,498,634,498,applejack|fluttershy|pinkie pie|rainbow dash|rarity|twilight sparkle,spinostud
2175989.png,https://derpicdn.net/img/view/2019/10/22/2175989.png,0,0.9493754506111144,374,0,836,375,462,375,applejack|fluttershy|mane six|pinkie pie|rainbow dash|rarity|spike|twilight sparkle,zsnowfilez
2175989.png,https://derpicdn.net/img/view/2019/10/22/2175989.png,1,0.916167676448822,130,0,374,236,244,236,applejack|fluttershy|mane six|pinkie pie|rainbow dash|rarity|spike|twilight sparkle,zsnowfilez
2176178.png,https://derpicdn.net/img/view/2019/10/22/2176178.png,0,0.9851446747779846,0,38,535,606,535,568,princess celestia|princess luna|twilight sparkle,
2177053.png,https://derpicdn.net/img/view/2019/10/23/2177053.png,3,0.9717397093772888,3507,241,4049,783,542,542,applejack|fluttershy|mane six|pinkie pie|rainbow dash|rarity|twilight sparkle,gurepinku
2177053.png,https://derpicdn.net/img/view/2019/10/23/2177053.png,4,0.9538472890853882,19,192,597,770,578,578,applejack|fluttershy|mane six|pinkie pie|rainbow dash|rarity|twilight sparkle,gurepinku
2177053.png,https://derpicdn.net/img/view/2019/10/23/2177053.png,5,0.92073255777359,1341,316,1949,924,608,608,applejack|fluttershy|mane six|pinkie pie|rainbow dash|rarity|twilight sparkle,gurepinku
2177833.png,https://derpicdn.net/img/view/2019/10/24/2177833.png,0,0.9559139609336852,275,31,737,493,462,462,rarity|twilight sparkle,rwl
2177972.png,https://derpicdn.net/img/view/2019/10/24/2177972.png,0,0.9489151239395142,0,8,574,726,574,718,spike|twilight sparkle,
2178045.png,https://derpicdn.net/img/view/2019/10/24/2178045.png,0,0.9942374229431152,164,0,850,549,686,549,princess celestia|princess luna|spike|twilight sparkle,candyclumsy
2178275.png,https://derpicdn.net/img/view/2019/10/25/2178275.png,0,0.9878339171409608,1305,293,1583,571,278,278,applejack|fluttershy|pinkie pie|rainbow dash|rarity|spike|twilight sparkle,flying pancake
2178275.png,https://derpicdn.net/img/view/2019/10/25/2178275.png,1,0.9597051739692688,534,193,926,585,392,392,applejack|fluttershy|pinkie pie|rainbow dash|rarity|spike|twilight sparkle,flying pancake
2179431.png,https://derpicdn.net/img/view/2019/10/26/2179431.png,0,0.9374650120735168,407,0,1275,829,868,829,trixie|twilight sparkle,pshyzomancer
2180541.png,https://derpicdn.net/img/view/2019/10/27/2180541.png,0,0.9998078942298888,841,512,1175,846,334,334,discord|fluttershy|twilight sparkle,doodling-is-magic
2180541.png,https://derpicdn.net/img/view/2019/10/27/2180541.png,1,0.9984366893768308,573,605,865,897,292,292,discord|fluttershy|twilight sparkle,doodling-is-magic
2182286.png,https://derpicdn.net/img/view/2019/10/29/2182286.png,0,0.9968967437744141,961,245,2048,1391,1087,1146,sunset shimmer|twilight sparkle,n3ro 182
2182286.png,https://derpicdn.net/img/view/2019/10/29/2182286.png,1,0.9961357712745668,22,257,990,1225,968,968,sunset shimmer|twilight sparkle,n3ro 182
2182842.png,https://derpicdn.net/img/view/2019/10/30/2182842.png,0,0.9153342843055724,1429,8,1873,452,444,444,applejack|fluttershy|mane six|pinkie pie|rainbow dash|rarity|spike|twilight sparkle,
2183376.png,https://derpicdn.net/img/view/2019/10/31/2183376.png,0,0.9843425154685974,2329,1984,3023,2678,694,694,applejack|fluttershy|mane six|pinkie pie|rainbow dash|rarity|spike|starlight glimmer|sunset shimmer|twilight sparkle,geraritydevillefort
2183376.png,https://derpicdn.net/img/view/2019/10/31/2183376.png,1,0.9775961637496948,1680,1349,2356,2025,676,676,applejack|fluttershy|mane six|pinkie pie|rainbow dash|rarity|spike|starlight glimmer|sunset shimmer|twilight sparkle,geraritydevillefort
2183376.png,https://derpicdn.net/img/view/2019/10/31/2183376.png,2,0.9175127148628236,1520,22,2422,924,902,902,applejack|fluttershy|mane six|pinkie pie|rainbow dash|rarity|spike|starlight glimmer|sunset shimmer|twilight sparkle,geraritydevillefort
2183684.png,https://derpicdn.net/img/view/2019/10/31/2183684.png,0,0.974196434020996,128,0,1300,1157,1172,1157,starlight glimmer|trixie|twilight sparkle,0okami-0ni
2183684.png,https://derpicdn.net/img/view/2019/10/31/2183684.png,1,0.9646859169006348,849,0,2089,1069,1240,1069,starlight glimmer|trixie|twilight sparkle,0okami-0ni
2183684.png,https://derpicdn.net/img/view/2019/10/31/2183684.png,2,0.9596003293991088,1655,0,2927,1202,1272,1202,starlight glimmer|trixie|twilight sparkle,0okami-0ni
2183908.png,https://derpicdn.net/img/view/2019/10/31/2183908.png,2,0.9931089878082277,102,1718,1506,3122,1404,1404,applejack|fluttershy|mane six|pinkie pie|rainbow dash|rarity|twilight sparkle,thebeckmanator
2183908.png,https://derpicdn.net/img/view/2019/10/31/2183908.png,3,0.9592958092689514,3085,105,4153,1173,1068,1068,applejack|fluttershy|mane six|pinkie pie|rainbow dash|rarity|twilight sparkle,thebeckmanator
2183972.png,https://derpicdn.net/img/view/2019/10/31/2183972.png,0,0.9495627284049988,391,395,597,601,206,206,applejack|fluttershy|mane six|pinkie pie|rainbow dash|rarity|twilight sparkle,mamath
2184034.png,https://derpicdn.net/img/view/2019/10/31/2184034.png,0,0.9534288048744202,301,82,749,530,448,448,fluttershy|pinkie pie|twilight sparkle,softyshy
2185013.png,https://derpicdn.net/img/view/2019/11/1/2185013.png,0,0.9717056155204772,330,109,608,387,278,278,princess celestia|princess luna|twilight sparkle,
2185026.png,https://derpicdn.net/img/view/2019/11/1/2185026.png,0,0.9763951897621156,67,0,597,511,530,511,princess celestia|princess luna|twilight sparkle,
2185027.png,https://derpicdn.net/img/view/2019/11/1/2185027.png,0,0.958243489265442,81,0,649,539,568,539,princess celestia|princess luna|twilight sparkle,
2187504.png,https://derpicdn.net/img/view/2019/11/4/2187504.png,0,0.9757705926895142,634,562,908,836,274,274,applejack|braeburn|starlight glimmer|twilight sparkle,soulcentinel
2187504.png,https://derpicdn.net/img/view/2019/11/4/2187504.png,1,0.9692122340202332,1088,510,1520,942,432,432,applejack|braeburn|starlight glimmer|twilight sparkle,soulcentinel
2187504.png,https://derpicdn.net/img/view/2019/11/4/2187504.png,2,0.951740026473999,808,268,1160,620,352,352,applejack|braeburn|starlight glimmer|twilight sparkle,soulcentinel
2187504.png,https://derpicdn.net/img/view/2019/11/4/2187504.png,3,0.914793848991394,262,249,760,747,498,498,applejack|braeburn|starlight glimmer|twilight sparkle,soulcentinel
2188101.png,https://derpicdn.net/img/view/2019/11/5/2188101.png,0,0.9831526279449464,295,0,467,131,172,131,spike|twilight sparkle,livitoza
2188311.png,https://derpicdn.net/img/view/2019/11/5/2188311.png,0,0.978814959526062,169,12,545,388,376,376,pinkie pie|rarity|spike|twilight sparkle,
2188314.png,https://derpicdn.net/img/view/2019/11/5/2188314.png,0,0.9414346218109132,169,31,549,411,380,380,pinkie pie|rarity|spike|twilight sparkle,
2196507.png,https://derpicdn.net/img/view/2019/11/15/2196507.png,0,0.9774667620658876,255,168,401,314,146,146,applejack|fluttershy|mane six|pinkie pie|rainbow dash|rarity|spike|twilight sparkle,
2200571.png,https://derpicdn.net/img/view/2019/11/20/2200571.png,0,0.9987591505050659,8767,2896,12903,7032,4136,4136,applejack|fluttershy|mane six|pinkie pie|rainbow dash|rarity|twilight sparkle,squeemishness
2209814.png,https://derpicdn.net/img/view/2019/12/1/2209814.png,0,0.9980519413948059,150,0,402,238,252,238,pinkie pie|rainbow dash|twilight sparkle,kona1025
2215411.png,https://derpicdn.net/img/view/2019/12/8/2215411.png,0,0.9958925843238832,361,518,675,832,314,314,applejack|fluttershy|mane six|pinkie pie|rainbow dash|rarity|twilight sparkle,awbt
2215411.png,https://derpicdn.net/img/view/2019/12/8/2215411.png,1,0.9923818707466124,401,11,645,255,244,244,applejack|fluttershy|mane six|pinkie pie|rainbow dash|rarity|twilight sparkle,awbt
2215411.png,https://derpicdn.net/img/view/2019/12/8/2215411.png,2,0.9900414347648621,96,582,362,848,266,266,applejack|fluttershy|mane six|pinkie pie|rainbow dash|rarity|twilight sparkle,awbt
221663.png,https://derpicdn.net/img/view/2013/1/23/221663.png,0,0.9900893568992616,390,238,572,420,182,182,big macintosh|twilight sparkle,metal-kitty
2220947.png,https://derpicdn.net/img/view/2019/12/15/2220947.png,0,0.989703893661499,388,0,770,299,382,299,applejack|fluttershy|mane six|pinkie pie|rainbow dash|rarity|spike|twilight sparkle,marshmallowbreeze
2220947.png,https://derpicdn.net/img/view/2019/12/15/2220947.png,1,0.9427841901779176,0,0,234,248,234,248,applejack|fluttershy|mane six|pinkie pie|rainbow dash|rarity|spike|twilight sparkle,marshmallowbreeze
2221365.png,https://derpicdn.net/img/view/2019/12/15/2221365.png,0,0.9727978110313416,7,309,187,489,180,180,applejack|pinkie pie|princess celestia|rainbow dash|rarity|spike|spitfire|sunset shimmer|twilight sparkle,anontheanon|mkogwheel|jargon scott
2222981.png,https://derpicdn.net/img/view/2019/12/17/2222981.png,0,0.9957708120346068,342,214,548,420,206,206,applejack|fluttershy|mane six|pinkie pie|rainbow dash|rarity|spike|twilight sparkle,frownfactory
2222981.png,https://derpicdn.net/img/view/2019/12/17/2222981.png,1,0.9763792753219604,66,29,286,249,220,220,applejack|fluttershy|mane six|pinkie pie|rainbow dash|rarity|spike|twilight sparkle,frownfactory
2222981.png,https://derpicdn.net/img/view/2019/12/17/2222981.png,2,0.9648666977882384,564,19,742,197,178,178,applejack|fluttershy|mane six|pinkie pie|rainbow dash|rarity|spike|twilight sparkle,frownfactory
2229768.jpg,https://derpicdn.net/img/view/2019/12/25/2229768.jpg,0,0.9295262098312378,621,27,975,381,354,354,applejack|fluttershy|pinkie pie|rainbow dash|rarity|twilight sparkle,rocioam7
2230952.png,https://derpicdn.net/img/view/2019/12/27/2230952.png,0,0.9946268796920776,1742,123,2748,1129,1006,1006,starlight glimmer|trixie|twilight sparkle,yoshiyoshi700
2230952.png,https://derpicdn.net/img/view/2019/12/27/2230952.png,1,0.9762235879898072,1221,187,1979,945,758,758,starlight glimmer|trixie|twilight sparkle,yoshiyoshi700
2235171.jpg,https://derpicdn.net/img/view/2020/1/1/2235171.jpg,0,0.9795419573783876,344,300,960,916,616,616,pinkie pie|twilight sparkle,velcius
2237919.jpg,https://derpicdn.net/img/view/2020/1/3/2237919.jpg,0,0.9718905687332152,860,284,1226,650,366,366,queen chrysalis|rainbow dash|starlight glimmer|twilight sparkle,olgfox
2237919.jpg,https://derpicdn.net/img/view/2020/1/3/2237919.jpg,1,0.9376338720321656,879,0,1255,341,376,341,queen chrysalis|rainbow dash|starlight glimmer|twilight sparkle,olgfox
2242351.png,https://derpicdn.net/img/view/2020/1/8/2242351.png,0,0.9051343202590942,3344,1295,4200,2151,856,856,applejack|fluttershy|mane six|pinkie pie|rainbow dash|rarity|spike|twilight sparkle,andoanimalia
2244114.jpg,https://derpicdn.net/img/view/2020/1/11/2244114.jpg,0,0.993901789188385,347,1571,831,2055,484,484,applejack|fluttershy|mane six|pinkie pie|rainbow dash|rarity|spike|twilight sparkle,graphic-ginger
2244114.jpg,https://derpicdn.net/img/view/2020/1/11/2244114.jpg,2,0.9806730151176452,1236,1585,1800,2149,564,564,applejack|fluttershy|mane six|pinkie pie|rainbow dash|rarity|spike|twilight sparkle,graphic-ginger
2245029.jpg,https://derpicdn.net/img/view/2020/1/12/2245029.jpg,0,0.9617220163345336,522,521,2066,2065,1544,1544,princess celestia|twilight sparkle,princessrosemcmitten
2246270.png,https://derpicdn.net/img/view/2020/1/13/2246270.png,0,0.9435145854949952,165,2581,867,3283,702,702,fluttershy|rainbow dash|rarity|scootaloo|twilight sparkle,whalepornoz
2246841.jpg,https://derpicdn.net/img/view/2020/1/14/2246841.jpg,0,0.9968786239624025,531,567,801,837,270,270,applejack|fluttershy|mane six|pinkie pie|rainbow dash|rarity|spike|twilight sparkle,takeburuo16|takeda sun
2246841.jpg,https://derpicdn.net/img/view/2020/1/14/2246841.jpg,1,0.9703991413116456,45,355,289,599,244,244,applejack|fluttershy|mane six|pinkie pie|rainbow dash|rarity|spike|twilight sparkle,takeburuo16|takeda sun
2246841.jpg,https://derpicdn.net/img/view/2020/1/14/2246841.jpg,2,0.9529750347137452,227,368,419,560,192,192,applejack|fluttershy|mane six|pinkie pie|rainbow dash|rarity|spike|twilight sparkle,takeburuo16|takeda sun
2246841.jpg,https://derpicdn.net/img/view/2020/1/14/2246841.jpg,3,0.9355866312980652,262,637,538,913,276,276,applejack|fluttershy|mane six|pinkie pie|rainbow dash|rarity|spike|twilight sparkle,takeburuo16|takeda sun
2248165.png,https://derpicdn.net/img/view/2020/1/15/2248165.png,0,0.9204093217849731,111,509,1349,1700,1238,1191,rainbow dash|twilight sparkle,stuwor-art
2252876.jpg,https://derpicdn.net/img/view/2020/1/21/2252876.jpg,0,0.9937541484832764,581,353,1053,825,472,472,trixie|twilight sparkle,moh_mlp2
2253791.png,https://derpicdn.net/img/view/2020/1/22/2253791.png,0,0.9967597723007202,0,340,247,594,247,254,applejack|fluttershy|mane six|pinkie pie|rainbow dash|rarity|twilight sparkle,colorful-horses
2253791.png,https://derpicdn.net/img/view/2020/1/22/2253791.png,1,0.9928255677223206,460,297,802,639,342,342,applejack|fluttershy|mane six|pinkie pie|rainbow dash|rarity|twilight sparkle,colorful-horses
2253791.png,https://derpicdn.net/img/view/2020/1/22/2253791.png,2,0.941062331199646,756,1,1074,319,318,318,applejack|fluttershy|mane six|pinkie pie|rainbow dash|rarity|twilight sparkle,colorful-horses
2260074.png,https://derpicdn.net/img/view/2020/1/29/2260074.png,0,0.9722978472709656,282,211,662,591,380,380,applejack|fluttershy|mane six|pinkie pie|rainbow dash|rarity|spike|twilight sparkle,alfa995
2260327.jpg,https://derpicdn.net/img/view/2020/1/29/2260327.jpg,0,0.9933677911758424,1388,475,1736,823,348,348,applejack|fluttershy|mane six|pinkie pie|rainbow dash|rarity|twilight sparkle,forbidden-love-arts
2264509.jpg,https://derpicdn.net/img/view/2020/2/3/2264509.jpg,1,0.9774206280708312,167,206,489,528,322,322,starlight glimmer|trixie|twilight sparkle,rawrienstein
2266069.jpg,https://derpicdn.net/img/view/2020/2/5/2266069.jpg,0,0.9760817885398864,703,483,901,681,198,198,applejack|fluttershy|mane six|pinkie pie|rainbow dash|rarity|spike|twilight sparkle,texasuberalles
2266069.jpg,https://derpicdn.net/img/view/2020/2/5/2266069.jpg,1,0.9591624736785888,141,9,331,199,190,190,applejack|fluttershy|mane six|pinkie pie|rainbow dash|rarity|spike|twilight sparkle,texasuberalles
2267855.jpg,https://derpicdn.net/img/view/2020/2/7/2267855.jpg,0,0.9936897754669192,2175,397,2560,853,385,456,applejack|fluttershy|mane six|pinkie pie|rainbow dash|rarity|spike|twilight sparkle,
2269026.png,https://derpicdn.net/img/view/2020/2/8/2269026.png,0,0.9980100989341736,382,46,570,234,188,188,applejack|fluttershy|mane six|pinkie pie|rainbow dash|rarity|twilight sparkle,confettiwater
2269026.png,https://derpicdn.net/img/view/2020/2/8/2269026.png,1,0.9919576048851012,531,116,755,340,224,224,applejack|fluttershy|mane six|pinkie pie|rainbow dash|rarity|twilight sparkle,confettiwater
2269026.png,https://derpicdn.net/img/view/2020/2/8/2269026.png,2,0.9916853308677672,234,278,450,494,216,216,applejack|fluttershy|mane six|pinkie pie|rainbow dash|rarity|twilight sparkle,confettiwater
2269026.png,https://derpicdn.net/img/view/2020/2/8/2269026.png,3,0.9477325081825256,267,496,485,714,218,218,applejack|fluttershy|mane six|pinkie pie|rainbow dash|rarity|twilight sparkle,confettiwater
2269210.png,https://derpicdn.net/img/view/2020/2/9/2269210.png,1,0.9973934292793274,318,964,978,1624,660,660,applejack|fluttershy|mane six|pinkie pie|rainbow dash|rarity|twilight sparkle,villjulie
2269210.png,https://derpicdn.net/img/view/2020/2/9/2269210.png,4,0.9879071712493896,1509,82,2151,724,642,642,applejack|fluttershy|mane six|pinkie pie|rainbow dash|rarity|twilight sparkle,villjulie
2270139.jpg,https://derpicdn.net/img/view/2020/2/9/2270139.jpg,0,0.9932464957237244,797,116,1037,356,240,240,rarity|twilight sparkle,earthsong9405
22710.jpg,https://derpicdn.net/img/view/2012/6/27/22710.jpg,1,0.9742690324783324,445,398,721,674,276,276,applejack|fluttershy|mane six|pinkie pie|rainbow dash|rarity|twilight sparkle,markmak
22710.jpg,https://derpicdn.net/img/view/2012/6/27/22710.jpg,2,0.9731898307800292,1211,514,1545,848,334,334,applejack|fluttershy|mane six|pinkie pie|rainbow dash|rarity|twilight sparkle,markmak
2274125.png,https://derpicdn.net/img/view/2020/2/14/2274125.png,0,0.9989826083183287,475,323,711,559,236,236,princess cadance|princess celestia|princess luna|twilight sparkle,bae-mon
2274125.png,https://derpicdn.net/img/view/2020/2/14/2274125.png,1,0.9982125163078308,489,8,769,288,280,280,princess cadance|princess celestia|princess luna|twilight sparkle,bae-mon
2274125.png,https://derpicdn.net/img/view/2020/2/14/2274125.png,2,0.9783660769462584,37,0,353,289,316,289,princess cadance|princess celestia|princess luna|twilight sparkle,bae-mon
2274125.png,https://derpicdn.net/img/view/2020/2/14/2274125.png,3,0.9685137271881104,52,380,300,628,248,248,princess cadance|princess celestia|princess luna|twilight sparkle,bae-mon
2284502.png,https://derpicdn.net/img/view/2020/2/27/2284502.png,0,0.9985026121139526,282,0,1980,1426,1698,1426,spike|twilight sparkle,julunis14
2284502.png,https://derpicdn.net/img/view/2020/2/27/2284502.png,1,0.988224446773529,1510,0,3576,1742,2066,1742,spike|twilight sparkle,julunis14
2285089.jpg,https://derpicdn.net/img/view/2020/2/28/2285089.jpg,0,0.9716200232505798,821,320,1011,510,190,190,applejack|fluttershy|mane six|pinkie pie|rainbow dash|rarity|twilight sparkle,creeate97
2285089.jpg,https://derpicdn.net/img/view/2020/2/28/2285089.jpg,1,0.962319552898407,331,340,513,522,182,182,applejack|fluttershy|mane six|pinkie pie|rainbow dash|rarity|twilight sparkle,creeate97
2286499.jpg,https://derpicdn.net/img/view/2020/2/29/2286499.jpg,0,0.9984598755836488,494,0,1168,646,674,646,apple bloom|applejack|fluttershy|pinkie pie|princess celestia|starlight glimmer|twilight sparkle,twily27889053
2286499.jpg,https://derpicdn.net/img/view/2020/2/29/2286499.jpg,1,0.9832363724708556,867,411,1459,1003,592,592,apple bloom|applejack|fluttershy|pinkie pie|princess celestia|starlight glimmer|twilight sparkle,twily27889053
2286499.jpg,https://derpicdn.net/img/view/2020/2/29/2286499.jpg,4,0.9398448467254642,324,465,832,973,508,508,apple bloom|applejack|fluttershy|pinkie pie|princess celestia|starlight glimmer|twilight sparkle,twily27889053
2287154.png,https://derpicdn.net/img/view/2020/3/1/2287154.png,0,0.9363522529602052,8787,80,9857,1150,1070,1070,applejack|fluttershy|mane six|pinkie pie|rainbow dash|rarity|twilight sparkle,pink1ejack
2288360.jpg,https://derpicdn.net/img/view/2020/3/2/2288360.jpg,0,0.9971725344657898,236,352,970,1086,734,734,princess flurry heart|twilight sparkle,citi
2290710.jpg,https://derpicdn.net/img/view/2020/3/5/2290710.jpg,0,0.9747129082679749,1294,549,1726,981,432,432,fluttershy|twilight sparkle,navokin
2291749.jpg,https://derpicdn.net/img/view/2020/3/7/2291749.jpg,0,0.9747514128684998,1101,0,1399,297,298,297,applejack|fluttershy|mane six|pinkie pie|rainbow dash|rarity|twilight sparkle,pinki3xpie
2291749.jpg,https://derpicdn.net/img/view/2020/3/7/2291749.jpg,1,0.9522626399993896,1663,10,1985,332,322,322,applejack|fluttershy|mane six|pinkie pie|rainbow dash|rarity|twilight sparkle,pinki3xpie
2295976.jpg,https://derpicdn.net/img/view/2020/3/12/2295976.jpg,0,0.90222829580307,124,0,634,504,510,504,sunset shimmer|twilight sparkle,nightrain96
2301878.jpg,https://derpicdn.net/img/view/2020/3/20/2301878.jpg,1,0.9845354557037354,641,976,1175,1510,534,534,applejack|fluttershy|mane six|pinkie pie|princess celestia|princess luna|rainbow dash|rarity|twilight sparkle,canvymamamoo
2301878.jpg,https://derpicdn.net/img/view/2020/3/20/2301878.jpg,2,0.9801820516586304,0,479,509,1001,509,522,applejack|fluttershy|mane six|pinkie pie|princess celestia|princess luna|rainbow dash|rarity|twilight sparkle,canvymamamoo
2302029.jpg,https://derpicdn.net/img/view/2020/3/20/2302029.jpg,0,0.9966994524002076,1766,0,2412,637,646,637,rarity|twilight sparkle,citi
2302029.jpg,https://derpicdn.net/img/view/2020/3/20/2302029.jpg,1,0.9894335865974426,1876,2228,2870,3222,994,994,rarity|twilight sparkle,citi
230465.png,https://derpicdn.net/img/view/2013/2/1/230465.png,1,0.995092511177063,234,747,842,1355,608,608,applejack|fluttershy|mane six|pinkie pie|rainbow dash|rarity|twilight sparkle,navitaserussirus
2305867.jpg,https://derpicdn.net/img/view/2020/3/25/2305867.jpg,0,0.9900745153427124,1406,579,2172,1345,766,766,rarity|twilight sparkle,citi
2308367.png,https://derpicdn.net/img/view/2020/3/28/2308367.png,1,0.9877574443817142,3,1521,477,1995,474,474,fluttershy|spike|twilight sparkle,papadragon69
2308367.png,https://derpicdn.net/img/view/2020/3/28/2308367.png,3,0.9714697599411012,1430,1226,1826,1622,396,396,fluttershy|spike|twilight sparkle,papadragon69
2308367.png,https://derpicdn.net/img/view/2020/3/28/2308367.png,4,0.9497802853584292,575,112,1031,568,456,456,fluttershy|spike|twilight sparkle,papadragon69
2312683.png,https://derpicdn.net/img/view/2020/4/3/2312683.png,0,0.90920090675354,611,40,913,342,302,302,princess celestia|twilight sparkle,onewithspitfire
2318140.png,https://derpicdn.net/img/view/2020/4/9/2318140.png,1,0.9138521552085876,1681,447,2337,1103,656,656,princess cadance|shining armor|spike|twilight sparkle,jac59col
2320104.png,https://derpicdn.net/img/view/2020/4/12/2320104.png,3,0.9615901112556458,1864,792,3440,2368,1576,1576,pinkie pie|spike|starlight glimmer|trixie|twilight sparkle,xeviousgreenii
2320104.png,https://derpicdn.net/img/view/2020/4/12/2320104.png,4,0.9608439207077026,87,1091,1249,2253,1162,1162,pinkie pie|spike|starlight glimmer|trixie|twilight sparkle,xeviousgreenii
2320104.png,https://derpicdn.net/img/view/2020/4/12/2320104.png,7,0.9211587905883788,2247,75,3263,1091,1016,1016,pinkie pie|spike|starlight glimmer|trixie|twilight sparkle,xeviousgreenii
2322720.png,https://derpicdn.net/img/view/2020/4/14/2322720.png,2,0.9954495429992676,1722,65,2408,751,686,686,rarity|twilight sparkle,arcticwaters
2322720.png,https://derpicdn.net/img/view/2020/4/14/2322720.png,3,0.9944438338279724,131,148,783,800,652,652,rarity|twilight sparkle,arcticwaters
2322885.png,https://derpicdn.net/img/view/2020/4/15/2322885.png,0,0.9888409972190856,307,901,623,1217,316,316,applejack|fluttershy|mane six|pinkie pie|rainbow dash|rarity|twilight sparkle,sunnypaw121
2324005.png,https://derpicdn.net/img/view/2020/4/16/2324005.png,2,0.9953088164329528,330,663,654,987,324,324,applejack|fluttershy|mane six|pinkie pie|rainbow dash|rarity|twilight sparkle,sunnymoutonnoir|pipoupip|mimihappy99|dipper-blue-pines|okimichan|creepybrooke59
2324005.png,https://derpicdn.net/img/view/2020/4/16/2324005.png,3,0.9937204122543336,1399,593,1869,1063,470,470,applejack|fluttershy|mane six|pinkie pie|rainbow dash|rarity|twilight sparkle,sunnymoutonnoir|pipoupip|mimihappy99|dipper-blue-pines|okimichan|creepybrooke59
2324005.png,https://derpicdn.net/img/view/2020/4/16/2324005.png,4,0.9200817346572876,1134,1411,1512,1789,378,378,applejack|fluttershy|mane six|pinkie pie|rainbow dash|rarity|twilight sparkle,sunnymoutonnoir|pipoupip|mimihappy99|dipper-blue-pines|okimichan|creepybrooke59
2324547.png,https://derpicdn.net/img/view/2020/4/17/2324547.png,0,0.9110970497131348,391,7,923,539,532,532,spike|twilight sparkle,varwing
2330542.jpg,https://derpicdn.net/img/view/2020/4/24/2330542.jpg,0,0.9990869760513306,3218,1770,4586,3138,1368,1368,applejack|spike|twilight sparkle,ivan-the-pony
2333579.jpg,https://derpicdn.net/img/view/2020/4/28/2333579.jpg,0,0.9359839558601379,97,68,413,384,316,316,starlight glimmer|twilight sparkle,slamjam|boi_slam
2334564.png,https://derpicdn.net/img/view/2020/4/29/2334564.png,0,0.9347957372665404,666,414,838,586,172,172,applejack|fluttershy|mane six|pinkie pie|rainbow dash|rarity|twilight sparkle,piemations
2334564.png,https://derpicdn.net/img/view/2020/4/29/2334564.png,1,0.9198069572448728,873,351,1077,555,204,204,applejack|fluttershy|mane six|pinkie pie|rainbow dash|rarity|twilight sparkle,piemations
2334804.jpg,https://derpicdn.net/img/view/2020/4/29/2334804.jpg,0,0.9548191428184508,1915,194,2401,680,486,486,pinkie pie|twilight sparkle,citi
2338041.png,https://derpicdn.net/img/view/2020/5/3/2338041.png,0,0.9924815893173218,351,41,601,291,250,250,applejack|fluttershy|mane six|pinkie pie|rainbow dash|rarity|twilight sparkle,happydream
2338041.png,https://derpicdn.net/img/view/2020/5/3/2338041.png,1,0.9833305478096008,232,553,478,799,246,246,applejack|fluttershy|mane six|pinkie pie|rainbow dash|rarity|twilight sparkle,happydream
2338041.png,https://derpicdn.net/img/view/2020/5/3/2338041.png,2,0.98307603597641,654,12,900,258,246,246,applejack|fluttershy|mane six|pinkie pie|rainbow dash|rarity|twilight sparkle,happydream
2338041.png,https://derpicdn.net/img/view/2020/5/3/2338041.png,3,0.9729782342910768,631,387,871,627,240,240,applejack|fluttershy|mane six|pinkie pie|rainbow dash|rarity|twilight sparkle,happydream
2338358.png,https://derpicdn.net/img/view/2020/5/3/2338358.png,0,0.9989919066429138,690,48,1278,636,588,588,queen chrysalis|twilight sparkle,saturdaymorningproj
233911.png,https://derpicdn.net/img/view/2013/2/5/233911.png,2,0.96119225025177,316,333,882,899,566,566,applejack|fluttershy|mane six|pinkie pie|rainbow dash|rarity|twilight sparkle,xcopyen002
2339885.png,https://derpicdn.net/img/view/2020/5/5/2339885.png,0,0.9946851134300232,598,298,1110,810,512,512,princess cadance|princess celestia|princess flurry heart|princess luna|twilight sparkle,rainbow eevee
2339885.png,https://derpicdn.net/img/view/2020/5/5/2339885.png,1,0.9837536215782166,1129,289,1673,833,544,544,princess cadance|princess celestia|princess flurry heart|princess luna|twilight sparkle,rainbow eevee
2339885.png,https://derpicdn.net/img/view/2020/5/5/2339885.png,2,0.9226301312446594,1683,30,2313,660,630,630,princess cadance|princess celestia|princess flurry heart|princess luna|twilight sparkle,rainbow eevee
2344178.png,https://derpicdn.net/img/view/2020/5/10/2344178.png,0,0.9978119134902954,757,274,1257,774,500,500,applejack|fluttershy|mane six|pinkie pie|rainbow dash|rarity|twilight sparkle,angelzillah
2344178.png,https://derpicdn.net/img/view/2020/5/10/2344178.png,1,0.9920445084571838,882,1000,1374,1492,492,492,applejack|fluttershy|mane six|pinkie pie|rainbow dash|rarity|twilight sparkle,angelzillah
2344866.jpg,https://derpicdn.net/img/view/2020/5/10/2344866.jpg,0,0.998866617679596,971,77,1555,661,584,584,rarity|twilight sparkle,citi
2344866.jpg,https://derpicdn.net/img/view/2020/5/10/2344866.jpg,1,0.9559889435768129,289,694,1031,1436,742,742,rarity|twilight sparkle,citi
2344866.jpg,https://derpicdn.net/img/view/2020/5/10/2344866.jpg,2,0.9073606729507446,1397,110,2043,756,646,646,rarity|twilight sparkle,citi
2344994.png,https://derpicdn.net/img/view/2020/5/10/2344994.png,0,0.969521462917328,64,0,796,622,732,622,rainbow dash|twilight sparkle,
2345016.png,https://derpicdn.net/img/view/2020/5/10/2345016.png,0,0.9403694272041321,188,0,1234,720,1046,720,rainbow dash|twilight sparkle,
2345308.png,https://derpicdn.net/img/view/2020/5/11/2345308.png,0,0.9782813191413879,49,0,807,615,758,615,rainbow dash|twilight sparkle,
2347412.jpg,https://derpicdn.net/img/view/2020/5/13/2347412.jpg,1,0.9258604645729064,10,143,678,811,668,668,spike|twilight sparkle,phoenixrk49
234790.png,https://derpicdn.net/img/view/2013/2/6/234790.png,0,0.9524918198585508,21,0,165,133,144,133,discord|twilight sparkle,
2347924.png,https://derpicdn.net/img/view/2020/5/13/2347924.png,0,0.9959883689880372,737,35,1153,451,416,416,spike|twilight sparkle,sinrar
2348583.jpg,https://derpicdn.net/img/view/2020/5/14/2348583.jpg,0,0.995708167552948,485,683,1205,1403,720,720,starlight glimmer|twilight sparkle,citi
2351037.jpg,https://derpicdn.net/img/view/2020/5/17/2351037.jpg,0,0.98737633228302,18,21,438,441,420,420,princess luna|rainbow dash|twilight sparkle,xjkenny
236756.png,https://derpicdn.net/img/view/2013/2/8/236756.png,2,0.9229677319526672,2171,1198,2857,1884,686,686,applejack|fluttershy|mane six|pinkie pie|rainbow dash|rarity|twilight sparkle,lilfaux
237998.jpg,https://derpicdn.net/img/view/2013/2/9/237998.jpg,0,0.9932093620300292,3,520,505,1022,502,502,spike|twilight sparkle,mysticalpha
239914.png,https://derpicdn.net/img/view/2013/2/11/239914.png,0,0.982064127922058,282,0,722,427,440,427,spike|twilight sparkle,yulyeen
243565.jpg,https://derpicdn.net/img/view/2013/2/14/243565.jpg,0,0.9998608827590942,10,7,330,327,320,320,applejack|fluttershy|mane six|pinkie pie|rainbow dash|rarity|twilight sparkle,zokoira
243565.jpg,https://derpicdn.net/img/view/2013/2/14/243565.jpg,1,0.9954546093940736,583,83,877,377,294,294,applejack|fluttershy|mane six|pinkie pie|rainbow dash|rarity|twilight sparkle,zokoira
243565.jpg,https://derpicdn.net/img/view/2013/2/14/243565.jpg,2,0.9847285151481628,7,620,275,888,268,268,applejack|fluttershy|mane six|pinkie pie|rainbow dash|rarity|twilight sparkle,zokoira
243565.jpg,https://derpicdn.net/img/view/2013/2/14/243565.jpg,3,0.98358815908432,509,570,761,822,252,252,applejack|fluttershy|mane six|pinkie pie|rainbow dash|rarity|twilight sparkle,zokoira
243565.jpg,https://derpicdn.net/img/view/2013/2/14/243565.jpg,4,0.9827951192855836,874,598,1110,834,236,236,applejack|fluttershy|mane six|pinkie pie|rainbow dash|rarity|twilight sparkle,zokoira
243565.jpg,https://derpicdn.net/img/view/2013/2/14/243565.jpg,5,0.964493453502655,879,54,1173,348,294,294,applejack|fluttershy|mane six|pinkie pie|rainbow dash|rarity|twilight sparkle,zokoira
245817.png,https://derpicdn.net/img/view/2013/2/16/245817.png,0,0.9829034209251404,641,449,1357,1165,716,716,princess celestia|twilight sparkle,adailey
249442.png,https://derpicdn.net/img/view/2013/2/20/249442.png,0,0.9311566948890686,3658,2590,5476,4408,1818,1818,fluttershy|rainbow dash|twilight sparkle,drpancakees
25001.jpg,https://derpicdn.net/img/view/2012/6/29/25001.jpg,0,0.9980634450912476,741,222,1341,822,600,600,princess celestia|twilight sparkle,pikafaa
252361.png,https://derpicdn.net/img/view/2013/2/23/252361.png,0,0.9630091190338136,290,0,704,380,414,380,fluttershy|rainbow dash|twilight sparkle,eshredder
252361.png,https://derpicdn.net/img/view/2013/2/23/252361.png,1,0.9437118172645568,710,244,1070,604,360,360,fluttershy|rainbow dash|twilight sparkle,eshredder
255465.png,https://derpicdn.net/img/view/2013/2/25/255465.png,0,0.9892995357513428,124,108,776,760,652,652,princess cadance|shining armor|spike|twilight sparkle,dawnmistpony
255465.png,https://derpicdn.net/img/view/2013/2/25/255465.png,1,0.985146701335907,990,559,1480,1049,490,490,princess cadance|shining armor|spike|twilight sparkle,dawnmistpony
255465.png,https://derpicdn.net/img/view/2013/2/25/255465.png,2,0.9427089691162108,1964,185,2384,605,420,420,princess cadance|shining armor|spike|twilight sparkle,dawnmistpony
257174.png,https://derpicdn.net/img/view/2013/2/27/257174.png,0,0.997350811958313,852,0,1296,385,444,385,apple bloom|applejack|cutie mark crusaders|fluttershy|mane six|pinkie pie|rainbow dash|rarity|scootaloo|spike|sweetie belle|twilight sparkle,elenaboosy
257174.png,https://derpicdn.net/img/view/2013/2/27/257174.png,1,0.9948303699493408,271,143,509,381,238,238,apple bloom|applejack|cutie mark crusaders|fluttershy|mane six|pinkie pie|rainbow dash|rarity|scootaloo|spike|sweetie belle|twilight sparkle,elenaboosy
260570.png,https://derpicdn.net/img/view/2013/3/2/260570.png,0,0.9953868985176086,111,55,525,469,414,414,spike|twilight sparkle,edtropolis
260636.png,https://derpicdn.net/img/view/2013/3/3/260636.png,0,0.999658465385437,1201,240,1819,858,618,618,trixie|twilight sparkle,catsncupcakes
263139.png,https://derpicdn.net/img/view/2013/3/5/263139.png,0,0.9986897110939026,0,1083,399,1515,399,432,apple bloom|applejack|cutie mark crusaders|discord|fluttershy|mane six|pinkie pie|princess celestia|princess luna|rainbow dash|rarity|scootaloo|spike|sweetie belle|trixie|twilight sparkle,041744
263139.png,https://derpicdn.net/img/view/2013/3/5/263139.png,2,0.97368723154068,1338,1103,1728,1569,390,466,apple bloom|applejack|cutie mark crusaders|discord|fluttershy|mane six|pinkie pie|princess celestia|princess luna|rainbow dash|rarity|scootaloo|spike|sweetie belle|trixie|twilight sparkle,041744
263139.png,https://derpicdn.net/img/view/2013/3/5/263139.png,3,0.9666751623153688,841,523,1271,953,430,430,apple bloom|applejack|cutie mark crusaders|discord|fluttershy|mane six|pinkie pie|princess celestia|princess luna|rainbow dash|rarity|scootaloo|spike|sweetie belle|trixie|twilight sparkle,041744
264342.png,https://derpicdn.net/img/view/2013/3/6/264342.png,0,0.998522698879242,229,518,949,1238,720,720,discord|twilight sparkle,jaquelindreamz
277933.png,https://derpicdn.net/img/view/2013/3/24/277933.png,0,0.9802542328834534,1167,1658,1853,2344,686,686,princess cadance|twilight sparkle,alumx
282004.png,https://derpicdn.net/img/view/2013/3/28/282004.png,0,0.996343731880188,1606,1106,2386,1886,780,780,princess cadance|princess celestia|princess luna|twilight sparkle,redapropos
288554.jpg,https://derpicdn.net/img/view/2013/4/5/288554.jpg,0,0.9969574213027954,408,1,586,179,178,178,applejack|fluttershy|rainbow dash|twilight sparkle,nyankamedon
288554.jpg,https://derpicdn.net/img/view/2013/4/5/288554.jpg,1,0.9165877103805542,68,259,216,407,148,148,applejack|fluttershy|rainbow dash|twilight sparkle,nyankamedon
289604.png,https://derpicdn.net/img/view/2013/4/6/289604.png,0,0.995001256465912,121,129,389,397,268,268,trixie|twilight sparkle,benkomilk
289604.png,https://derpicdn.net/img/view/2013/4/6/289604.png,1,0.9899408221244812,480,145,736,401,256,256,trixie|twilight sparkle,benkomilk
294880.png,https://derpicdn.net/img/view/2013/4/11/294880.png,0,0.926994562149048,3946,333,4592,979,646,646,applejack|big macintosh|fluttershy|pinkie pie|princess luna|rainbow dash|rarity|twilight sparkle,beavernator
29541.png,https://derpicdn.net/img/view/2012/7/3/29541.png,0,0.9270829558372498,0,0,815,788,815,788,spike|twilight sparkle,dzetawmdunion
300938.png,https://derpicdn.net/img/view/2013/4/17/300938.png,0,0.9843841195106506,107,0,1000,563,893,563,princess celestia|princess luna|twilight sparkle,
304595.png,https://derpicdn.net/img/view/2013/4/21/304595.png,0,0.9172547459602356,2731,107,5385,2761,2654,2654,pinkie pie|twilight sparkle,lzw-adzel
305631.png,https://derpicdn.net/img/view/2013/4/22/305631.png,0,0.998254895210266,259,0,541,280,282,280,applejack|fluttershy|mane six|pinkie pie|rainbow dash|rarity|twilight sparkle,akuoreo
305631.png,https://derpicdn.net/img/view/2013/4/22/305631.png,1,0.963924527168274,14,0,348,321,334,321,applejack|fluttershy|mane six|pinkie pie|rainbow dash|rarity|twilight sparkle,akuoreo
30821.png,https://derpicdn.net/img/view/2012/7/4/30821.png,0,0.9843519926071168,81,28,239,186,158,158,applejack|fluttershy|mane six|pinkie pie|rainbow dash|rarity|twilight sparkle,khorme
30951.png,https://derpicdn.net/img/view/2012/7/4/30951.png,0,0.9258313179016112,363,0,631,245,268,245,applejack|fluttershy|mane six|pinkie pie|rainbow dash|rarity|twilight sparkle,selective-yellow
314693.png,https://derpicdn.net/img/view/2013/5/2/314693.png,0,0.9799373745918274,37,503,243,709,206,206,braeburn|rainbow dash|twilight sparkle,toonbat
317137.png,https://derpicdn.net/img/view/2013/5/5/317137.png,0,0.9859604239463806,731,510,931,710,200,200,applejack|fluttershy|pinkie pie|rainbow dash|rarity|spike|twilight sparkle,biscuitcrumbs
317137.png,https://derpicdn.net/img/view/2013/5/5/317137.png,1,0.9319154024124146,50,502,256,708,206,206,applejack|fluttershy|pinkie pie|rainbow dash|rarity|spike|twilight sparkle,biscuitcrumbs
319175.png,https://derpicdn.net/img/view/2013/5/7/319175.png,0,0.9549226164817808,0,0,3329,3358,3329,3358,rainbow dash|twilight sparkle,yanoda
321275.png,https://derpicdn.net/img/view/2013/5/10/321275.png,0,0.9070463180541992,200,347,404,551,204,204,applejack|big macintosh|fluttershy|pinkie pie|rainbow dash|rarity|twilight sparkle,metal-kitty
327232.png,https://derpicdn.net/img/view/2013/5/17/327232.png,0,0.9992005825042723,486,26,1002,542,516,516,shining armor|twilight sparkle,dm29
327232.png,https://derpicdn.net/img/view/2013/5/17/327232.png,1,0.9392729997634888,94,250,650,806,556,556,shining armor|twilight sparkle,dm29
327324.png,https://derpicdn.net/img/view/2013/5/17/327324.png,0,0.9942969679832458,87,118,383,414,296,296,big macintosh|twilight sparkle,alasou
328900.png,https://derpicdn.net/img/view/2013/5/19/328900.png,0,0.98032146692276,1846,1301,3156,2611,1310,1310,rainbow dash|twilight sparkle,vaderpl
3307.jpg,https://derpicdn.net/img/view/2012/2/20/3307.jpg,0,0.9535351395606996,1146,473,1368,695,222,222,fluttershy|rarity|twilight sparkle,glancojusticar
3307.jpg,https://derpicdn.net/img/view/2012/2/20/3307.jpg,1,0.9059596657752992,1268,417,1522,671,254,254,fluttershy|rarity|twilight sparkle,glancojusticar
332249.png,https://derpicdn.net/img/view/2013/5/23/332249.png,0,0.932874858379364,487,7,893,413,406,406,trixie|twilight sparkle,sircinnamon|fenixthefox93
334198.png,https://derpicdn.net/img/view/2013/5/26/334198.png,0,0.9988777041435242,0,1513,545,2075,545,562,apple bloom|applejack|babs seed|big macintosh|cutie mark crusaders|fluttershy|mane six|pinkie pie|princess cadance|queen chrysalis|rainbow dash|rarity|scootaloo|shining armor|soarin'|spitfire|sweetie belle|twilight sparkle,041744
334198.png,https://derpicdn.net/img/view/2013/5/26/334198.png,1,0.9967150688171388,690,2777,1112,3199,422,422,apple bloom|applejack|babs seed|big macintosh|cutie mark crusaders|fluttershy|mane six|pinkie pie|princess cadance|queen chrysalis|rainbow dash|rarity|scootaloo|shining armor|soarin'|spitfire|sweetie belle|twilight sparkle,041744
334198.png,https://derpicdn.net/img/view/2013/5/26/334198.png,2,0.9952084422111512,119,2290,685,2856,566,566,apple bloom|applejack|babs seed|big macintosh|cutie mark crusaders|fluttershy|mane six|pinkie pie|princess cadance|queen chrysalis|rainbow dash|rarity|scootaloo|shining armor|soarin'|spitfire|sweetie belle|twilight sparkle,041744
334198.png,https://derpicdn.net/img/view/2013/5/26/334198.png,3,0.9926727414131165,1943,0,2400,451,457,451,apple bloom|applejack|babs seed|big macintosh|cutie mark crusaders|fluttershy|mane six|pinkie pie|princess cadance|queen chrysalis|rainbow dash|rarity|scootaloo|shining armor|soarin'|spitfire|sweetie belle|twilight sparkle,041744
334198.png,https://derpicdn.net/img/view/2013/5/26/334198.png,4,0.9794549942016602,1937,1599,2389,2051,452,452,apple bloom|applejack|babs seed|big macintosh|cutie mark crusaders|fluttershy|mane six|pinkie pie|princess cadance|queen chrysalis|rainbow dash|rarity|scootaloo|shining armor|soarin'|spitfire|sweetie belle|twilight sparkle,041744
334198.png,https://derpicdn.net/img/view/2013/5/26/334198.png,5,0.9685196280479432,1257,0,1717,451,460,451,apple bloom|applejack|babs seed|big macintosh|cutie mark crusaders|fluttershy|mane six|pinkie pie|princess cadance|queen chrysalis|rainbow dash|rarity|scootaloo|shining armor|soarin'|spitfire|sweetie belle|twilight sparkle,041744
334198.png,https://derpicdn.net/img/view/2013/5/26/334198.png,6,0.9573999643325806,314,437,682,805,368,368,apple bloom|applejack|babs seed|big macintosh|cutie mark crusaders|fluttershy|mane six|pinkie pie|princess cadance|queen chrysalis|rainbow dash|rarity|scootaloo|shining armor|soarin'|spitfire|sweetie belle|twilight sparkle,041744
334198.png,https://derpicdn.net/img/view/2013/5/26/334198.png,7,0.9534368515014648,0,448,331,840,331,392,apple bloom|applejack|babs seed|big macintosh|cutie mark crusaders|fluttershy|mane six|pinkie pie|princess cadance|queen chrysalis|rainbow dash|rarity|scootaloo|shining armor|soarin'|spitfire|sweetie belle|twilight sparkle,041744
339605.png,https://derpicdn.net/img/view/2013/6/3/339605.png,0,0.9997856020927428,79,2,425,348,346,346,trixie|twilight sparkle,namelessenemy
341238.png,https://derpicdn.net/img/view/2013/6/5/341238.png,0,0.9932055473327636,1217,160,1741,684,524,524,applejack|fluttershy|rainbow dash|twilight sparkle,jonpablo45
341238.png,https://derpicdn.net/img/view/2013/6/5/341238.png,1,0.967737078666687,187,143,685,641,498,498,applejack|fluttershy|rainbow dash|twilight sparkle,jonpablo45
341238.png,https://derpicdn.net/img/view/2013/6/5/341238.png,2,0.9577378034591676,1682,995,2264,1577,582,582,applejack|fluttershy|rainbow dash|twilight sparkle,jonpablo45
342675.png,https://derpicdn.net/img/view/2013/6/7/342675.png,0,0.9813786149024964,572,21,850,299,278,278,applejack|fluttershy|mane six|pinkie pie|rainbow dash|rarity|twilight sparkle,anggrc
342675.png,https://derpicdn.net/img/view/2013/6/7/342675.png,1,0.9326819777488708,95,560,461,926,366,366,applejack|fluttershy|mane six|pinkie pie|rainbow dash|rarity|twilight sparkle,anggrc
343952.jpg,https://derpicdn.net/img/view/2013/6/9/343952.jpg,0,0.99897038936615,897,316,1345,764,448,448,pinkie pie|twilight sparkle,dahtamnay
346155.png,https://derpicdn.net/img/view/2013/6/11/346155.png,0,0.9483189582824708,0,0,470,519,470,519,pinkie pie|twilight sparkle,hannathegamer
347913.png,https://derpicdn.net/img/view/2013/6/13/347913.png,0,0.9982303380966188,370,73,696,399,326,326,fluttershy|rainbow dash|twilight sparkle,incinerater
352100.jpg,https://derpicdn.net/img/view/2013/6/19/352100.jpg,0,0.9546126127243042,718,256,842,380,124,124,applejack|fluttershy|pinkie pie|rainbow dash|rarity|spike|sunset shimmer|twilight sparkle,
352100.jpg,https://derpicdn.net/img/view/2013/6/19/352100.jpg,2,0.9348607063293456,796,247,932,383,136,136,applejack|fluttershy|pinkie pie|rainbow dash|rarity|spike|sunset shimmer|twilight sparkle,
352870.png,https://derpicdn.net/img/view/2013/6/20/352870.png,0,0.9042309522628784,254,13,570,329,316,316,rainbow dash|twilight sparkle,somepony
353058.png,https://derpicdn.net/img/view/2013/6/20/353058.png,1,0.9250528812408448,1559,106,2193,740,634,634,fluttershy|pinkie pie|rainbow dash|rarity|twilight sparkle,crispokefan
353058.png,https://derpicdn.net/img/view/2013/6/20/353058.png,2,0.904384195804596,1064,1783,1978,2697,914,914,fluttershy|pinkie pie|rainbow dash|rarity|twilight sparkle,crispokefan
35316.jpg,https://derpicdn.net/img/view/2012/7/7/35316.jpg,0,0.9707046747207642,255,378,421,544,166,166,applejack|big macintosh|fluttershy|pinkie pie|rainbow dash|rarity|twilight sparkle,chibi-jen-hen
35316.jpg,https://derpicdn.net/img/view/2012/7/7/35316.jpg,1,0.9551175832748412,575,0,755,170,180,170,applejack|big macintosh|fluttershy|pinkie pie|rainbow dash|rarity|twilight sparkle,chibi-jen-hen
3565.jpg,https://derpicdn.net/img/view/2012/2/26/3565.jpg,0,0.999484658241272,1142,791,1500,1205,358,414,applejack|fluttershy|mane six|pinkie pie|rainbow dash|rarity|twilight sparkle,uc77
3565.jpg,https://derpicdn.net/img/view/2012/2/26/3565.jpg,1,0.9947211146354676,545,0,849,280,304,280,applejack|fluttershy|mane six|pinkie pie|rainbow dash|rarity|twilight sparkle,uc77
357960.jpg,https://derpicdn.net/img/view/2013/6/27/357960.jpg,0,0.9836109280586244,0,770,447,1246,447,476,applejack|fluttershy|mane six|pinkie pie|rainbow dash|rarity|twilight sparkle,romaniz
359091.png,https://derpicdn.net/img/view/2013/6/28/359091.png,1,0.9418111443519592,2836,597,4422,2183,1586,1586,princess cadance|twilight sparkle,290pika
36280.jpg,https://derpicdn.net/img/view/2012/7/7/36280.jpg,1,0.9044670462608336,1850,510,2076,736,226,226,applejack|fluttershy|mane six|pinkie pie|rainbow dash|rarity|spike|twilight sparkle,glancojusticar|laugh
362990.png,https://derpicdn.net/img/view/2013/7/3/362990.png,0,0.91056090593338,582,75,824,317,242,242,rainbow dash|twilight sparkle,lance
370902.png,https://derpicdn.net/img/view/2013/7/12/370902.png,0,0.9986363053321838,468,193,932,657,464,464,princess luna|twilight sparkle,neysanight
3733.jpg,https://derpicdn.net/img/view/2012/3/15/3733.jpg,0,0.950367271900177,62,0,864,465,802,465,applejack|fluttershy|mane six|pinkie pie|rainbow dash|rarity|spike|twilight sparkle,bosoxboy521
373945.jpg,https://derpicdn.net/img/view/2013/7/14/373945.jpg,0,0.9992932081222534,490,670,904,1084,414,414,applejack|fluttershy|mane six|pinkie pie|rainbow dash|rarity|twilight sparkle,ajin|leche|miu
378687.png,https://derpicdn.net/img/view/2013/7/19/378687.png,0,0.9557334780693054,1095,1071,1501,1477,406,406,apple bloom|applejack|cutie mark crusaders|fluttershy|mane six|pinkie pie|princess cadance|princess celestia|princess luna|rainbow dash|rarity|scootaloo|shining armor|spike|sweetie belle|twilight sparkle,thecheeseburger
380035.png,https://derpicdn.net/img/view/2013/7/21/380035.png,0,0.9068365693092346,528,642,676,790,148,148,apple bloom|applejack|fluttershy|mane six|pinkie pie|rainbow dash|rarity|spike|twilight sparkle,
382392.png,https://derpicdn.net/img/view/2013/7/24/382392.png,0,0.9903223514556884,217,0,533,320,316,320,pinkie pie|twilight sparkle,chiyoneun
38427.jpg,https://derpicdn.net/img/view/2012/7/9/38427.jpg,0,0.9964181780815125,395,0,871,458,476,458,pinkie pie|twilight sparkle,celine-artnsfw
38427.jpg,https://derpicdn.net/img/view/2012/7/9/38427.jpg,1,0.9868069887161256,0,141,380,579,380,438,pinkie pie|twilight sparkle,celine-artnsfw
385498.png,https://derpicdn.net/img/view/2013/7/30/385498.png,0,0.9952436685562134,585,475,733,623,148,148,big macintosh|rainbow dash|rarity|twilight sparkle,
385498.png,https://derpicdn.net/img/view/2013/7/30/385498.png,1,0.9721158146858216,561,41,751,231,190,190,big macintosh|rainbow dash|rarity|twilight sparkle,
385498.png,https://derpicdn.net/img/view/2013/7/30/385498.png,2,0.956068217754364,569,260,703,394,134,134,big macintosh|rainbow dash|rarity|twilight sparkle,
385498.png,https://derpicdn.net/img/view/2013/7/30/385498.png,3,0.9047053456306458,588,826,732,970,144,144,big macintosh|rainbow dash|rarity|twilight sparkle,
3865.png,https://derpicdn.net/img/view/2012/4/7/3865.png,0,0.9758225679397584,959,311,1217,569,258,258,applejack|discord|fluttershy|mane six|pinkie pie|rainbow dash|rarity|twilight sparkle,flausch-katzerl
3865.png,https://derpicdn.net/img/view/2012/4/7/3865.png,1,0.9361231923103333,1198,495,1474,771,276,276,applejack|discord|fluttershy|mane six|pinkie pie|rainbow dash|rarity|twilight sparkle,flausch-katzerl
388923.png,https://derpicdn.net/img/view/2013/8/2/388923.png,0,0.9081662893295288,180,52,930,802,750,750,shining armor|twilight sparkle,earthsong9405
390527.png,https://derpicdn.net/img/view/2013/8/3/390527.png,0,0.9031234979629515,523,907,735,1119,212,212,trixie|twilight sparkle,selective-yellow|mellowyellowpony
391004.png,https://derpicdn.net/img/view/2013/8/4/391004.png,0,0.9934598803520204,716,465,900,683,184,218,applejack|fluttershy|princess celestia|princess luna|rainbow dash|rarity|trixie|twilight sparkle,
391004.png,https://derpicdn.net/img/view/2013/8/4/391004.png,1,0.9366825222969056,50,187,310,447,260,260,applejack|fluttershy|princess celestia|princess luna|rainbow dash|rarity|trixie|twilight sparkle,
391354.png,https://derpicdn.net/img/view/2013/8/4/391354.png,0,0.9088761210441588,459,128,835,504,376,376,applejack|twilight sparkle,doublewbrothers
392534.jpg,https://derpicdn.net/img/view/2013/8/6/392534.jpg,0,0.944699227809906,885,138,1171,424,286,286,applejack|rainbow dash|rarity|twilight sparkle,dtkraus
392534.jpg,https://derpicdn.net/img/view/2013/8/6/392534.jpg,1,0.9267328381538392,156,140,418,402,262,262,applejack|rainbow dash|rarity|twilight sparkle,dtkraus
39464.png,https://derpicdn.net/img/view/2012/7/10/39464.png,0,0.997749388217926,586,481,1014,909,428,428,applejack|pinkie pie|princess luna|rainbow dash|twilight sparkle,cat-cly
39464.png,https://derpicdn.net/img/view/2012/7/10/39464.png,1,0.9834904670715332,1298,0,1982,581,684,581,applejack|pinkie pie|princess luna|rainbow dash|twilight sparkle,cat-cly
395227.png,https://derpicdn.net/img/view/2013/8/9/395227.png,0,0.922717809677124,364,656,552,894,188,238,fluttershy|princess cadance|princess celestia|princess luna|spike|twilight sparkle,diamond ice
40365.png,https://derpicdn.net/img/view/2012/7/11/40365.png,1,0.9991511702537536,523,543,711,731,188,188,applejack|fluttershy|mane six|pinkie pie|rainbow dash|rarity|twilight sparkle,hezaa
40365.png,https://derpicdn.net/img/view/2012/7/11/40365.png,2,0.992982804775238,150,175,348,373,198,198,applejack|fluttershy|mane six|pinkie pie|rainbow dash|rarity|twilight sparkle,hezaa
4040.png,https://derpicdn.net/img/view/2012/5/6/4040.png,0,0.9955561757087708,1070,134,1370,434,300,300,princess cadance|spitfire|twilight sparkle,kiyoshiii
4040.png,https://derpicdn.net/img/view/2012/5/6/4040.png,1,0.96786230802536,288,215,606,533,318,318,princess cadance|spitfire|twilight sparkle,kiyoshiii
405384.jpg,https://derpicdn.net/img/view/2013/8/20/405384.jpg,0,0.9962347745895386,67,53,437,423,370,370,trixie|twilight sparkle,feather-ponyart
406370.png,https://derpicdn.net/img/view/2013/8/21/406370.png,0,0.9988039135932922,43,18,567,542,524,524,fluttershy|twilight sparkle,firefoxyuki
408586.jpg,https://derpicdn.net/img/view/2013/8/23/408586.jpg,2,0.9855026006698608,2014,1205,2740,1931,726,726,rarity|spike|twilight sparkle,bluntwhiskey
409615.png,https://derpicdn.net/img/view/2013/8/25/409615.png,0,0.9852672815322876,1328,72,2186,930,858,858,princess luna|twilight sparkle,xonxt
412671.jpg,https://derpicdn.net/img/view/2013/8/28/412671.jpg,0,0.9921473264694214,297,5,489,197,192,192,applejack|fluttershy|pinkie pie|rainbow dash|rarity|spike|trixie|twilight sparkle,
414285.png,https://derpicdn.net/img/view/2013/8/30/414285.png,0,0.9871439337730408,767,136,1100,478,333,342,pinkie pie|twilight sparkle,senx
414375.png,https://derpicdn.net/img/view/2013/8/30/414375.png,0,0.9909856915473938,411,715,725,1029,314,314,applejack|discord|fluttershy|mane six|pinkie pie|rainbow dash|rarity|twilight sparkle,miokomata
414408.jpg,https://derpicdn.net/img/view/2013/8/30/414408.jpg,0,0.9669191241264344,5013,308,5787,1082,774,774,applejack|fluttershy|mane six|pinkie pie|rainbow dash|rarity|twilight sparkle,pumadriftcat
414803.png,https://derpicdn.net/img/view/2013/8/30/414803.png,1,0.9027624726295472,416,110,846,540,430,430,rainbow dash|twilight sparkle,ambris
415892.png,https://derpicdn.net/img/view/2013/9/1/415892.png,0,0.975735068321228,585,397,921,733,336,336,rainbow dash|twilight sparkle,marcusmaximus
418903.png,https://derpicdn.net/img/view/2013/9/4/418903.png,1,0.9882711172103882,460,210,696,446,236,236,applejack|fluttershy|pinkie pie|rainbow dash|rarity|twilight sparkle,ambris
418903.png,https://derpicdn.net/img/view/2013/9/4/418903.png,2,0.9745738506317142,283,134,531,382,248,248,applejack|fluttershy|pinkie pie|rainbow dash|rarity|twilight sparkle,ambris
4204.jpg,https://derpicdn.net/img/view/2012/5/31/4204.jpg,0,0.9753686785697936,191,247,627,683,436,436,shining armor|twilight sparkle,psychodikdik
420505.png,https://derpicdn.net/img/view/2013/9/6/420505.png,0,0.9799110293388368,295,268,715,688,420,420,princess celestia|princess luna|twilight sparkle,brony-artisan
423403.png,https://derpicdn.net/img/view/2013/9/9/423403.png,0,0.9971411824226379,224,239,814,829,590,590,princess celestia|twilight sparkle,benjik
429918.jpg,https://derpicdn.net/img/view/2013/9/17/429918.jpg,0,0.9946300983428956,1110,499,1418,807,308,308,apple bloom|applejack|big macintosh|discord|fluttershy|mane six|pinkie pie|princess cadance|queen chrysalis|rainbow dash|rarity|sunset shimmer|trixie|twilight sparkle,fimoman
4301.png,https://derpicdn.net/img/view/2012/6/3/4301.png,0,0.9382383227348328,111,166,265,320,154,154,applejack|fluttershy|mane six|pinkie pie|rainbow dash|rarity|twilight sparkle,senselesssquirrel
43380.png,https://derpicdn.net/img/view/2012/7/14/43380.png,0,0.9278326034545898,738,0,1280,491,542,491,rainbow dash|twilight sparkle,niggerfaggot
434693.jpg,https://derpicdn.net/img/view/2013/9/25/434693.jpg,0,0.9986756443977356,304,84,510,290,206,206,shining armor|twilight sparkle,
438645.png,https://derpicdn.net/img/view/2013/9/30/438645.png,0,0.973657727241516,0,1126,1188,2530,1188,1404,princess celestia|twilight sparkle,mothgeist
439879.png,https://derpicdn.net/img/view/2013/10/2/439879.png,0,0.9804790019989014,47,268,437,658,390,390,applejack|fluttershy|mane six|pinkie pie|rainbow dash|rarity|twilight sparkle,eljonek
43996.png,https://derpicdn.net/img/view/2012/7/14/43996.png,0,0.9962637424468994,589,32,741,184,152,152,apple bloom|applejack|cutie mark crusaders|fluttershy|mane six|pinkie pie|rainbow dash|rarity|scootaloo|spike|sweetie belle|trixie|twilight sparkle,shutterflye
441573.png,https://derpicdn.net/img/view/2013/10/4/441573.png,0,0.9944053292274476,506,23,744,261,238,238,pinkie pie|twilight sparkle,metal-kitty
443113.jpg,https://derpicdn.net/img/view/2013/10/6/443113.jpg,0,0.9850453734397888,39,133,289,383,250,250,fluttershy|twilight sparkle,gamermac
443113.jpg,https://derpicdn.net/img/view/2013/10/6/443113.jpg,1,0.9827808737754822,458,129,720,391,262,262,fluttershy|twilight sparkle,gamermac
450826.jpg,https://derpicdn.net/img/view/2013/10/17/450826.jpg,0,0.9995890855789183,473,67,1503,1097,1030,1030,rainbow dash|twilight sparkle,gamermac
450826.jpg,https://derpicdn.net/img/view/2013/10/17/450826.jpg,1,0.911665678024292,1294,514,2132,1352,838,838,rainbow dash|twilight sparkle,gamermac
453387.png,https://derpicdn.net/img/view/2013/10/21/453387.png,0,0.997160255908966,507,100,731,324,224,224,applejack|fluttershy|mane six|pinkie pie|rainbow dash|rarity|twilight sparkle,andypriceart
456283.png,https://derpicdn.net/img/view/2013/10/25/456283.png,0,0.9982473254203796,506,401,800,729,294,328,applejack|fluttershy|mane six|pinkie pie|rainbow dash|rarity|twilight sparkle,radioactive-k
456283.png,https://derpicdn.net/img/view/2013/10/25/456283.png,1,0.995951235294342,507,67,800,361,293,294,applejack|fluttershy|mane six|pinkie pie|rainbow dash|rarity|twilight sparkle,radioactive-k
456283.png,https://derpicdn.net/img/view/2013/10/25/456283.png,2,0.9950889348983764,246,2,526,282,280,280,applejack|fluttershy|mane six|pinkie pie|rainbow dash|rarity|twilight sparkle,radioactive-k
456283.png,https://derpicdn.net/img/view/2013/10/25/456283.png,3,0.970565915107727,0,367,341,713,341,346,applejack|fluttershy|mane six|pinkie pie|rainbow dash|rarity|twilight sparkle,radioactive-k
456283.png,https://derpicdn.net/img/view/2013/10/25/456283.png,4,0.9092280268669128,0,82,266,354,266,272,applejack|fluttershy|mane six|pinkie pie|rainbow dash|rarity|twilight sparkle,radioactive-k
456512.png,https://derpicdn.net/img/view/2013/10/25/456512.png,0,0.9320035576820374,276,512,504,760,228,248,discord|pinkie pie|twilight sparkle,
456905.png,https://derpicdn.net/img/view/2013/10/26/456905.png,0,0.9522518515586852,1239,532,1563,856,324,324,applejack|fluttershy|mane six|pinkie pie|princess luna|rainbow dash|rarity|twilight sparkle,hoyeechun
46320.jpg,https://derpicdn.net/img/view/2012/7/16/46320.jpg,1,0.9938966631889344,107,462,491,846,384,384,applejack|big macintosh|fluttershy|mane six|pinkie pie|rainbow dash|rarity|twilight sparkle,wolfjedisamuel
46320.jpg,https://derpicdn.net/img/view/2012/7/16/46320.jpg,2,0.9734689593315125,441,141,889,589,448,448,applejack|big macintosh|fluttershy|mane six|pinkie pie|rainbow dash|rarity|twilight sparkle,wolfjedisamuel
46320.jpg,https://derpicdn.net/img/view/2012/7/16/46320.jpg,3,0.9713943600654602,222,742,556,1076,334,334,applejack|big macintosh|fluttershy|mane six|pinkie pie|rainbow dash|rarity|twilight sparkle,wolfjedisamuel
468269.jpg,https://derpicdn.net/img/view/2013/11/9/468269.jpg,0,0.996326744556427,12,1015,236,1239,224,224,apple bloom|applejack|big macintosh|fluttershy|mane six|pinkie pie|princess celestia|princess luna|rainbow dash|rarity|scootaloo|spike|sweetie belle|trixie|twilight sparkle,
468269.jpg,https://derpicdn.net/img/view/2013/11/9/468269.jpg,1,0.9959681630134584,726,710,962,946,236,236,apple bloom|applejack|big macintosh|fluttershy|mane six|pinkie pie|princess celestia|princess luna|rainbow dash|rarity|scootaloo|spike|sweetie belle|trixie|twilight sparkle,
468269.jpg,https://derpicdn.net/img/view/2013/11/9/468269.jpg,2,0.9724712371826172,168,748,352,932,184,184,apple bloom|applejack|big macintosh|fluttershy|mane six|pinkie pie|princess celestia|princess luna|rainbow dash|rarity|scootaloo|spike|sweetie belle|trixie|twilight sparkle,
468269.jpg,https://derpicdn.net/img/view/2013/11/9/468269.jpg,3,0.9668912291526794,1063,1038,1257,1232,194,194,apple bloom|applejack|big macintosh|fluttershy|mane six|pinkie pie|princess celestia|princess luna|rainbow dash|rarity|scootaloo|spike|sweetie belle|trixie|twilight sparkle,
468269.jpg,https://derpicdn.net/img/view/2013/11/9/468269.jpg,4,0.9502508640289308,148,1337,376,1565,228,228,apple bloom|applejack|big macintosh|fluttershy|mane six|pinkie pie|princess celestia|princess luna|rainbow dash|rarity|scootaloo|spike|sweetie belle|trixie|twilight sparkle,
46851.png,https://derpicdn.net/img/view/2012/7/17/46851.png,0,0.9827991724014282,892,285,1202,595,310,310,apple bloom|applejack|big macintosh|fluttershy|pinkie pie|rainbow dash|rarity|twilight sparkle,
46851.png,https://derpicdn.net/img/view/2012/7/17/46851.png,1,0.9765144586563108,1008,15,1434,441,426,426,apple bloom|applejack|big macintosh|fluttershy|pinkie pie|rainbow dash|rarity|twilight sparkle,
46851.png,https://derpicdn.net/img/view/2012/7/17/46851.png,3,0.9258989095687866,330,192,622,484,292,292,apple bloom|applejack|big macintosh|fluttershy|pinkie pie|rainbow dash|rarity|twilight sparkle,
46851.png,https://derpicdn.net/img/view/2012/7/17/46851.png,4,0.9240709543228148,1100,429,1466,795,366,366,apple bloom|applejack|big macintosh|fluttershy|pinkie pie|rainbow dash|rarity|twilight sparkle,
473754.png,https://derpicdn.net/img/view/2013/11/16/473754.png,0,0.920253574848175,2294,91,2736,533,442,442,applejack|fluttershy|pinkie pie|princess cadance|princess celestia|princess luna|queen chrysalis|rainbow dash|rarity|twilight sparkle,vird-gi
478747.png,https://derpicdn.net/img/view/2013/11/23/478747.png,0,0.996231198310852,60,111,402,453,342,342,pinkie pie|twilight sparkle,zortail
478747.png,https://derpicdn.net/img/view/2013/11/23/478747.png,1,0.9757686257362366,390,206,704,520,314,314,pinkie pie|twilight sparkle,zortail
479579.png,https://derpicdn.net/img/view/2013/11/23/479579.png,0,0.9813843965530396,2196,2110,3804,3718,1608,1608,applejack|fluttershy|mane six|pinkie pie|rainbow dash|rarity|twilight sparkle,jordila-forge
479810.png,https://derpicdn.net/img/view/2013/11/24/479810.png,0,0.9961352348327636,352,22,544,214,192,192,applejack|fluttershy|mane six|pinkie pie|rainbow dash|rarity|twilight sparkle,metal-kitty
482376.png,https://derpicdn.net/img/view/2013/11/26/482376.png,0,0.9928545951843262,314,0,480,163,166,163,applejack|big macintosh|braeburn|twilight sparkle,nekocrispy
484481.png,https://derpicdn.net/img/view/2013/11/28/484481.png,0,0.9683615565299988,0,56,427,496,427,440,rainbow dash|twilight sparkle,madmax
488549.png,https://derpicdn.net/img/view/2013/12/3/488549.png,0,0.994629442691803,385,352,549,516,164,164,applejack|fluttershy|mane six|pinkie pie|rainbow dash|rarity|twilight sparkle,ranban
488549.png,https://derpicdn.net/img/view/2013/12/3/488549.png,1,0.9842121601104736,354,23,530,199,176,176,applejack|fluttershy|mane six|pinkie pie|rainbow dash|rarity|twilight sparkle,ranban
488549.png,https://derpicdn.net/img/view/2013/12/3/488549.png,2,0.9771091341972352,42,30,214,202,172,172,applejack|fluttershy|mane six|pinkie pie|rainbow dash|rarity|twilight sparkle,ranban
488564.png,https://derpicdn.net/img/view/2013/12/3/488564.png,0,0.9810732007026672,649,0,2104,1474,1455,1474,pinkie pie|twilight sparkle,pixelkitties
489065.jpg,https://derpicdn.net/img/view/2013/12/4/489065.jpg,0,0.9937127232551576,103,30,345,272,242,242,trixie|twilight sparkle,theimmortalwolf
489458.png,https://derpicdn.net/img/view/2013/12/4/489458.png,0,0.999381422996521,586,364,852,630,266,266,applejack|twilight sparkle,kemokun
489458.png,https://derpicdn.net/img/view/2013/12/4/489458.png,1,0.986421763896942,402,167,716,481,314,314,applejack|twilight sparkle,kemokun
489684.png,https://derpicdn.net/img/view/2013/12/4/489684.png,0,0.9968157410621644,17,13,181,177,164,164,princess luna|rainbow dash|trixie|twilight sparkle,stepandy
490960.png,https://derpicdn.net/img/view/2013/12/6/490960.png,0,0.9156497716903688,32,1182,342,1492,310,310,spike|twilight sparkle,mixermike622
493381.png,https://derpicdn.net/img/view/2013/12/8/493381.png,0,0.9873325824737548,115,367,1153,1405,1038,1038,shining armor|twilight sparkle,frezien
493864.png,https://derpicdn.net/img/view/2013/12/10/493864.png,0,0.9993430972099304,622,274,870,522,248,248,rainbow dash|twilight sparkle,kemokun
499233.jpg,https://derpicdn.net/img/view/2013/12/17/499233.jpg,0,0.9949750900268556,1508,82,2388,988,880,906,applejack|fluttershy|mane six|pinkie pie|rainbow dash|rarity|spike|twilight sparkle,soulveiwinterfall
499233.jpg,https://derpicdn.net/img/view/2013/12/17/499233.jpg,1,0.9909761548042296,55,0,993,785,938,785,applejack|fluttershy|mane six|pinkie pie|rainbow dash|rarity|spike|twilight sparkle,soulveiwinterfall
499233.jpg,https://derpicdn.net/img/view/2013/12/17/499233.jpg,2,0.9875667095184326,1516,1665,2388,2625,872,960,applejack|fluttershy|mane six|pinkie pie|rainbow dash|rarity|spike|twilight sparkle,soulveiwinterfall
501376.png,https://derpicdn.net/img/view/2013/12/19/501376.png,0,0.927578330039978,3132,1176,4786,2830,1654,1654,spike|twilight sparkle,vector-brony
505553.jpg,https://derpicdn.net/img/view/2013/12/24/505553.jpg,1,0.9460620880126952,2857,1247,3163,1553,306,306,apple bloom|applejack|cutie mark crusaders|fluttershy|mane six|pinkie pie|rainbow dash|rarity|scootaloo|spike|sweetie belle|twilight sparkle,jbwarner86
505623.png,https://derpicdn.net/img/view/2013/12/24/505623.png,0,0.9346621632575988,361,1603,2417,3659,2056,2056,applejack|fluttershy|mane six|pinkie pie|rainbow dash|rarity|twilight sparkle,90sigma
50599.jpg,https://derpicdn.net/img/view/2012/7/20/50599.jpg,1,0.9796233773231506,203,235,403,435,200,200,applejack|big macintosh|fluttershy|mane six|pinkie pie|rainbow dash|rarity|spike|trixie|twilight sparkle,willdrawforfood1
506130.png,https://derpicdn.net/img/view/2013/12/25/506130.png,0,0.9974346160888672,651,168,889,406,238,238,applejack|fluttershy|mane six|pinkie pie|rainbow dash|rarity|twilight sparkle,swanlullaby
506202.png,https://derpicdn.net/img/view/2013/12/25/506202.png,1,0.9718191027641296,0,0,343,348,343,348,applejack|fluttershy|mane six|pinkie pie|rainbow dash|rarity|twilight sparkle,tarian
515263.png,https://derpicdn.net/img/view/2014/1/4/515263.png,0,0.9862487316131592,399,82,735,418,336,336,applejack|fluttershy|pinkie pie|rainbow dash|twilight sparkle,violetclm
515263.png,https://derpicdn.net/img/view/2014/1/4/515263.png,1,0.9850378632545472,720,101,1032,413,312,312,applejack|fluttershy|pinkie pie|rainbow dash|twilight sparkle,violetclm
517221.png,https://derpicdn.net/img/view/2014/1/6/517221.png,0,0.9782679080963136,14,0,668,633,654,633,apple bloom|applejack|cutie mark crusaders|fluttershy|mane six|pinkie pie|rainbow dash|rarity|scootaloo|spitfire|sweetie belle|twilight sparkle,secret-pony
517959.png,https://derpicdn.net/img/view/2014/1/7/517959.png,0,0.97960764169693,561,0,837,255,276,255,applejack|big macintosh|fluttershy|mane six|pinkie pie|princess celestia|princess luna|rainbow dash|rarity|twilight sparkle,techtechno
518599.png,https://derpicdn.net/img/view/2014/1/8/518599.png,0,0.9497189521789552,924,34,1280,424,356,390,applejack|fluttershy|pinkie pie|rainbow dash|rarity|twilight sparkle,
522540.png,https://derpicdn.net/img/view/2014/1/12/522540.png,0,0.924107015132904,304,111,1282,1089,978,978,spike|twilight sparkle,shiverbear
522755.jpg,https://derpicdn.net/img/view/2014/1/12/522755.jpg,0,0.9955734610557556,3448,2026,5000,3764,1552,1738,applejack|fluttershy|mane six|pinkie pie|rainbow dash|rarity|twilight sparkle,bloodyhellhayden
522755.jpg,https://derpicdn.net/img/view/2014/1/12/522755.jpg,1,0.9223066568374634,359,1228,2237,3106,1878,1878,applejack|fluttershy|mane six|pinkie pie|rainbow dash|rarity|twilight sparkle,bloodyhellhayden
528721.png,https://derpicdn.net/img/view/2014/1/19/528721.png,0,0.9875804781913756,2193,0,3811,1618,1618,1618,pinkie pie|rainbow dash|twilight sparkle,haltie
528721.png,https://derpicdn.net/img/view/2014/1/19/528721.png,1,0.9734864830970764,4092,787,5848,2543,1756,1756,pinkie pie|rainbow dash|twilight sparkle,haltie
529405.jpg,https://derpicdn.net/img/view/2014/1/20/529405.jpg,0,0.9523234367370604,68,348,294,574,226,226,applejack|fluttershy|mane six|pinkie pie|rainbow dash|rarity|spike|twilight sparkle,fadri
529405.jpg,https://derpicdn.net/img/view/2014/1/20/529405.jpg,1,0.907852828502655,368,89,558,279,190,190,applejack|fluttershy|mane six|pinkie pie|rainbow dash|rarity|spike|twilight sparkle,fadri
530224.png,https://derpicdn.net/img/view/2014/1/21/530224.png,0,0.9912646412849426,322,66,514,258,192,192,spike|twilight sparkle,lulubell
531213.jpg,https://derpicdn.net/img/view/2014/1/22/531213.jpg,0,0.9979866743087769,506,0,790,268,284,268,rarity|twilight sparkle,shenkelton
533604.jpg,https://derpicdn.net/img/view/2014/1/25/533604.jpg,0,0.9996030926704408,262,148,912,798,650,650,rainbow dash|soarin'|twilight sparkle,sinaherib
533604.jpg,https://derpicdn.net/img/view/2014/1/25/533604.jpg,1,0.9994415640830994,1388,0,2072,620,684,620,rainbow dash|soarin'|twilight sparkle,sinaherib
533604.jpg,https://derpicdn.net/img/view/2014/1/25/533604.jpg,2,0.9993760585784912,911,108,1481,678,570,570,rainbow dash|soarin'|twilight sparkle,sinaherib
534222.png,https://derpicdn.net/img/view/2014/1/25/534222.png,0,0.9544807672500608,319,271,683,635,364,364,discord|princess cadance|twilight sparkle,
534387.jpg,https://derpicdn.net/img/view/2014/1/26/534387.jpg,0,0.9980448484420776,54,564,462,972,408,408,princess cadance|twilight sparkle,mechashockwave
534581.png,https://derpicdn.net/img/view/2014/1/26/534581.png,0,0.9924997091293336,945,2027,1737,2819,792,792,spike|twilight sparkle,kitsunehino
536845.png,https://derpicdn.net/img/view/2014/1/28/536845.png,0,0.9190099239349364,244,1775,808,2339,564,564,pinkie pie|twilight sparkle,fimoman
537128.png,https://derpicdn.net/img/view/2014/1/28/537128.png,0,0.9661735296249392,291,811,543,1063,252,252,princess celestia|princess luna|twilight sparkle,ajin
537128.png,https://derpicdn.net/img/view/2014/1/28/537128.png,1,0.9651973843574524,61,728,391,1058,330,330,princess celestia|princess luna|twilight sparkle,ajin
538590.png,https://derpicdn.net/img/view/2014/1/30/538590.png,0,0.9971469044685364,10,52,276,318,266,266,princess celestia|twilight sparkle,mixermike622
540723.jpg,https://derpicdn.net/img/view/2014/2/1/540723.jpg,1,0.9536068439483644,0,2047,475,2557,475,510,rainbow dash|twilight sparkle,
544800.jpg,https://derpicdn.net/img/view/2014/2/6/544800.jpg,0,0.9994187355041504,1067,693,1647,1273,580,580,applejack|fluttershy|mane six|pinkie pie|rainbow dash|rarity|twilight sparkle,kiriya
544800.jpg,https://derpicdn.net/img/view/2014/2/6/544800.jpg,2,0.996950089931488,87,48,493,454,406,406,applejack|fluttershy|mane six|pinkie pie|rainbow dash|rarity|twilight sparkle,kiriya
544800.jpg,https://derpicdn.net/img/view/2014/2/6/544800.jpg,4,0.9220709204673768,1072,0,1578,469,506,469,applejack|fluttershy|mane six|pinkie pie|rainbow dash|rarity|twilight sparkle,kiriya
544897.png,https://derpicdn.net/img/view/2014/2/6/544897.png,0,0.9952946305274964,1055,0,1531,446,476,446,applejack|fluttershy|mane six|pinkie pie|rainbow dash|rarity|spike|twilight sparkle,hairezz
544897.png,https://derpicdn.net/img/view/2014/2/6/544897.png,1,0.9836452603340148,165,0,709,541,544,541,applejack|fluttershy|mane six|pinkie pie|rainbow dash|rarity|spike|twilight sparkle,hairezz
545786.jpg,https://derpicdn.net/img/view/2014/2/7/545786.jpg,0,0.9920620918273926,1536,530,2226,1220,690,690,applejack|fluttershy|mane six|pinkie pie|rainbow dash|rarity|spike|twilight sparkle,semajz
546110.jpg,https://derpicdn.net/img/view/2014/2/7/546110.jpg,0,0.9322550296783448,2084,408,2516,840,432,432,applejack|fluttershy|mane six|pinkie pie|rainbow dash|rarity|trixie|twilight sparkle,tahublade7
54843.jpg,https://derpicdn.net/img/view/2012/7/24/54843.jpg,0,0.996536374092102,569,398,757,586,188,188,applejack|fluttershy|mane six|pinkie pie|rainbow dash|rarity|twilight sparkle,j8d
54843.jpg,https://derpicdn.net/img/view/2012/7/24/54843.jpg,2,0.9859393835067748,497,46,693,242,196,196,applejack|fluttershy|mane six|pinkie pie|rainbow dash|rarity|twilight sparkle,j8d
54843.jpg,https://derpicdn.net/img/view/2012/7/24/54843.jpg,4,0.9367300271987916,244,338,460,554,216,216,applejack|fluttershy|mane six|pinkie pie|rainbow dash|rarity|twilight sparkle,j8d
550086.png,https://derpicdn.net/img/view/2014/2/12/550086.png,1,0.9879745244979858,124,0,392,256,268,256,pinkie pie|rainbow dash|twilight sparkle,flam3zero
551507.jpg,https://derpicdn.net/img/view/2014/2/14/551507.jpg,0,0.9473109841346741,622,936,1536,1850,914,914,applejack|fluttershy|mane six|pinkie pie|rainbow dash|rarity|twilight sparkle,scorpiyo
551507.jpg,https://derpicdn.net/img/view/2014/2/14/551507.jpg,1,0.9137030243873596,1427,869,2345,1787,918,918,applejack|fluttershy|mane six|pinkie pie|rainbow dash|rarity|twilight sparkle,scorpiyo
552209.png,https://derpicdn.net/img/view/2014/2/15/552209.png,0,0.9996168613433838,173,200,381,408,208,208,rainbow dash|twilight sparkle,january3rd
552209.png,https://derpicdn.net/img/view/2014/2/15/552209.png,1,0.9833617806434632,422,214,652,444,230,230,rainbow dash|twilight sparkle,january3rd
554867.png,https://derpicdn.net/img/view/2014/2/17/554867.png,0,0.9988611936569214,73,35,443,405,370,370,fluttershy|pinkie pie|twilight sparkle,wonton soup
554867.png,https://derpicdn.net/img/view/2014/2/17/554867.png,1,0.9532992243766784,1532,231,1896,595,364,364,fluttershy|pinkie pie|twilight sparkle,wonton soup
554867.png,https://derpicdn.net/img/view/2014/2/17/554867.png,2,0.9063524007797241,844,11,1182,349,338,338,fluttershy|pinkie pie|twilight sparkle,wonton soup
555071.png,https://derpicdn.net/img/view/2014/2/17/555071.png,0,0.9916380047798156,1453,586,2654,1806,1201,1220,trixie|twilight sparkle,catfood-mcfly
557221.png,https://derpicdn.net/img/view/2014/2/20/557221.png,0,0.9895049333572388,1793,2243,2331,2781,538,538,princess celestia|spike|twilight sparkle,l1nkoln
557858.png,https://derpicdn.net/img/view/2014/2/21/557858.png,0,0.9975924491882324,12,0,396,341,384,341,applejack|fluttershy|mane six|pinkie pie|rainbow dash|rarity|twilight sparkle,crispych0colate
557858.png,https://derpicdn.net/img/view/2014/2/21/557858.png,1,0.9952215552330016,396,474,770,848,374,374,applejack|fluttershy|mane six|pinkie pie|rainbow dash|rarity|twilight sparkle,crispych0colate
557858.png,https://derpicdn.net/img/view/2014/2/21/557858.png,2,0.9942412376403807,1,518,327,844,326,326,applejack|fluttershy|mane six|pinkie pie|rainbow dash|rarity|twilight sparkle,crispych0colate
557858.png,https://derpicdn.net/img/view/2014/2/21/557858.png,3,0.9940493702888488,386,0,770,344,384,344,applejack|fluttershy|mane six|pinkie pie|rainbow dash|rarity|twilight sparkle,crispych0colate
557858.png,https://derpicdn.net/img/view/2014/2/21/557858.png,4,0.988326132297516,774,483,1182,891,408,408,applejack|fluttershy|mane six|pinkie pie|rainbow dash|rarity|twilight sparkle,crispych0colate
559869.png,https://derpicdn.net/img/view/2014/2/23/559869.png,0,0.9922340512275696,680,0,1046,339,366,339,fluttershy|rainbow dash|twilight sparkle,kittyhawk-contrail
559960.png,https://derpicdn.net/img/view/2014/2/23/559960.png,1,0.9679274559020996,50,1215,376,1541,326,326,princess luna|scootaloo|twilight sparkle,pridark
561361.png,https://derpicdn.net/img/view/2014/2/25/561361.png,1,0.9753583073616028,400,750,836,1186,436,436,applejack|fluttershy|mane six|pinkie pie|rainbow dash|rarity|twilight sparkle,applemelody
561361.png,https://derpicdn.net/img/view/2014/2/25/561361.png,2,0.9273515343666076,734,456,1110,832,376,376,applejack|fluttershy|mane six|pinkie pie|rainbow dash|rarity|twilight sparkle,applemelody
561554.png,https://derpicdn.net/img/view/2014/2/26/561554.png,0,0.9525660276412964,110,0,544,425,434,425,spike|twilight sparkle,aviantheatrics
562386.png,https://derpicdn.net/img/view/2014/2/27/562386.png,0,0.9626398086547852,563,210,873,520,310,310,spike|twilight sparkle,wickedsilly
563354.jpg,https://derpicdn.net/img/view/2014/2/28/563354.jpg,1,0.9718253612518308,2813,0,3347,440,534,440,apple bloom|applejack|cutie mark crusaders|fluttershy|mane six|pinkie pie|rainbow dash|rarity|scootaloo|spike|sweetie belle|twilight sparkle,haku
563354.jpg,https://derpicdn.net/img/view/2014/2/28/563354.jpg,2,0.9701361656188964,2945,911,3377,1343,432,432,apple bloom|applejack|cutie mark crusaders|fluttershy|mane six|pinkie pie|rainbow dash|rarity|scootaloo|spike|sweetie belle|twilight sparkle,haku
566619.png,https://derpicdn.net/img/view/2014/3/4/566619.png,0,0.9838638305664062,526,59,914,447,388,388,fluttershy|twilight sparkle,empyu
569001.png,https://derpicdn.net/img/view/2014/3/8/569001.png,0,0.9716078639030457,651,256,789,394,138,138,princess celestia|queen chrysalis|rainbow dash|twilight sparkle,
570961.png,https://derpicdn.net/img/view/2014/3/9/570961.png,0,0.9649617075920104,861,121,1259,519,398,398,pinkie pie|twilight sparkle,senx
571620.jpg,https://derpicdn.net/img/view/2014/3/10/571620.jpg,0,0.963324248790741,1794,251,2236,693,442,442,applejack|fluttershy|mane six|pinkie pie|rainbow dash|rarity|twilight sparkle,greyscaleart
573474.png,https://derpicdn.net/img/view/2014/3/12/573474.png,0,0.9772117137908936,131,88,289,246,158,158,applejack|fluttershy|mane six|pinkie pie|rainbow dash|rarity|twilight sparkle,
573851.png,https://derpicdn.net/img/view/2014/3/13/573851.png,0,0.9970261454582214,459,0,749,260,290,260,applejack|fluttershy|mane six|pinkie pie|rainbow dash|rarity|twilight sparkle,drawponies
575208.png,https://derpicdn.net/img/view/2014/3/14/575208.png,0,0.9344141483306884,547,112,969,534,422,422,pinkie pie|twilight sparkle,otterlore
579573.jpg,https://derpicdn.net/img/view/2014/3/19/579573.jpg,0,0.9926463961601256,0,976,386,1410,386,434,applejack|fluttershy|pinkie pie|princess celestia|princess luna|rainbow dash|rarity|spike|twilight sparkle,andypriceart
580324.png,https://derpicdn.net/img/view/2014/3/20/580324.png,0,0.993444561958313,306,410,1224,1328,918,918,fluttershy|pinkie pie|twilight sparkle,nekokevin
580324.png,https://derpicdn.net/img/view/2014/3/20/580324.png,1,0.9672421216964722,1185,557,2005,1377,820,820,fluttershy|pinkie pie|twilight sparkle,nekokevin
580324.png,https://derpicdn.net/img/view/2014/3/20/580324.png,2,0.9560875296592712,1982,818,2944,1780,962,962,fluttershy|pinkie pie|twilight sparkle,nekokevin
580832.png,https://derpicdn.net/img/view/2014/3/21/580832.png,0,0.9422029852867126,108,155,438,500,330,345,trixie|twilight sparkle,
581586.png,https://derpicdn.net/img/view/2014/3/22/581586.png,0,0.9779981970787048,2,55,310,363,308,308,pinkie pie|twilight sparkle,lulubell
586801.png,https://derpicdn.net/img/view/2014/3/28/586801.png,0,0.9790042042732242,133,809,665,1341,532,532,rainbow dash|twilight sparkle,seyllah
587859.jpg,https://derpicdn.net/img/view/2014/3/29/587859.jpg,0,0.9942866563796996,824,40,1400,702,576,662,applejack|fluttershy|princess celestia|princess luna|rainbow dash|twilight sparkle,
587859.jpg,https://derpicdn.net/img/view/2014/3/29/587859.jpg,1,0.91545432806015,0,436,331,842,331,406,applejack|fluttershy|princess celestia|princess luna|rainbow dash|twilight sparkle,
588859.png,https://derpicdn.net/img/view/2014/3/30/588859.png,0,0.9988734126091005,186,0,522,324,336,324,trixie|twilight sparkle,norang94
588859.png,https://derpicdn.net/img/view/2014/3/30/588859.png,1,0.9934236407279968,379,15,689,325,310,310,trixie|twilight sparkle,norang94
589302.png,https://derpicdn.net/img/view/2014/3/31/589302.png,0,0.996247947216034,578,259,802,485,224,226,rainbow dash|spike|twilight sparkle,artflicker
590543.png,https://derpicdn.net/img/view/2014/4/1/590543.png,0,0.9910379648208618,147,260,687,800,540,540,applejack|fluttershy|mane six|pinkie pie|rainbow dash|rarity|twilight sparkle,itoruna-the-platypus
590543.png,https://derpicdn.net/img/view/2014/4/1/590543.png,1,0.978937029838562,2280,342,3014,1076,734,734,applejack|fluttershy|mane six|pinkie pie|rainbow dash|rarity|twilight sparkle,itoruna-the-platypus
590543.png,https://derpicdn.net/img/view/2014/4/1/590543.png,2,0.9749687910079956,2344,1193,2954,1803,610,610,applejack|fluttershy|mane six|pinkie pie|rainbow dash|rarity|twilight sparkle,itoruna-the-platypus
590543.png,https://derpicdn.net/img/view/2014/4/1/590543.png,3,0.9465182423591614,1782,1477,2352,2047,570,570,applejack|fluttershy|mane six|pinkie pie|rainbow dash|rarity|twilight sparkle,itoruna-the-platypus
590843.png,https://derpicdn.net/img/view/2014/4/2/590843.png,0,0.9778991937637328,0,240,1685,1966,1685,1726,pinkie pie|twilight sparkle,gurne0
592077.png,https://derpicdn.net/img/view/2014/4/4/592077.png,0,0.9850732088088988,0,0,296,296,296,296,queen chrysalis|twilight sparkle,mixermike622
594501.png,https://derpicdn.net/img/view/2014/4/6/594501.png,0,0.9973775148391724,207,265,581,639,374,374,rainbow dash|twilight sparkle,tunairs
594501.png,https://derpicdn.net/img/view/2014/4/6/594501.png,1,0.9970993995666504,677,203,1097,623,420,420,rainbow dash|twilight sparkle,tunairs
594509.png,https://derpicdn.net/img/view/2014/4/6/594509.png,0,0.9855914115905762,506,42,862,398,356,356,rainbow dash|twilight sparkle,vividvulpine
594655.png,https://derpicdn.net/img/view/2014/4/6/594655.png,0,0.9670120477676392,174,23,456,305,282,282,rainbow dash|twilight sparkle,
594655.png,https://derpicdn.net/img/view/2014/4/6/594655.png,1,0.939771056175232,230,346,767,918,537,572,rainbow dash|twilight sparkle,
597877.png,https://derpicdn.net/img/view/2014/4/11/597877.png,0,0.9850269556045532,750,254,1452,956,702,702,pinkie pie|twilight sparkle,january3rd
598890.png,https://derpicdn.net/img/view/2014/4/12/598890.png,0,0.9667813777923584,164,0,538,378,374,378,pinkie pie|twilight sparkle,dilemmas4u
60021.png,https://derpicdn.net/img/view/2012/7/28/60021.png,0,0.9978331327438354,71,31,745,705,674,674,rainbow dash|twilight sparkle,yourfavoritesenpai
601906.png,https://derpicdn.net/img/view/2014/4/16/601906.png,0,0.9704504013061525,1169,0,1689,448,520,448,princess celestia|shining armor|twilight sparkle,nadnerbd
603458.png,https://derpicdn.net/img/view/2014/4/18/603458.png,0,0.9985357522964478,17,422,379,784,362,362,pinkie pie|rarity|twilight sparkle,cuppycakesprinkles
603458.png,https://derpicdn.net/img/view/2014/4/18/603458.png,1,0.9980360269546508,337,23,669,355,332,332,pinkie pie|rarity|twilight sparkle,cuppycakesprinkles
603458.png,https://derpicdn.net/img/view/2014/4/18/603458.png,2,0.9654384851455688,6,15,388,397,382,382,pinkie pie|rarity|twilight sparkle,cuppycakesprinkles
603458.png,https://derpicdn.net/img/view/2014/4/18/603458.png,3,0.9649725556373596,298,401,680,819,382,418,pinkie pie|rarity|twilight sparkle,cuppycakesprinkles
607360.png,https://derpicdn.net/img/view/2014/4/22/607360.png,0,0.9966121315956116,203,108,569,474,366,366,fluttershy|twilight sparkle,january3rd
609957.png,https://derpicdn.net/img/view/2014/4/26/609957.png,0,0.9877845644950868,118,452,274,608,156,156,applejack|big macintosh|pinkie pie|rarity|twilight sparkle,burgerlicious
617541.png,https://derpicdn.net/img/view/2014/5/4/617541.png,0,0.9954434037208556,365,484,779,898,414,414,trixie|twilight sparkle,snapai
617670.png,https://derpicdn.net/img/view/2014/5/4/617670.png,0,0.9921367764472958,240,27,1112,899,872,872,spike|twilight sparkle,drawing-heart
618553.png,https://derpicdn.net/img/view/2014/5/5/618553.png,0,0.9878141283988952,128,287,1486,1645,1358,1358,rainbow dash|twilight sparkle,doggonepony
618827.png,https://derpicdn.net/img/view/2014/5/6/618827.png,0,0.99925696849823,1099,0,4361,2914,3262,2914,rarity|twilight sparkle,byteslice
621327.png,https://derpicdn.net/img/view/2014/5/9/621327.png,0,0.9436404705047609,95,150,483,538,388,388,princess celestia|sunset shimmer|twilight sparkle,fallingrain22
623482.jpg,https://derpicdn.net/img/view/2014/5/11/623482.jpg,0,0.9935582876205444,473,1588,2145,3260,1672,1672,rainbow dash|twilight sparkle,bloodyhellhayden
623482.jpg,https://derpicdn.net/img/view/2014/5/11/623482.jpg,1,0.992463767528534,3207,0,5157,1906,1950,1906,rainbow dash|twilight sparkle,bloodyhellhayden
625897.jpg,https://derpicdn.net/img/view/2014/5/13/625897.jpg,0,0.9867479205131532,668,297,942,571,274,274,applejack|discord|twilight sparkle,sonicdramon
634523.png,https://derpicdn.net/img/view/2014/5/23/634523.png,0,0.9978692531585692,130,0,396,255,266,255,fluttershy|twilight sparkle,geekoflove
63478.jpg,https://derpicdn.net/img/view/2012/7/31/63478.jpg,0,0.9976363182067872,26,28,280,282,254,254,pinkie pie|twilight sparkle,keterok
63478.jpg,https://derpicdn.net/img/view/2012/7/31/63478.jpg,1,0.9831266403198242,429,0,681,214,252,214,pinkie pie|twilight sparkle,keterok
638557.png,https://derpicdn.net/img/view/2014/5/27/638557.png,0,0.9355268478393556,276,34,1000,700,724,666,rainbow dash|twilight sparkle,paulyvectors
64372.png,https://derpicdn.net/img/view/2012/8/1/64372.png,0,0.9680583477020264,378,178,638,438,260,260,rainbow dash|twilight sparkle,lustrous-dreams
644268.png,https://derpicdn.net/img/view/2014/6/3/644268.png,1,0.9890273213386536,139,571,777,1209,638,638,princess cadance|queen chrysalis|twilight sparkle,r0b0tassassin
65015.jpg,https://derpicdn.net/img/view/2012/8/2/65015.jpg,0,0.9610551595687866,583,281,983,681,400,400,apple bloom|applejack|fluttershy|mane six|pinkie pie|rainbow dash|rarity|scootaloo|sweetie belle|twilight sparkle,bunnimation
651148.png,https://derpicdn.net/img/view/2014/6/12/651148.png,0,0.9984949827194214,3317,123,5000,1907,1683,1784,rarity|sweetie belle|twilight sparkle,silfoe
651148.png,https://derpicdn.net/img/view/2014/6/12/651148.png,1,0.9081671237945556,0,0,1921,2066,1921,2066,rarity|sweetie belle|twilight sparkle,silfoe
652509.png,https://derpicdn.net/img/view/2014/6/13/652509.png,3,0.9817553162574768,307,1338,843,1874,536,536,applejack|fluttershy|mane six|pinkie pie|rainbow dash|rarity|twilight sparkle,nekokevin
65488.jpg,https://derpicdn.net/img/view/2012/8/2/65488.jpg,0,0.9942466020584106,675,119,1681,1125,1006,1006,applejack|fluttershy|mane six|pinkie pie|princess celestia|princess luna|rainbow dash|rarity|spike|twilight sparkle,willisninety-six
65488.jpg,https://derpicdn.net/img/view/2012/8/2/65488.jpg,1,0.9631590247154236,0,86,1133,1240,1133,1154,applejack|fluttershy|mane six|pinkie pie|princess celestia|princess luna|rainbow dash|rarity|spike|twilight sparkle,willisninety-six
65488.jpg,https://derpicdn.net/img/view/2012/8/2/65488.jpg,2,0.9457774758338928,1286,2146,1990,2850,704,704,applejack|fluttershy|mane six|pinkie pie|princess celestia|princess luna|rainbow dash|rarity|spike|twilight sparkle,willisninety-six
65488.jpg,https://derpicdn.net/img/view/2012/8/2/65488.jpg,3,0.9165823459625244,1189,247,2143,1201,954,954,applejack|fluttershy|mane six|pinkie pie|princess celestia|princess luna|rainbow dash|rarity|spike|twilight sparkle,willisninety-six
656936.jpg,https://derpicdn.net/img/view/2014/6/19/656936.jpg,1,0.969974160194397,450,356,642,548,192,192,applejack|pinkie pie|princess celestia|princess luna|spike|twilight sparkle,
663704.png,https://derpicdn.net/img/view/2014/6/29/663704.png,0,0.98760324716568,0,376,278,666,278,290,rarity|trixie|twilight sparkle,raggyrabbit94
663704.png,https://derpicdn.net/img/view/2014/6/29/663704.png,1,0.9604321718215942,588,325,928,679,340,354,rarity|trixie|twilight sparkle,raggyrabbit94
665433.jpg,https://derpicdn.net/img/view/2014/7/1/665433.jpg,0,0.9919835329055786,75,48,663,636,588,588,princess cadance|shining armor|twilight sparkle,redanon
665582.png,https://derpicdn.net/img/view/2014/7/1/665582.png,0,0.9696511030197144,5834,2926,7700,4792,1866,1866,applejack|fluttershy|mane six|pinkie pie|rainbow dash|rarity|spike|twilight sparkle,notlikelyanartist
665582.png,https://derpicdn.net/img/view/2014/7/1/665582.png,1,0.9277907609939576,9859,215,12319,2675,2460,2460,applejack|fluttershy|mane six|pinkie pie|rainbow dash|rarity|spike|twilight sparkle,notlikelyanartist
667126.png,https://derpicdn.net/img/view/2014/7/4/667126.png,0,0.9989497661590576,0,0,800,803,800,803,spike|twilight sparkle,zaponator
672633.png,https://derpicdn.net/img/view/2014/7/11/672633.png,0,0.9588395953178406,0,236,264,592,264,356,spike|twilight sparkle,inuyuru
673864.png,https://derpicdn.net/img/view/2014/7/13/673864.png,0,0.9967508912086488,2,0,260,221,258,221,applejack|fluttershy|mane six|pinkie pie|rainbow dash|rarity|twilight sparkle,pepooni
673864.png,https://derpicdn.net/img/view/2014/7/13/673864.png,1,0.9921294450759888,280,262,548,530,268,268,applejack|fluttershy|mane six|pinkie pie|rainbow dash|rarity|twilight sparkle,pepooni
674106.png,https://derpicdn.net/img/view/2014/7/13/674106.png,0,0.999049723148346,496,92,1314,910,818,818,applejack|fluttershy|pinkie pie|rainbow dash|rarity|twilight sparkle,mt
677357.png,https://derpicdn.net/img/view/2014/7/18/677357.png,0,0.9963299036026,0,304,242,572,242,268,applejack|twilight sparkle,deusexequus
677828.png,https://derpicdn.net/img/view/2014/7/18/677828.png,0,0.9621235728263856,165,243,597,675,432,432,spike|twilight sparkle,omgproductions
678414.png,https://derpicdn.net/img/view/2014/7/19/678414.png,0,0.9933115839958192,900,305,1486,891,586,586,applejack|big macintosh|fluttershy|princess celestia|princess luna|rainbow dash|rarity|spike|sweetie belle|twilight sparkle,zsparkonequus
678414.png,https://derpicdn.net/img/view/2014/7/19/678414.png,1,0.9745272994041444,17,1174,527,1684,510,510,applejack|big macintosh|fluttershy|princess celestia|princess luna|rainbow dash|rarity|spike|sweetie belle|twilight sparkle,zsparkonequus
680388.jpg,https://derpicdn.net/img/view/2014/7/21/680388.jpg,0,0.9688015580177308,350,0,648,260,298,260,fluttershy|pinkie pie|rarity|twilight sparkle,dtkraus
681717.png,https://derpicdn.net/img/view/2014/7/23/681717.png,0,0.96255224943161,2087,1606,2605,2000,518,394,apple bloom|applejack|cutie mark crusaders|discord|pinkie pie|princess cadance|princess celestia|princess luna|queen chrysalis|rainbow dash|rarity|scootaloo|shining armor|spike|sweetie belle|trixie|twilight sparkle,kkitsu
683015.png,https://derpicdn.net/img/view/2014/7/25/683015.png,0,0.9984961748123168,923,281,1325,683,402,402,applejack|fluttershy|mane six|pinkie pie|rainbow dash|rarity|twilight sparkle,xpesifeindx|almostfictional|mithandir730|pirill|missbeigepony|emper24|zutheskunk edits
683015.png,https://derpicdn.net/img/view/2014/7/25/683015.png,1,0.9944846630096436,24,271,382,629,358,358,applejack|fluttershy|mane six|pinkie pie|rainbow dash|rarity|twilight sparkle,xpesifeindx|almostfictional|mithandir730|pirill|missbeigepony|emper24|zutheskunk edits
683015.png,https://derpicdn.net/img/view/2014/7/25/683015.png,3,0.9819268584251404,1560,220,1888,548,328,328,applejack|fluttershy|mane six|pinkie pie|rainbow dash|rarity|twilight sparkle,xpesifeindx|almostfictional|mithandir730|pirill|missbeigepony|emper24|zutheskunk edits
68351.jpg,https://derpicdn.net/img/view/2012/8/6/68351.jpg,0,0.99657142162323,744,625,1324,1205,580,580,applejack|fluttershy|mane six|pinkie pie|rainbow dash|rarity|spike|twilight sparkle,berrydrops
684723.png,https://derpicdn.net/img/view/2014/7/27/684723.png,0,0.972389042377472,863,208,1229,574,366,366,applejack|fluttershy|mane six|pinkie pie|rainbow dash|rarity|twilight sparkle,zedrin
685174.png,https://derpicdn.net/img/view/2014/7/28/685174.png,0,0.9793494939804076,121,151,341,371,220,220,spike|twilight sparkle,cosmicponye
685995.png,https://derpicdn.net/img/view/2014/7/29/685995.png,0,0.9997071623802184,982,54,1324,396,342,342,applejack|fluttershy|mane six|pinkie pie|rainbow dash|rarity|twilight sparkle,crispych0colate
685995.png,https://derpicdn.net/img/view/2014/7/29/685995.png,1,0.9915481805801392,1867,164,2235,532,368,368,applejack|fluttershy|mane six|pinkie pie|rainbow dash|rarity|twilight sparkle,crispych0colate
685995.png,https://derpicdn.net/img/view/2014/7/29/685995.png,2,0.9736095070838928,42,82,398,438,356,356,applejack|fluttershy|mane six|pinkie pie|rainbow dash|rarity|twilight sparkle,crispych0colate
685995.png,https://derpicdn.net/img/view/2014/7/29/685995.png,3,0.9413754343986512,313,156,693,536,380,380,applejack|fluttershy|mane six|pinkie pie|rainbow dash|rarity|twilight sparkle,crispych0colate
686228.png,https://derpicdn.net/img/view/2014/7/29/686228.png,0,0.9761394262313844,257,117,445,305,188,188,fluttershy|twilight sparkle,coggler
687423.png,https://derpicdn.net/img/view/2014/7/31/687423.png,0,0.9946506023406982,217,75,437,295,220,220,applejack|fluttershy|mane six|pinkie pie|rainbow dash|rarity|twilight sparkle,sound-resonance
687706.png,https://derpicdn.net/img/view/2014/7/31/687706.png,1,0.993439555168152,100,107,726,733,626,626,pinkie pie|twilight sparkle,zacatron94
687940.png,https://derpicdn.net/img/view/2014/7/31/687940.png,0,0.98508620262146,588,360,974,746,386,386,applejack|fluttershy|mane six|pinkie pie|rainbow dash|rarity|spike|twilight sparkle,davidcurser
687940.png,https://derpicdn.net/img/view/2014/7/31/687940.png,1,0.9425361156463624,222,436,566,780,344,344,applejack|fluttershy|mane six|pinkie pie|rainbow dash|rarity|spike|twilight sparkle,davidcurser
688340.png,https://derpicdn.net/img/view/2014/8/1/688340.png,0,0.9754219651222228,1626,738,2380,1492,754,754,applejack|fluttershy|mane six|pinkie pie|rainbow dash|rarity|twilight sparkle,theshadowstone
688832.png,https://derpicdn.net/img/view/2014/8/1/688832.png,0,0.9968392848968506,70,54,500,484,430,430,spike|twilight sparkle,rue-willings
695856.png,https://derpicdn.net/img/view/2014/8/9/695856.png,0,0.9963237643241882,3830,0,6968,2993,3138,2993,trixie|twilight sparkle,masem
701467.png,https://derpicdn.net/img/view/2014/8/17/701467.png,0,0.9595734477043152,828,444,1504,1120,676,676,trixie|twilight sparkle,fimlie
702150.png,https://derpicdn.net/img/view/2014/8/17/702150.png,1,0.9249192476272584,356,262,614,520,258,258,applejack|fluttershy|mane six|pinkie pie|rainbow dash|rarity|twilight sparkle,lolisoup
703572.png,https://derpicdn.net/img/view/2014/8/19/703572.png,0,0.9986315965652466,17,18,437,438,420,420,trixie|twilight sparkle,lilliesinthegarden
704303.png,https://derpicdn.net/img/view/2014/8/20/704303.png,0,0.9892218708992004,463,0,1233,713,770,713,rarity|twilight sparkle,littleovertures
707787.jpg,https://derpicdn.net/img/view/2014/8/25/707787.jpg,0,0.9965476989746094,999,478,1457,936,458,458,applejack|fluttershy|mane six|pinkie pie|rainbow dash|rarity|twilight sparkle,flameydragwasp
707787.jpg,https://derpicdn.net/img/view/2014/8/25/707787.jpg,1,0.996402621269226,1392,11,1634,253,242,242,applejack|fluttershy|mane six|pinkie pie|rainbow dash|rarity|twilight sparkle,flameydragwasp
707787.jpg,https://derpicdn.net/img/view/2014/8/25/707787.jpg,2,0.983417272567749,48,561,306,819,258,258,applejack|fluttershy|mane six|pinkie pie|rainbow dash|rarity|twilight sparkle,flameydragwasp
707787.jpg,https://derpicdn.net/img/view/2014/8/25/707787.jpg,3,0.9826599955558776,504,892,890,1233,386,341,applejack|fluttershy|mane six|pinkie pie|rainbow dash|rarity|twilight sparkle,flameydragwasp
708518.png,https://derpicdn.net/img/view/2014/8/26/708518.png,0,0.994124174118042,606,296,874,564,268,268,rainbow dash|twilight sparkle,empyu
708678.png,https://derpicdn.net/img/view/2014/8/26/708678.png,0,0.99804025888443,648,894,1024,1280,376,386,applejack|fluttershy|mane six|pinkie pie|rainbow dash|rarity|twilight sparkle,30clock
708678.png,https://derpicdn.net/img/view/2014/8/26/708678.png,1,0.9851880073547364,363,759,795,1191,432,432,applejack|fluttershy|mane six|pinkie pie|rainbow dash|rarity|twilight sparkle,30clock
708678.png,https://derpicdn.net/img/view/2014/8/26/708678.png,2,0.9483596682548524,0,1062,394,1494,394,432,applejack|fluttershy|mane six|pinkie pie|rainbow dash|rarity|twilight sparkle,30clock
708678.png,https://derpicdn.net/img/view/2014/8/26/708678.png,3,0.9417632222175598,0,459,345,889,345,430,applejack|fluttershy|mane six|pinkie pie|rainbow dash|rarity|twilight sparkle,30clock
714183.jpg,https://derpicdn.net/img/view/2014/9/3/714183.jpg,0,0.9986975193023682,154,197,446,489,292,292,spike|trixie|twilight sparkle,negativefox
714183.jpg,https://derpicdn.net/img/view/2014/9/3/714183.jpg,1,0.9963481426239014,9,486,231,708,222,222,spike|trixie|twilight sparkle,negativefox
714901.png,https://derpicdn.net/img/view/2014/9/4/714901.png,0,0.9255733489990234,0,309,358,733,358,424,applejack|pinkie pie|rainbow dash|twilight sparkle,amy mebberson
720613.png,https://derpicdn.net/img/view/2014/9/12/720613.png,0,0.9966684579849244,465,1591,779,1905,314,314,fluttershy|princess celestia|princess luna|twilight sparkle,silent-nona-light
720714.jpg,https://derpicdn.net/img/view/2014/9/12/720714.jpg,0,0.9873509407043456,532,0,1188,648,656,648,princess celestia|twilight sparkle,dtkraus
721493.png,https://derpicdn.net/img/view/2014/9/13/721493.png,0,0.9669843316078186,254,0,724,446,470,446,pinkie pie|twilight sparkle,spectralunicorn
725277.png,https://derpicdn.net/img/view/2014/9/19/725277.png,0,0.971444010734558,616,289,826,499,210,210,applejack|fluttershy|mane six|pinkie pie|rainbow dash|rarity|twilight sparkle,rflzqt
725277.png,https://derpicdn.net/img/view/2014/9/19/725277.png,1,0.9588164687156676,453,270,661,478,208,208,applejack|fluttershy|mane six|pinkie pie|rainbow dash|rarity|twilight sparkle,rflzqt
726691.png,https://derpicdn.net/img/view/2014/9/21/726691.png,0,0.9170119762420654,692,78,948,334,256,256,discord|twilight sparkle,scramjet747
729680.png,https://derpicdn.net/img/view/2014/9/26/729680.png,0,0.9759907126426696,151,140,467,456,316,316,princess celestia|twilight sparkle,empyu
732314.png,https://derpicdn.net/img/view/2014/9/29/732314.png,0,0.9964040517807008,194,477,530,813,336,336,princess cadance|princess celestia|princess luna|twilight sparkle,poniesforparents
732314.png,https://derpicdn.net/img/view/2014/9/29/732314.png,1,0.981730580329895,688,495,1004,811,316,316,princess cadance|princess celestia|princess luna|twilight sparkle,poniesforparents
732314.png,https://derpicdn.net/img/view/2014/9/29/732314.png,2,0.9659014940261841,422,279,782,639,360,360,princess cadance|princess celestia|princess luna|twilight sparkle,poniesforparents
732659.png,https://derpicdn.net/img/view/2014/9/30/732659.png,0,0.9969561100006104,0,299,265,571,265,272,shining armor|twilight sparkle,artiecanvas
732659.png,https://derpicdn.net/img/view/2014/9/30/732659.png,1,0.9511737823486328,631,249,1001,619,370,370,shining armor|twilight sparkle,artiecanvas
73883.jpg,https://derpicdn.net/img/view/2012/8/13/73883.jpg,1,0.9856953024864196,0,37,631,669,631,632,princess cadance|queen chrysalis|shining armor|twilight sparkle,docpel
73983.png,https://derpicdn.net/img/view/2012/8/13/73983.png,0,0.9588916301727296,2151,0,3795,1606,1644,1606,fluttershy|twilight sparkle,adamscage
741872.png,https://derpicdn.net/img/view/2014/10/13/741872.png,0,0.9970380067825316,592,219,994,621,402,402,shining armor|twilight sparkle,artiecanvas
741872.png,https://derpicdn.net/img/view/2014/10/13/741872.png,1,0.9638075232505798,881,229,1211,559,330,330,shining armor|twilight sparkle,artiecanvas
74433.jpg,https://derpicdn.net/img/view/2012/8/14/74433.jpg,0,0.9955057501792908,441,40,633,232,192,192,applejack|fluttershy|mane six|pinkie pie|rainbow dash|rarity|twilight sparkle,alloyrabbit
744430.png,https://derpicdn.net/img/view/2014/10/17/744430.png,0,0.981216549873352,405,5,559,159,154,154,rarity|twilight sparkle,congee-painting
748865.png,https://derpicdn.net/img/view/2014/10/23/748865.png,0,0.9908891320228576,32,420,358,746,326,326,applejack|fluttershy|pinkie pie|rainbow dash|rarity|spike|twilight sparkle,dattebayo681
748865.png,https://derpicdn.net/img/view/2014/10/23/748865.png,2,0.9537692666053772,683,392,1117,826,434,434,applejack|fluttershy|pinkie pie|rainbow dash|rarity|spike|twilight sparkle,dattebayo681
75116.png,https://derpicdn.net/img/view/2012/8/15/75116.png,0,0.9827853441238404,295,757,623,1085,328,328,applejack|fluttershy|pinkie pie|trixie|twilight sparkle,tzulin520
75116.png,https://derpicdn.net/img/view/2012/8/15/75116.png,1,0.975678026676178,56,478,320,742,264,264,applejack|fluttershy|pinkie pie|trixie|twilight sparkle,tzulin520
75116.png,https://derpicdn.net/img/view/2012/8/15/75116.png,2,0.9701951742172241,504,475,838,809,334,334,applejack|fluttershy|pinkie pie|trixie|twilight sparkle,tzulin520
752278.png,https://derpicdn.net/img/view/2014/10/28/752278.png,0,0.9983553290367126,603,0,907,264,304,264,big macintosh|princess luna|twilight sparkle,collaredginger
752278.png,https://derpicdn.net/img/view/2014/10/28/752278.png,2,0.9421748518943788,286,0,630,329,344,329,big macintosh|princess luna|twilight sparkle,collaredginger
752852.png,https://derpicdn.net/img/view/2014/10/29/752852.png,0,0.9804377555847168,492,202,792,502,300,300,rarity|twilight sparkle,puffpink
754154.png,https://derpicdn.net/img/view/2014/10/30/754154.png,1,0.9475301504135132,9,29,243,263,234,234,applejack|fluttershy|mane six|pinkie pie|rainbow dash|rarity|twilight sparkle,emiliearts
754154.png,https://derpicdn.net/img/view/2014/10/30/754154.png,2,0.9015844464302064,546,23,768,245,222,222,applejack|fluttershy|mane six|pinkie pie|rainbow dash|rarity|twilight sparkle,emiliearts
760077.png,https://derpicdn.net/img/view/2014/11/7/760077.png,0,0.960576057434082,218,306,504,592,286,286,princess cadance|princess celestia|princess luna|twilight sparkle,asika-aida
760077.png,https://derpicdn.net/img/view/2014/11/7/760077.png,1,0.9546779990196228,0,269,308,639,308,370,princess cadance|princess celestia|princess luna|twilight sparkle,asika-aida
760077.png,https://derpicdn.net/img/view/2014/11/7/760077.png,2,0.9359022974967957,1468,98,1782,412,314,314,princess cadance|princess celestia|princess luna|twilight sparkle,asika-aida
767857.jpg,https://derpicdn.net/img/view/2014/11/19/767857.jpg,0,0.9983431100845336,1822,178,2510,866,688,688,applejack|fluttershy|mane six|pinkie pie|rainbow dash|rarity|spike|twilight sparkle,inkypsycho
7679.jpg,https://derpicdn.net/img/view/2012/6/18/7679.jpg,0,0.9966169595718384,0,452,181,654,181,202,spike|twilight sparkle,tomatocoup
7679.jpg,https://derpicdn.net/img/view/2012/6/18/7679.jpg,1,0.9481648206710817,200,251,474,525,274,274,spike|twilight sparkle,tomatocoup
768041.png,https://derpicdn.net/img/view/2014/11/20/768041.png,0,0.9521334171295166,14,644,186,816,172,172,scootaloo|spike|twilight sparkle,brendahickey
76997.png,https://derpicdn.net/img/view/2012/8/18/76997.png,0,0.9476447105407716,1401,989,1607,1195,206,206,apple bloom|applejack|big macintosh|braeburn|cutie mark crusaders|diamond tiara|discord|fluttershy|mane six|pinkie pie|princess cadance|princess celestia|princess luna|queen chrysalis|rainbow dash|rarity|scootaloo|shining armor|silver spoon|soarin'|spike|spitfire|sweetie belle|trixie|twilight sparkle,xain-russell
770132.jpg,https://derpicdn.net/img/view/2014/11/23/770132.jpg,0,0.9820834398269652,220,13,404,197,184,184,spike|twilight sparkle,susu
771311.png,https://derpicdn.net/img/view/2014/11/24/771311.png,0,0.9835031032562256,740,0,1426,570,686,570,trixie|twilight sparkle,lonely-frostflower|asika-aida
771311.png,https://derpicdn.net/img/view/2014/11/24/771311.png,1,0.9815158247947692,58,92,570,604,512,512,trixie|twilight sparkle,lonely-frostflower|asika-aida
77239.png,https://derpicdn.net/img/view/2012/8/18/77239.png,0,0.9870468378067015,484,509,796,821,312,312,rarity|twilight sparkle,sketchyjackie
77239.png,https://derpicdn.net/img/view/2012/8/18/77239.png,1,0.972915768623352,85,505,389,809,304,304,rarity|twilight sparkle,sketchyjackie
773486.jpg,https://derpicdn.net/img/view/2014/11/28/773486.jpg,0,0.9288485646247864,271,84,397,210,126,126,applejack|fluttershy|mane six|pinkie pie|rainbow dash|rarity|sunset shimmer|trixie|twilight sparkle,tatsuka
775382.png,https://derpicdn.net/img/view/2014/11/30/775382.png,0,0.9113998413085938,169,0,789,450,620,450,sunset shimmer|twilight sparkle,fallenangel5414
776450.jpg,https://derpicdn.net/img/view/2014/12/2/776450.jpg,0,0.9646543860435486,372,0,752,361,380,361,sunset shimmer|twilight sparkle,ladyanidraws
782020.png,https://derpicdn.net/img/view/2014/12/10/782020.png,0,0.9770774245262146,18,78,216,276,198,198,pinkie pie|twilight sparkle,brendahickey
783161.png,https://derpicdn.net/img/view/2014/12/12/783161.png,0,0.9669217467308044,397,760,829,1192,432,432,princess luna|twilight sparkle,nightmarelunafan
784087.png,https://derpicdn.net/img/view/2014/12/13/784087.png,0,0.9773884415626526,1111,32,1633,554,522,522,applejack|rarity|twilight sparkle,9de-light6
784087.png,https://derpicdn.net/img/view/2014/12/13/784087.png,1,0.9757217764854432,433,28,1023,618,590,590,applejack|rarity|twilight sparkle,9de-light6
784087.png,https://derpicdn.net/img/view/2014/12/13/784087.png,2,0.9748675227165222,1671,14,2215,558,544,544,applejack|rarity|twilight sparkle,9de-light6
784253.png,https://derpicdn.net/img/view/2014/12/13/784253.png,0,0.9972629547119141,167,480,725,1038,558,558,trixie|twilight sparkle,southparktaoist
785063.jpg,https://derpicdn.net/img/view/2014/12/14/785063.jpg,0,0.9626822471618652,75,24,245,194,170,170,applejack|fluttershy|mane six|pinkie pie|rainbow dash|rarity|twilight sparkle,ruffu
786551.png,https://derpicdn.net/img/view/2014/12/17/786551.png,0,0.9072380065917968,324,84,1118,878,794,794,trixie|twilight sparkle,ravirr94
786853.png,https://derpicdn.net/img/view/2014/12/17/786853.png,2,0.9256941080093384,347,40,1027,720,680,680,applejack|fluttershy|mane six|pinkie pie|princess cadance|princess celestia|princess luna|queen chrysalis|rainbow dash|rarity|sunset shimmer|twilight sparkle,kotatsu|hashioaryut|monon0|aruurara|phoenixperegrine
787801.jpg,https://derpicdn.net/img/view/2014/12/19/787801.jpg,0,0.9971753358840942,1,9,427,435,426,426,applejack|twilight sparkle,nazonazopowerfu
788754.jpg,https://derpicdn.net/img/view/2014/12/20/788754.jpg,1,0.9863151907920836,1551,0,2555,770,1004,770,applejack|fluttershy|pinkie pie|rainbow dash|rarity|twilight sparkle,djmoonray
788754.jpg,https://derpicdn.net/img/view/2014/12/20/788754.jpg,2,0.93636155128479,2000,573,2754,1327,754,754,applejack|fluttershy|pinkie pie|rainbow dash|rarity|twilight sparkle,djmoonray
788776.png,https://derpicdn.net/img/view/2014/12/20/788776.png,0,0.9986987709999084,2462,1697,2958,2193,496,496,apple bloom|applejack|cutie mark crusaders|fluttershy|mane six|pinkie pie|princess celestia|princess luna|rainbow dash|rarity|scootaloo|spike|sweetie belle|trixie|twilight sparkle,dr-whiskey
788776.png,https://derpicdn.net/img/view/2014/12/20/788776.png,1,0.9945653080940248,1920,1102,2344,1526,424,424,apple bloom|applejack|cutie mark crusaders|fluttershy|mane six|pinkie pie|princess celestia|princess luna|rainbow dash|rarity|scootaloo|spike|sweetie belle|trixie|twilight sparkle,dr-whiskey
788776.png,https://derpicdn.net/img/view/2014/12/20/788776.png,2,0.9761281013488772,445,1823,881,2259,436,436,apple bloom|applejack|cutie mark crusaders|fluttershy|mane six|pinkie pie|princess celestia|princess luna|rainbow dash|rarity|scootaloo|spike|sweetie belle|trixie|twilight sparkle,dr-whiskey
788830.png,https://derpicdn.net/img/view/2014/12/20/788830.png,0,0.9990940690040588,524,0,854,292,330,292,applejack|fluttershy|mane six|pinkie pie|rainbow dash|rarity|spike|twilight sparkle,rflzqt
788830.png,https://derpicdn.net/img/view/2014/12/20/788830.png,1,0.9782140851020812,260,281,560,581,300,300,applejack|fluttershy|mane six|pinkie pie|rainbow dash|rarity|spike|twilight sparkle,rflzqt
788830.png,https://derpicdn.net/img/view/2014/12/20/788830.png,2,0.9774021506309508,419,208,799,588,380,380,applejack|fluttershy|mane six|pinkie pie|rainbow dash|rarity|spike|twilight sparkle,rflzqt
788830.png,https://derpicdn.net/img/view/2014/12/20/788830.png,3,0.9522598385810852,13,22,345,354,332,332,applejack|fluttershy|mane six|pinkie pie|rainbow dash|rarity|spike|twilight sparkle,rflzqt
789779.png,https://derpicdn.net/img/view/2014/12/21/789779.png,0,0.9915608167648317,291,451,735,895,444,444,applejack|fluttershy|mane six|pinkie pie|rainbow dash|rarity|spike|twilight sparkle,hoyeechun
789779.png,https://derpicdn.net/img/view/2014/12/21/789779.png,1,0.9814129471778872,1036,1109,1350,1423,314,314,applejack|fluttershy|mane six|pinkie pie|rainbow dash|rarity|spike|twilight sparkle,hoyeechun
789945.png,https://derpicdn.net/img/view/2014/12/22/789945.png,0,0.9942456483840942,246,775,454,983,208,208,applejack|fluttershy|mane six|pinkie pie|rainbow dash|rarity|trixie|twilight sparkle,darkkodkod
791683.png,https://derpicdn.net/img/view/2014/12/24/791683.png,1,0.935831606388092,515,322,879,686,364,364,shining armor|twilight sparkle,reaver75|archerinblue|unoriginai
791765.png,https://derpicdn.net/img/view/2014/12/24/791765.png,0,0.9981631636619568,523,272,821,570,298,298,applejack|fluttershy|mane six|pinkie pie|rainbow dash|rarity|twilight sparkle,norang94
791765.png,https://derpicdn.net/img/view/2014/12/24/791765.png,1,0.9918310046195984,66,561,384,879,318,318,applejack|fluttershy|mane six|pinkie pie|rainbow dash|rarity|twilight sparkle,norang94
792171.png,https://derpicdn.net/img/view/2014/12/25/792171.png,0,0.9762727618217468,491,257,851,617,360,360,pinkie pie|twilight sparkle,flutterthrash
792321.png,https://derpicdn.net/img/view/2014/12/25/792321.png,1,0.9267597794532776,514,64,808,358,294,294,applejack|fluttershy|mane six|pinkie pie|rainbow dash|rarity|spike|twilight sparkle,clouddg
792969.jpg,https://derpicdn.net/img/view/2014/12/26/792969.jpg,0,0.9990103244781494,234,70,532,368,298,298,rarity|twilight sparkle,zokoira
792969.jpg,https://derpicdn.net/img/view/2014/12/26/792969.jpg,1,0.9983423948287964,570,69,884,383,314,314,rarity|twilight sparkle,zokoira
793325.jpg,https://derpicdn.net/img/view/2014/12/26/793325.jpg,0,0.984465718269348,62,672,970,1580,908,908,shining armor|twilight sparkle,unoriginai
793325.jpg,https://derpicdn.net/img/view/2014/12/26/793325.jpg,1,0.953121781349182,240,1770,698,2228,458,458,shining armor|twilight sparkle,unoriginai
793325.jpg,https://derpicdn.net/img/view/2014/12/26/793325.jpg,2,0.9306124448776244,376,235,1042,901,666,666,shining armor|twilight sparkle,unoriginai
794441.png,https://derpicdn.net/img/view/2014/12/28/794441.png,0,0.9795683026313782,1855,766,2687,1598,832,832,sunset shimmer|twilight sparkle,kaylathehedgehog
794808.png,https://derpicdn.net/img/view/2014/12/29/794808.png,0,0.9297439455986024,367,0,867,380,500,380,rainbow dash|twilight sparkle,coloringwolf
794857.png,https://derpicdn.net/img/view/2014/12/29/794857.png,0,0.9931573271751404,1400,148,1730,478,330,330,princess cadance|princess celestia|princess luna|twilight sparkle,virenth
794857.png,https://derpicdn.net/img/view/2014/12/29/794857.png,1,0.9513314962387084,152,172,482,502,330,330,princess cadance|princess celestia|princess luna|twilight sparkle,virenth
794857.png,https://derpicdn.net/img/view/2014/12/29/794857.png,2,0.905671000480652,722,125,1086,489,364,364,princess cadance|princess celestia|princess luna|twilight sparkle,virenth
795302.png,https://derpicdn.net/img/view/2014/12/29/795302.png,0,0.9819522500038148,14,836,284,1106,270,270,applejack|fluttershy|mane six|pinkie pie|rainbow dash|rarity|spike|twilight sparkle,xaiena
795534.png,https://derpicdn.net/img/view/2014/12/30/795534.png,0,0.99168199300766,591,346,801,556,210,210,applejack|fluttershy|mane six|pinkie pie|rainbow dash|rarity|twilight sparkle,ponygoddess
795534.png,https://derpicdn.net/img/view/2014/12/30/795534.png,1,0.9230221509933472,15,300,321,606,306,306,applejack|fluttershy|mane six|pinkie pie|rainbow dash|rarity|twilight sparkle,ponygoddess
7994.jpg,https://derpicdn.net/img/view/2012/6/18/7994.jpg,1,0.9964517951011658,389,0,607,218,218,218,applejack|fluttershy|mane six|pinkie pie|rainbow dash|rarity|twilight sparkle,notjailbait
801345.png,https://derpicdn.net/img/view/2015/1/7/801345.png,0,0.9094558954238892,510,39,726,255,216,216,applejack|rainbow dash|twilight sparkle,milkrainn
801838.jpg,https://derpicdn.net/img/view/2015/1/8/801838.jpg,0,0.9757297039031982,680,455,1450,1225,770,770,rarity|spike|twilight sparkle,bico-kun
802704.png,https://derpicdn.net/img/view/2015/1/9/802704.png,0,0.9924866557121276,496,715,970,1189,474,474,applejack|fluttershy|mane six|pinkie pie|rainbow dash|rarity|spike|twilight sparkle,amy mebberson
803592.png,https://derpicdn.net/img/view/2015/1/10/803592.png,1,0.9648093581199646,1531,96,1891,456,360,360,applejack|fluttershy|mane six|pinkie pie|princess celestia|princess luna|rainbow dash|rarity|spike|twilight sparkle,malamol
804272.png,https://derpicdn.net/img/view/2015/1/11/804272.png,0,0.9787353873252868,999,201,1437,639,438,438,spike|twilight sparkle,masterjosh140
805587.png,https://derpicdn.net/img/view/2015/1/13/805587.png,0,0.9725526571273804,373,174,627,428,254,254,rainbow dash|twilight sparkle,lustrous-dreams
807637.png,https://derpicdn.net/img/view/2015/1/16/807637.png,0,0.990115225315094,239,760,561,1082,322,322,discord|princess celestia|twilight sparkle,artiecanvas
808292.png,https://derpicdn.net/img/view/2015/1/17/808292.png,0,0.9945191740989684,449,31,799,381,350,350,applejack|fluttershy|mane six|pinkie pie|rainbow dash|rarity|shining armor|twilight sparkle,jargon scott
811157.png,https://derpicdn.net/img/view/2015/1/20/811157.png,0,0.9398180842399596,269,101,611,443,342,342,fluttershy|twilight sparkle,majkashinoda626
812287.jpg,https://derpicdn.net/img/view/2015/1/22/812287.jpg,0,0.9940562844276428,405,383,605,583,200,200,applejack|fluttershy|mane six|pinkie pie|rainbow dash|rarity|twilight sparkle,alliemackie
812287.jpg,https://derpicdn.net/img/view/2015/1/22/812287.jpg,2,0.9909251928329468,754,0,950,195,196,195,applejack|fluttershy|mane six|pinkie pie|rainbow dash|rarity|twilight sparkle,alliemackie
812287.jpg,https://derpicdn.net/img/view/2015/1/22/812287.jpg,3,0.9799469113349916,32,3,252,223,220,220,applejack|fluttershy|mane six|pinkie pie|rainbow dash|rarity|twilight sparkle,alliemackie
812287.jpg,https://derpicdn.net/img/view/2015/1/22/812287.jpg,4,0.9494670629501344,373,0,595,214,222,214,applejack|fluttershy|mane six|pinkie pie|rainbow dash|rarity|twilight sparkle,alliemackie
812287.jpg,https://derpicdn.net/img/view/2015/1/22/812287.jpg,5,0.9454262256622314,69,392,293,616,224,224,applejack|fluttershy|mane six|pinkie pie|rainbow dash|rarity|twilight sparkle,alliemackie
815375.png,https://derpicdn.net/img/view/2015/1/26/815375.png,0,0.9965758323669434,19,40,199,220,180,180,applejack|fluttershy|mane six|pinkie pie|rainbow dash|rarity|twilight sparkle,scobionicle99
815375.png,https://derpicdn.net/img/view/2015/1/26/815375.png,1,0.9926201105117798,1074,31,1276,233,202,202,applejack|fluttershy|mane six|pinkie pie|rainbow dash|rarity|twilight sparkle,scobionicle99
816536.png,https://derpicdn.net/img/view/2015/1/28/816536.png,0,0.9931008219718932,85,404,1377,1696,1292,1292,fluttershy|twilight sparkle,fluffyxai
819014.png,https://derpicdn.net/img/view/2015/2/1/819014.png,1,0.976242184638977,372,195,620,443,248,248,applejack|discord|fluttershy|twilight sparkle,dovethekitty
819595.jpg,https://derpicdn.net/img/view/2015/2/2/819595.jpg,0,0.9757418632507324,654,284,810,440,156,156,applejack|fluttershy|mane six|pinkie pie|rainbow dash|rarity|twilight sparkle,
824838.png,https://derpicdn.net/img/view/2015/2/9/824838.png,0,0.9976496696472168,527,0,965,395,438,395,applejack|twilight sparkle,mushroomcookiebear
825018.png,https://derpicdn.net/img/view/2015/2/9/825018.png,0,0.9769611954689026,311,3,523,215,212,212,trixie|twilight sparkle,weiliy
8307.jpg,https://derpicdn.net/img/view/2012/6/18/8307.jpg,0,0.99772709608078,830,663,1340,1173,510,510,applejack|fluttershy|mane six|pinkie pie|rainbow dash|rarity|twilight sparkle,kaizenwerx
830847.png,https://derpicdn.net/img/view/2015/2/17/830847.png,0,0.9131636023521424,2311,1484,3395,2568,1084,1084,applejack|fluttershy|mane six|pinkie pie|rainbow dash|rarity|twilight sparkle,jeatz-axl
833004.png,https://derpicdn.net/img/view/2015/2/20/833004.png,0,0.9966193437576294,1263,1359,1500,1617,237,258,pinkie pie|rainbow dash|rarity|twilight sparkle,
833004.png,https://derpicdn.net/img/view/2015/2/20/833004.png,1,0.9940518736839294,0,0,825,1077,825,1077,pinkie pie|rainbow dash|rarity|twilight sparkle,
833599.png,https://derpicdn.net/img/view/2015/2/21/833599.png,1,0.9707913398742676,391,741,999,1349,608,608,applejack|fluttershy|mane six|pinkie pie|rainbow dash|rarity|twilight sparkle,anticular
833907.png,https://derpicdn.net/img/view/2015/2/21/833907.png,0,0.9024798274040222,32,284,368,620,336,336,princess luna|twilight sparkle,kodabomb
834163.png,https://derpicdn.net/img/view/2015/2/21/834163.png,0,0.9942057132720948,220,37,888,705,668,668,fluttershy|twilight sparkle,inkie-heart
835656.png,https://derpicdn.net/img/view/2015/2/23/835656.png,0,0.9901666045188904,1668,210,2232,774,564,564,princess cadance|princess celestia|princess luna|twilight sparkle,subduedmoon
835656.png,https://derpicdn.net/img/view/2015/2/23/835656.png,1,0.9792266488075256,388,256,1100,968,712,712,princess cadance|princess celestia|princess luna|twilight sparkle,subduedmoon
83661.png,https://derpicdn.net/img/view/2012/8/27/83661.png,0,0.9882037043571472,501,318,1173,990,672,672,applejack|fluttershy|mane six|pinkie pie|rainbow dash|rarity|twilight sparkle,turbojuk
83661.png,https://derpicdn.net/img/view/2012/8/27/83661.png,1,0.9788665771484376,1901,822,2311,1232,410,410,applejack|fluttershy|mane six|pinkie pie|rainbow dash|rarity|twilight sparkle,turbojuk
836760.png,https://derpicdn.net/img/view/2015/2/24/836760.png,0,0.9997201561927797,2214,99,2972,857,758,758,fluttershy|pinkie pie|twilight sparkle,artyjoyful
836760.png,https://derpicdn.net/img/view/2015/2/24/836760.png,1,0.9989723563194276,0,81,780,885,780,804,fluttershy|pinkie pie|twilight sparkle,artyjoyful
836760.png,https://derpicdn.net/img/view/2015/2/24/836760.png,2,0.9788055419921876,938,0,2036,1039,1098,1039,fluttershy|pinkie pie|twilight sparkle,artyjoyful
840756.png,https://derpicdn.net/img/view/2015/3/2/840756.png,0,0.951586663722992,654,742,1426,1514,772,772,spike|twilight sparkle,alskylark
842547.png,https://derpicdn.net/img/view/2015/3/5/842547.png,0,0.984119176864624,728,0,2336,1539,1608,1539,rainbow dash|twilight sparkle,shutterflyeqd
843531.jpg,https://derpicdn.net/img/view/2015/3/6/843531.jpg,0,0.9991291761398317,941,0,1311,362,370,362,applejack|fluttershy|mane six|pinkie pie|rainbow dash|rarity|spike|twilight sparkle,mornincloud
843531.jpg,https://derpicdn.net/img/view/2015/3/6/843531.jpg,1,0.9981824159622192,1152,405,1500,769,348,364,applejack|fluttershy|mane six|pinkie pie|rainbow dash|rarity|spike|twilight sparkle,mornincloud
843531.jpg,https://derpicdn.net/img/view/2015/3/6/843531.jpg,2,0.9962373971939088,978,449,1290,761,312,312,applejack|fluttershy|mane six|pinkie pie|rainbow dash|rarity|spike|twilight sparkle,mornincloud
843531.jpg,https://derpicdn.net/img/view/2015/3/6/843531.jpg,3,0.9754895567893982,217,434,527,744,310,310,applejack|fluttershy|mane six|pinkie pie|rainbow dash|rarity|spike|twilight sparkle,mornincloud
846613.png,https://derpicdn.net/img/view/2015/3/10/846613.png,3,0.9168553948402404,188,213,570,595,382,382,princess cadance|princess celestia|princess luna|twilight sparkle,vanillafox2035
8474.png,https://derpicdn.net/img/view/2012/6/18/8474.png,0,0.9409787654876708,1312,577,1680,945,368,368,applejack|discord|fluttershy|mane six|pinkie pie|rainbow dash|rarity|twilight sparkle,kroliath
847430.png,https://derpicdn.net/img/view/2015/3/11/847430.png,0,0.9978739619255066,299,274,557,532,258,258,apple bloom|twilight sparkle,novaquinmat
8478.png,https://derpicdn.net/img/view/2012/6/18/8478.png,0,0.9991257786750792,892,0,1326,411,434,411,trixie|twilight sparkle,kroliath
8478.png,https://derpicdn.net/img/view/2012/6/18/8478.png,1,0.9920014142990112,163,149,669,655,506,506,trixie|twilight sparkle,kroliath
849372.png,https://derpicdn.net/img/view/2015/3/14/849372.png,0,0.9950483441352844,888,110,1720,942,832,832,spike|twilight sparkle,wodahseht|bri-sta
851990.png,https://derpicdn.net/img/view/2015/3/18/851990.png,0,0.9893326163291932,245,473,409,637,164,164,applejack|fluttershy|pinkie pie|rainbow dash|rarity|twilight sparkle,
852131.jpg,https://derpicdn.net/img/view/2015/3/18/852131.jpg,0,0.9755967855453492,27,316,387,676,360,360,fluttershy|twilight sparkle,starbat
857413.png,https://derpicdn.net/img/view/2015/3/26/857413.png,1,0.937386989593506,1914,656,3014,1756,1100,1100,princess celestia|twilight sparkle,kaleysia
861095.png,https://derpicdn.net/img/view/2015/3/31/861095.png,0,0.997796595096588,826,212,1252,638,426,426,pinkie pie|twilight sparkle,poisindoodles
861095.png,https://derpicdn.net/img/view/2015/3/31/861095.png,1,0.9862914681434632,84,387,562,865,478,478,pinkie pie|twilight sparkle,poisindoodles
864072.png,https://derpicdn.net/img/view/2015/4/3/864072.png,0,0.9744783043861388,0,0,316,310,316,310,princess celestia|princess luna|twilight sparkle,ooxkatiekatxoo
866440.png,https://derpicdn.net/img/view/2015/4/6/866440.png,0,0.9830312728881836,416,0,962,542,546,542,starlight glimmer|twilight sparkle,karzii
86652.jpg,https://derpicdn.net/img/view/2012/8/30/86652.jpg,0,0.9739575386047364,2371,849,2874,1357,503,508,princess celestia|princess luna|twilight sparkle,holivi
867072.jpg,https://derpicdn.net/img/view/2015/4/6/867072.jpg,0,0.9945329427719116,1210,623,1504,917,294,294,applejack|fluttershy|pinkie pie|rainbow dash|rarity|twilight sparkle,
867072.jpg,https://derpicdn.net/img/view/2015/4/6/867072.jpg,1,0.9499462246894836,1305,93,1767,555,462,462,applejack|fluttershy|pinkie pie|rainbow dash|rarity|twilight sparkle,
867949.png,https://derpicdn.net/img/view/2015/4/7/867949.png,0,0.9867088794708252,502,105,926,529,424,424,applejack|fluttershy|mane six|pinkie pie|rainbow dash|rarity|twilight sparkle,edcom02|krynos79
869737.png,https://derpicdn.net/img/view/2015/4/9/869737.png,0,0.9876759052276612,82,168,518,604,436,436,rainbow dash|twilight sparkle,lostinthetrees
871571.jpg,https://derpicdn.net/img/view/2015/4/11/871571.jpg,0,0.9805092811584472,445,0,871,319,426,319,spike|twilight sparkle,
872300.png,https://derpicdn.net/img/view/2015/4/12/872300.png,0,0.9786719679832458,328,0,871,535,543,535,applejack|pinkie pie|rarity|twilight sparkle,
873027.png,https://derpicdn.net/img/view/2015/4/13/873027.png,0,0.9926245212554932,687,172,927,412,240,240,rainbow dash|twilight sparkle,
874266.png,https://derpicdn.net/img/view/2015/4/15/874266.png,3,0.9535230398178101,1713,754,2000,1066,287,312,applejack|fluttershy|mane six|pinkie pie|princess celestia|princess luna|rainbow dash|rarity|trixie|twilight sparkle,thealjavis
884143.png,https://derpicdn.net/img/view/2015/4/27/884143.png,0,0.9891608953475952,428,26,1024,634,596,608,spike|twilight sparkle,wolfy-pony
884192.png,https://derpicdn.net/img/view/2015/4/27/884192.png,0,0.9994574785232544,97,1389,277,1569,180,180,princess celestia|twilight sparkle,deusexequus
886923.jpg,https://derpicdn.net/img/view/2015/5/1/886923.jpg,3,0.9606114029884338,887,338,1127,578,240,240,apple bloom|applejack|cutie mark crusaders|fluttershy|mane six|pinkie pie|princess cadance|princess celestia|princess luna|rainbow dash|rarity|scootaloo|sweetie belle|twilight sparkle,ponygoddess
886923.jpg,https://derpicdn.net/img/view/2015/5/1/886923.jpg,4,0.9443137049674988,697,419,917,639,220,220,apple bloom|applejack|cutie mark crusaders|fluttershy|mane six|pinkie pie|princess cadance|princess celestia|princess luna|rainbow dash|rarity|scootaloo|sweetie belle|twilight sparkle,ponygoddess
891216.png,https://derpicdn.net/img/view/2015/5/7/891216.png,0,0.9737452864646912,0,431,269,747,269,316,applejack|discord|fluttershy|mane six|pinkie pie|princess luna|rainbow dash|rarity|twilight sparkle,paradigmpizza
893922.png,https://derpicdn.net/img/view/2015/5/11/893922.png,0,0.9774271845817566,3807,1132,5389,2714,1582,1582,applejack|rainbow dash|rarity|twilight sparkle,djdavid98|uxyd
894196.png,https://derpicdn.net/img/view/2015/5/11/894196.png,0,0.9960724711418152,1533,483,2199,1149,666,666,applejack|fluttershy|lightning dust|mane six|pinkie pie|rainbow dash|rarity|sunset shimmer|trixie|twilight sparkle,anarchemitis
897147.jpg,https://derpicdn.net/img/view/2015/5/16/897147.jpg,0,0.9865429997444152,271,146,583,458,312,312,princess celestia|twilight sparkle,
89772.jpg,https://derpicdn.net/img/view/2012/9/4/89772.jpg,2,0.9104735255241394,1389,847,1593,1051,204,204,apple bloom|applejack|big macintosh|cutie mark crusaders|fluttershy|pinkie pie|princess cadance|queen chrysalis|rainbow dash|rarity|scootaloo|shining armor|spike|sweetie belle|twilight sparkle,
8982.jpg,https://derpicdn.net/img/view/2012/6/19/8982.jpg,0,0.9826051592826844,1004,0,1770,649,766,649,rainbow dash|twilight sparkle,nyuuchandiannepie
8985.jpg,https://derpicdn.net/img/view/2012/6/19/8985.jpg,0,0.9962101578712464,825,12,1447,634,622,622,rainbow dash|twilight sparkle,nyuuchandiannepie
900421.png,https://derpicdn.net/img/view/2015/5/20/900421.png,0,0.99656879901886,565,84,791,310,226,226,applejack|fluttershy|mane six|pinkie pie|rainbow dash|rarity|spike|twilight sparkle,jorobro
903076.png,https://derpicdn.net/img/view/2015/5/24/903076.png,0,0.9991918206214904,661,0,1819,949,1158,949,apple bloom|twilight sparkle,tizerfiction
907476.png,https://derpicdn.net/img/view/2015/5/31/907476.png,0,0.9638162851333618,167,153,355,341,188,188,applejack|fluttershy|mane six|pinkie pie|rainbow dash|rarity|spike|twilight sparkle,phyllismi
908557.png,https://derpicdn.net/img/view/2015/6/2/908557.png,0,0.9833993315696716,327,0,735,399,408,399,rainbow dash|twilight sparkle,clouddg
910629.png,https://derpicdn.net/img/view/2015/6/5/910629.png,0,0.9804182648658752,315,113,681,479,366,366,sunset shimmer|trixie|twilight sparkle,novaspark
914018.png,https://derpicdn.net/img/view/2015/6/10/914018.png,0,0.9875146746635436,2164,334,2752,1018,588,684,apple bloom|cutie mark crusaders|diamond tiara|fluttershy|rainbow dash|rarity|scootaloo|silver spoon|sweetie belle|twilight sparkle,
915681.png,https://derpicdn.net/img/view/2015/6/13/915681.png,0,0.9995248317718506,0,1905,244,2173,244,268,applejack|fluttershy|mane six|pinkie pie|princess cadance|princess celestia|princess luna|rainbow dash|rarity|spike|twilight sparkle,rue-willings
915681.png,https://derpicdn.net/img/view/2015/6/13/915681.png,2,0.9670038223266602,18,0,472,401,454,401,applejack|fluttershy|mane six|pinkie pie|princess cadance|princess celestia|princess luna|rainbow dash|rarity|spike|twilight sparkle,rue-willings
915681.png,https://derpicdn.net/img/view/2015/6/13/915681.png,3,0.9465705752372742,643,1372,991,1720,348,348,applejack|fluttershy|mane six|pinkie pie|princess cadance|princess celestia|princess luna|rainbow dash|rarity|spike|twilight sparkle,rue-willings
916999.png,https://derpicdn.net/img/view/2015/6/14/916999.png,0,0.903471827507019,234,0,522,202,288,202,rarity|twilight sparkle,silverscarf
918117.png,https://derpicdn.net/img/view/2015/6/16/918117.png,0,0.9453272223472596,234,0,490,248,256,248,applejack|fluttershy|mane six|pinkie pie|rainbow dash|rarity|twilight sparkle,dsana
919042.png,https://derpicdn.net/img/view/2015/6/18/919042.png,0,0.9903004765510559,1762,0,3550,1656,1788,1656,spike|twilight sparkle,porygon2z
919479.png,https://derpicdn.net/img/view/2015/6/18/919479.png,0,0.9951695203781128,25,2,493,470,468,468,applejack|fluttershy|mane six|pinkie pie|rainbow dash|rarity|twilight sparkle,9de-light6
919479.png,https://derpicdn.net/img/view/2015/6/18/919479.png,3,0.9648601412773132,90,931,532,1373,442,442,applejack|fluttershy|mane six|pinkie pie|rainbow dash|rarity|twilight sparkle,9de-light6
920141.png,https://derpicdn.net/img/view/2015/6/20/920141.png,0,0.9763240814208984,1304,0,2580,1174,1276,1174,starlight glimmer|sunset shimmer|trixie|twilight sparkle,thecheeseburger
920141.png,https://derpicdn.net/img/view/2015/6/20/920141.png,1,0.9742999076843262,4526,0,5906,1234,1380,1234,starlight glimmer|sunset shimmer|trixie|twilight sparkle,thecheeseburger
920141.png,https://derpicdn.net/img/view/2015/6/20/920141.png,2,0.9690318703651428,103,2160,991,3048,888,888,starlight glimmer|sunset shimmer|trixie|twilight sparkle,thecheeseburger
920413.png,https://derpicdn.net/img/view/2015/6/20/920413.png,0,0.9182320237159728,311,180,589,458,278,278,spike|twilight sparkle,kleineluhnar
921250.png,https://derpicdn.net/img/view/2015/6/21/921250.png,1,0.9901710748672484,219,0,535,292,316,292,applejack|fluttershy|mane six|pinkie pie|rainbow dash|rarity|twilight sparkle,karmamoonshadow
921250.png,https://derpicdn.net/img/view/2015/6/21/921250.png,2,0.961467742919922,93,649,409,965,316,316,applejack|fluttershy|mane six|pinkie pie|rainbow dash|rarity|twilight sparkle,karmamoonshadow
923138.png,https://derpicdn.net/img/view/2015/6/24/923138.png,0,0.990982174873352,497,4,1231,738,734,734,trixie|twilight sparkle,alittleofsomething
923138.png,https://derpicdn.net/img/view/2015/6/24/923138.png,1,0.9618431329727172,1009,0,1729,691,720,691,trixie|twilight sparkle,alittleofsomething
924525.png,https://derpicdn.net/img/view/2015/6/27/924525.png,0,0.9748720526695251,25,70,351,396,326,326,princess celestia|rainbow dash|twilight sparkle,ame-baki
924841.png,https://derpicdn.net/img/view/2015/6/27/924841.png,0,0.9889455437660216,1632,603,1920,923,288,320,applejack|rainbow dash|rarity|twilight sparkle,
926440.png,https://derpicdn.net/img/view/2015/6/29/926440.png,0,0.977878212928772,2384,781,3308,1705,924,924,applejack|fluttershy|mane six|pinkie pie|rainbow dash|rarity|spike|twilight sparkle,theshadowstone|flarescale
926440.png,https://derpicdn.net/img/view/2015/6/29/926440.png,1,0.957723081111908,1548,1142,2620,2214,1072,1072,applejack|fluttershy|mane six|pinkie pie|rainbow dash|rarity|spike|twilight sparkle,theshadowstone|flarescale
926440.png,https://derpicdn.net/img/view/2015/6/29/926440.png,2,0.943261444568634,773,1508,1647,2382,874,874,applejack|fluttershy|mane six|pinkie pie|rainbow dash|rarity|spike|twilight sparkle,theshadowstone|flarescale
92743.png,https://derpicdn.net/img/view/2012/9/8/92743.png,0,0.9938414692878724,734,1089,1022,1377,288,288,applejack|fluttershy|mane six|pinkie pie|rainbow dash|rarity|twilight sparkle,flamehusky
92743.png,https://derpicdn.net/img/view/2012/9/8/92743.png,1,0.993109941482544,72,1131,348,1407,276,276,applejack|fluttershy|mane six|pinkie pie|rainbow dash|rarity|twilight sparkle,flamehusky
92934.png,https://derpicdn.net/img/view/2012/9/8/92934.png,0,0.9710779786109924,566,249,786,469,220,220,princess celestia|princess luna|rainbow dash|twilight sparkle,dobromyslov
931385.png,https://derpicdn.net/img/view/2015/7/6/931385.png,1,0.961288332939148,306,0,1222,825,916,825,spike|starlight glimmer|twilight sparkle,demigod-spike|paragonaj
933433.png,https://derpicdn.net/img/view/2015/7/9/933433.png,0,0.914679229259491,547,61,849,363,302,302,spike|twilight sparkle,dashiesparkle|sailortrekkie92
934882.png,https://derpicdn.net/img/view/2015/7/11/934882.png,0,0.9644635915756226,486,295,930,739,444,444,applejack|fluttershy|mane six|pinkie pie|rainbow dash|rarity|twilight sparkle,
934882.png,https://derpicdn.net/img/view/2015/7/11/934882.png,1,0.9545493721961976,63,646,455,1038,392,392,applejack|fluttershy|mane six|pinkie pie|rainbow dash|rarity|twilight sparkle,
935710.png,https://derpicdn.net/img/view/2015/7/12/935710.png,1,0.9329478740692142,915,105,1197,387,282,282,spike|twilight sparkle,zetapold
939708.png,https://derpicdn.net/img/view/2015/7/19/939708.png,0,0.9901784658432008,164,1200,846,1882,682,682,princess celestia|twilight sparkle,dsp2003|mrs1989
944230.png,https://derpicdn.net/img/view/2015/7/26/944230.png,0,0.9987740516662598,857,51,1699,893,842,842,pinkie pie|princess celestia|rarity|shining armor|twilight sparkle,indexpony
944230.png,https://derpicdn.net/img/view/2015/7/26/944230.png,1,0.95527583360672,237,233,875,871,638,638,pinkie pie|princess celestia|rarity|shining armor|twilight sparkle,indexpony
946489.jpg,https://derpicdn.net/img/view/2015/7/29/946489.jpg,0,0.9449462890625,367,189,629,451,262,262,apple bloom|applejack|big macintosh|braeburn|cutie mark crusaders|diamond tiara|fluttershy|granny smith|mane six|pinkie pie|princess cadance|princess celestia|princess luna|rainbow dash|rarity|scootaloo|shining armor|silver spoon|soarin'|spitfire|sweetie belle|trixie|twilight sparkle,
949893.png,https://derpicdn.net/img/view/2015/8/3/949893.png,0,0.9864129424095154,517,0,721,194,204,194,princess celestia|twilight sparkle,pokekid963
949893.png,https://derpicdn.net/img/view/2015/8/3/949893.png,1,0.9508196711540222,161,128,453,420,292,292,princess celestia|twilight sparkle,pokekid963
951601.png,https://derpicdn.net/img/view/2015/8/5/951601.png,0,0.9982659816741944,536,680,1656,1800,1120,1120,trixie|twilight sparkle,dazed-and-wandering
951601.png,https://derpicdn.net/img/view/2015/8/5/951601.png,1,0.9979923367500304,1957,579,3019,1641,1062,1062,trixie|twilight sparkle,dazed-and-wandering
952329.png,https://derpicdn.net/img/view/2015/8/6/952329.png,0,0.9939613938331604,337,224,487,374,150,150,apple bloom|applejack|big macintosh|cutie mark crusaders|fluttershy|pinkie pie|princess cadance|princess celestia|princess luna|rainbow dash|scootaloo|spike|sweetie belle|twilight sparkle,pixel-prism
952329.png,https://derpicdn.net/img/view/2015/8/6/952329.png,1,0.9911616444587708,183,155,349,321,166,166,apple bloom|applejack|big macintosh|cutie mark crusaders|fluttershy|pinkie pie|princess cadance|princess celestia|princess luna|rainbow dash|scootaloo|spike|sweetie belle|twilight sparkle,pixel-prism
953137.png,https://derpicdn.net/img/view/2015/8/7/953137.png,1,0.9678977131843568,1759,0,3047,1084,1288,1084,applejack|fluttershy|mane six|pinkie pie|rainbow dash|rarity|twilight sparkle,dashiemlpfim|xebck
953137.png,https://derpicdn.net/img/view/2015/8/7/953137.png,2,0.9470619559288024,978,1451,2128,2601,1150,1150,applejack|fluttershy|mane six|pinkie pie|rainbow dash|rarity|twilight sparkle,dashiemlpfim|xebck
95343.png,https://derpicdn.net/img/view/2012/9/11/95343.png,0,0.9981992244720459,606,55,1108,557,502,502,pinkie pie|rainbow dash|twilight sparkle,lolopan
95343.png,https://derpicdn.net/img/view/2012/9/11/95343.png,1,0.9854558110237122,993,39,1569,615,576,576,pinkie pie|rainbow dash|twilight sparkle,lolopan
957670.png,https://derpicdn.net/img/view/2015/8/14/957670.png,0,0.9737213253974916,1531,291,1920,683,389,392,applejack|fluttershy|mane six|pinkie pie|princess luna|rainbow dash|rarity|twilight sparkle,nightsilverchelly
957670.png,https://derpicdn.net/img/view/2015/8/14/957670.png,1,0.9554657936096193,926,102,1326,502,400,400,applejack|fluttershy|mane six|pinkie pie|princess luna|rainbow dash|rarity|twilight sparkle,nightsilverchelly
960896.png,https://derpicdn.net/img/view/2015/8/19/960896.png,0,0.9977211356163024,2,0,336,281,334,281,spike|twilight sparkle,marinakirby
963378.png,https://derpicdn.net/img/view/2015/8/22/963378.png,0,0.9658249020576476,0,18,2109,2384,2109,2366,trixie|twilight sparkle,novaspark
964801.png,https://derpicdn.net/img/view/2015/8/24/964801.png,0,0.9939842224121094,547,384,1337,1174,790,790,trixie|twilight sparkle,phallen1
964801.png,https://derpicdn.net/img/view/2015/8/24/964801.png,1,0.9939690828323364,0,407,586,1021,586,614,trixie|twilight sparkle,phallen1
964959.jpg,https://derpicdn.net/img/view/2015/8/24/964959.jpg,0,0.976332664489746,799,459,1131,720,332,261,fluttershy|twilight sparkle,ntheping
966405.jpg,https://derpicdn.net/img/view/2015/8/26/966405.jpg,1,0.9891003966331482,1681,31,2393,743,712,712,applejack|fluttershy|mane six|pinkie pie|rainbow dash|rarity|twilight sparkle,canvymamamoo
966405.jpg,https://derpicdn.net/img/view/2015/8/26/966405.jpg,2,0.9853528738021852,1246,977,2202,1933,956,956,applejack|fluttershy|mane six|pinkie pie|rainbow dash|rarity|twilight sparkle,canvymamamoo
966405.jpg,https://derpicdn.net/img/view/2015/8/26/966405.jpg,3,0.9805501103401184,71,1083,881,1893,810,810,applejack|fluttershy|mane six|pinkie pie|rainbow dash|rarity|twilight sparkle,canvymamamoo
966405.jpg,https://derpicdn.net/img/view/2015/8/26/966405.jpg,4,0.916597068309784,0,2164,870,3194,870,1030,applejack|fluttershy|mane six|pinkie pie|rainbow dash|rarity|twilight sparkle,canvymamamoo
967080.png,https://derpicdn.net/img/view/2015/8/27/967080.png,0,0.9882121682167052,527,155,1000,733,473,578,applejack|fluttershy|mane six|pinkie pie|rainbow dash|rarity|twilight sparkle,1trick
967080.png,https://derpicdn.net/img/view/2015/8/27/967080.png,1,0.9244456887245178,0,1221,496,1691,496,470,applejack|fluttershy|mane six|pinkie pie|rainbow dash|rarity|twilight sparkle,1trick
967080.png,https://derpicdn.net/img/view/2015/8/27/967080.png,3,0.9103261828422546,0,616,553,1292,553,676,applejack|fluttershy|mane six|pinkie pie|rainbow dash|rarity|twilight sparkle,1trick
967080.png,https://derpicdn.net/img/view/2015/8/27/967080.png,4,0.9101210236549376,0,61,649,729,649,668,applejack|fluttershy|mane six|pinkie pie|rainbow dash|rarity|twilight sparkle,1trick
967969.png,https://derpicdn.net/img/view/2015/8/29/967969.png,0,0.9982092976570128,107,199,509,601,402,402,spike|twilight sparkle,spectralunicorn
969301.png,https://derpicdn.net/img/view/2015/8/30/969301.png,0,0.9814151525497437,1425,756,1813,1144,388,388,princess luna|twilight sparkle,blackfreya
970600.png,https://derpicdn.net/img/view/2015/9/1/970600.png,0,0.9945074915885924,1477,0,2603,1070,1126,1070,pinkie pie|twilight sparkle,sintakhra
970600.png,https://derpicdn.net/img/view/2015/9/1/970600.png,1,0.9222045540809632,461,0,1677,1105,1216,1105,pinkie pie|twilight sparkle,sintakhra
972521.png,https://derpicdn.net/img/view/2015/9/4/972521.png,0,0.9873316884040833,938,1018,1396,1476,458,458,applejack|discord|fluttershy|princess cadance|soarin'|spike|spitfire|twilight sparkle,knadire|knadow-the-hechidna
972521.png,https://derpicdn.net/img/view/2015/9/4/972521.png,1,0.937308132648468,212,1313,578,1679,366,366,applejack|discord|fluttershy|princess cadance|soarin'|spike|spitfire|twilight sparkle,knadire|knadow-the-hechidna
975395.png,https://derpicdn.net/img/view/2015/9/8/975395.png,0,0.9971228241920472,687,94,981,388,294,294,pinkie pie|twilight sparkle,empyu
97614.jpg,https://derpicdn.net/img/view/2012/9/14/97614.jpg,0,0.9946720004081726,612,0,754,141,142,141,apple bloom|applejack|big macintosh|braeburn|fluttershy|pinkie pie|princess celestia|princess luna|rainbow dash|rarity|scootaloo|soarin'|spike|spitfire|sweetie belle|trixie|twilight sparkle,moloko-plus
97614.jpg,https://derpicdn.net/img/view/2012/9/14/97614.jpg,3,0.9135825634002686,98,647,292,841,194,194,apple bloom|applejack|big macintosh|braeburn|fluttershy|pinkie pie|princess celestia|princess luna|rainbow dash|rarity|scootaloo|soarin'|spike|spitfire|sweetie belle|trixie|twilight sparkle,moloko-plus
977488.png,https://derpicdn.net/img/view/2015/9/11/977488.png,0,0.9938781261444092,479,151,711,383,232,232,applejack|fluttershy|mane six|pinkie pie|rainbow dash|rarity|twilight sparkle,theshadowstone
977488.png,https://derpicdn.net/img/view/2015/9/11/977488.png,1,0.9663503766059875,327,144,549,366,222,222,applejack|fluttershy|mane six|pinkie pie|rainbow dash|rarity|twilight sparkle,theshadowstone
977488.png,https://derpicdn.net/img/view/2015/9/11/977488.png,3,0.924359917640686,653,124,941,412,288,288,applejack|fluttershy|mane six|pinkie pie|rainbow dash|rarity|twilight sparkle,theshadowstone
979642.png,https://derpicdn.net/img/view/2015/9/14/979642.png,0,0.9922286868095398,2195,777,2857,1439,662,662,applejack|fluttershy|mane six|pinkie pie|princess celestia|rainbow dash|rarity|twilight sparkle,dormin-kanna
979642.png,https://derpicdn.net/img/view/2015/9/14/979642.png,1,0.9838420152664183,1051,1018,1555,1522,504,504,applejack|fluttershy|mane six|pinkie pie|princess celestia|rainbow dash|rarity|twilight sparkle,dormin-kanna
979642.png,https://derpicdn.net/img/view/2015/9/14/979642.png,2,0.9236255884170532,1618,278,2242,902,624,624,applejack|fluttershy|mane six|pinkie pie|princess celestia|rainbow dash|rarity|twilight sparkle,dormin-kanna
982052.png,https://derpicdn.net/img/view/2015/9/18/982052.png,0,0.9412268996238708,404,168,760,554,356,386,sunset shimmer|twilight sparkle,pandanx12
982600.png,https://derpicdn.net/img/view/2015/9/18/982600.png,0,0.9331068396568298,113,14,405,306,292,292,spike|twilight sparkle,jurisalis
983173.png,https://derpicdn.net/img/view/2015/9/19/983173.png,0,0.978874444961548,450,188,866,604,416,416,princess luna|twilight sparkle,rawiltshire103|alixnight
984000.png,https://derpicdn.net/img/view/2015/9/20/984000.png,0,0.9959210753440856,467,88,871,492,404,404,rarity|twilight sparkle,mirululu
984597.png,https://derpicdn.net/img/view/2015/9/21/984597.png,0,0.979132354259491,1198,402,1678,882,480,480,applejack|rainbow dash|rarity|twilight sparkle,
989468.png,https://derpicdn.net/img/view/2015/9/27/989468.png,1,0.9717475175857544,480,698,1394,1612,914,914,spike|twilight sparkle,
993546.png,https://derpicdn.net/img/view/2015/10/3/993546.png,0,0.9957257509231568,499,207,703,411,204,204,applejack|fluttershy|mane six|pinkie pie|rainbow dash|rarity|sunset shimmer|twilight sparkle,potzm
993546.png,https://derpicdn.net/img/view/2015/10/3/993546.png,1,0.939457893371582,22,74,200,252,178,178,applejack|fluttershy|mane six|pinkie pie|rainbow dash|rarity|sunset shimmer|twilight sparkle,potzm
995229.png,https://derpicdn.net/img/view/2015/10/5/995229.png,1,0.9670352935791016,414,251,688,525,274,274,applejack|fluttershy|mane six|pinkie pie|rainbow dash|rarity|spike|trixie|twilight sparkle,shybaldur
997318.png,https://derpicdn.net/img/view/2015/10/8/997318.png,0,0.9768220782279968,728,81,888,241,160,160,pinkie pie|rainbow dash|twilight sparkle,trefleix
998557.png,https://derpicdn.net/img/view/2015/10/10/998557.png,0,0.9860981702804564,1489,0,2400,959,911,959,applejack|fluttershy|mane six|pinkie pie|rainbow dash|rarity|twilight sparkle,geraritydevillefort
1005012.png,https://derpicdn.net/img/view/2015/10/18/1005012.png,0,0.9865384697914124,843,0,1637,657,794,657,shining armor|twilight sparkle,
1005929.png,https://derpicdn.net/img/view/2015/10/19/1005929.png,0,0.9661293625831604,473,575,969,1071,496,496,discord|twilight sparkle,leffenkitty
1006695.png,https://derpicdn.net/img/view/2015/10/21/1006695.png,0,0.9883173108100892,1369,1220,1983,1834,614,614,apple bloom|applejack|cutie mark crusaders|fluttershy|mane six|pinkie pie|rainbow dash|rarity|scootaloo|sweetie belle|twilight sparkle,spellboundcanvas
1007435.jpg,https://derpicdn.net/img/view/2015/10/22/1007435.jpg,0,0.9529059529304504,1042,162,1428,548,386,386,fluttershy|rarity|twilight sparkle,
1007813.png,https://derpicdn.net/img/view/2015/10/23/1007813.png,0,0.998458206653595,974,228,1262,516,288,288,pinkie pie|rainbow dash|twilight sparkle,
1009775.png,https://derpicdn.net/img/view/2015/10/25/1009775.png,0,0.9497469663619996,3144,1282,3700,1864,556,582,applejack|rainbow dash|rarity|twilight sparkle,geraritydevillefort
1010153.png,https://derpicdn.net/img/view/2015/10/25/1010153.png,0,0.9994770884513856,38,0,2866,2596,2828,2596,applejack|pinkie pie|rainbow dash|rarity|twilight sparkle,revstreak
1010153.png,https://derpicdn.net/img/view/2015/10/25/1010153.png,1,0.9716269373893738,3017,599,5437,3019,2420,2420,applejack|pinkie pie|rainbow dash|rarity|twilight sparkle,revstreak
1013057.png,https://derpicdn.net/img/view/2015/10/31/1013057.png,0,0.9757516384124756,1173,3,1863,693,690,690,rainbow dash|trixie|twilight sparkle,yaasho
1015640.png,https://derpicdn.net/img/view/2015/11/3/1015640.png,0,0.9942039251327516,1088,681,1514,1107,426,426,applejack|fluttershy|mane six|pinkie pie|rainbow dash|rarity|twilight sparkle,beavernator
1015640.png,https://derpicdn.net/img/view/2015/11/3/1015640.png,1,0.9796122312545776,758,0,1478,543,720,543,applejack|fluttershy|mane six|pinkie pie|rainbow dash|rarity|twilight sparkle,beavernator
1015640.png,https://derpicdn.net/img/view/2015/11/3/1015640.png,2,0.9663442969322203,1780,646,2288,1154,508,508,applejack|fluttershy|mane six|pinkie pie|rainbow dash|rarity|twilight sparkle,beavernator
1015640.png,https://derpicdn.net/img/view/2015/11/3/1015640.png,3,0.9654030799865724,1394,712,1868,1186,474,474,applejack|fluttershy|mane six|pinkie pie|rainbow dash|rarity|twilight sparkle,beavernator
1015640.png,https://derpicdn.net/img/view/2015/11/3/1015640.png,4,0.9569052457809448,29,540,871,1382,842,842,applejack|fluttershy|mane six|pinkie pie|rainbow dash|rarity|twilight sparkle,beavernator
1015640.png,https://derpicdn.net/img/view/2015/11/3/1015640.png,5,0.9552900195121764,656,676,1162,1182,506,506,applejack|fluttershy|mane six|pinkie pie|rainbow dash|rarity|twilight sparkle,beavernator
1017887.png,https://derpicdn.net/img/view/2015/11/7/1017887.png,1,0.9909325242042542,86,116,2220,2250,2134,2134,sunset shimmer|twilight sparkle,ashtoneer
101903.jpg,https://derpicdn.net/img/view/2012/9/19/101903.jpg,0,0.9982763528823853,358,29,718,389,360,360,princess cadance|twilight sparkle,mel-rosey
1019882.png,https://derpicdn.net/img/view/2015/11/9/1019882.png,0,0.9028977155685424,41,0,1063,768,1022,768,spike|twilight sparkle,
1019923.png,https://derpicdn.net/img/view/2015/11/9/1019923.png,0,0.9528232216835022,942,261,1182,501,240,240,spike|twilight sparkle,
1019982.jpg,https://derpicdn.net/img/view/2015/11/9/1019982.jpg,0,0.9073066115379332,61,40,943,922,882,882,spike|twilight sparkle,
1022336.jpg,https://derpicdn.net/img/view/2015/11/14/1022336.jpg,0,0.9628071188926696,481,764,1054,1404,573,640,rainbow dash|twilight sparkle,tonyfleecs
1022337.jpg,https://derpicdn.net/img/view/2015/11/14/1022337.jpg,0,0.9930503964424132,189,768,917,1496,728,728,rainbow dash|twilight sparkle,brendahickey
1022337.jpg,https://derpicdn.net/img/view/2015/11/14/1022337.jpg,1,0.948823094367981,181,451,731,1001,550,550,rainbow dash|twilight sparkle,brendahickey
10240.png,https://derpicdn.net/img/view/2012/6/19/10240.png,1,0.9992706179618835,0,413,213,629,213,216,applejack|fluttershy|mane six|pinkie pie|rainbow dash|rarity|twilight sparkle,bamboodog
10240.png,https://derpicdn.net/img/view/2012/6/19/10240.png,2,0.9915089011192322,265,451,493,679,228,228,applejack|fluttershy|mane six|pinkie pie|rainbow dash|rarity|twilight sparkle,bamboodog
10240.png,https://derpicdn.net/img/view/2012/6/19/10240.png,3,0.9617197513580322,197,0,393,195,196,195,applejack|fluttershy|mane six|pinkie pie|rainbow dash|rarity|twilight sparkle,bamboodog
10240.png,https://derpicdn.net/img/view/2012/6/19/10240.png,4,0.920141100883484,486,294,674,482,188,188,applejack|fluttershy|mane six|pinkie pie|rainbow dash|rarity|twilight sparkle,bamboodog
1024485.png,https://derpicdn.net/img/view/2015/11/17/1024485.png,0,0.9756776690483092,604,740,836,972,232,232,applejack|fluttershy|mane six|pinkie pie|rainbow dash|rarity|spike|twilight sparkle,
1027116.png,https://derpicdn.net/img/view/2015/11/21/1027116.png,0,0.9250447750091552,548,780,900,1132,352,352,applejack|fluttershy|pinkie pie|rarity|twilight sparkle,
1029924.png,https://derpicdn.net/img/view/2015/11/25/1029924.png,0,0.9712292551994324,1025,320,1355,650,330,330,applejack|fluttershy|mane six|pinkie pie|rainbow dash|rarity|twilight sparkle,storm-flash
1029924.png,https://derpicdn.net/img/view/2015/11/25/1029924.png,1,0.9120118618011476,575,562,827,814,252,252,applejack|fluttershy|mane six|pinkie pie|rainbow dash|rarity|twilight sparkle,storm-flash
1030782.png,https://derpicdn.net/img/view/2015/11/26/1030782.png,0,0.9629847407341005,360,54,852,545,492,491,sunset shimmer|twilight sparkle,lyx-d
1031494.png,https://derpicdn.net/img/view/2015/11/28/1031494.png,0,0.966569483280182,128,0,367,259,239,259,rarity|twilight sparkle,
1031999.png,https://derpicdn.net/img/view/2015/11/28/1031999.png,0,0.9292519092559814,1133,561,1601,1029,468,468,apple bloom|cutie mark crusaders|scootaloo|sweetie belle|twilight sparkle,
1032817.png,https://derpicdn.net/img/view/2015/11/29/1032817.png,0,0.9917370080947876,888,169,1276,557,388,388,pinkie pie|twilight sparkle,jamescorck
1032817.png,https://derpicdn.net/img/view/2015/11/29/1032817.png,1,0.9817741513252258,1394,0,2034,621,640,621,pinkie pie|twilight sparkle,jamescorck
1033498.jpg,https://derpicdn.net/img/view/2015/11/30/1033498.jpg,0,0.9614467620849608,418,0,1280,686,862,686,fluttershy|twilight sparkle,
1036265.png,https://derpicdn.net/img/view/2015/12/3/1036265.png,0,0.9279513359069824,1299,0,3850,2391,2551,2391,starlight glimmer|twilight sparkle,ardentwing
1037477.jpg,https://derpicdn.net/img/view/2015/12/5/1037477.jpg,0,0.9973716139793396,532,83,848,399,316,316,trixie|twilight sparkle,quakehoof
1037477.jpg,https://derpicdn.net/img/view/2015/12/5/1037477.jpg,1,0.9955854415893556,200,151,612,563,412,412,trixie|twilight sparkle,quakehoof
10384.jpg,https://derpicdn.net/img/view/2012/6/19/10384.jpg,0,0.9670735597610474,279,165,671,557,392,392,spike|twilight sparkle,mohawkrex
1042691.png,https://derpicdn.net/img/view/2015/12/12/1042691.png,0,0.9895344376564026,7243,5387,9523,7667,2280,2280,applejack|fluttershy|mane six|pinkie pie|rainbow dash|rarity|twilight sparkle,pinipy
1042691.png,https://derpicdn.net/img/view/2015/12/12/1042691.png,1,0.9868115186691284,393,5403,2617,7627,2224,2224,applejack|fluttershy|mane six|pinkie pie|rainbow dash|rarity|twilight sparkle,pinipy
1042691.png,https://derpicdn.net/img/view/2015/12/12/1042691.png,2,0.9832856059074402,3723,487,6101,2865,2378,2378,applejack|fluttershy|mane six|pinkie pie|rainbow dash|rarity|twilight sparkle,pinipy
1042691.png,https://derpicdn.net/img/view/2015/12/12/1042691.png,4,0.9089381098747252,7972,820,9542,2390,1570,1570,applejack|fluttershy|mane six|pinkie pie|rainbow dash|rarity|twilight sparkle,pinipy
1044726.png,https://derpicdn.net/img/view/2015/12/15/1044726.png,0,0.9000653028488159,185,797,383,995,198,198,starlight glimmer|sunset shimmer|trixie|twilight sparkle,dragonpone
1044850.png,https://derpicdn.net/img/view/2015/12/15/1044850.png,0,0.991109311580658,361,420,801,860,440,440,shining armor|twilight sparkle,paperlover
1044850.png,https://derpicdn.net/img/view/2015/12/15/1044850.png,1,0.9858706593513488,549,0,960,458,411,458,shining armor|twilight sparkle,paperlover
1044865.png,https://derpicdn.net/img/view/2015/12/15/1044865.png,0,0.9912096858024596,525,21,933,429,408,408,shining armor|twilight sparkle,paperlover
1044865.png,https://derpicdn.net/img/view/2015/12/15/1044865.png,1,0.9904425144195556,392,735,838,1181,446,446,shining armor|twilight sparkle,paperlover
1044870.png,https://derpicdn.net/img/view/2015/12/15/1044870.png,0,0.9995136260986328,14,467,380,833,366,366,shining armor|twilight sparkle,paperlover
1044870.png,https://derpicdn.net/img/view/2015/12/15/1044870.png,1,0.9211742281913756,517,421,913,817,396,396,shining armor|twilight sparkle,paperlover
1044870.png,https://derpicdn.net/img/view/2015/12/15/1044870.png,2,0.9191078543663024,175,813,605,1243,430,430,shining armor|twilight sparkle,paperlover
1044898.png,https://derpicdn.net/img/view/2015/12/15/1044898.png,1,0.9898961186408995,263,326,505,568,242,242,shining armor|twilight sparkle,paperlover
1044948.png,https://derpicdn.net/img/view/2015/12/15/1044948.png,0,0.9398661255836488,165,106,327,268,162,162,big macintosh|fluttershy|pinkie pie|princess luna|soarin'|twilight sparkle,metal-kitty
1047005.png,https://derpicdn.net/img/view/2015/12/18/1047005.png,0,0.9963120818138124,1286,0,1906,586,620,586,sunset shimmer|twilight sparkle,antylavx|yatonokami|90sigma
1048569.png,https://derpicdn.net/img/view/2015/12/20/1048569.png,0,0.9913600087165833,827,2657,1465,3295,638,638,applejack|fluttershy|mane six|pinkie pie|rainbow dash|rarity|twilight sparkle,sparkofswiss|plnki
1048769.png,https://derpicdn.net/img/view/2015/12/20/1048769.png,1,0.9950448274612428,384,32,792,440,408,408,applejack|fluttershy|mane six|pinkie pie|rainbow dash|rarity|twilight sparkle,arkiiwarki
1048769.png,https://derpicdn.net/img/view/2015/12/20/1048769.png,4,0.9442209601402284,82,709,430,1057,348,348,applejack|fluttershy|mane six|pinkie pie|rainbow dash|rarity|twilight sparkle,arkiiwarki
1048769.png,https://derpicdn.net/img/view/2015/12/20/1048769.png,5,0.9106827378273008,1073,584,1500,1020,427,436,applejack|fluttershy|mane six|pinkie pie|rainbow dash|rarity|twilight sparkle,arkiiwarki
1054779.png,https://derpicdn.net/img/view/2015/12/29/1054779.png,0,0.9828006625175476,0,135,269,409,269,274,applejack|fluttershy|mane six|pinkie pie|rainbow dash|rarity|spike|twilight sparkle,fishstickmystic
1054779.png,https://derpicdn.net/img/view/2015/12/29/1054779.png,1,0.9710102677345276,544,178,766,400,222,222,applejack|fluttershy|mane six|pinkie pie|rainbow dash|rarity|spike|twilight sparkle,fishstickmystic
1054779.png,https://derpicdn.net/img/view/2015/12/29/1054779.png,2,0.9399524927139282,220,189,430,399,210,210,applejack|fluttershy|mane six|pinkie pie|rainbow dash|rarity|spike|twilight sparkle,fishstickmystic
1055800.png,https://derpicdn.net/img/view/2015/12/30/1055800.png,0,0.9978914260864258,13,106,283,376,270,270,rainbow dash|scootaloo|twilight sparkle,spirit-dude
1055800.png,https://derpicdn.net/img/view/2015/12/30/1055800.png,1,0.9918190836906432,472,242,664,434,192,192,rainbow dash|scootaloo|twilight sparkle,spirit-dude
1059928.png,https://derpicdn.net/img/view/2016/1/5/1059928.png,0,0.9832481145858764,3406,0,4144,737,738,737,rainbow dash|twilight sparkle,ambassad0r
1060735.png,https://derpicdn.net/img/view/2016/1/6/1060735.png,0,0.9989266991615297,1942,255,2624,937,682,682,applejack|fluttershy|mane six|pinkie pie|rainbow dash|rarity|spike|twilight sparkle,osawari64
1060735.png,https://derpicdn.net/img/view/2016/1/6/1060735.png,1,0.9903059601783752,372,1144,1110,1882,738,738,applejack|fluttershy|mane six|pinkie pie|rainbow dash|rarity|spike|twilight sparkle,osawari64
1060735.png,https://derpicdn.net/img/view/2016/1/6/1060735.png,2,0.9868001341819764,1395,3031,1935,3571,540,540,applejack|fluttershy|mane six|pinkie pie|rainbow dash|rarity|spike|twilight sparkle,osawari64
106085.jpg,https://derpicdn.net/img/view/2012/9/25/106085.jpg,0,0.9247691631317142,637,276,871,510,234,234,applejack|fluttershy|mane six|pinkie pie|rainbow dash|rarity|twilight sparkle,carnifex
1061157.png,https://derpicdn.net/img/view/2016/1/6/1061157.png,0,0.958172082901001,3136,0,3892,672,756,672,applejack|big macintosh|braeburn|fluttershy|lightning dust|queen chrysalis|rainbow dash|scootaloo|shining armor|sunset shimmer|twilight sparkle,tsitra360
1061157.png,https://derpicdn.net/img/view/2016/1/6/1061157.png,1,0.9566748142242432,0,1147,735,1891,735,744,applejack|big macintosh|braeburn|fluttershy|lightning dust|queen chrysalis|rainbow dash|scootaloo|shining armor|sunset shimmer|twilight sparkle,tsitra360
1061157.png,https://derpicdn.net/img/view/2016/1/6/1061157.png,2,0.9341182112693788,619,1456,1491,2328,872,872,applejack|big macintosh|braeburn|fluttershy|lightning dust|queen chrysalis|rainbow dash|scootaloo|shining armor|sunset shimmer|twilight sparkle,tsitra360
1066450.png,https://derpicdn.net/img/view/2016/1/14/1066450.png,0,0.995769500732422,567,346,1911,1690,1344,1344,rainbow dash|twilight sparkle,sollace
1066517.png,https://derpicdn.net/img/view/2016/1/14/1066517.png,0,0.9505175352096558,463,664,741,942,278,278,discord|twilight sparkle,saturdaymorningproj
1066728.png,https://derpicdn.net/img/view/2016/1/15/1066728.png,0,0.9934763312339784,409,0,931,517,522,517,rainbow dash|twilight sparkle,christiancerda
1068136.png,https://derpicdn.net/img/view/2016/1/17/1068136.png,0,0.9974701404571532,386,415,618,647,232,232,apple bloom|applejack|big macintosh|braeburn|cutie mark crusaders|fluttershy|pinkie pie|princess cadance|princess celestia|princess luna|queen chrysalis|rainbow dash|rarity|scootaloo|shining armor|sweetie belle|twilight sparkle,zombie
1068136.png,https://derpicdn.net/img/view/2016/1/17/1068136.png,1,0.9965534210205078,633,173,893,433,260,260,apple bloom|applejack|big macintosh|braeburn|cutie mark crusaders|fluttershy|pinkie pie|princess cadance|princess celestia|princess luna|queen chrysalis|rainbow dash|rarity|scootaloo|shining armor|sweetie belle|twilight sparkle,zombie
1068136.png,https://derpicdn.net/img/view/2016/1/17/1068136.png,2,0.9943457841873168,149,164,403,418,254,254,apple bloom|applejack|big macintosh|braeburn|cutie mark crusaders|fluttershy|pinkie pie|princess cadance|princess celestia|princess luna|queen chrysalis|rainbow dash|rarity|scootaloo|shining armor|sweetie belle|twilight sparkle,zombie
1068136.png,https://derpicdn.net/img/view/2016/1/17/1068136.png,3,0.9892137050628662,209,896,407,1094,198,198,apple bloom|applejack|big macintosh|braeburn|cutie mark crusaders|fluttershy|pinkie pie|princess cadance|princess celestia|princess luna|queen chrysalis|rainbow dash|rarity|scootaloo|shining armor|sweetie belle|twilight sparkle,zombie
1068136.png,https://derpicdn.net/img/view/2016/1/17/1068136.png,4,0.9878321886062622,380,188,584,392,204,204,apple bloom|applejack|big macintosh|braeburn|cutie mark crusaders|fluttershy|pinkie pie|princess cadance|princess celestia|princess luna|queen chrysalis|rainbow dash|rarity|scootaloo|shining armor|sweetie belle|twilight sparkle,zombie
1068136.png,https://derpicdn.net/img/view/2016/1/17/1068136.png,5,0.9875875115394592,868,877,1110,1119,242,242,apple bloom|applejack|big macintosh|braeburn|cutie mark crusaders|fluttershy|pinkie pie|princess cadance|princess celestia|princess luna|queen chrysalis|rainbow dash|rarity|scootaloo|shining armor|sweetie belle|twilight sparkle,zombie
1068136.png,https://derpicdn.net/img/view/2016/1/17/1068136.png,6,0.9867672324180604,153,400,399,646,246,246,apple bloom|applejack|big macintosh|braeburn|cutie mark crusaders|fluttershy|pinkie pie|princess cadance|princess celestia|princess luna|queen chrysalis|rainbow dash|rarity|scootaloo|shining armor|sweetie belle|twilight sparkle,zombie
1068136.png,https://derpicdn.net/img/view/2016/1/17/1068136.png,7,0.9822849035263062,885,1363,1105,1583,220,220,apple bloom|applejack|big macintosh|braeburn|cutie mark crusaders|fluttershy|pinkie pie|princess cadance|princess celestia|princess luna|queen chrysalis|rainbow dash|rarity|scootaloo|shining armor|sweetie belle|twilight sparkle,zombie
1068136.png,https://derpicdn.net/img/view/2016/1/17/1068136.png,8,0.9764670729637146,623,660,859,896,236,236,apple bloom|applejack|big macintosh|braeburn|cutie mark crusaders|fluttershy|pinkie pie|princess cadance|princess celestia|princess luna|queen chrysalis|rainbow dash|rarity|scootaloo|shining armor|sweetie belle|twilight sparkle,zombie
1068136.png,https://derpicdn.net/img/view/2016/1/17/1068136.png,9,0.9734920859336852,1087,394,1351,658,264,264,apple bloom|applejack|big macintosh|braeburn|cutie mark crusaders|fluttershy|pinkie pie|princess cadance|princess celestia|princess luna|queen chrysalis|rainbow dash|rarity|scootaloo|shining armor|sweetie belle|twilight sparkle,zombie
1068136.png,https://derpicdn.net/img/view/2016/1/17/1068136.png,10,0.9682654738426208,1095,640,1343,888,248,248,apple bloom|applejack|big macintosh|braeburn|cutie mark crusaders|fluttershy|pinkie pie|princess cadance|princess celestia|princess luna|queen chrysalis|rainbow dash|rarity|scootaloo|shining armor|sweetie belle|twilight sparkle,zombie
1068136.png,https://derpicdn.net/img/view/2016/1/17/1068136.png,11,0.9542450904846193,871,623,1113,865,242,242,apple bloom|applejack|big macintosh|braeburn|cutie mark crusaders|fluttershy|pinkie pie|princess cadance|princess celestia|princess luna|queen chrysalis|rainbow dash|rarity|scootaloo|shining armor|sweetie belle|twilight sparkle,zombie
1068136.png,https://derpicdn.net/img/view/2016/1/17/1068136.png,12,0.9516107439994812,637,1102,879,1344,242,242,apple bloom|applejack|big macintosh|braeburn|cutie mark crusaders|fluttershy|pinkie pie|princess cadance|princess celestia|princess luna|queen chrysalis|rainbow dash|rarity|scootaloo|shining armor|sweetie belle|twilight sparkle,zombie
1068136.png,https://derpicdn.net/img/view/2016/1/17/1068136.png,13,0.9449180960655212,895,207,1097,409,202,202,apple bloom|applejack|big macintosh|braeburn|cutie mark crusaders|fluttershy|pinkie pie|princess cadance|princess celestia|princess luna|queen chrysalis|rainbow dash|rarity|scootaloo|shining armor|sweetie belle|twilight sparkle,zombie
1068136.png,https://derpicdn.net/img/view/2016/1/17/1068136.png,14,0.9406762719154358,1099,176,1337,414,238,238,apple bloom|applejack|big macintosh|braeburn|cutie mark crusaders|fluttershy|pinkie pie|princess cadance|princess celestia|princess luna|queen chrysalis|rainbow dash|rarity|scootaloo|shining armor|sweetie belle|twilight sparkle,zombie
1068136.png,https://derpicdn.net/img/view/2016/1/17/1068136.png,15,0.9075393676757812,614,1349,852,1587,238,238,apple bloom|applejack|big macintosh|braeburn|cutie mark crusaders|fluttershy|pinkie pie|princess cadance|princess celestia|princess luna|queen chrysalis|rainbow dash|rarity|scootaloo|shining armor|sweetie belle|twilight sparkle,zombie
1068445.png,https://derpicdn.net/img/view/2016/1/17/1068445.png,1,0.9981658458709716,1798,2840,2810,3852,1012,1012,applejack|fluttershy|mane six|pinkie pie|rainbow dash|rarity|sunset shimmer|twilight sparkle,oliwia2514
1068445.png,https://derpicdn.net/img/view/2016/1/17/1068445.png,2,0.9921746850013732,1758,8,2392,642,634,634,applejack|fluttershy|mane six|pinkie pie|rainbow dash|rarity|sunset shimmer|twilight sparkle,oliwia2514
1070624.png,https://derpicdn.net/img/view/2016/1/21/1070624.png,0,0.9904186129570008,1489,2084,2227,2822,738,738,apple bloom|applejack|cutie mark crusaders|fluttershy|mane six|pinkie pie|rainbow dash|rarity|scootaloo|spike|sweetie belle|twilight sparkle,lostinthetrees
1070624.png,https://derpicdn.net/img/view/2016/1/21/1070624.png,1,0.9557204246520996,4149,2132,4933,2916,784,784,apple bloom|applejack|cutie mark crusaders|fluttershy|mane six|pinkie pie|rainbow dash|rarity|scootaloo|spike|sweetie belle|twilight sparkle,lostinthetrees
1070660.png,https://derpicdn.net/img/view/2016/1/21/1070660.png,1,0.9919713139533995,0,719,180,933,180,214,applejack|fluttershy|mane six|pinkie pie|rainbow dash|rarity|starlight glimmer|twilight sparkle,swanlullaby
1070660.png,https://derpicdn.net/img/view/2016/1/21/1070660.png,2,0.9673869013786316,768,621,1000,867,232,246,applejack|fluttershy|mane six|pinkie pie|rainbow dash|rarity|starlight glimmer|twilight sparkle,swanlullaby
1070660.png,https://derpicdn.net/img/view/2016/1/21/1070660.png,3,0.9629136323928832,70,458,364,752,294,294,applejack|fluttershy|mane six|pinkie pie|rainbow dash|rarity|starlight glimmer|twilight sparkle,swanlullaby
1077514.jpg,https://derpicdn.net/img/view/2016/1/31/1077514.jpg,1,0.9986336231231692,445,280,635,470,190,190,applejack|pinkie pie|rainbow dash|rarity|twilight sparkle,mosamosa_n
1077514.jpg,https://derpicdn.net/img/view/2016/1/31/1077514.jpg,2,0.9494503736495972,130,559,372,801,242,242,applejack|pinkie pie|rainbow dash|rarity|twilight sparkle,mosamosa_n
1083959.png,https://derpicdn.net/img/view/2016/2/9/1083959.png,0,0.9957579374313354,74,32,728,686,654,654,pinkie pie|twilight sparkle,hoshinousagi
1091095.png,https://derpicdn.net/img/view/2016/2/18/1091095.png,0,0.9512247443199158,501,2016,1367,2882,866,866,rarity|spike|starlight glimmer|twilight sparkle,
1091095.png,https://derpicdn.net/img/view/2016/2/18/1091095.png,1,0.923988163471222,211,1048,811,1648,600,600,rarity|spike|starlight glimmer|twilight sparkle,
1093397.png,https://derpicdn.net/img/view/2016/2/21/1093397.png,0,0.9966256022453308,78,17,502,441,424,424,princess cadance|twilight sparkle,blah23z
1093667.png,https://derpicdn.net/img/view/2016/2/21/1093667.png,1,0.9661237597465516,0,2247,541,2793,541,546,applejack|fluttershy|lightning dust|pinkie pie|princess celestia|princess flurry heart|princess luna|queen chrysalis|rainbow dash|rarity|shining armor|starlight glimmer|sunset shimmer|twilight sparkle,
1098179.png,https://derpicdn.net/img/view/2016/2/28/1098179.png,0,0.9983707070350648,4190,1009,5592,2411,1402,1402,applejack|fluttershy|mane six|pinkie pie|rainbow dash|rarity|sunset shimmer|twilight sparkle,e-e-r
1098179.png,https://derpicdn.net/img/view/2016/2/28/1098179.png,1,0.9750979542732242,3294,680,4604,1990,1310,1310,applejack|fluttershy|mane six|pinkie pie|rainbow dash|rarity|sunset shimmer|twilight sparkle,e-e-r
1098948.jpg,https://derpicdn.net/img/view/2016/2/28/1098948.jpg,2,0.9505895376205444,0,198,171,422,171,224,applejack|fluttershy|mane six|pinkie pie|rainbow dash|rarity|spike|trixie|twilight sparkle,jenkiwi
11018.png,https://derpicdn.net/img/view/2012/6/20/11018.png,0,0.998931884765625,445,11,647,213,202,202,applejack|fluttershy|mane six|pinkie pie|rainbow dash|rarity|twilight sparkle,nataliadsw
11018.png,https://derpicdn.net/img/view/2012/6/20/11018.png,1,0.9960176944732666,49,339,231,521,182,182,applejack|fluttershy|mane six|pinkie pie|rainbow dash|rarity|twilight sparkle,nataliadsw
11018.png,https://derpicdn.net/img/view/2012/6/20/11018.png,2,0.9957259297370912,461,337,639,515,178,178,applejack|fluttershy|mane six|pinkie pie|rainbow dash|rarity|twilight sparkle,nataliadsw
11018.png,https://derpicdn.net/img/view/2012/6/20/11018.png,3,0.9940049648284912,272,345,430,503,158,158,applejack|fluttershy|mane six|pinkie pie|rainbow dash|rarity|twilight sparkle,nataliadsw
11018.png,https://derpicdn.net/img/view/2012/6/20/11018.png,4,0.9903044104576112,33,18,199,184,166,166,applejack|fluttershy|mane six|pinkie pie|rainbow dash|rarity|twilight sparkle,nataliadsw
11018.png,https://derpicdn.net/img/view/2012/6/20/11018.png,5,0.9824535250663756,232,8,432,208,200,200,applejack|fluttershy|mane six|pinkie pie|rainbow dash|rarity|twilight sparkle,nataliadsw
1103412.png,https://derpicdn.net/img/view/2016/3/6/1103412.png,0,0.9866943359375,1028,1189,3100,3261,2072,2072,applejack|fluttershy|mane six|pinkie pie|rainbow dash|rarity|twilight sparkle,osipush
1103412.png,https://derpicdn.net/img/view/2016/3/6/1103412.png,1,0.961052179336548,4839,1472,6453,3086,1614,1614,applejack|fluttershy|mane six|pinkie pie|rainbow dash|rarity|twilight sparkle,osipush
1105479.png,https://derpicdn.net/img/view/2016/3/9/1105479.png,0,0.9953534007072448,175,0,477,296,302,296,applejack|fluttershy|pinkie pie|rainbow dash|rarity|sunset shimmer|twilight sparkle,onofuji
1107442.png,https://derpicdn.net/img/view/2016/3/12/1107442.png,0,0.98929363489151,2263,1296,3079,2112,816,816,princess celestia|princess luna|twilight sparkle,phobicalbino
1107442.png,https://derpicdn.net/img/view/2016/3/12/1107442.png,1,0.9671670794487,3726,722,4750,1764,1024,1042,princess celestia|princess luna|twilight sparkle,phobicalbino
1108719.jpg,https://derpicdn.net/img/view/2016/3/14/1108719.jpg,0,0.9951165914535522,206,446,604,844,398,398,applejack|fluttershy|rainbow dash|rarity|starlight glimmer|twilight sparkle,
1108719.jpg,https://derpicdn.net/img/view/2016/3/14/1108719.jpg,1,0.9786121845245358,1347,219,1857,729,510,510,applejack|fluttershy|rainbow dash|rarity|starlight glimmer|twilight sparkle,
110896.png,https://derpicdn.net/img/view/2012/10/1/110896.png,0,0.9483526349067688,404,25,630,251,226,226,applejack|fluttershy|mane six|pinkie pie|princess celestia|princess luna|rainbow dash|rarity|trixie|twilight sparkle,pekou
1109756.png,https://derpicdn.net/img/view/2016/3/16/1109756.png,0,0.9982602000236512,0,379,313,735,313,356,sunset shimmer|trixie|twilight sparkle,spritepony
1110929.png,https://derpicdn.net/img/view/2016/3/17/1110929.png,0,0.9976241588592528,5279,1746,7403,3870,2124,2124,applejack|fluttershy|mane six|pinkie pie|rainbow dash|rarity|twilight sparkle,aethon056
1110929.png,https://derpicdn.net/img/view/2016/3/17/1110929.png,1,0.9858456254005432,206,1440,1582,2816,1376,1376,applejack|fluttershy|mane six|pinkie pie|rainbow dash|rarity|twilight sparkle,aethon056
1110929.png,https://derpicdn.net/img/view/2016/3/17/1110929.png,2,0.9766998887062072,2706,2002,3976,3272,1270,1270,applejack|fluttershy|mane six|pinkie pie|rainbow dash|rarity|twilight sparkle,aethon056
1111442.png,https://derpicdn.net/img/view/2016/3/18/1111442.png,0,0.9371826052665708,777,17,1289,529,512,512,applejack|discord|fluttershy|mane six|pinkie pie|princess celestia|princess luna|rainbow dash|rarity|spike|trixie|twilight sparkle,blue-paint-sea
1113834.png,https://derpicdn.net/img/view/2016/3/21/1113834.png,0,0.927442729473114,0,75,478,561,478,486,starlight glimmer|twilight sparkle,anamaria0246
1115876.png,https://derpicdn.net/img/view/2016/3/24/1115876.png,0,0.9633914232254028,611,0,817,198,206,198,applejack|fluttershy|mane six|pinkie pie|rainbow dash|rarity|spike|twilight sparkle,doodle-28
1117998.png,https://derpicdn.net/img/view/2016/3/27/1117998.png,0,0.9773551821708679,977,0,2159,996,1182,996,starlight glimmer|twilight sparkle,fluttersdreams
1117998.png,https://derpicdn.net/img/view/2016/3/27/1117998.png,1,0.9047750234603882,91,35,1017,961,926,926,starlight glimmer|twilight sparkle,fluttersdreams
1123240.png,https://derpicdn.net/img/view/2016/4/3/1123240.png,0,0.9989199042320251,505,119,761,375,256,256,spike|sunset shimmer|twilight sparkle,fallenangel5414
1123240.png,https://derpicdn.net/img/view/2016/4/3/1123240.png,3,0.9883666038513184,414,437,636,659,222,222,spike|sunset shimmer|twilight sparkle,fallenangel5414
1123240.png,https://derpicdn.net/img/view/2016/4/3/1123240.png,4,0.9634955525398254,661,179,925,443,264,264,spike|sunset shimmer|twilight sparkle,fallenangel5414
112542.png,https://derpicdn.net/img/view/2012/10/3/112542.png,0,0.9961493611335754,912,252,1100,450,188,198,princess celestia|princess luna|rainbow dash|twilight sparkle,johnjoseco|dobromyslov
112542.png,https://derpicdn.net/img/view/2012/10/3/112542.png,1,0.9820899367332458,0,199,212,441,212,242,princess celestia|princess luna|rainbow dash|twilight sparkle,johnjoseco|dobromyslov
112542.png,https://derpicdn.net/img/view/2012/10/3/112542.png,2,0.9738569855690002,487,195,655,363,168,168,princess celestia|princess luna|rainbow dash|twilight sparkle,johnjoseco|dobromyslov
112542.png,https://derpicdn.net/img/view/2012/10/3/112542.png,3,0.9102382659912108,335,267,519,451,184,184,princess celestia|princess luna|rainbow dash|twilight sparkle,johnjoseco|dobromyslov
112829.png,https://derpicdn.net/img/view/2012/10/3/112829.png,0,0.9780436754226683,667,194,900,458,233,264,princess cadance|princess luna|twilight sparkle,johnjoseco
1135570.png,https://derpicdn.net/img/view/2016/4/19/1135570.png,0,0.9308844208717346,242,0,1018,612,776,612,rarity|spike|twilight sparkle,
1143028.png,https://derpicdn.net/img/view/2016/4/30/1143028.png,0,0.9522737860679626,94,382,1156,1425,1062,1043,princess celestia|twilight sparkle,
1143320.png,https://derpicdn.net/img/view/2016/4/30/1143320.png,0,0.9651367068290708,932,24,1172,264,240,240,trixie|twilight sparkle,
1143463.png,https://derpicdn.net/img/view/2016/4/30/1143463.png,0,0.9223599433898926,0,678,570,1286,570,608,trixie|twilight sparkle,
1143665.png,https://derpicdn.net/img/view/2016/5/1/1143665.png,0,0.9767957925796508,146,82,470,406,324,324,starlight glimmer|twilight sparkle,
1148644.jpg,https://derpicdn.net/img/view/2016/5/7/1148644.jpg,1,0.98500257730484,553,323,769,539,216,216,apple bloom|applejack|fluttershy|rarity|sweetie belle|twilight sparkle,
1148644.jpg,https://derpicdn.net/img/view/2016/5/7/1148644.jpg,2,0.9846322536468506,614,108,832,326,218,218,apple bloom|applejack|fluttershy|rarity|sweetie belle|twilight sparkle,
1148644.jpg,https://derpicdn.net/img/view/2016/5/7/1148644.jpg,3,0.9707187414169312,1065,11,1277,223,212,212,apple bloom|applejack|fluttershy|rarity|sweetie belle|twilight sparkle,
1148692.png,https://derpicdn.net/img/view/2016/5/7/1148692.png,0,0.9943615198135376,799,141,990,337,191,196,apple bloom|applejack|cutie mark crusaders|fluttershy|rainbow dash|rarity|scootaloo|sweetie belle|twilight sparkle,
1148919.png,https://derpicdn.net/img/view/2016/5/8/1148919.png,0,0.931782066822052,148,158,304,314,156,156,applejack|starlight glimmer|twilight sparkle,
1150131.jpg,https://derpicdn.net/img/view/2016/5/9/1150131.jpg,0,0.9788827300071716,931,325,1280,685,349,360,sunset shimmer|twilight sparkle,angeltorchic
1150858.png,https://derpicdn.net/img/view/2016/5/10/1150858.png,0,0.9877418279647828,1819,0,4688,2642,2869,2642,fluttershy|twilight sparkle,cloudyglow
1150858.png,https://derpicdn.net/img/view/2016/5/10/1150858.png,1,0.9830124378204346,0,319,1884,2375,1884,2056,fluttershy|twilight sparkle,cloudyglow
1153784.png,https://derpicdn.net/img/view/2016/5/14/1153784.png,0,0.9990924000740052,300,52,500,252,200,200,applejack|fluttershy|mane six|pinkie pie|rainbow dash|rarity|twilight sparkle,riisuu
1153784.png,https://derpicdn.net/img/view/2016/5/14/1153784.png,1,0.9664947986602784,28,6,318,296,290,290,applejack|fluttershy|mane six|pinkie pie|rainbow dash|rarity|twilight sparkle,riisuu
1153848.png,https://derpicdn.net/img/view/2016/5/14/1153848.png,0,0.9772189259529114,0,282,153,458,153,176,applejack|fluttershy|mane six|pinkie pie|rainbow dash|rarity|starlight glimmer|twilight sparkle,
1157735.png,https://derpicdn.net/img/view/2016/5/19/1157735.png,0,0.9677735567092896,169,146,367,344,198,198,princess celestia|sunset shimmer|twilight sparkle,johesy
1157736.png,https://derpicdn.net/img/view/2016/5/19/1157736.png,0,0.9915377497673036,1294,75,2023,837,729,762,shining armor|twilight sparkle,johesy
1157736.png,https://derpicdn.net/img/view/2016/5/19/1157736.png,1,0.9792813062667848,0,125,795,979,795,854,shining armor|twilight sparkle,johesy
1159041.png,https://derpicdn.net/img/view/2016/5/21/1159041.png,0,0.9000422954559326,297,346,523,572,226,226,princess celestia|twilight sparkle,
1159168.png,https://derpicdn.net/img/view/2016/5/21/1159168.png,0,0.9948648810386658,513,145,719,351,206,206,spike|starlight glimmer|twilight sparkle,
1161171.png,https://derpicdn.net/img/view/2016/5/23/1161171.png,0,0.9650037288665771,337,0,623,218,286,218,applejack|fluttershy|pinkie pie|rainbow dash|twilight sparkle,jbond
1165705.png,https://derpicdn.net/img/view/2016/5/29/1165705.png,0,0.9832644462585448,716,50,1144,478,428,428,fluttershy|twilight sparkle,megadisia
1165731.png,https://derpicdn.net/img/view/2016/5/29/1165731.png,1,0.9993923902511596,89,1983,1117,3011,1028,1028,applejack|fluttershy|mane six|pinkie pie|rainbow dash|rarity|twilight sparkle,sane-scribbler
1165731.png,https://derpicdn.net/img/view/2016/5/29/1165731.png,2,0.9975279569625854,154,0,1306,1134,1152,1134,applejack|fluttershy|mane six|pinkie pie|rainbow dash|rarity|twilight sparkle,sane-scribbler
1165731.png,https://derpicdn.net/img/view/2016/5/29/1165731.png,3,0.9957040548324584,1625,0,2659,959,1034,959,applejack|fluttershy|mane six|pinkie pie|rainbow dash|rarity|twilight sparkle,sane-scribbler
1165731.png,https://derpicdn.net/img/view/2016/5/29/1165731.png,4,0.9952707886695862,2506,1850,3892,3236,1386,1386,applejack|fluttershy|mane six|pinkie pie|rainbow dash|rarity|twilight sparkle,sane-scribbler
1166589.png,https://derpicdn.net/img/view/2016/5/30/1166589.png,0,0.9961448907852172,304,909,658,1263,354,354,rainbow dash|twilight sparkle,brainiac
1179184.png,https://derpicdn.net/img/view/2016/6/15/1179184.png,0,0.9975332021713256,514,1471,850,1807,336,336,princess celestia|princess luna|twilight sparkle,phobicalbino
1179184.png,https://derpicdn.net/img/view/2016/6/15/1179184.png,2,0.9886730313301086,510,751,1100,1341,590,590,princess celestia|princess luna|twilight sparkle,phobicalbino
1179184.png,https://derpicdn.net/img/view/2016/6/15/1179184.png,3,0.9835555553436279,110,0,612,480,502,480,princess celestia|princess luna|twilight sparkle,phobicalbino
1179184.png,https://derpicdn.net/img/view/2016/6/15/1179184.png,4,0.9558707475662231,1068,894,1586,1412,518,518,princess celestia|princess luna|twilight sparkle,phobicalbino
1179184.png,https://derpicdn.net/img/view/2016/6/15/1179184.png,5,0.955131769180298,1055,161,1611,717,556,556,princess celestia|princess luna|twilight sparkle,phobicalbino
1179184.png,https://derpicdn.net/img/view/2016/6/15/1179184.png,6,0.9096017479896544,48,673,622,1247,574,574,princess celestia|princess luna|twilight sparkle,phobicalbino
1180001.png,https://derpicdn.net/img/view/2016/6/17/1180001.png,0,0.9826604127883912,220,946,1072,1798,852,852,pinkie pie|twilight sparkle,squipycheetah
1180001.png,https://derpicdn.net/img/view/2016/6/17/1180001.png,1,0.9698429107666016,1661,2,2592,960,931,958,pinkie pie|twilight sparkle,squipycheetah
11827.jpg,https://derpicdn.net/img/view/2012/6/20/11827.jpg,0,0.997336745262146,211,795,377,961,166,166,applejack|fluttershy|mane six|pinkie pie|rainbow dash|rarity|twilight sparkle,closet-brony
11827.jpg,https://derpicdn.net/img/view/2012/6/20/11827.jpg,1,0.9943094849586488,11,800,181,970,170,170,applejack|fluttershy|mane six|pinkie pie|rainbow dash|rarity|twilight sparkle,closet-brony
11827.jpg,https://derpicdn.net/img/view/2012/6/20/11827.jpg,2,0.9870495200157166,148,574,298,724,150,150,applejack|fluttershy|mane six|pinkie pie|rainbow dash|rarity|twilight sparkle,closet-brony
11827.jpg,https://derpicdn.net/img/view/2012/6/20/11827.jpg,3,0.9170381426811218,876,691,1002,817,126,126,applejack|fluttershy|mane six|pinkie pie|rainbow dash|rarity|twilight sparkle,closet-brony
11827.jpg,https://derpicdn.net/img/view/2012/6/20/11827.jpg,4,0.9155385494232178,656,775,830,949,174,174,applejack|fluttershy|mane six|pinkie pie|rainbow dash|rarity|twilight sparkle,closet-brony
1184238.png,https://derpicdn.net/img/view/2016/6/22/1184238.png,0,0.9930662512779236,831,342,1075,586,244,244,rainbow dash|twilight sparkle,
1184238.png,https://derpicdn.net/img/view/2016/6/22/1184238.png,1,0.9869021773338318,951,738,1245,1032,294,294,rainbow dash|twilight sparkle,
1184238.png,https://derpicdn.net/img/view/2016/6/22/1184238.png,3,0.93415629863739,977,406,1263,692,286,286,rainbow dash|twilight sparkle,
1185856.png,https://derpicdn.net/img/view/2016/6/24/1185856.png,0,0.9607411026954652,122,25,332,235,210,210,rarity|twilight sparkle,onofuji
1190408.png,https://derpicdn.net/img/view/2016/6/30/1190408.png,0,0.9936622977256776,414,0,832,401,418,401,rarity|spike|starlight glimmer|sweetie belle|twilight sparkle,danj16
1190408.png,https://derpicdn.net/img/view/2016/6/30/1190408.png,1,0.9839597940444946,1139,0,1615,459,476,459,rarity|spike|starlight glimmer|sweetie belle|twilight sparkle,danj16
1190408.png,https://derpicdn.net/img/view/2016/6/30/1190408.png,2,0.9837921261787416,27,397,365,735,338,338,rarity|spike|starlight glimmer|sweetie belle|twilight sparkle,danj16
1190698.png,https://derpicdn.net/img/view/2016/7/1/1190698.png,0,0.9987468719482422,1641,105,2027,491,386,386,big macintosh|fluttershy|rainbow dash|shining armor|spike|twilight sparkle,
1190698.png,https://derpicdn.net/img/view/2016/7/1/1190698.png,1,0.9779394268989564,316,719,890,1293,574,574,big macintosh|fluttershy|rainbow dash|shining armor|spike|twilight sparkle,
1191029.png,https://derpicdn.net/img/view/2016/7/1/1191029.png,1,0.9509122967720032,222,625,1010,1413,788,788,discord|twilight sparkle,blablashmo
1193503.png,https://derpicdn.net/img/view/2016/7/4/1193503.png,0,0.9322075843811036,1171,514,1625,968,454,454,princess celestia|twilight sparkle,bangart
1194392.png,https://derpicdn.net/img/view/2016/7/6/1194392.png,0,0.97604101896286,181,198,741,758,560,560,rainbow dash|twilight sparkle,eva-sama
1199268.png,https://derpicdn.net/img/view/2016/7/12/1199268.png,0,0.9827793836593628,0,147,718,899,718,752,applejack|twilight sparkle,sailor-sheep
1199812.png,https://derpicdn.net/img/view/2016/7/13/1199812.png,0,0.9857012033462524,1066,343,1466,743,400,400,pinkie pie|rarity|twilight sparkle,deathpwny
1200581.png,https://derpicdn.net/img/view/2016/7/14/1200581.png,0,0.9948520660400392,109,817,729,1437,620,620,pinkie pie|twilight sparkle,weird--fish
1200581.png,https://derpicdn.net/img/view/2016/7/14/1200581.png,1,0.984342098236084,916,103,1488,675,572,572,pinkie pie|twilight sparkle,weird--fish
1200600.png,https://derpicdn.net/img/view/2016/7/14/1200600.png,0,0.9984301924705504,715,1523,1019,1827,304,304,applejack|fluttershy|pinkie pie|rainbow dash|rarity|twilight sparkle,crmareli|xjrobot
1200600.png,https://derpicdn.net/img/view/2016/7/14/1200600.png,1,0.9934585094451904,509,630,759,880,250,250,applejack|fluttershy|pinkie pie|rainbow dash|rarity|twilight sparkle,crmareli|xjrobot
1200600.png,https://derpicdn.net/img/view/2016/7/14/1200600.png,2,0.9795501232147216,1434,1466,1688,1720,254,254,applejack|fluttershy|pinkie pie|rainbow dash|rarity|twilight sparkle,crmareli|xjrobot
1200600.png,https://derpicdn.net/img/view/2016/7/14/1200600.png,3,0.9284088611602784,272,1394,616,1738,344,344,applejack|fluttershy|pinkie pie|rainbow dash|rarity|twilight sparkle,crmareli|xjrobot
1201243.png,https://derpicdn.net/img/view/2016/7/15/1201243.png,0,0.9970994591712952,4075,514,8323,4762,4248,4248,trixie|twilight sparkle,parclytaxel
120267.png,https://derpicdn.net/img/view/2012/10/12/120267.png,0,0.9998759031295776,1597,1004,2479,1886,882,882,discord|twilight sparkle,jitterbugjive
120267.png,https://derpicdn.net/img/view/2012/10/12/120267.png,1,0.9898582100868224,957,784,1701,1528,744,744,discord|twilight sparkle,jitterbugjive
120267.png,https://derpicdn.net/img/view/2012/10/12/120267.png,2,0.9718729257583618,18,0,558,450,540,450,discord|twilight sparkle,jitterbugjive
1208334.png,https://derpicdn.net/img/view/2016/7/24/1208334.png,0,0.9992194175720216,0,1012,771,1808,771,796,applejack|twilight sparkle,emberfall0507
1208334.png,https://derpicdn.net/img/view/2016/7/24/1208334.png,1,0.9600458741188048,589,467,1339,1217,750,750,applejack|twilight sparkle,emberfall0507
1212881.png,https://derpicdn.net/img/view/2016/7/30/1212881.png,0,0.9918873906135559,263,0,585,310,322,310,sunset shimmer|twilight sparkle,royaltwilight
1212881.png,https://derpicdn.net/img/view/2016/7/30/1212881.png,1,0.971348762512207,639,141,997,499,358,358,sunset shimmer|twilight sparkle,royaltwilight
1217740.png,https://derpicdn.net/img/view/2016/8/5/1217740.png,0,0.9852306246757508,0,0,800,805,800,805,shining armor|twilight sparkle,neonblaze909
1223990.png,https://derpicdn.net/img/view/2016/8/13/1223990.png,0,0.9272477030754088,305,0,1193,818,888,818,fluttershy|twilight sparkle,pandaamanda11
1225638.png,https://derpicdn.net/img/view/2016/8/15/1225638.png,0,0.972108781337738,0,0,524,629,524,629,apple bloom|applejack|big macintosh|cutie mark crusaders|fluttershy|granny smith|pinkie pie|rarity|scootaloo|spike|sweetie belle|twilight sparkle,
1228088.png,https://derpicdn.net/img/view/2016/8/18/1228088.png,0,0.9974163174629213,346,352,646,652,300,300,applejack|fluttershy|mane six|pinkie pie|rainbow dash|rarity|twilight sparkle,matteglaze
1228088.png,https://derpicdn.net/img/view/2016/8/18/1228088.png,1,0.9917994737625122,502,672,792,984,290,312,applejack|fluttershy|mane six|pinkie pie|rainbow dash|rarity|twilight sparkle,matteglaze
1228088.png,https://derpicdn.net/img/view/2016/8/18/1228088.png,2,0.9668996930122375,523,55,792,337,269,282,applejack|fluttershy|mane six|pinkie pie|rainbow dash|rarity|twilight sparkle,matteglaze
1228088.png,https://derpicdn.net/img/view/2016/8/18/1228088.png,3,0.9262718558311462,152,305,438,591,286,286,applejack|fluttershy|mane six|pinkie pie|rainbow dash|rarity|twilight sparkle,matteglaze
1229944.png,https://derpicdn.net/img/view/2016/8/20/1229944.png,0,0.9799709320068359,305,0,583,276,278,276,starlight glimmer|twilight sparkle,
1232644.png,https://derpicdn.net/img/view/2016/8/24/1232644.png,0,0.998488426208496,36,210,218,392,182,182,apple bloom|applejack|fluttershy|mane six|pinkie pie|rainbow dash|rarity|twilight sparkle,novaintellus
1232644.png,https://derpicdn.net/img/view/2016/8/24/1232644.png,1,0.9983031153678894,647,376,881,610,234,234,apple bloom|applejack|fluttershy|mane six|pinkie pie|rainbow dash|rarity|twilight sparkle,novaintellus
1232644.png,https://derpicdn.net/img/view/2016/8/24/1232644.png,2,0.9904533624649048,133,430,325,622,192,192,apple bloom|applejack|fluttershy|mane six|pinkie pie|rainbow dash|rarity|twilight sparkle,novaintellus
1232644.png,https://derpicdn.net/img/view/2016/8/24/1232644.png,3,0.9799315333366394,822,202,980,360,158,158,apple bloom|applejack|fluttershy|mane six|pinkie pie|rainbow dash|rarity|twilight sparkle,novaintellus
1232644.png,https://derpicdn.net/img/view/2016/8/24/1232644.png,4,0.9788439869880676,9,520,155,666,146,146,apple bloom|applejack|fluttershy|mane six|pinkie pie|rainbow dash|rarity|twilight sparkle,novaintellus
1232644.png,https://derpicdn.net/img/view/2016/8/24/1232644.png,5,0.9759431481361388,368,250,662,544,294,294,apple bloom|applejack|fluttershy|mane six|pinkie pie|rainbow dash|rarity|twilight sparkle,novaintellus
1233488.png,https://derpicdn.net/img/view/2016/8/25/1233488.png,0,0.989294171333313,283,41,535,293,252,252,applejack|twilight sparkle,sallindaemon
1235340.png,https://derpicdn.net/img/view/2016/8/27/1235340.png,0,0.9880817532539368,337,0,1000,665,663,665,applejack|twilight sparkle,cruelunicorn
1240244.png,https://derpicdn.net/img/view/2016/9/2/1240244.png,0,0.9252529144287108,459,0,723,255,264,255,applejack|twilight sparkle,sallindaemon
1241107.png,https://derpicdn.net/img/view/2016/9/3/1241107.png,0,0.9982007741928101,542,54,770,282,228,228,applejack|fluttershy|mane six|pinkie pie|rainbow dash|rarity|spike|starlight glimmer|twilight sparkle,sallindaemon
1242408.png,https://derpicdn.net/img/view/2016/9/5/1242408.png,0,0.9653548002243042,6297,1568,11699,7182,5402,5614,rarity|twilight sparkle,cyanlightning
1242646.png,https://derpicdn.net/img/view/2016/9/5/1242646.png,0,0.9987826347351074,0,254,418,676,418,422,fluttershy|twilight sparkle,empyu
1242646.png,https://derpicdn.net/img/view/2016/9/5/1242646.png,1,0.9962096214294434,445,0,891,383,446,383,fluttershy|twilight sparkle,empyu
1243150.png,https://derpicdn.net/img/view/2016/9/6/1243150.png,0,0.9979233741760254,269,304,539,574,270,270,spike|twilight sparkle,ladyanidraws
1245006.png,https://derpicdn.net/img/view/2016/9/9/1245006.png,1,0.9332451224327089,115,63,661,609,546,546,rainbow dash|twilight sparkle,zogzor
1248802.png,https://derpicdn.net/img/view/2016/9/14/1248802.png,0,0.9975100755691528,724,671,1838,1785,1114,1114,sunset shimmer|twilight sparkle,peppertomb
1248802.png,https://derpicdn.net/img/view/2016/9/14/1248802.png,1,0.9973095655441284,2570,101,3796,1327,1226,1226,sunset shimmer|twilight sparkle,peppertomb
1248802.png,https://derpicdn.net/img/view/2016/9/14/1248802.png,2,0.9823758006095886,0,113,1289,1423,1289,1310,sunset shimmer|twilight sparkle,peppertomb
1249321.png,https://derpicdn.net/img/view/2016/9/14/1249321.png,0,0.990986168384552,2411,34,2797,420,386,386,applejack|fluttershy|mane six|pinkie pie|rainbow dash|rarity|twilight sparkle,bladedeehunter
1249321.png,https://derpicdn.net/img/view/2016/9/14/1249321.png,1,0.988804817199707,1132,10,1574,452,442,442,applejack|fluttershy|mane six|pinkie pie|rainbow dash|rarity|twilight sparkle,bladedeehunter
1249321.png,https://derpicdn.net/img/view/2016/9/14/1249321.png,2,0.9485230445861816,603,16,977,390,374,374,applejack|fluttershy|mane six|pinkie pie|rainbow dash|rarity|twilight sparkle,bladedeehunter
1252974.png,https://derpicdn.net/img/view/2016/9/19/1252974.png,0,0.9982820153236388,310,473,448,611,138,138,apple bloom|applejack|cutie mark crusaders|diamond tiara|fluttershy|granny smith|mane six|pinkie pie|princess cadance|princess celestia|princess luna|rainbow dash|rarity|scootaloo|silver spoon|starlight glimmer|sunset shimmer|sweetie belle|trixie|twilight sparkle,陳芫茹‎
1252974.png,https://derpicdn.net/img/view/2016/9/19/1252974.png,1,0.9753544330596924,800,324,918,442,118,118,apple bloom|applejack|cutie mark crusaders|diamond tiara|fluttershy|granny smith|mane six|pinkie pie|princess cadance|princess celestia|princess luna|rainbow dash|rarity|scootaloo|silver spoon|starlight glimmer|sunset shimmer|sweetie belle|trixie|twilight sparkle,陳芫茹‎
1252974.png,https://derpicdn.net/img/view/2016/9/19/1252974.png,3,0.968982756137848,321,0,447,123,126,123,apple bloom|applejack|cutie mark crusaders|diamond tiara|fluttershy|granny smith|mane six|pinkie pie|princess cadance|princess celestia|princess luna|rainbow dash|rarity|scootaloo|silver spoon|starlight glimmer|sunset shimmer|sweetie belle|trixie|twilight sparkle,陳芫茹‎
1252974.png,https://derpicdn.net/img/view/2016/9/19/1252974.png,4,0.9452653527259828,135,138,287,290,152,152,apple bloom|applejack|cutie mark crusaders|diamond tiara|fluttershy|granny smith|mane six|pinkie pie|princess cadance|princess celestia|princess luna|rainbow dash|rarity|scootaloo|silver spoon|starlight glimmer|sunset shimmer|sweetie belle|trixie|twilight sparkle,陳芫茹‎
1256240.png,https://derpicdn.net/img/view/2016/9/23/1256240.png,0,0.9424397945404052,119,284,285,450,166,166,trixie|twilight sparkle,drewdini|[redacted]
1257887.png,https://derpicdn.net/img/view/2016/9/25/1257887.png,1,0.9957464337348938,2,39,602,639,600,600,applejack|fluttershy|mane six|pinkie pie|rainbow dash|rarity|twilight sparkle,shimazun
1257887.png,https://derpicdn.net/img/view/2016/9/25/1257887.png,3,0.9896823763847352,610,36,1208,634,598,598,applejack|fluttershy|mane six|pinkie pie|rainbow dash|rarity|twilight sparkle,shimazun
1259551.png,https://derpicdn.net/img/view/2016/9/27/1259551.png,0,0.9973683953285216,42,1004,382,1344,340,340,applejack|fluttershy|mane six|pinkie pie|rainbow dash|rarity|starlight glimmer|twilight sparkle,not-ordinary-pony
1259551.png,https://derpicdn.net/img/view/2016/9/27/1259551.png,1,0.9902267456054688,430,975,716,1261,286,286,applejack|fluttershy|mane six|pinkie pie|rainbow dash|rarity|starlight glimmer|twilight sparkle,not-ordinary-pony
1259551.png,https://derpicdn.net/img/view/2016/9/27/1259551.png,2,0.981082797050476,20,649,310,939,290,290,applejack|fluttershy|mane six|pinkie pie|rainbow dash|rarity|starlight glimmer|twilight sparkle,not-ordinary-pony
1259551.png,https://derpicdn.net/img/view/2016/9/27/1259551.png,3,0.9810442924499512,604,630,978,1004,374,374,applejack|fluttershy|mane six|pinkie pie|rainbow dash|rarity|starlight glimmer|twilight sparkle,not-ordinary-pony
12648.png,https://derpicdn.net/img/view/2012/6/20/12648.png,0,0.983157515525818,211,0,653,405,442,405,rainbow dash|twilight sparkle,speccysy
1269314.png,https://derpicdn.net/img/view/2016/10/10/1269314.png,1,0.9719185829162598,0,441,338,779,338,338,sunset shimmer|twilight sparkle,ladyilus
1270013.png,https://derpicdn.net/img/view/2016/10/10/1270013.png,1,0.9762253165245056,378,227,744,593,366,366,rarity|twilight sparkle,proenix|davidsfire|themexicanpunisher
1273495.png,https://derpicdn.net/img/view/2016/10/15/1273495.png,0,0.9977139234542848,272,137,1008,873,736,736,rainbow dash|twilight sparkle,spirit-dude
1273726.png,https://derpicdn.net/img/view/2016/10/15/1273726.png,0,0.9679482579231262,3971,210,5193,1432,1222,1222,spike|twilight sparkle,bluemeganium
1273902.png,https://derpicdn.net/img/view/2016/10/15/1273902.png,0,0.9000626802444458,840,12,1020,192,180,180,rainbow dash|twilight sparkle,cheezedoodle96|dragonchaser123|dashiesparkle
1275056.png,https://derpicdn.net/img/view/2016/10/17/1275056.png,0,0.9926325678825378,1765,1176,2167,1578,402,402,applejack|fluttershy|mane six|pinkie pie|rainbow dash|rarity|twilight sparkle,kp-shadowsquirrel|altalector
1275056.png,https://derpicdn.net/img/view/2016/10/17/1275056.png,1,0.9882742166519164,888,70,1680,862,792,792,applejack|fluttershy|mane six|pinkie pie|rainbow dash|rarity|twilight sparkle,kp-shadowsquirrel|altalector
127617.jpg,https://derpicdn.net/img/view/2012/10/20/127617.jpg,1,0.9379929900169371,501,170,795,464,294,294,apple bloom|applejack|fluttershy|mane six|pinkie pie|rainbow dash|rarity|scootaloo|sweetie belle|twilight sparkle,rinnsi
1281511.png,https://derpicdn.net/img/view/2016/10/25/1281511.png,0,0.9219067096710204,3715,275,4203,763,488,488,applejack|fluttershy|mane six|pinkie pie|rainbow dash|rarity|starlight glimmer|twilight sparkle,crazynutbob
1281511.png,https://derpicdn.net/img/view/2016/10/25/1281511.png,1,0.9177900552749634,1049,236,1547,734,498,498,applejack|fluttershy|mane six|pinkie pie|rainbow dash|rarity|starlight glimmer|twilight sparkle,crazynutbob
1282538.png,https://derpicdn.net/img/view/2016/10/27/1282538.png,0,0.9337133169174194,351,207,565,421,214,214,applejack|fluttershy|mane six|pinkie pie|princess cadance|princess celestia|princess luna|rainbow dash|rarity|shining armor|twilight sparkle,
1283195.png,https://derpicdn.net/img/view/2016/10/28/1283195.png,0,0.9966930150985718,1165,536,1799,1170,634,634,rainbow dash|twilight sparkle,my-little-brony
1283469.png,https://derpicdn.net/img/view/2016/10/28/1283469.png,0,0.980299174785614,8,0,366,312,358,312,rainbow dash|twilight sparkle,shimazun
12849.png,https://derpicdn.net/img/view/2012/6/20/12849.png,0,0.9817810654640198,0,0,368,349,368,349,rarity|twilight sparkle,
1286505.png,https://derpicdn.net/img/view/2016/11/1/1286505.png,2,0.9959155321121216,1050,719,1380,1049,330,330,applejack|fluttershy|mane six|pinkie pie|rainbow dash|rarity|spike|twilight sparkle,spirit-dude
1288125.png,https://derpicdn.net/img/view/2016/11/3/1288125.png,0,0.9899874329566956,387,57,583,253,196,196,applejack|fluttershy|mane six|pinkie pie|rainbow dash|rarity|spike|twilight sparkle,traupa
1288125.png,https://derpicdn.net/img/view/2016/11/3/1288125.png,1,0.9804909825325012,106,0,436,318,330,318,applejack|fluttershy|mane six|pinkie pie|rainbow dash|rarity|spike|twilight sparkle,traupa
1288125.png,https://derpicdn.net/img/view/2016/11/3/1288125.png,2,0.9288511872291564,216,326,460,570,244,244,applejack|fluttershy|mane six|pinkie pie|rainbow dash|rarity|spike|twilight sparkle,traupa
1288125.png,https://derpicdn.net/img/view/2016/11/3/1288125.png,3,0.9146477580070496,0,266,220,522,220,256,applejack|fluttershy|mane six|pinkie pie|rainbow dash|rarity|spike|twilight sparkle,traupa
1289669.png,https://derpicdn.net/img/view/2016/11/6/1289669.png,0,0.9573090076446532,104,305,344,545,240,240,spike|twilight sparkle,shimazun
129609.png,https://derpicdn.net/img/view/2012/10/22/129609.png,0,0.9876950979232788,163,1131,543,1511,380,380,big macintosh|twilight sparkle,illuminatiums|charleston-and-itchy
1300781.png,https://derpicdn.net/img/view/2016/11/21/1300781.png,0,0.9967109560966492,1076,375,1388,687,312,312,applejack|fluttershy|mane six|pinkie pie|rainbow dash|rarity|twilight sparkle,
1300781.png,https://derpicdn.net/img/view/2016/11/21/1300781.png,1,0.9941353797912598,1367,353,1707,693,340,340,applejack|fluttershy|mane six|pinkie pie|rainbow dash|rarity|twilight sparkle,
1300781.png,https://derpicdn.net/img/view/2016/11/21/1300781.png,2,0.9693213701248168,487,319,945,777,458,458,applejack|fluttershy|mane six|pinkie pie|rainbow dash|rarity|twilight sparkle,
1300781.png,https://derpicdn.net/img/view/2016/11/21/1300781.png,3,0.9297496676445008,206,311,698,803,492,492,applejack|fluttershy|mane six|pinkie pie|rainbow dash|rarity|twilight sparkle,
1300781.png,https://derpicdn.net/img/view/2016/11/21/1300781.png,4,0.9084323644638062,1043,0,1563,410,520,410,applejack|fluttershy|mane six|pinkie pie|rainbow dash|rarity|twilight sparkle,
1315175.png,https://derpicdn.net/img/view/2016/12/11/1315175.png,1,0.9882082939147948,355,77,477,225,122,148,apple bloom|applejack|cutie mark crusaders|diamond tiara|fluttershy|mane six|pinkie pie|rainbow dash|rarity|scootaloo|sunset shimmer|sweetie belle|twilight sparkle,lumineko
1315175.png,https://derpicdn.net/img/view/2016/12/11/1315175.png,2,0.9859368801116944,296,776,378,858,82,82,apple bloom|applejack|cutie mark crusaders|diamond tiara|fluttershy|mane six|pinkie pie|rainbow dash|rarity|scootaloo|sunset shimmer|sweetie belle|twilight sparkle,lumineko
1316170.png,https://derpicdn.net/img/view/2016/12/12/1316170.png,0,0.9236299991607666,1833,1206,3793,3096,1960,1890,sunset shimmer|twilight sparkle,burdo49
1320170.png,https://derpicdn.net/img/view/2016/12/18/1320170.png,0,0.998001217842102,985,168,1465,648,480,480,starlight glimmer|sunset shimmer|twilight sparkle,3lorenzo3
1320170.png,https://derpicdn.net/img/view/2016/12/18/1320170.png,1,0.9831133484840392,40,207,472,639,432,432,starlight glimmer|sunset shimmer|twilight sparkle,3lorenzo3
1320170.png,https://derpicdn.net/img/view/2016/12/18/1320170.png,2,0.9621115326881408,612,575,834,797,222,222,starlight glimmer|sunset shimmer|twilight sparkle,3lorenzo3
1320686.png,https://derpicdn.net/img/view/2016/12/19/1320686.png,0,0.9995763897895812,2807,1271,3507,1971,700,700,applejack|fluttershy|mane six|pinkie pie|rainbow dash|rarity|twilight sparkle,pridark
1320686.png,https://derpicdn.net/img/view/2016/12/19/1320686.png,2,0.99338299036026,1980,58,2684,762,704,704,applejack|fluttershy|mane six|pinkie pie|rainbow dash|rarity|twilight sparkle,pridark
1320686.png,https://derpicdn.net/img/view/2016/12/19/1320686.png,3,0.9861223697662354,812,997,1582,1767,770,770,applejack|fluttershy|mane six|pinkie pie|rainbow dash|rarity|twilight sparkle,pridark
1320850.png,https://derpicdn.net/img/view/2016/12/19/1320850.png,0,0.992624044418335,943,654,1249,960,306,306,princess celestia|princess luna|twilight sparkle,vasillium
1320850.png,https://derpicdn.net/img/view/2016/12/19/1320850.png,1,0.9911870360374452,1003,338,1280,618,277,280,princess celestia|princess luna|twilight sparkle,vasillium
1320850.png,https://derpicdn.net/img/view/2016/12/19/1320850.png,2,0.9697684049606324,174,125,570,521,396,396,princess celestia|princess luna|twilight sparkle,vasillium
1320850.png,https://derpicdn.net/img/view/2016/12/19/1320850.png,3,0.9680178165435792,562,9,1066,513,504,504,princess celestia|princess luna|twilight sparkle,vasillium
1323679.png,https://derpicdn.net/img/view/2016/12/23/1323679.png,0,0.9150861501693726,438,908,1286,1756,848,848,sunset shimmer|twilight sparkle,cybersquirrel
1326.png,https://derpicdn.net/img/view/2012/1/22/1326.png,3,0.9743073582649232,0,911,396,1325,396,414,rarity|twilight sparkle,saturnspace
1326269.png,https://derpicdn.net/img/view/2016/12/27/1326269.png,0,0.9850999116897584,693,254,947,508,254,254,applejack|fluttershy|mane six|pinkie pie|rainbow dash|rarity|twilight sparkle,saramanda101|selenaede
132756.png,https://derpicdn.net/img/view/2012/10/26/132756.png,0,0.9410257935523988,131,666,517,1052,386,386,big macintosh|braeburn|fluttershy|shining armor|soarin'|twilight sparkle,mrponiator
132756.png,https://derpicdn.net/img/view/2012/10/26/132756.png,1,0.9390326738357544,634,271,1104,741,470,470,big macintosh|braeburn|fluttershy|shining armor|soarin'|twilight sparkle,mrponiator
1328706.png,https://derpicdn.net/img/view/2016/12/31/1328706.png,0,0.9997044205665588,3145,0,3975,793,830,793,applejack|fluttershy|mane six|pinkie pie|rainbow dash|rarity|sunset shimmer|twilight sparkle,0okami-0ni
1328706.png,https://derpicdn.net/img/view/2016/12/31/1328706.png,1,0.997098743915558,92,1476,916,2300,824,824,applejack|fluttershy|mane six|pinkie pie|rainbow dash|rarity|sunset shimmer|twilight sparkle,0okami-0ni
1328706.png,https://derpicdn.net/img/view/2016/12/31/1328706.png,2,0.9922634363174438,2842,1143,3878,2179,1036,1036,applejack|fluttershy|mane six|pinkie pie|rainbow dash|rarity|sunset shimmer|twilight sparkle,0okami-0ni
1328706.png,https://derpicdn.net/img/view/2016/12/31/1328706.png,3,0.9264772534370422,2185,56,3073,944,888,888,applejack|fluttershy|mane six|pinkie pie|rainbow dash|rarity|sunset shimmer|twilight sparkle,0okami-0ni
1329948.png,https://derpicdn.net/img/view/2017/1/1/1329948.png,0,0.9884733557701112,540,3607,1802,4869,1262,1262,applejack|fluttershy|mane six|pinkie pie|rainbow dash|rarity|twilight sparkle,marzipan-madness|chickadeelittle
1332481.png,https://derpicdn.net/img/view/2017/1/5/1332481.png,0,0.9389792084693908,162,51,382,271,220,220,princess celestia|twilight sparkle,
1332635.png,https://derpicdn.net/img/view/2017/1/5/1332635.png,0,0.9935886263847352,143,0,699,532,556,532,applejack|fluttershy|rainbow dash|rarity|twilight sparkle,basykail
1332699.png,https://derpicdn.net/img/view/2017/1/5/1332699.png,0,0.9895462989807128,200,267,1448,1515,1248,1248,applejack|twilight sparkle,ruushiicz
1334485.png,https://derpicdn.net/img/view/2017/1/8/1334485.png,0,0.9259666204452516,499,125,955,581,456,456,pinkie pie|rainbow dash|trixie|twilight sparkle,ashtoneer
1334485.png,https://derpicdn.net/img/view/2017/1/8/1334485.png,1,0.9227179884910583,1385,110,1887,612,502,502,pinkie pie|rainbow dash|trixie|twilight sparkle,ashtoneer
1337795.png,https://derpicdn.net/img/view/2017/1/12/1337795.png,0,0.987919807434082,370,46,586,262,216,216,applejack|fluttershy|mane six|pinkie pie|rainbow dash|rarity|twilight sparkle,detoxx-retoxx
1337795.png,https://derpicdn.net/img/view/2017/1/12/1337795.png,1,0.987789273262024,772,57,1000,285,228,228,applejack|fluttershy|mane six|pinkie pie|rainbow dash|rarity|twilight sparkle,detoxx-retoxx
1339059.png,https://derpicdn.net/img/view/2017/1/14/1339059.png,0,0.999190390110016,0,0,677,696,677,696,applejack|fluttershy|mane six|pinkie pie|rainbow dash|rarity|twilight sparkle,wolfy-pony
1339059.png,https://derpicdn.net/img/view/2017/1/14/1339059.png,1,0.9940447807312012,19,762,685,1428,666,666,applejack|fluttershy|mane six|pinkie pie|rainbow dash|rarity|twilight sparkle,wolfy-pony
1339059.png,https://derpicdn.net/img/view/2017/1/14/1339059.png,2,0.9936413168907166,1807,0,2549,682,742,682,applejack|fluttershy|mane six|pinkie pie|rainbow dash|rarity|twilight sparkle,wolfy-pony
1339059.png,https://derpicdn.net/img/view/2017/1/14/1339059.png,3,0.993256688117981,648,0,1816,928,1168,928,applejack|fluttershy|mane six|pinkie pie|rainbow dash|rarity|twilight sparkle,wolfy-pony
1339059.png,https://derpicdn.net/img/view/2017/1/14/1339059.png,4,0.9287402033805848,1891,791,2497,1397,606,606,applejack|fluttershy|mane six|pinkie pie|rainbow dash|rarity|twilight sparkle,wolfy-pony
1343759.png,https://derpicdn.net/img/view/2017/1/20/1343759.png,0,0.9853802919387816,538,358,988,808,450,450,sunset shimmer|twilight sparkle,dekkii
1346350.png,https://derpicdn.net/img/view/2017/1/23/1346350.png,0,0.9832776188850404,48,13,408,373,360,360,rarity|twilight sparkle,sambragg|shepherd0821|stasysolitude|-fuchs-|couldysky
1346350.png,https://derpicdn.net/img/view/2017/1/23/1346350.png,1,0.9255075454711914,644,16,836,208,192,192,rarity|twilight sparkle,sambragg|shepherd0821|stasysolitude|-fuchs-|couldysky
1346350.png,https://derpicdn.net/img/view/2017/1/23/1346350.png,2,0.9207920432090759,1769,21,2033,285,264,264,rarity|twilight sparkle,sambragg|shepherd0821|stasysolitude|-fuchs-|couldysky
1349313.png,https://derpicdn.net/img/view/2017/1/27/1349313.png,0,0.9272149801254272,1579,0,2275,633,696,633,applejack|fluttershy|mane six|pinkie pie|rainbow dash|rarity|twilight sparkle,truffle shine
1350677.png,https://derpicdn.net/img/view/2017/1/29/1350677.png,0,0.9518573880195618,886,0,1652,630,766,630,princess cadance|twilight sparkle,hendro107
1350739.png,https://derpicdn.net/img/view/2017/1/29/1350739.png,0,0.9471222758293152,261,984,787,1510,526,526,princess celestia|twilight sparkle,rinioshi
1350811.png,https://derpicdn.net/img/view/2017/1/29/1350811.png,0,0.9982704520225524,465,0,905,389,440,389,spike|twilight sparkle,
1350811.png,https://derpicdn.net/img/view/2017/1/29/1350811.png,1,0.9585937261581421,0,71,399,491,399,420,spike|twilight sparkle,
1352587.png,https://derpicdn.net/img/view/2017/2/1/1352587.png,0,0.9980865120887756,1235,0,1787,525,552,525,applejack|rarity|twilight sparkle,dinight
1352587.png,https://derpicdn.net/img/view/2017/2/1/1352587.png,1,0.9980467557907104,25,59,493,527,468,468,applejack|rarity|twilight sparkle,dinight
1358433.png,https://derpicdn.net/img/view/2017/2/9/1358433.png,0,0.9487839937210084,2322,195,3312,1185,990,990,apple bloom|applejack|fluttershy|mane six|pinkie pie|princess celestia|princess luna|queen chrysalis|rainbow dash|rarity|scootaloo|starlight glimmer|sweetie belle|trixie|twilight sparkle,mississippikite
1358433.png,https://derpicdn.net/img/view/2017/2/9/1358433.png,1,0.9079506993293762,4368,260,5316,1208,948,948,apple bloom|applejack|fluttershy|mane six|pinkie pie|princess celestia|princess luna|queen chrysalis|rainbow dash|rarity|scootaloo|starlight glimmer|sweetie belle|trixie|twilight sparkle,mississippikite
1358433.png,https://derpicdn.net/img/view/2017/2/9/1358433.png,2,0.9012292623519896,2304,3142,3330,4168,1026,1026,apple bloom|applejack|fluttershy|mane six|pinkie pie|princess celestia|princess luna|queen chrysalis|rainbow dash|rarity|scootaloo|starlight glimmer|sweetie belle|trixie|twilight sparkle,mississippikite
1358554.png,https://derpicdn.net/img/view/2017/2/9/1358554.png,0,0.9887510538101196,2411,231,3449,1269,1038,1038,pinkie pie|rainbow dash|rarity|spike|twilight sparkle,elephanteddie
1359362.png,https://derpicdn.net/img/view/2017/2/10/1359362.png,1,0.9292272925376892,489,397,865,773,376,376,starlight glimmer|twilight sparkle,starlightflopple
1360855.png,https://derpicdn.net/img/view/2017/2/12/1360855.png,0,0.9957414269447328,0,0,739,773,739,773,applejack|fluttershy|rainbow dash|rarity|scootaloo|starlight glimmer|twilight sparkle,geraritydevillefort
1360855.png,https://derpicdn.net/img/view/2017/2/12/1360855.png,1,0.9912066459655762,569,0,1303,706,734,706,applejack|fluttershy|rainbow dash|rarity|scootaloo|starlight glimmer|twilight sparkle,geraritydevillefort
1360855.png,https://derpicdn.net/img/view/2017/2/12/1360855.png,2,0.9841217398643494,1902,0,3110,956,1208,956,applejack|fluttershy|rainbow dash|rarity|scootaloo|starlight glimmer|twilight sparkle,geraritydevillefort
1361448.png,https://derpicdn.net/img/view/2017/2/13/1361448.png,3,0.9570425748825072,2067,2216,3391,3540,1324,1324,applejack|fluttershy|mane six|pinkie pie|rainbow dash|rarity|twilight sparkle,stjonal
1361448.png,https://derpicdn.net/img/view/2017/2/13/1361448.png,4,0.9321949481964112,4065,2202,5411,3548,1346,1346,applejack|fluttershy|mane six|pinkie pie|rainbow dash|rarity|twilight sparkle,stjonal
1369319.png,https://derpicdn.net/img/view/2017/2/21/1369319.png,0,0.9209365248680116,8124,638,9736,2250,1612,1612,princess cadance|princess celestia|princess luna|twilight sparkle,akimi--chan|chrysalisgalaxy19|cartoonivia|minelvi
1370471.png,https://derpicdn.net/img/view/2017/2/22/1370471.png,0,0.9953836798667908,474,2,796,324,322,322,applejack|fluttershy|mane six|pinkie pie|princess celestia|princess luna|rainbow dash|rarity|twilight sparkle,catpensive
1370471.png,https://derpicdn.net/img/view/2017/2/22/1370471.png,1,0.9801371693611144,0,36,447,574,447,538,applejack|fluttershy|mane six|pinkie pie|princess celestia|princess luna|rainbow dash|rarity|twilight sparkle,catpensive
1370471.png,https://derpicdn.net/img/view/2017/2/22/1370471.png,3,0.9093469381332396,0,1245,375,1657,375,412,applejack|fluttershy|mane six|pinkie pie|princess celestia|princess luna|rainbow dash|rarity|twilight sparkle,catpensive
1381148.png,https://derpicdn.net/img/view/2017/3/7/1381148.png,0,0.9781710505485536,1626,595,1920,951,294,356,diamond tiara|silver spoon|twilight sparkle,
1382092.png,https://derpicdn.net/img/view/2017/3/8/1382092.png,0,0.9746031761169434,5376,0,10870,4056,5494,4056,pinkie pie|twilight sparkle,eagle1division
1383424.png,https://derpicdn.net/img/view/2017/3/10/1383424.png,0,0.9801719188690186,1123,60,1981,918,858,858,rainbow dash|twilight sparkle,brainiac
1383878.png,https://derpicdn.net/img/view/2017/3/10/1383878.png,0,0.9041350483894348,731,276,1899,1444,1168,1168,applejack|fluttershy|mane six|pinkie pie|princess cadance|princess celestia|princess luna|rainbow dash|rarity|spike|twilight sparkle,eclispeluna|akili-amethyst
1383994.png,https://derpicdn.net/img/view/2017/3/10/1383994.png,0,0.9991191029548644,342,20,500,178,158,158,applejack|fluttershy|mane six|pinkie pie|rainbow dash|rarity|twilight sparkle,usagi-zakura
1383994.png,https://derpicdn.net/img/view/2017/3/10/1383994.png,1,0.993309497833252,6,10,188,192,182,182,applejack|fluttershy|mane six|pinkie pie|rainbow dash|rarity|twilight sparkle,usagi-zakura
1383994.png,https://derpicdn.net/img/view/2017/3/10/1383994.png,2,0.979800581932068,690,389,848,547,158,158,applejack|fluttershy|mane six|pinkie pie|rainbow dash|rarity|twilight sparkle,usagi-zakura
1383994.png,https://derpicdn.net/img/view/2017/3/10/1383994.png,3,0.9327678680419922,664,44,840,220,176,176,applejack|fluttershy|mane six|pinkie pie|rainbow dash|rarity|twilight sparkle,usagi-zakura
1384504.png,https://derpicdn.net/img/view/2017/3/11/1384504.png,0,0.9938172101974488,661,194,817,350,156,156,applejack|fluttershy|pinkie pie|rainbow dash|rarity|spike|sunset shimmer|twilight sparkle,ra1nb0wk1tty
1384504.png,https://derpicdn.net/img/view/2017/3/11/1384504.png,1,0.9862672686576844,141,250,287,396,146,146,applejack|fluttershy|pinkie pie|rainbow dash|rarity|spike|sunset shimmer|twilight sparkle,ra1nb0wk1tty
1384504.png,https://derpicdn.net/img/view/2017/3/11/1384504.png,3,0.9659907817840576,588,27,762,201,174,174,applejack|fluttershy|pinkie pie|rainbow dash|rarity|spike|sunset shimmer|twilight sparkle,ra1nb0wk1tty
1384504.png,https://derpicdn.net/img/view/2017/3/11/1384504.png,5,0.9245890974998474,0,240,171,414,171,174,applejack|fluttershy|pinkie pie|rainbow dash|rarity|spike|sunset shimmer|twilight sparkle,ra1nb0wk1tty
1386876.png,https://derpicdn.net/img/view/2017/3/14/1386876.png,0,0.943425714969635,28,0,264,226,236,226,discord|princess cadance|princess celestia|princess luna|queen chrysalis|starlight glimmer|twilight sparkle,chiarinuk
1391263.png,https://derpicdn.net/img/view/2017/3/19/1391263.png,1,0.9959605932235718,145,589,439,883,294,294,applejack|fluttershy|mane six|pinkie pie|rainbow dash|rarity|spike|sunset shimmer|twilight sparkle,
1391263.png,https://derpicdn.net/img/view/2017/3/19/1391263.png,2,0.9494849443435668,478,422,602,546,124,124,applejack|fluttershy|mane six|pinkie pie|rainbow dash|rarity|spike|sunset shimmer|twilight sparkle,
1394384.png,https://derpicdn.net/img/view/2017/3/23/1394384.png,0,0.975765824317932,581,21,1257,697,676,676,rainbow dash|twilight sparkle,sky-thepony65
1402676.png,https://derpicdn.net/img/view/2017/4/2/1402676.png,0,0.997799515724182,341,0,979,547,638,547,applejack|fluttershy|mane six|pinkie pie|rainbow dash|rarity|starlight glimmer|sunset shimmer|twilight sparkle,katakiuchi4u
1402676.png,https://derpicdn.net/img/view/2017/4/2/1402676.png,1,0.9932085275650024,8,437,206,635,198,198,applejack|fluttershy|mane six|pinkie pie|rainbow dash|rarity|starlight glimmer|sunset shimmer|twilight sparkle,katakiuchi4u
1402676.png,https://derpicdn.net/img/view/2017/4/2/1402676.png,2,0.9574052691459656,121,786,351,1016,230,230,applejack|fluttershy|mane six|pinkie pie|rainbow dash|rarity|starlight glimmer|sunset shimmer|twilight sparkle,katakiuchi4u
1402676.png,https://derpicdn.net/img/view/2017/4/2/1402676.png,3,0.9285163283348083,110,200,340,430,230,230,applejack|fluttershy|mane six|pinkie pie|rainbow dash|rarity|starlight glimmer|sunset shimmer|twilight sparkle,katakiuchi4u
1406919.png,https://derpicdn.net/img/view/2017/4/8/1406919.png,0,0.9287272691726683,142,109,334,301,192,192,applejack|fluttershy|mane six|pinkie pie|rainbow dash|rarity|twilight sparkle,
1411164.png,https://derpicdn.net/img/view/2017/4/14/1411164.png,0,0.950355350971222,72,0,732,480,660,480,pinkie pie|twilight sparkle,ecoster1268
1411252.png,https://derpicdn.net/img/view/2017/4/14/1411252.png,0,0.9781569838523864,0,2318,2095,4512,2095,2194,rainbow dash|twilight sparkle,evilfrenzy
1412241.png,https://derpicdn.net/img/view/2017/4/15/1412241.png,0,0.9679351449012756,190,187,522,519,332,332,princess celestia|twilight sparkle,
1415662.png,https://derpicdn.net/img/view/2017/4/19/1415662.png,0,0.9920754432678224,593,835,2009,2251,1416,1416,applejack|fluttershy|mane six|pinkie pie|rainbow dash|rarity|twilight sparkle,cloudyglow
1415662.png,https://derpicdn.net/img/view/2017/4/19/1415662.png,1,0.9904705882072448,2559,641,3961,2043,1402,1402,applejack|fluttershy|mane six|pinkie pie|rainbow dash|rarity|twilight sparkle,cloudyglow
1415662.png,https://derpicdn.net/img/view/2017/4/19/1415662.png,2,0.9373093247413636,3730,959,4448,1677,718,718,applejack|fluttershy|mane six|pinkie pie|rainbow dash|rarity|twilight sparkle,cloudyglow
1417101.png,https://derpicdn.net/img/view/2017/4/20/1417101.png,0,0.9933357238769532,2011,0,3593,1389,1582,1389,applejack|fluttershy|mane six|pinkie pie|rainbow dash|rarity|twilight sparkle,infanio
1417101.png,https://derpicdn.net/img/view/2017/4/20/1417101.png,2,0.9250777959823608,2663,846,4043,2226,1380,1380,applejack|fluttershy|mane six|pinkie pie|rainbow dash|rarity|twilight sparkle,infanio
1418700.png,https://derpicdn.net/img/view/2017/4/22/1418700.png,0,0.973642885684967,22,0,414,407,392,407,spike|twilight sparkle,
1419074.png,https://derpicdn.net/img/view/2017/4/22/1419074.png,0,0.997459888458252,513,929,1111,1527,598,598,princess flurry heart|twilight sparkle,liniitadash23
1420197.png,https://derpicdn.net/img/view/2017/4/24/1420197.png,0,0.997167706489563,1152,32,1564,444,412,412,pinkie pie|spike|twilight sparkle,
1420197.png,https://derpicdn.net/img/view/2017/4/24/1420197.png,1,0.9845314025878906,106,110,452,456,346,346,pinkie pie|spike|twilight sparkle,
1420307.png,https://derpicdn.net/img/view/2017/4/24/1420307.png,0,0.9181286096572876,711,27,1001,317,290,290,princess flurry heart|spike|twilight sparkle,
1421752.png,https://derpicdn.net/img/view/2017/4/25/1421752.png,0,0.9839959144592284,61,184,1103,1226,1042,1042,applejack|fluttershy|mane six|pinkie pie|rainbow dash|rarity|twilight sparkle,befishproductions
1421752.png,https://derpicdn.net/img/view/2017/4/25/1421752.png,1,0.9601829051971436,4588,319,5424,1155,836,836,applejack|fluttershy|mane six|pinkie pie|rainbow dash|rarity|twilight sparkle,befishproductions
1422524.png,https://derpicdn.net/img/view/2017/4/26/1422524.png,0,0.9996591806411744,1103,390,1643,930,540,540,princess flurry heart|twilight sparkle,oinktweetstudios
1427919.png,https://derpicdn.net/img/view/2017/5/3/1427919.png,0,0.9997385144233704,126,270,396,540,270,270,princess flurry heart|starlight glimmer|twilight sparkle,hayley566
1429016.png,https://derpicdn.net/img/view/2017/5/5/1429016.png,0,0.9893603324890136,17,565,773,1321,756,756,princess flurry heart|twilight sparkle,schokocream
1433689.png,https://derpicdn.net/img/view/2017/5/11/1433689.png,5,0.904761016368866,1495,908,1885,1298,390,390,applejack|discord|fluttershy|pinkie pie|rainbow dash|spike|twilight sparkle,terry
1434852.png,https://derpicdn.net/img/view/2017/5/12/1434852.png,0,0.976637601852417,465,540,785,860,320,320,applejack|discord|fluttershy|mane six|pinkie pie|queen chrysalis|rainbow dash|rarity|starlight glimmer|trixie|twilight sparkle,
1435196.png,https://derpicdn.net/img/view/2017/5/13/1435196.png,0,0.995688021183014,90,0,568,460,478,460,rarity|twilight sparkle,
1439460.png,https://derpicdn.net/img/view/2017/5/18/1439460.png,0,0.9440857768058776,859,309,1149,599,290,290,applejack|fluttershy|mane six|pinkie pie|rainbow dash|rarity|twilight sparkle,redflare500
1441302.png,https://derpicdn.net/img/view/2017/5/20/1441302.png,0,0.9127355217933656,277,156,591,470,314,314,spike|starlight glimmer|twilight sparkle,
1442172.png,https://derpicdn.net/img/view/2017/5/21/1442172.png,0,0.9867433309555054,544,264,742,462,198,198,princess cadance|princess flurry heart|shining armor|twilight sparkle,uniquecolorchaos
1444528.png,https://derpicdn.net/img/view/2017/5/24/1444528.png,0,0.9906286597251892,386,186,626,426,240,240,pinkie pie|sunset shimmer|trixie|twilight sparkle,stevetwisp
1445654.png,https://derpicdn.net/img/view/2017/5/25/1445654.png,1,0.99046528339386,110,0,416,293,306,293,applejack|fluttershy|mane six|pinkie pie|rainbow dash|rarity|twilight sparkle,twily-star
1447981.png,https://derpicdn.net/img/view/2017/5/28/1447981.png,0,0.9903931021690368,648,787,870,1009,222,222,starlight glimmer|sunset shimmer|twilight sparkle,
1449799.png,https://derpicdn.net/img/view/2017/5/30/1449799.png,0,0.9874623417854308,1175,455,1399,679,224,224,applejack|fluttershy|mane six|pinkie pie|rainbow dash|rarity|twilight sparkle,
1449801.png,https://derpicdn.net/img/view/2017/5/30/1449801.png,0,0.9674192667007446,1137,399,1475,737,338,338,applejack|fluttershy|mane six|pinkie pie|rainbow dash|rarity|twilight sparkle,
1450002.png,https://derpicdn.net/img/view/2017/5/30/1450002.png,0,0.9996218085289,42,0,1152,1058,1110,1058,applejack|fluttershy|mane six|pinkie pie|rainbow dash|rarity|twilight sparkle,facelesssoles
1450002.png,https://derpicdn.net/img/view/2017/5/30/1450002.png,1,0.999564290046692,39,1201,1135,2297,1096,1096,applejack|fluttershy|mane six|pinkie pie|rainbow dash|rarity|twilight sparkle,facelesssoles
1450002.png,https://derpicdn.net/img/view/2017/5/30/1450002.png,2,0.9597941040992736,2347,1096,3500,2286,1153,1190,applejack|fluttershy|mane six|pinkie pie|rainbow dash|rarity|twilight sparkle,facelesssoles
1450794.png,https://derpicdn.net/img/view/2017/5/31/1450794.png,0,0.9893734455108644,592,319,1282,1009,690,690,sunset shimmer|twilight sparkle,little-tweenframes
1450900.png,https://derpicdn.net/img/view/2017/5/31/1450900.png,0,0.9996656179428101,1424,0,2000,567,576,567,soarin'|twilight sparkle,spirit-dude
1450900.png,https://derpicdn.net/img/view/2017/5/31/1450900.png,2,0.9883859157562256,0,0,516,486,516,486,soarin'|twilight sparkle,spirit-dude
1450900.png,https://derpicdn.net/img/view/2017/5/31/1450900.png,5,0.9597464203834534,647,2317,1265,2935,618,618,soarin'|twilight sparkle,spirit-dude
1453556.png,https://derpicdn.net/img/view/2017/6/4/1453556.png,0,0.9806600213050842,752,98,1086,432,334,334,spike|twilight sparkle,
1453556.png,https://derpicdn.net/img/view/2017/6/4/1453556.png,1,0.915157914161682,108,251,402,545,294,294,spike|twilight sparkle,
1458478.png,https://derpicdn.net/img/view/2017/6/10/1458478.png,0,0.988312840461731,479,0,1059,444,580,444,applejack|fluttershy|mane six|pinkie pie|rainbow dash|rarity|spike|twilight sparkle,powdan
1458478.png,https://derpicdn.net/img/view/2017/6/10/1458478.png,1,0.983461618423462,976,37,1358,419,382,382,applejack|fluttershy|mane six|pinkie pie|rainbow dash|rarity|spike|twilight sparkle,powdan
1460559.png,https://derpicdn.net/img/view/2017/6/13/1460559.png,1,0.982450306415558,463,202,659,398,196,196,princess flurry heart|twilight sparkle,sisitowe
1461524.png,https://derpicdn.net/img/view/2017/6/14/1461524.png,0,0.9966753721237184,1424,29,1724,329,300,300,applejack|fluttershy|mane six|pinkie pie|rainbow dash|rarity|twilight sparkle,blackspoiler
1466611.png,https://derpicdn.net/img/view/2017/6/20/1466611.png,0,0.9760864973068236,90,60,694,664,604,604,rainbow dash|twilight sparkle,pinkiepie6680
1467160.png,https://derpicdn.net/img/view/2017/6/20/1467160.png,4,0.9823406338691713,843,1609,1080,1851,237,242,sunset shimmer|twilight sparkle,phyllismi
1470191.png,https://derpicdn.net/img/view/2017/6/24/1470191.png,0,0.9911982417106628,261,572,593,904,332,332,applejack|fluttershy|mane six|pinkie pie|rainbow dash|rarity|twilight sparkle,
1473865.png,https://derpicdn.net/img/view/2017/6/29/1473865.png,0,0.9045605063438416,626,245,896,515,270,270,applejack|fluttershy|mane six|pinkie pie|rainbow dash|rarity|spike|twilight sparkle,
1473879.png,https://derpicdn.net/img/view/2017/6/29/1473879.png,0,0.9929879903793336,139,227,537,625,398,398,spike|twilight sparkle,
1479326.png,https://derpicdn.net/img/view/2017/7/5/1479326.png,0,0.9971758723258972,173,0,555,376,382,376,princess cadance|twilight sparkle,
1479954.png,https://derpicdn.net/img/view/2017/7/6/1479954.png,0,0.9422861933708192,359,0,663,279,304,279,princess flurry heart|twilight sparkle,dashblitz90-fonnie
1481177.png,https://derpicdn.net/img/view/2017/7/7/1481177.png,0,0.9771153926849364,627,198,1575,1146,948,948,rainbow dash|twilight sparkle,mazuuur
1481925.png,https://derpicdn.net/img/view/2017/7/8/1481925.png,0,0.9709463715553284,534,53,1026,545,492,492,spike|twilight sparkle,
1482111.png,https://derpicdn.net/img/view/2017/7/9/1482111.png,1,0.9187067151069641,554,40,740,226,186,186,starlight glimmer|twilight sparkle,s1nb0y
1484042.png,https://derpicdn.net/img/view/2017/7/11/1484042.png,0,0.9752663373947144,84,0,594,495,510,495,sunset shimmer|twilight sparkle,jase1505
1485828.png,https://derpicdn.net/img/view/2017/7/14/1485828.png,0,0.9978607892990112,38,0,602,556,564,556,applejack|princess flurry heart|twilight sparkle,rwl
1488493.png,https://derpicdn.net/img/view/2017/7/17/1488493.png,0,0.9844028949737548,175,0,637,369,462,369,princess cadance|shining armor|trixie|twilight sparkle,sugarberry
1490047.png,https://derpicdn.net/img/view/2017/7/19/1490047.png,0,0.9972832798957824,506,0,1774,1245,1268,1245,princess celestia|twilight sparkle,isorrayi
1490047.png,https://derpicdn.net/img/view/2017/7/19/1490047.png,1,0.9972719550132751,1502,706,2616,1820,1114,1114,princess celestia|twilight sparkle,isorrayi
1490889.png,https://derpicdn.net/img/view/2017/7/20/1490889.png,0,0.9870007634162904,7,26,703,722,696,696,princess cadance|princess flurry heart|shining armor|spike|twilight sparkle,crazynutbob
1490889.png,https://derpicdn.net/img/view/2017/7/20/1490889.png,1,0.9861394166946412,994,546,1392,944,398,398,princess cadance|princess flurry heart|shining armor|spike|twilight sparkle,crazynutbob
1492980.png,https://derpicdn.net/img/view/2017/7/23/1492980.png,0,0.9250811338424684,3554,196,4212,854,658,658,applejack|fluttershy|mane six|pinkie pie|rainbow dash|rarity|twilight sparkle,soundwavepie
1499685.png,https://derpicdn.net/img/view/2017/7/31/1499685.png,0,0.9961846470832824,2176,0,4864,1995,2688,1995,princess cadance|twilight sparkle,cloudyglow
1499974.png,https://derpicdn.net/img/view/2017/8/1/1499974.png,0,0.998929798603058,1825,312,2141,628,316,316,applejack|fluttershy|mane six|pinkie pie|rainbow dash|rarity|twilight sparkle,australian-senior
1499974.png,https://derpicdn.net/img/view/2017/8/1/1499974.png,1,0.989261507987976,756,29,1218,491,462,462,applejack|fluttershy|mane six|pinkie pie|rainbow dash|rarity|twilight sparkle,australian-senior
1499974.png,https://derpicdn.net/img/view/2017/8/1/1499974.png,4,0.9188479781150818,429,313,815,699,386,386,applejack|fluttershy|mane six|pinkie pie|rainbow dash|rarity|twilight sparkle,australian-senior
1500019.png,https://derpicdn.net/img/view/2017/8/1/1500019.png,0,0.99330735206604,540,0,852,310,312,310,applejack|fluttershy|mane six|pinkie pie|rainbow dash|rarity|twilight sparkle,yourfavoritesoybean
1500019.png,https://derpicdn.net/img/view/2017/8/1/1500019.png,1,0.992545247077942,84,0,348,243,264,243,applejack|fluttershy|mane six|pinkie pie|rainbow dash|rarity|twilight sparkle,yourfavoritesoybean
1500019.png,https://derpicdn.net/img/view/2017/8/1/1500019.png,2,0.972477376461029,146,447,464,765,318,318,applejack|fluttershy|mane six|pinkie pie|rainbow dash|rarity|twilight sparkle,yourfavoritesoybean
1500019.png,https://derpicdn.net/img/view/2017/8/1/1500019.png,3,0.9621180295944214,778,0,1058,273,280,273,applejack|fluttershy|mane six|pinkie pie|rainbow dash|rarity|twilight sparkle,yourfavoritesoybean
1501515.png,https://derpicdn.net/img/view/2017/8/3/1501515.png,0,0.978971302509308,349,62,691,404,342,342,applejack|fluttershy|rainbow dash|soarin'|spike|twilight sparkle,
1503361.png,https://derpicdn.net/img/view/2017/8/5/1503361.png,0,0.9949021339416504,1037,4,2265,1232,1228,1228,rainbow dash|twilight sparkle,twidasher
1503362.png,https://derpicdn.net/img/view/2017/8/5/1503362.png,0,0.9994297623634338,855,165,1949,1259,1094,1094,rainbow dash|twilight sparkle,twidasher
1503362.png,https://derpicdn.net/img/view/2017/8/5/1503362.png,1,0.9844342470169068,1286,1156,2282,2152,996,996,rainbow dash|twilight sparkle,twidasher
1505877.png,https://derpicdn.net/img/view/2017/8/8/1505877.png,0,0.9994582533836364,0,0,1197,1272,1197,1272,rainbow dash|twilight sparkle,twidasher
1507003.png,https://derpicdn.net/img/view/2017/8/10/1507003.png,0,0.938580334186554,224,1211,1324,2311,1100,1100,sweetie belle|twilight sparkle,eagle1division
1508408.png,https://derpicdn.net/img/view/2017/8/11/1508408.png,0,0.9956542253494264,1227,100,1655,528,428,428,applejack|fluttershy|mane six|pinkie pie|rainbow dash|rarity|twilight sparkle,lieutenantkyohei
1508408.png,https://derpicdn.net/img/view/2017/8/11/1508408.png,1,0.9628094434738159,345,284,811,750,466,466,applejack|fluttershy|mane six|pinkie pie|rainbow dash|rarity|twilight sparkle,lieutenantkyohei
1509150.png,https://derpicdn.net/img/view/2017/8/12/1509150.png,0,0.96747088432312,340,990,4870,5119,4530,4129,rarity|twilight sparkle,pink1ejack
1509308.png,https://derpicdn.net/img/view/2017/8/12/1509308.png,0,0.9555160403251648,306,16,1050,760,744,744,applejack|fluttershy|mane six|pinkie pie|rainbow dash|rarity|twilight sparkle,
1510112.png,https://derpicdn.net/img/view/2017/8/13/1510112.png,0,0.9894906878471376,82,0,924,680,842,680,rarity|twilight sparkle,selective-yellow
1510549.png,https://derpicdn.net/img/view/2017/8/14/1510549.png,0,0.999263346195221,1287,0,1920,572,633,572,applejack|fluttershy|mane six|pinkie pie|rainbow dash|rarity|twilight sparkle,p1nk1e ra1n
1510549.png,https://derpicdn.net/img/view/2017/8/14/1510549.png,3,0.9779649972915648,0,551,516,1080,516,529,applejack|fluttershy|mane six|pinkie pie|rainbow dash|rarity|twilight sparkle,p1nk1e ra1n
1510549.png,https://derpicdn.net/img/view/2017/8/14/1510549.png,5,0.970024824142456,1418,517,1920,1035,502,518,applejack|fluttershy|mane six|pinkie pie|rainbow dash|rarity|twilight sparkle,p1nk1e ra1n
1513803.png,https://derpicdn.net/img/view/2017/8/18/1513803.png,0,0.9788599014282228,68,0,878,690,810,690,trixie|twilight sparkle,daniel-sg|wallkick
1514551.png,https://derpicdn.net/img/view/2017/8/19/1514551.png,0,0.9948223829269408,1400,0,2809,1380,1409,1380,starlight glimmer|twilight sparkle,uponia
1514566.png,https://derpicdn.net/img/view/2017/8/19/1514566.png,0,0.9637081027030944,0,28,657,750,657,722,starlight glimmer|twilight sparkle,
1514628.png,https://derpicdn.net/img/view/2017/8/19/1514628.png,0,0.9974547028541564,1819,1706,2523,2410,704,704,applejack|fluttershy|mane six|pinkie pie|rainbow dash|rarity|twilight sparkle,stardust-r3x
1514628.png,https://derpicdn.net/img/view/2017/8/19/1514628.png,1,0.9937753677368164,546,613,1284,1351,738,738,applejack|fluttershy|mane six|pinkie pie|rainbow dash|rarity|twilight sparkle,stardust-r3x
1514628.png,https://derpicdn.net/img/view/2017/8/19/1514628.png,2,0.9671564102172852,1205,1163,1843,1801,638,638,applejack|fluttershy|mane six|pinkie pie|rainbow dash|rarity|twilight sparkle,stardust-r3x
1514628.png,https://derpicdn.net/img/view/2017/8/19/1514628.png,3,0.9397132992744446,961,64,1621,724,660,660,applejack|fluttershy|mane six|pinkie pie|rainbow dash|rarity|twilight sparkle,stardust-r3x
1514628.png,https://derpicdn.net/img/view/2017/8/19/1514628.png,4,0.9151408076286316,677,1577,1361,2261,684,684,applejack|fluttershy|mane six|pinkie pie|rainbow dash|rarity|twilight sparkle,stardust-r3x
1516436.png,https://derpicdn.net/img/view/2017/8/21/1516436.png,0,0.9578155279159546,69,7,467,405,398,398,starlight glimmer|twilight sparkle,
1516627.png,https://derpicdn.net/img/view/2017/8/21/1516627.png,0,0.949990689754486,42,2,436,396,394,394,starlight glimmer|twilight sparkle,
1517111.png,https://derpicdn.net/img/view/2017/8/22/1517111.png,0,0.9171361923217772,59,87,430,509,371,422,pinkie pie|twilight sparkle,
1519383.png,https://derpicdn.net/img/view/2017/8/25/1519383.png,0,0.9983066320419312,759,1733,1761,2735,1002,1002,rainbow dash|twilight sparkle,twidasher
1526660.png,https://derpicdn.net/img/view/2017/9/3/1526660.png,0,0.946098268032074,8336,5033,10980,7971,2644,2938,applejack|fluttershy|mane six|pinkie pie|rainbow dash|rarity|twilight sparkle,amarthgul
1526660.png,https://derpicdn.net/img/view/2017/9/3/1526660.png,1,0.9271408319473268,129,4305,3685,7861,3556,3556,applejack|fluttershy|mane six|pinkie pie|rainbow dash|rarity|twilight sparkle,amarthgul
1526691.png,https://derpicdn.net/img/view/2017/9/3/1526691.png,0,0.9992156624794006,6637,95,9769,3227,3132,3132,starlight glimmer|twilight sparkle,parclytaxel
1528123.png,https://derpicdn.net/img/view/2017/9/5/1528123.png,1,0.9496453404426576,790,450,1318,978,528,528,pinkie pie|rainbow dash|spike|twilight sparkle,porygon2z
1528533.png,https://derpicdn.net/img/view/2017/9/5/1528533.png,0,0.9952911734580994,645,443,1291,1089,646,646,sunset shimmer|twilight sparkle,little-tweenframes
1530319.png,https://derpicdn.net/img/view/2017/9/7/1530319.png,0,0.90949809551239,579,572,747,740,168,168,applejack|fluttershy|mane six|pinkie pie|rainbow dash|rarity|spike|twilight sparkle,lumineko
1533708.png,https://derpicdn.net/img/view/2017/9/12/1533708.png,0,0.9886513948440552,342,0,910,537,568,537,applejack|fluttershy|pinkie pie|spike|twilight sparkle,
1533708.png,https://derpicdn.net/img/view/2017/9/12/1533708.png,1,0.9163494110107422,231,130,497,396,266,266,applejack|fluttershy|pinkie pie|spike|twilight sparkle,
1537185.png,https://derpicdn.net/img/view/2017/9/16/1537185.png,0,0.9093204140663148,398,0,1024,608,626,608,pinkie pie|twilight sparkle,miatsukyyy
15405.jpg,https://derpicdn.net/img/view/2012/6/22/15405.jpg,0,0.99501770734787,0,111,355,493,355,382,applejack|fluttershy|rainbow dash|rarity|twilight sparkle,
15405.jpg,https://derpicdn.net/img/view/2012/6/22/15405.jpg,1,0.9605541229248048,354,219,1124,989,770,770,applejack|fluttershy|rainbow dash|rarity|twilight sparkle,
1541935.png,https://derpicdn.net/img/view/2017/9/22/1541935.png,0,0.9811323285102844,8,33,938,963,930,930,rainbow dash|twilight sparkle,xquiizitgam3r
1542387.png,https://derpicdn.net/img/view/2017/9/23/1542387.png,0,0.9959630370140076,3602,1779,4484,2661,882,882,applejack|fluttershy|mane six|pinkie pie|rainbow dash|rarity|spike|twilight sparkle,guillex3
1542387.png,https://derpicdn.net/img/view/2017/9/23/1542387.png,1,0.9590731859207152,821,694,1621,1494,800,800,applejack|fluttershy|mane six|pinkie pie|rainbow dash|rarity|spike|twilight sparkle,guillex3
1544149.png,https://derpicdn.net/img/view/2017/9/25/1544149.png,0,0.996410071849823,264,1271,620,1627,356,356,discord|princess celestia|rarity|spike|twilight sparkle,miyathegoldenflower
1544149.png,https://derpicdn.net/img/view/2017/9/25/1544149.png,2,0.980109930038452,619,1355,945,1681,326,326,discord|princess celestia|rarity|spike|twilight sparkle,miyathegoldenflower
1546322.png,https://derpicdn.net/img/view/2017/9/27/1546322.png,0,0.995600700378418,515,9,837,331,322,322,applejack|fluttershy|mane six|pinkie pie|rainbow dash|rarity|twilight sparkle,ak4neh
1546555.png,https://derpicdn.net/img/view/2017/9/28/1546555.png,1,0.9978985786437988,165,203,507,545,342,342,applejack|fluttershy|mane six|pinkie pie|rainbow dash|rarity|spike|twilight sparkle,
1547829.png,https://derpicdn.net/img/view/2017/9/29/1547829.png,0,0.9930847883224488,933,248,1099,414,166,166,applejack|fluttershy|mane six|pinkie pie|rainbow dash|rarity|spike|twilight sparkle,
1547829.png,https://derpicdn.net/img/view/2017/9/29/1547829.png,1,0.9594082832336426,734,162,958,386,224,224,applejack|fluttershy|mane six|pinkie pie|rainbow dash|rarity|spike|twilight sparkle,
1548741.png,https://derpicdn.net/img/view/2017/9/30/1548741.png,0,0.9766995310783386,1373,1162,1859,1648,486,486,applejack|fluttershy|mane six|pinkie pie|rainbow dash|rarity|spike|twilight sparkle,ejlightning007arts
1549097.png,https://derpicdn.net/img/view/2017/10/1/1549097.png,0,0.9164152741432192,110,0,1598,800,1488,800,pinkie pie|twilight sparkle,
1549295.png,https://derpicdn.net/img/view/2017/10/1/1549295.png,0,0.9973034858703612,150,0,542,337,392,337,applejack|fluttershy|rainbow dash|rarity|twilight sparkle,
1549295.png,https://derpicdn.net/img/view/2017/10/1/1549295.png,1,0.9896875023841858,0,738,228,994,228,256,applejack|fluttershy|rainbow dash|rarity|twilight sparkle,
1549295.png,https://derpicdn.net/img/view/2017/10/1/1549295.png,2,0.9801079034805298,402,377,622,597,220,220,applejack|fluttershy|rainbow dash|rarity|twilight sparkle,
1549295.png,https://derpicdn.net/img/view/2017/10/1/1549295.png,3,0.9789693355560304,185,386,407,608,222,222,applejack|fluttershy|rainbow dash|rarity|twilight sparkle,
1549295.png,https://derpicdn.net/img/view/2017/10/1/1549295.png,5,0.9540495276451112,399,711,641,953,242,242,applejack|fluttershy|rainbow dash|rarity|twilight sparkle,
1549295.png,https://derpicdn.net/img/view/2017/10/1/1549295.png,6,0.9440640211105348,0,386,252,642,252,256,applejack|fluttershy|rainbow dash|rarity|twilight sparkle,
1554418.png,https://derpicdn.net/img/view/2017/10/7/1554418.png,0,0.999439775943756,1206,0,1834,586,628,586,princess cadance|princess flurry heart|shining armor|twilight sparkle,
1554418.png,https://derpicdn.net/img/view/2017/10/7/1554418.png,1,0.9871512055397034,1528,310,1920,758,392,448,princess cadance|princess flurry heart|shining armor|twilight sparkle,
1554765.png,https://derpicdn.net/img/view/2017/10/7/1554765.png,0,0.994097113609314,500,0,888,350,388,350,starlight glimmer|twilight sparkle,
1555955.png,https://derpicdn.net/img/view/2017/10/9/1555955.png,0,0.9658450484275818,409,38,761,390,352,352,spike|twilight sparkle,
1557984.png,https://derpicdn.net/img/view/2017/10/11/1557984.png,1,0.9689583778381348,165,0,475,263,310,263,applejack|fluttershy|mane six|pinkie pie|rainbow dash|rarity|spike|twilight sparkle,
156040.png,https://derpicdn.net/img/view/2012/11/18/156040.png,0,0.994434118270874,0,1480,2153,3844,2153,2364,rainbow dash|twilight sparkle,austiniousi
156040.png,https://derpicdn.net/img/view/2012/11/18/156040.png,1,0.9816805124282836,2276,908,4034,2666,1758,1758,rainbow dash|twilight sparkle,austiniousi
156040.png,https://derpicdn.net/img/view/2012/11/18/156040.png,2,0.9003311395645142,4273,1393,6335,3455,2062,2062,rainbow dash|twilight sparkle,austiniousi
1560677.png,https://derpicdn.net/img/view/2017/10/14/1560677.png,0,0.9981278777122498,1075,96,1757,778,682,682,applejack|fluttershy|mane six|pinkie pie|rainbow dash|rarity|twilight sparkle,kimjoman
156171.jpg,https://derpicdn.net/img/view/2012/11/18/156171.jpg,0,0.9873855710029602,63,0,747,602,684,602,trixie|twilight sparkle,c.d.i.
1563594.png,https://derpicdn.net/img/view/2017/10/17/1563594.png,0,0.9980515837669371,66,743,454,1131,388,388,applejack|fluttershy|mane six|pinkie pie|rainbow dash|rarity|twilight sparkle,stuflox
1565.png,https://derpicdn.net/img/view/2012/1/23/1565.png,0,0.9099745750427246,369,6,987,624,618,618,rainbow dash|twilight sparkle,sonicrainboom93
1566546.png,https://derpicdn.net/img/view/2017/10/21/1566546.png,0,0.9570176005363464,1122,322,1786,986,664,664,applejack|fluttershy|mane six|pinkie pie|rainbow dash|rarity|twilight sparkle,
1567886.png,https://derpicdn.net/img/view/2017/10/22/1567886.png,0,0.9920924305915833,161,79,521,439,360,360,pinkie pie|trixie|twilight sparkle,ferasor
15679.jpg,https://derpicdn.net/img/view/2012/6/22/15679.jpg,0,0.9951174259185792,358,25,898,565,540,540,spike|twilight sparkle,jacky-bunny
1571216.png,https://derpicdn.net/img/view/2017/10/27/1571216.png,0,0.9406064748764038,770,146,1184,560,414,414,sunset shimmer|twilight sparkle,bijutsuyoukai
1571752.png,https://derpicdn.net/img/view/2017/10/28/1571752.png,0,0.9838627576828004,808,940,2384,2516,1576,1576,rainbow dash|twilight sparkle,twidasher
1572296.png,https://derpicdn.net/img/view/2017/10/28/1572296.png,2,0.917092740535736,1483,1176,2015,1708,532,532,spike|twilight sparkle,tomfraggle|dashiesparkle|cheezedoodle96|red4567|yetioner
1572849.png,https://derpicdn.net/img/view/2017/10/29/1572849.png,0,0.9901922941207886,93,0,1223,720,1130,720,rainbow dash|twilight sparkle,
1575554.png,https://derpicdn.net/img/view/2017/11/1/1575554.png,0,0.9277001619338988,157,10,489,342,332,332,rainbow dash|twilight sparkle,paint-pot
1576658.png,https://derpicdn.net/img/view/2017/11/3/1576658.png,0,0.995804488658905,46,93,240,287,194,194,applejack|fluttershy|mane six|pinkie pie|rainbow dash|rarity|spike|twilight sparkle,
1576658.png,https://derpicdn.net/img/view/2017/11/3/1576658.png,1,0.977408230304718,195,0,407,206,212,206,applejack|fluttershy|mane six|pinkie pie|rainbow dash|rarity|spike|twilight sparkle,
1576658.png,https://derpicdn.net/img/view/2017/11/3/1576658.png,3,0.9675562381744384,368,619,582,833,214,214,applejack|fluttershy|mane six|pinkie pie|rainbow dash|rarity|spike|twilight sparkle,
1576658.png,https://derpicdn.net/img/view/2017/11/3/1576658.png,4,0.9599477648735046,215,543,407,735,192,192,applejack|fluttershy|mane six|pinkie pie|rainbow dash|rarity|spike|twilight sparkle,
1579434.png,https://derpicdn.net/img/view/2017/11/6/1579434.png,0,0.997646152973175,1893,196,2327,630,434,434,applejack|fluttershy|mane six|pinkie pie|rainbow dash|rarity|twilight sparkle,yukomaussi
1584805.png,https://derpicdn.net/img/view/2017/11/12/1584805.png,0,0.98753559589386,1185,1338,1503,1656,318,318,applejack|fluttershy|mane six|pinkie pie|rainbow dash|rarity|spike|twilight sparkle,
1585284.png,https://derpicdn.net/img/view/2017/11/13/1585284.png,0,0.9923847913742064,316,17,516,217,200,200,applejack|fluttershy|mane six|pinkie pie|rainbow dash|rarity|spike|twilight sparkle,shamy-crist
1585284.png,https://derpicdn.net/img/view/2017/11/13/1585284.png,1,0.98960679769516,783,115,965,297,182,182,applejack|fluttershy|mane six|pinkie pie|rainbow dash|rarity|spike|twilight sparkle,shamy-crist
1589584.png,https://derpicdn.net/img/view/2017/11/19/1589584.png,0,0.9766858220100404,12,31,216,235,204,204,spike|twilight sparkle,fauna-joy
159091.png,https://derpicdn.net/img/view/2012/11/21/159091.png,1,0.9720150232315063,609,97,1355,843,746,746,applejack|fluttershy|mane six|pinkie pie|princess cadance|princess celestia|princess luna|rainbow dash|rarity|shining armor|spike|twilight sparkle,anscathmarcach
1591545.png,https://derpicdn.net/img/view/2017/11/21/1591545.png,0,0.9963416457176208,1321,3902,2263,4844,942,942,fluttershy|pinkie pie|trixie|twilight sparkle,softbuttdoodles
1591545.png,https://derpicdn.net/img/view/2017/11/21/1591545.png,3,0.9769209623336792,1396,1028,2426,2058,1030,1030,fluttershy|pinkie pie|trixie|twilight sparkle,softbuttdoodles
1591999.png,https://derpicdn.net/img/view/2017/11/22/1591999.png,0,0.9968178272247314,335,325,585,575,250,250,applejack|fluttershy|pinkie pie|rainbow dash|rarity|soarin'|sunset shimmer|twilight sparkle,fioweress
159347.jpg,https://derpicdn.net/img/view/2012/11/22/159347.jpg,0,0.9729699492454528,196,0,370,172,174,172,apple bloom|applejack|big macintosh|cutie mark crusaders|diamond tiara|discord|fluttershy|mane six|pinkie pie|princess celestia|princess luna|rainbow dash|rarity|scootaloo|silver spoon|soarin'|spike|spitfire|sweetie belle|trixie|twilight sparkle,
1593769.png,https://derpicdn.net/img/view/2017/11/25/1593769.png,0,0.9872814416885376,54,361,210,517,156,156,rainbow dash|starlight glimmer|twilight sparkle,novaintellus
1593769.png,https://derpicdn.net/img/view/2017/11/25/1593769.png,1,0.9816427826881408,568,11,1024,487,456,476,rainbow dash|starlight glimmer|twilight sparkle,novaintellus
1593769.png,https://derpicdn.net/img/view/2017/11/25/1593769.png,2,0.9448643922805786,237,359,397,519,160,160,rainbow dash|starlight glimmer|twilight sparkle,novaintellus
1595614.png,https://derpicdn.net/img/view/2017/11/27/1595614.png,0,0.9940742254257202,176,1858,758,2440,582,582,sunset shimmer|twilight sparkle,h0mi3|triplestitch
1598377.png,https://derpicdn.net/img/view/2017/12/1/1598377.png,0,0.949098527431488,142,172,658,688,516,516,fluttershy|twilight sparkle,
1598962.png,https://derpicdn.net/img/view/2017/12/2/1598962.png,0,0.9915929436683656,251,0,913,581,662,581,rainbow dash|twilight sparkle,shad0w-galaxy
1609348.png,https://derpicdn.net/img/view/2017/12/17/1609348.png,0,0.9878379702568054,633,275,1385,1027,752,752,rarity|twilight sparkle,tealflight
1609937.png,https://derpicdn.net/img/view/2017/12/17/1609937.png,0,0.9964855313301086,677,154,2283,1760,1606,1606,princess luna|twilight sparkle,pndrws
1610946.png,https://derpicdn.net/img/view/2017/12/19/1610946.png,1,0.96235191822052,2120,180,2648,708,528,528,applejack|fluttershy|mane six|pinkie pie|rainbow dash|rarity|twilight sparkle,sintakhra
1610946.png,https://derpicdn.net/img/view/2017/12/19/1610946.png,2,0.9004154205322266,2446,249,3106,909,660,660,applejack|fluttershy|mane six|pinkie pie|rainbow dash|rarity|twilight sparkle,sintakhra
1612207.png,https://derpicdn.net/img/view/2017/12/20/1612207.png,0,0.9980133175849916,293,0,509,187,216,187,rainbow dash|scootaloo|starlight glimmer|twilight sparkle,jake heritagu
1612355.png,https://derpicdn.net/img/view/2017/12/21/1612355.png,0,0.9225562214851379,945,0,1955,985,1010,985,rarity|trixie|twilight sparkle,3d4d
1613212.png,https://derpicdn.net/img/view/2017/12/22/1613212.png,0,0.997788667678833,1354,439,1664,749,310,310,sunset shimmer|twilight sparkle,carouselunique|little-tweenframes
1613212.png,https://derpicdn.net/img/view/2017/12/22/1613212.png,1,0.9955329895019532,578,0,1372,649,794,649,sunset shimmer|twilight sparkle,carouselunique|little-tweenframes
1615610.png,https://derpicdn.net/img/view/2017/12/25/1615610.png,0,0.96197247505188,1772,449,2226,903,454,454,applejack|fluttershy|mane six|pinkie pie|rainbow dash|rarity|spike|twilight sparkle,crazyaniknowit
1619777.png,https://derpicdn.net/img/view/2017/12/30/1619777.png,0,0.9009894132614136,392,363,1026,997,634,634,rarity|twilight sparkle,ogaraorcynder
1622067.png,https://derpicdn.net/img/view/2018/1/2/1622067.png,0,0.9979842901229858,305,295,553,543,248,248,applejack|fluttershy|mane six|pinkie pie|rainbow dash|rarity|twilight sparkle,galacticcinnamonbuni
1622067.png,https://derpicdn.net/img/view/2018/1/2/1622067.png,2,0.9908494353294371,397,0,597,193,200,193,applejack|fluttershy|mane six|pinkie pie|rainbow dash|rarity|twilight sparkle,galacticcinnamonbuni
1623087.png,https://derpicdn.net/img/view/2018/1/3/1623087.png,0,0.9329573512077332,7846,272,8714,1140,868,868,applejack|fluttershy|pinkie pie|rainbow dash|rarity|sunset shimmer|twilight sparkle,limedazzle
1635185.png,https://derpicdn.net/img/view/2018/1/18/1635185.png,0,0.93428772687912,95,866,397,1168,302,302,rainbow dash|scootaloo|twilight sparkle,liaaqila
1637086.png,https://derpicdn.net/img/view/2018/1/20/1637086.png,0,0.9983347654342652,2182,1040,3226,2084,1044,1044,applejack|fluttershy|mane six|pinkie pie|rainbow dash|rarity|spike|twilight sparkle,ejlightning007arts
1637086.png,https://derpicdn.net/img/view/2018/1/20/1637086.png,1,0.9008617401123048,1175,332,2207,1364,1032,1032,applejack|fluttershy|mane six|pinkie pie|rainbow dash|rarity|spike|twilight sparkle,ejlightning007arts
1637524.png,https://derpicdn.net/img/view/2018/1/21/1637524.png,0,0.9994781613349916,319,1432,573,1686,254,254,princess cadance|princess flurry heart|shining armor|twilight sparkle,grayworldcorporation
1637524.png,https://derpicdn.net/img/view/2018/1/21/1637524.png,2,0.9953312873840332,79,621,327,869,248,248,princess cadance|princess flurry heart|shining armor|twilight sparkle,grayworldcorporation
1637524.png,https://derpicdn.net/img/view/2018/1/21/1637524.png,3,0.9939017295837402,803,1857,1127,2181,324,324,princess cadance|princess flurry heart|shining armor|twilight sparkle,grayworldcorporation
1637524.png,https://derpicdn.net/img/view/2018/1/21/1637524.png,4,0.9904316067695618,735,1311,1095,1671,360,360,princess cadance|princess flurry heart|shining armor|twilight sparkle,grayworldcorporation
1637524.png,https://derpicdn.net/img/view/2018/1/21/1637524.png,5,0.9822966456413268,242,1888,526,2172,284,284,princess cadance|princess flurry heart|shining armor|twilight sparkle,grayworldcorporation
1637524.png,https://derpicdn.net/img/view/2018/1/21/1637524.png,7,0.9074062705039978,485,2396,705,2616,220,220,princess cadance|princess flurry heart|shining armor|twilight sparkle,grayworldcorporation
1639415.png,https://derpicdn.net/img/view/2018/1/24/1639415.png,0,0.9696170687675476,1290,305,1584,599,294,294,applejack|fluttershy|mane six|pinkie pie|rainbow dash|rarity|spike|twilight sparkle,
1639847.png,https://derpicdn.net/img/view/2018/1/24/1639847.png,1,0.9799014925956726,1543,384,1867,708,324,324,fluttershy|rainbow dash|twilight sparkle,robsa990
1641054.png,https://derpicdn.net/img/view/2018/1/26/1641054.png,0,0.9527714848518372,4247,473,5167,1393,920,920,applejack|fluttershy|mane six|pinkie pie|rainbow dash|rarity|spike|twilight sparkle,cutepencilcase
1651328.png,https://derpicdn.net/img/view/2018/2/8/1651328.png,0,0.9767619967460632,625,487,1343,1205,718,718,rainbow dash|twilight sparkle,uunicornicc
1651959.png,https://derpicdn.net/img/view/2018/2/9/1651959.png,0,0.9856223464012146,906,321,1338,753,432,432,princess cadance|princess celestia|princess luna|twilight sparkle,nintendash
1653152.png,https://derpicdn.net/img/view/2018/2/11/1653152.png,0,0.9901953935623168,862,146,1168,452,306,306,applejack|fluttershy|pinkie pie|princess cadance|princess celestia|princess luna|rainbow dash|spike|twilight sparkle,
1653632.png,https://derpicdn.net/img/view/2018/2/11/1653632.png,1,0.9558447003364564,10,848,452,1290,442,442,fluttershy|rainbow dash|rarity|twilight sparkle,aschenstern
1653989.png,https://derpicdn.net/img/view/2018/2/12/1653989.png,0,0.9841251969337464,225,250,921,946,696,696,pinkie pie|twilight sparkle,radpanic
1654801.png,https://derpicdn.net/img/view/2018/2/13/1654801.png,0,0.9089908003807068,65,0,1333,804,1268,804,pinkie pie|twilight sparkle,
1654876.png,https://derpicdn.net/img/view/2018/2/13/1654876.png,0,0.9676775932312012,8,148,204,344,196,196,applejack|fluttershy|mane six|pinkie pie|rainbow dash|rarity|twilight sparkle,bezziie
165497.png,https://derpicdn.net/img/view/2012/11/27/165497.png,0,0.9663347005844116,33,158,201,326,168,168,applejack|fluttershy|pinkie pie|rainbow dash|rarity|twilight sparkle,
1657196.png,https://derpicdn.net/img/view/2018/2/16/1657196.png,0,0.9823926091194152,678,5,1000,327,322,322,applejack|fluttershy|mane six|pinkie pie|rainbow dash|rarity|twilight sparkle,
1657288.png,https://derpicdn.net/img/view/2018/2/16/1657288.png,0,0.9773601293563844,1208,370,1538,700,330,330,fluttershy|spike|twilight sparkle,
1659569.png,https://derpicdn.net/img/view/2018/2/18/1659569.png,0,0.9965019822120668,1310,295,1820,805,510,510,sunset shimmer|twilight sparkle,
1659969.png,https://derpicdn.net/img/view/2018/2/19/1659969.png,0,0.99087792634964,1094,196,2048,1150,954,954,starlight glimmer|twilight sparkle,squipycheetah
1659969.png,https://derpicdn.net/img/view/2018/2/19/1659969.png,1,0.9129480123519896,1920,782,2656,1518,736,736,starlight glimmer|twilight sparkle,squipycheetah
1660771.png,https://derpicdn.net/img/view/2018/2/19/1660771.png,0,0.93223375082016,392,405,624,637,232,232,princess flurry heart|spike|twilight sparkle,lawombat
1661158.png,https://derpicdn.net/img/view/2018/2/20/1661158.png,0,0.9996095895767212,181,0,1011,764,830,764,princess luna|twilight sparkle,amarynceus
1661479.png,https://derpicdn.net/img/view/2018/2/20/1661479.png,0,0.9605101346969604,307,450,531,674,224,224,applejack|fluttershy|mane six|pinkie pie|rainbow dash|rarity|twilight sparkle,xxmelody-scribblexx
1661479.png,https://derpicdn.net/img/view/2018/2/20/1661479.png,1,0.9103016257286072,32,521,194,683,162,162,applejack|fluttershy|mane six|pinkie pie|rainbow dash|rarity|twilight sparkle,xxmelody-scribblexx
166213.png,https://derpicdn.net/img/view/2012/11/28/166213.png,0,0.9404093027114868,135,259,307,431,172,172,applejack|fluttershy|pinkie pie|rainbow dash|rarity|spike|twilight sparkle,andypriceart
1663577.png,https://derpicdn.net/img/view/2018/2/23/1663577.png,0,0.9834162592887878,493,201,1201,909,708,708,princess celestia|sunset shimmer|twilight sparkle,
1666524.png,https://derpicdn.net/img/view/2018/2/26/1666524.png,2,0.9616647362709044,665,494,1024,856,359,362,big macintosh|discord|fluttershy|pinkie pie|sunset shimmer|twilight sparkle,snowstoat
1666524.png,https://derpicdn.net/img/view/2018/2/26/1666524.png,3,0.9317044019699096,225,1415,501,1691,276,276,big macintosh|discord|fluttershy|pinkie pie|sunset shimmer|twilight sparkle,snowstoat
1667736.png,https://derpicdn.net/img/view/2018/2/28/1667736.png,0,0.9384078979492188,10046,2987,11198,4139,1152,1152,apple bloom|applejack|cutie mark crusaders|discord|fluttershy|mane six|pinkie pie|princess cadance|princess celestia|princess luna|rainbow dash|rarity|scootaloo|shining armor|spike|starlight glimmer|sweetie belle|trixie|twilight sparkle,stay gold
1670002.png,https://derpicdn.net/img/view/2018/3/2/1670002.png,0,0.995735228061676,66,913,816,1663,750,750,applejack|fluttershy|mane six|pinkie pie|rainbow dash|rarity|twilight sparkle,vcm1824
1670002.png,https://derpicdn.net/img/view/2018/3/2/1670002.png,1,0.9909330010414124,1937,972,2637,1672,700,700,applejack|fluttershy|mane six|pinkie pie|rainbow dash|rarity|twilight sparkle,vcm1824
1670002.png,https://derpicdn.net/img/view/2018/3/2/1670002.png,3,0.9813538193702698,48,0,734,637,686,637,applejack|fluttershy|mane six|pinkie pie|rainbow dash|rarity|twilight sparkle,vcm1824
1670002.png,https://derpicdn.net/img/view/2018/3/2/1670002.png,5,0.9432635307312012,1973,0,2675,669,702,669,applejack|fluttershy|mane six|pinkie pie|rainbow dash|rarity|twilight sparkle,vcm1824
1670065.png,https://derpicdn.net/img/view/2018/3/2/1670065.png,0,0.9362000226974488,335,955,655,1275,320,320,applejack|fluttershy|mane six|pinkie pie|rainbow dash|rarity|twilight sparkle,kysimon
1670071.png,https://derpicdn.net/img/view/2018/3/2/1670071.png,0,0.990179479122162,467,0,1189,678,722,678,rainbow dash|twilight sparkle,kysimon
1672355.png,https://derpicdn.net/img/view/2018/3/5/1672355.png,0,0.9857679605484008,1451,594,1745,888,294,294,sunset shimmer|twilight sparkle,legoinflatables|sugar-loop|kingdark0001|ryan1942|mewtwo-ex
1672355.png,https://derpicdn.net/img/view/2018/3/5/1672355.png,1,0.9761207699775696,1378,177,1724,523,346,346,sunset shimmer|twilight sparkle,legoinflatables|sugar-loop|kingdark0001|ryan1942|mewtwo-ex
1672355.png,https://derpicdn.net/img/view/2018/3/5/1672355.png,2,0.9625287652015686,868,278,1312,722,444,444,sunset shimmer|twilight sparkle,legoinflatables|sugar-loop|kingdark0001|ryan1942|mewtwo-ex
1672355.png,https://derpicdn.net/img/view/2018/3/5/1672355.png,3,0.9606606364250184,242,111,650,519,408,408,sunset shimmer|twilight sparkle,legoinflatables|sugar-loop|kingdark0001|ryan1942|mewtwo-ex
1676373.png,https://derpicdn.net/img/view/2018/3/10/1676373.png,0,0.9772369861602784,352,98,814,560,462,462,sunset shimmer|twilight sparkle,little-tweenframes|becca-the-baka
1676373.png,https://derpicdn.net/img/view/2018/3/10/1676373.png,1,0.9753984808921814,79,97,587,605,508,508,sunset shimmer|twilight sparkle,little-tweenframes|becca-the-baka
1677512.png,https://derpicdn.net/img/view/2018/3/11/1677512.png,0,0.9269354343414308,81,0,649,441,568,441,applejack|rainbow dash|rarity|twilight sparkle,
1677629.png,https://derpicdn.net/img/view/2018/3/11/1677629.png,0,0.987632155418396,87,0,433,337,346,337,spike|twilight sparkle,
1681418.png,https://derpicdn.net/img/view/2018/3/15/1681418.png,0,0.9986909627914428,71,295,527,751,456,456,applejack|rarity|twilight sparkle,pony-berserker
1681418.png,https://derpicdn.net/img/view/2018/3/15/1681418.png,2,0.9951252937316896,606,206,1334,934,728,728,applejack|rarity|twilight sparkle,pony-berserker
1683482.png,https://derpicdn.net/img/view/2018/3/17/1683482.png,0,0.9865902066230774,1306,332,1816,842,510,510,fluttershy|rainbow dash|twilight sparkle,flysouldragon
1684347.png,https://derpicdn.net/img/view/2018/3/18/1684347.png,0,0.9964697957038879,1244,418,1884,1058,640,640,rarity|twilight sparkle,uunicornicc
1687109.png,https://derpicdn.net/img/view/2018/3/22/1687109.png,0,0.9562669396400452,248,94,608,454,360,360,rainbow dash|twilight sparkle,rwl
1688946.png,https://derpicdn.net/img/view/2018/3/24/1688946.png,0,0.9579948782920836,886,715,1666,1495,780,780,pinkie pie|rarity|twilight sparkle,baigak
1689028.png,https://derpicdn.net/img/view/2018/3/24/1689028.png,2,0.9850339889526368,3557,1142,4067,1652,510,510,applejack|fluttershy|mane six|pinkie pie|rainbow dash|rarity|spike|starlight glimmer|twilight sparkle,andoanimalia
1689198.png,https://derpicdn.net/img/view/2018/3/24/1689198.png,0,0.9988154768943788,117,464,289,636,172,172,starlight glimmer|twilight sparkle,
1690375.png,https://derpicdn.net/img/view/2018/3/25/1690375.png,0,0.9410231709480286,396,640,1850,2094,1454,1454,princess celestia|twilight sparkle,kids-in-the-corner
1692216.png,https://derpicdn.net/img/view/2018/3/27/1692216.png,0,0.95312237739563,804,74,1046,316,242,242,applejack|big macintosh|fluttershy|mane six|pinkie pie|rainbow dash|rarity|spike|sunset shimmer|twilight sparkle,sparkledashyt
1692314.png,https://derpicdn.net/img/view/2018/3/27/1692314.png,0,0.9747871160507202,476,377,696,597,220,220,applejack|fluttershy|mane six|pinkie pie|rainbow dash|rarity|spike|starlight glimmer|twilight sparkle,
1694324.png,https://derpicdn.net/img/view/2018/3/30/1694324.png,0,0.9897273182868958,3670,158,5194,1682,1524,1524,pinkie pie|princess celestia|rarity|twilight sparkle,mattyhex|90sigma|parclytaxel|awesomecas
1696293.png,https://derpicdn.net/img/view/2018/4/1/1696293.png,4,0.9427581429481506,919,252,1213,546,294,294,applejack|fluttershy|mane six|pinkie pie|rainbow dash|rarity|spike|starlight glimmer|twilight sparkle,
1696343.png,https://derpicdn.net/img/view/2018/4/1/1696343.png,0,0.9894177317619324,615,286,993,664,378,378,scootaloo|twilight sparkle,stuflox
1698202.png,https://derpicdn.net/img/view/2018/4/3/1698202.png,0,0.9875500202178956,320,103,628,411,308,308,applejack|rarity|twilight sparkle,rwl
1701429.png,https://derpicdn.net/img/view/2018/4/7/1701429.png,2,0.9298749566078186,20,630,276,886,256,256,rainbow dash|twilight sparkle,brysfine
1703980.png,https://derpicdn.net/img/view/2018/4/10/1703980.png,0,0.9751788377761841,0,0,323,371,323,371,pinkie pie|spike|twilight sparkle,
1709547.png,https://derpicdn.net/img/view/2018/4/16/1709547.png,0,0.9818031191825868,717,80,1351,714,634,634,applejack|fluttershy|mane six|pinkie pie|rainbow dash|rarity|twilight sparkle,anyatrix
1709547.png,https://derpicdn.net/img/view/2018/4/16/1709547.png,1,0.9811207056045532,3848,227,4282,661,434,434,applejack|fluttershy|mane six|pinkie pie|rainbow dash|rarity|twilight sparkle,anyatrix
1712778.png,https://derpicdn.net/img/view/2018/4/20/1712778.png,0,0.9583352208137512,892,0,1838,864,946,864,starlight glimmer|twilight sparkle,
1714261.png,https://derpicdn.net/img/view/2018/4/22/1714261.png,0,0.9644919037818908,121,316,549,744,428,428,apple bloom|cutie mark crusaders|scootaloo|sweetie belle|twilight sparkle,
1714261.png,https://derpicdn.net/img/view/2018/4/22/1714261.png,2,0.9054991006851196,1267,396,1753,882,486,486,apple bloom|cutie mark crusaders|scootaloo|sweetie belle|twilight sparkle,
1715344.png,https://derpicdn.net/img/view/2018/4/23/1715344.png,0,0.93962424993515,1167,1246,2480,2678,1313,1432,rainbow dash|twilight sparkle,twidasher
1716648.png,https://derpicdn.net/img/view/2018/4/25/1716648.png,0,0.9685795307159424,353,520,567,734,214,214,apple bloom|cutie mark crusaders|scootaloo|sweetie belle|twilight sparkle,
1717194.png,https://derpicdn.net/img/view/2018/4/26/1717194.png,0,0.9874054193496704,0,12,286,368,286,356,spike|twilight sparkle,
1717647.png,https://derpicdn.net/img/view/2018/4/26/1717647.png,1,0.9479252099990844,132,108,490,466,358,358,rainbow dash|twilight sparkle,shimazun
171791.png,https://derpicdn.net/img/view/2012/12/3/171791.png,0,0.9625331163406372,298,0,650,323,352,323,spike|twilight sparkle,swanlullaby
171791.png,https://derpicdn.net/img/view/2012/12/3/171791.png,1,0.9419331550598145,502,172,722,392,220,220,spike|twilight sparkle,swanlullaby
1719799.png,https://derpicdn.net/img/view/2018/4/29/1719799.png,0,0.9328975677490234,365,565,833,1033,468,468,applejack|fluttershy|rainbow dash|rarity|spike|starlight glimmer|twilight sparkle,
1721568.png,https://derpicdn.net/img/view/2018/5/1/1721568.png,0,0.9432507157325744,124,0,672,500,548,500,spike|twilight sparkle,emositecc
1722641.png,https://derpicdn.net/img/view/2018/5/2/1722641.png,3,0.9545717835426332,1792,1965,2312,2485,520,520,applejack|fluttershy|mane six|pinkie pie|rainbow dash|rarity|starlight glimmer|twilight sparkle,pepemay93
1723264.png,https://derpicdn.net/img/view/2018/5/3/1723264.png,0,0.9637091159820556,791,0,1012,181,221,181,applejack|big macintosh|fluttershy|pinkie pie|rainbow dash|rarity|soarin'|twilight sparkle,brendalobinha
1723361.png,https://derpicdn.net/img/view/2018/5/3/1723361.png,0,0.9977624416351318,2361,441,3393,1473,1032,1032,spike|twilight sparkle,mlledashie
1723361.png,https://derpicdn.net/img/view/2018/5/3/1723361.png,1,0.9956615567207336,809,468,1817,1476,1008,1008,spike|twilight sparkle,mlledashie
1725934.png,https://derpicdn.net/img/view/2018/5/6/1725934.png,0,0.9079008102416992,258,12,658,412,400,400,spike|twilight sparkle,
1728270.png,https://derpicdn.net/img/view/2018/5/9/1728270.png,0,0.9199122786521912,2330,4079,4066,5815,1736,1736,applejack|fluttershy|mane six|pinkie pie|rainbow dash|rarity|twilight sparkle,sollace
1731610.png,https://derpicdn.net/img/view/2018/5/13/1731610.png,1,0.9293547272682192,1231,129,1920,829,689,700,applejack|rainbow dash|twilight sparkle,
1732476.png,https://derpicdn.net/img/view/2018/5/14/1732476.png,0,0.9972248673439026,229,294,479,544,250,250,rainbow dash|trixie|twilight sparkle,dekomaru
1732476.png,https://derpicdn.net/img/view/2018/5/14/1732476.png,1,0.9931108355522156,48,286,292,530,244,244,rainbow dash|trixie|twilight sparkle,dekomaru
173675.png,https://derpicdn.net/img/view/2012/12/5/173675.png,0,0.972817838191986,411,0,813,390,402,390,applejack|fluttershy|mane six|pinkie pie|rainbow dash|rarity|twilight sparkle,ctb-36
173675.png,https://derpicdn.net/img/view/2012/12/5/173675.png,1,0.9720709323883056,35,472,241,678,206,206,applejack|fluttershy|mane six|pinkie pie|rainbow dash|rarity|twilight sparkle,ctb-36
1737068.png,https://derpicdn.net/img/view/2018/5/20/1737068.png,1,0.9271617531776428,1221,866,1997,1642,776,776,sunset shimmer|twilight sparkle,xenalollie
1739976.png,https://derpicdn.net/img/view/2018/5/24/1739976.png,0,0.9068202972412108,352,387,594,629,242,242,apple bloom|applejack|big macintosh|fluttershy|granny smith|pinkie pie|queen chrysalis|rainbow dash|rarity|scootaloo|spike|starlight glimmer|sweetie belle|twilight sparkle,
1740267.png,https://derpicdn.net/img/view/2018/5/24/1740267.png,0,0.9942405223846436,0,128,836,1000,836,872,spike|twilight sparkle,sihyre
1740267.png,https://derpicdn.net/img/view/2018/5/24/1740267.png,1,0.9681289196014404,888,148,1500,760,612,612,spike|twilight sparkle,sihyre
1740294.png,https://derpicdn.net/img/view/2018/5/24/1740294.png,0,0.9441977739334106,465,78,793,440,328,362,princess celestia|twilight sparkle,
1743932.png,https://derpicdn.net/img/view/2018/5/28/1743932.png,0,0.9685335755348206,0,1150,271,1448,271,298,applejack|rainbow dash|starlight glimmer|twilight sparkle,sibsy
1744080.png,https://derpicdn.net/img/view/2018/5/28/1744080.png,0,0.9931680560112,2885,1073,3201,1389,316,316,applejack|fluttershy|mane six|pinkie pie|rainbow dash|rarity|twilight sparkle,namelesstrickster
1748581.png,https://derpicdn.net/img/view/2018/6/3/1748581.png,1,0.9933047890663148,229,1296,825,1892,596,596,princess cadance|princess celestia|princess luna|twilight sparkle,valo-son
1748581.png,https://derpicdn.net/img/view/2018/6/3/1748581.png,2,0.9668848514556884,754,0,1514,728,760,728,princess cadance|princess celestia|princess luna|twilight sparkle,valo-son
1749603.png,https://derpicdn.net/img/view/2018/6/4/1749603.png,0,0.99695086479187,452,0,816,318,364,318,applejack|fluttershy|mane six|pinkie pie|rainbow dash|rarity|twilight sparkle,hollybright
1749603.png,https://derpicdn.net/img/view/2018/6/4/1749603.png,2,0.9950153231620787,465,535,801,871,336,336,applejack|fluttershy|mane six|pinkie pie|rainbow dash|rarity|twilight sparkle,hollybright
1749603.png,https://derpicdn.net/img/view/2018/6/4/1749603.png,3,0.9943186044692992,834,489,1238,893,404,404,applejack|fluttershy|mane six|pinkie pie|rainbow dash|rarity|twilight sparkle,hollybright
1749603.png,https://derpicdn.net/img/view/2018/6/4/1749603.png,4,0.9831697344779968,44,522,402,880,358,358,applejack|fluttershy|mane six|pinkie pie|rainbow dash|rarity|twilight sparkle,hollybright
1749603.png,https://derpicdn.net/img/view/2018/6/4/1749603.png,5,0.9685344099998474,93,0,411,294,318,294,applejack|fluttershy|mane six|pinkie pie|rainbow dash|rarity|twilight sparkle,hollybright
17497.png,https://derpicdn.net/img/view/2012/6/23/17497.png,0,0.9937123656272888,1636,267,2694,1325,1058,1058,rainbow dash|spike|twilight sparkle,colorsymphony
1754048.png,https://derpicdn.net/img/view/2018/6/10/1754048.png,0,0.9960321187973022,12,253,316,557,304,304,starlight glimmer|twilight sparkle,red4567
1754048.png,https://derpicdn.net/img/view/2018/6/10/1754048.png,1,0.9858182668685912,643,55,1178,639,535,584,starlight glimmer|twilight sparkle,red4567
1754621.png,https://derpicdn.net/img/view/2018/6/10/1754621.png,0,0.9942861795425416,1806,36,2610,840,804,804,sunset shimmer|twilight sparkle,pikokko
175494.png,https://derpicdn.net/img/view/2012/12/7/175494.png,1,0.923249125480652,687,465,1049,827,362,362,applejack|fluttershy|pinkie pie|rainbow dash|rarity|twilight sparkle,reikomuffin
1758850.png,https://derpicdn.net/img/view/2018/6/16/1758850.png,0,0.9928187727928162,4232,528,5108,1404,876,876,applejack|fluttershy|pinkie pie|rainbow dash|rarity|starlight glimmer|twilight sparkle,marzipan-madness
1759454.png,https://derpicdn.net/img/view/2018/6/17/1759454.png,0,0.924241840839386,1242,2062,2056,2876,814,814,apple bloom|applejack|cutie mark crusaders|fluttershy|mane six|pinkie pie|princess flurry heart|rainbow dash|rarity|scootaloo|spike|starlight glimmer|sunset shimmer|sweetie belle|trixie|twilight sparkle,cheezedoodle96|really-unimportant|dragonm97hd|ambassad0r|mattbas|osipush|vectorshy
1763574.png,https://derpicdn.net/img/view/2018/6/22/1763574.png,0,0.9910888671875,577,71,1079,573,502,502,spike|twilight sparkle,papadragon69
176792.jpg,https://derpicdn.net/img/view/2012/12/8/176792.jpg,0,0.9610850811004642,560,352,758,550,198,198,spike|twilight sparkle,blood-asp0123
1768825.png,https://derpicdn.net/img/view/2018/6/29/1768825.png,0,0.9119789600372314,0,70,881,1076,881,1006,starlight glimmer|twilight sparkle,artiks
1769387.png,https://derpicdn.net/img/view/2018/6/30/1769387.png,0,0.9865270256996156,441,0,1105,540,664,540,spike|twilight sparkle,castaspellliana
1775249.png,https://derpicdn.net/img/view/2018/7/7/1775249.png,0,0.973869264125824,988,179,2518,1709,1530,1530,pinkie pie|twilight sparkle,sollace
1776247.png,https://derpicdn.net/img/view/2018/7/8/1776247.png,0,0.997763991355896,660,0,948,283,288,283,apple bloom|applejack|princess celestia|queen chrysalis|rarity|trixie|twilight sparkle,
1776247.png,https://derpicdn.net/img/view/2018/7/8/1776247.png,1,0.9710296988487244,354,297,626,569,272,272,apple bloom|applejack|princess celestia|queen chrysalis|rarity|trixie|twilight sparkle,
17775.jpg,https://derpicdn.net/img/view/2012/6/23/17775.jpg,0,0.9937760829925536,0,1892,488,2436,488,544,princess cadance|shining armor|twilight sparkle,solar-slash
1779721.png,https://derpicdn.net/img/view/2018/7/13/1779721.png,0,0.9989753365516664,1048,79,1428,459,380,380,princess celestia|rainbow dash|twilight sparkle,saphi-boo
1779721.png,https://derpicdn.net/img/view/2018/7/13/1779721.png,1,0.9973372220993042,455,855,847,1247,392,392,princess celestia|rainbow dash|twilight sparkle,saphi-boo
1779721.png,https://derpicdn.net/img/view/2018/7/13/1779721.png,2,0.9964916706085204,915,941,1259,1285,344,344,princess celestia|rainbow dash|twilight sparkle,saphi-boo
1779721.png,https://derpicdn.net/img/view/2018/7/13/1779721.png,3,0.9139756560325624,185,165,643,623,458,458,princess celestia|rainbow dash|twilight sparkle,saphi-boo
1780778.png,https://derpicdn.net/img/view/2018/7/14/1780778.png,0,0.9733262658119202,964,36,1302,374,338,338,applejack|fluttershy|mane six|pinkie pie|rainbow dash|rarity|twilight sparkle,saphi-boo
1780778.png,https://derpicdn.net/img/view/2018/7/14/1780778.png,1,0.9584181308746338,1837,0,2203,350,366,350,applejack|fluttershy|mane six|pinkie pie|rainbow dash|rarity|twilight sparkle,saphi-boo
1782087.png,https://derpicdn.net/img/view/2018/7/16/1782087.png,0,0.9899125695228576,460,80,728,348,268,268,rainbow dash|twilight sparkle,nootaz
1782087.png,https://derpicdn.net/img/view/2018/7/16/1782087.png,1,0.9895486235618592,272,56,584,368,312,312,rainbow dash|twilight sparkle,nootaz
178377.png,https://derpicdn.net/img/view/2012/12/10/178377.png,0,0.9990657567977904,453,472,917,936,464,464,pinkie pie|trixie|twilight sparkle,hoyeechun
1784670.png,https://derpicdn.net/img/view/2018/7/19/1784670.png,0,0.9673752784729004,0,44,184,246,184,202,princess flurry heart|twilight sparkle,
1789986.png,https://derpicdn.net/img/view/2018/7/26/1789986.png,0,0.9910970330238342,2389,169,3025,805,636,636,applejack|pinkie pie|princess luna|rainbow dash|twilight sparkle,blackspoiler
1789986.png,https://derpicdn.net/img/view/2018/7/26/1789986.png,1,0.9756208658218384,3489,196,3933,640,444,444,applejack|pinkie pie|princess luna|rainbow dash|twilight sparkle,blackspoiler
1790052.png,https://derpicdn.net/img/view/2018/7/26/1790052.png,2,0.9732234477996826,480,934,1010,1550,530,616,applejack|fluttershy|mane six|pinkie pie|rainbow dash|rarity|twilight sparkle,wolftendragon
1790731.png,https://derpicdn.net/img/view/2018/7/27/1790731.png,0,0.9509410858154296,0,195,740,1051,740,856,princess celestia|starlight glimmer|twilight sparkle,phat_guy
1798981.png,https://derpicdn.net/img/view/2018/8/5/1798981.png,1,0.9521015286445618,534,4,1000,502,466,498,rainbow dash|twilight sparkle,waterz-colrxz
1801379.png,https://derpicdn.net/img/view/2018/8/8/1801379.png,0,0.9815817475318908,0,19,254,299,254,280,applejack|fluttershy|mane six|pinkie pie|rainbow dash|rarity|twilight sparkle,eggoatt|eggoat
1801379.png,https://derpicdn.net/img/view/2018/8/8/1801379.png,1,0.9660730361938475,243,1009,505,1271,262,262,applejack|fluttershy|mane six|pinkie pie|rainbow dash|rarity|twilight sparkle,eggoatt|eggoat
1801589.png,https://derpicdn.net/img/view/2018/8/8/1801589.png,0,0.998718798160553,932,356,2228,1652,1296,1296,rainbow dash|twilight sparkle,lunagalaxy2003
180425.png,https://derpicdn.net/img/view/2012/12/12/180425.png,0,0.9695606231689452,213,58,495,340,282,282,applejack|fluttershy|rarity|twilight sparkle,akili-amethyst
1804790.png,https://derpicdn.net/img/view/2018/8/12/1804790.png,0,0.9293859004974364,671,2,843,174,172,172,applejack|fluttershy|mane six|pinkie pie|rainbow dash|rarity|twilight sparkle,erkythehero23
1806359.png,https://derpicdn.net/img/view/2018/8/14/1806359.png,0,0.999042809009552,1082,17,1710,683,628,666,applejack|fluttershy|mane six|pinkie pie|rainbow dash|rarity|starlight glimmer|sunset shimmer|twilight sparkle,mustachedbain
1806359.png,https://derpicdn.net/img/view/2018/8/14/1806359.png,1,0.9964988231658936,519,763,1215,1459,696,696,applejack|fluttershy|mane six|pinkie pie|rainbow dash|rarity|starlight glimmer|sunset shimmer|twilight sparkle,mustachedbain
1806359.png,https://derpicdn.net/img/view/2018/8/14/1806359.png,2,0.9952801465988159,468,0,1222,723,754,723,applejack|fluttershy|mane six|pinkie pie|rainbow dash|rarity|starlight glimmer|sunset shimmer|twilight sparkle,mustachedbain
1806359.png,https://derpicdn.net/img/view/2018/8/14/1806359.png,3,0.9921414256095886,1127,1638,1710,2262,583,624,applejack|fluttershy|mane six|pinkie pie|rainbow dash|rarity|starlight glimmer|sunset shimmer|twilight sparkle,mustachedbain
1806359.png,https://derpicdn.net/img/view/2018/8/14/1806359.png,4,0.98493629693985,1167,838,1710,1456,543,618,applejack|fluttershy|mane six|pinkie pie|rainbow dash|rarity|starlight glimmer|sunset shimmer|twilight sparkle,mustachedbain
1807538.png,https://derpicdn.net/img/view/2018/8/15/1807538.png,0,0.9777787923812866,0,326,382,720,382,394,princess cadance|princess flurry heart|starlight glimmer|twilight sparkle,gihhbloonde
1808564.png,https://derpicdn.net/img/view/2018/8/16/1808564.png,0,0.9793411493301392,0,0,197,201,197,201,applejack|twilight sparkle,pencils
1809912.png,https://derpicdn.net/img/view/2018/8/18/1809912.png,0,0.9644876718521118,16,0,276,203,260,203,fluttershy|pinkie pie|twilight sparkle,pencils
1809912.png,https://derpicdn.net/img/view/2018/8/18/1809912.png,1,0.9455889463424684,61,0,363,203,302,203,fluttershy|pinkie pie|twilight sparkle,pencils
1810139.png,https://derpicdn.net/img/view/2018/8/18/1810139.png,0,0.9013336896896362,314,265,494,445,180,180,discord|princess cadance|twilight sparkle,
1810738.png,https://derpicdn.net/img/view/2018/8/19/1810738.png,0,0.9979634284973145,241,142,435,336,194,194,princess cadance|princess flurry heart|shining armor|starlight glimmer|twilight sparkle,jhayarr23
1810738.png,https://derpicdn.net/img/view/2018/8/19/1810738.png,3,0.9298884272575378,481,164,681,364,200,200,princess cadance|princess flurry heart|shining armor|starlight glimmer|twilight sparkle,jhayarr23
1811089.png,https://derpicdn.net/img/view/2018/8/19/1811089.png,0,0.9649144411087036,993,54,1987,1000,994,946,starlight glimmer|twilight sparkle,uotapo
1815081.png,https://derpicdn.net/img/view/2018/8/24/1815081.png,0,0.9995459914207458,508,0,952,413,444,413,princess celestia|princess luna|sunset shimmer|twilight sparkle,meto30
1819051.png,https://derpicdn.net/img/view/2018/8/29/1819051.png,0,0.9834244847297668,482,4,774,296,292,292,applejack|fluttershy|mane six|pinkie pie|rainbow dash|rarity|spike|twilight sparkle,imaplatypus
1819051.png,https://derpicdn.net/img/view/2018/8/29/1819051.png,1,0.9808807373046876,1024,186,1280,492,256,306,applejack|fluttershy|mane six|pinkie pie|rainbow dash|rarity|spike|twilight sparkle,imaplatypus
1819051.png,https://derpicdn.net/img/view/2018/8/29/1819051.png,2,0.9179774522781372,125,24,449,348,324,324,applejack|fluttershy|mane six|pinkie pie|rainbow dash|rarity|spike|twilight sparkle,imaplatypus
1819289.png,https://derpicdn.net/img/view/2018/8/29/1819289.png,0,0.9434890151023864,545,0,931,342,386,342,spike|twilight sparkle,aleximusprime
182418.png,https://derpicdn.net/img/view/2012/12/14/182418.png,0,0.9509232640266418,42,18,190,166,148,148,apple bloom|applejack|cutie mark crusaders|fluttershy|mane six|pinkie pie|rainbow dash|rarity|scootaloo|spike|sweetie belle|twilight sparkle,death-driver-5000
1824631.png,https://derpicdn.net/img/view/2018/9/4/1824631.png,0,0.9967975616455078,115,0,813,682,698,682,rainbow dash|sunset shimmer|twilight sparkle,nichroniclesvsart
1824631.png,https://derpicdn.net/img/view/2018/9/4/1824631.png,2,0.9959425330162048,234,865,772,1403,538,538,rainbow dash|sunset shimmer|twilight sparkle,nichroniclesvsart
1824928.png,https://derpicdn.net/img/view/2018/9/4/1824928.png,1,0.9934430718421936,476,106,1054,684,578,578,rainbow dash|sunset shimmer|twilight sparkle,nichroniclesvsart
1824928.png,https://derpicdn.net/img/view/2018/9/4/1824928.png,2,0.9896228313446044,116,862,732,1478,616,616,rainbow dash|sunset shimmer|twilight sparkle,nichroniclesvsart
1824928.png,https://derpicdn.net/img/view/2018/9/4/1824928.png,3,0.9877340197563172,604,1018,1146,1560,542,542,rainbow dash|sunset shimmer|twilight sparkle,nichroniclesvsart
1824935.png,https://derpicdn.net/img/view/2018/9/4/1824935.png,1,0.945244073867798,669,459,1849,1639,1180,1180,pinkie pie|twilight sparkle,acerotiburon
1826799.png,https://derpicdn.net/img/view/2018/9/7/1826799.png,0,0.9962220191955566,401,418,619,636,218,218,applejack|fluttershy|mane six|pinkie pie|rainbow dash|rarity|twilight sparkle,shiiazu
1826799.png,https://derpicdn.net/img/view/2018/9/7/1826799.png,1,0.9783164262771606,667,330,927,590,260,260,applejack|fluttershy|mane six|pinkie pie|rainbow dash|rarity|twilight sparkle,shiiazu
1826799.png,https://derpicdn.net/img/view/2018/9/7/1826799.png,2,0.9533540606498718,975,366,1173,564,198,198,applejack|fluttershy|mane six|pinkie pie|rainbow dash|rarity|twilight sparkle,shiiazu
1826799.png,https://derpicdn.net/img/view/2018/9/7/1826799.png,3,0.9090425372123718,85,344,385,644,300,300,applejack|fluttershy|mane six|pinkie pie|rainbow dash|rarity|twilight sparkle,shiiazu
1827297.png,https://derpicdn.net/img/view/2018/9/8/1827297.png,0,0.9925107955932616,1032,573,1330,871,298,298,princess flurry heart|shining armor|twilight sparkle,mintbubbie
1829454.png,https://derpicdn.net/img/view/2018/9/10/1829454.png,0,0.9355825781822203,196,0,531,311,335,311,pinkie pie|rainbow dash|twilight sparkle,
1831142.png,https://derpicdn.net/img/view/2018/9/12/1831142.png,0,0.903215765953064,84,0,272,138,188,138,apple bloom|applejack|fluttershy|sweetie belle|twilight sparkle,
1832820.png,https://derpicdn.net/img/view/2018/9/15/1832820.png,0,0.9108726978302002,22,0,554,477,532,477,rainbow dash|twilight sparkle,
1833071.png,https://derpicdn.net/img/view/2018/9/15/1833071.png,0,0.9288523197174072,432,0,1372,924,940,924,starlight glimmer|trixie|twilight sparkle,mistleinn
1834529.png,https://derpicdn.net/img/view/2018/9/17/1834529.png,0,0.9985891580581664,325,18,875,568,550,550,sunset shimmer|twilight sparkle,nichroniclesvsart
1835989.png,https://derpicdn.net/img/view/2018/9/19/1835989.png,0,0.9924266934394836,122,0,870,745,748,745,rainbow dash|twilight sparkle,celiaurore
1837593.png,https://derpicdn.net/img/view/2018/9/21/1837593.png,0,0.9197996854782104,297,58,1280,1094,983,1036,starlight glimmer|twilight sparkle,badponyvectors
1838122.png,https://derpicdn.net/img/view/2018/9/21/1838122.png,0,0.918738067150116,434,47,1270,883,836,836,rainbow dash|twilight sparkle,sweet-mayhem
1839509.png,https://derpicdn.net/img/view/2018/9/23/1839509.png,0,0.9949275851249696,473,1060,1141,1728,668,668,princess celestia|twilight sparkle,the-furry-railfan
1840775.png,https://derpicdn.net/img/view/2018/9/25/1840775.png,0,0.9727711081504822,0,22,310,348,310,326,applejack|rarity|twilight sparkle,
1844365.png,https://derpicdn.net/img/view/2018/9/30/1844365.png,0,0.9995713829994202,2977,493,4201,1775,1224,1282,apple bloom|twilight sparkle,comfydove
1844365.png,https://derpicdn.net/img/view/2018/9/30/1844365.png,1,0.9769152998924256,1057,894,2361,2198,1304,1304,apple bloom|twilight sparkle,comfydove
1845193.png,https://derpicdn.net/img/view/2018/10/1/1845193.png,0,0.9979486465454102,840,58,1712,930,872,872,princess luna|twilight sparkle,renarde-louve
1850882.png,https://derpicdn.net/img/view/2018/10/7/1850882.png,1,0.9109176993370056,1849,158,3417,1726,1568,1568,apple bloom|cutie mark crusaders|princess cadance|rainbow dash|scootaloo|sweetie belle|twilight sparkle,apexpredator923
1855817.png,https://derpicdn.net/img/view/2018/10/13/1855817.png,1,0.9202829003334044,208,171,530,493,322,322,pinkie pie|rainbow dash|twilight sparkle,thegreatrouge
1855965.png,https://derpicdn.net/img/view/2018/10/14/1855965.png,0,0.998683750629425,107,10,621,524,514,514,rarity|twilight sparkle,nichroniclesvsart
1859877.png,https://derpicdn.net/img/view/2018/10/18/1859877.png,3,0.9584985971450806,628,964,1164,1500,536,536,apple bloom|applejack|fluttershy|pinkie pie|princess cadance|rainbow dash|rarity|twilight sparkle,saphi-boo
1860193.png,https://derpicdn.net/img/view/2018/10/19/1860193.png,0,0.9998488426208496,595,83,1001,489,406,406,applejack|fluttershy|mane six|pinkie pie|rainbow dash|rarity|sunset shimmer|twilight sparkle,nichroniclesvsart
1860934.png,https://derpicdn.net/img/view/2018/10/19/1860934.png,0,0.9968597888946532,290,0,778,468,488,468,spike|twilight sparkle,foxxy-arts
1861317.png,https://derpicdn.net/img/view/2018/10/20/1861317.png,0,0.9838802814483644,394,1590,982,2178,588,588,applejack|fluttershy|mane six|pinkie pie|princess celestia|rainbow dash|rarity|spike|spitfire|starlight glimmer|twilight sparkle,sonofaskywalker
1861317.png,https://derpicdn.net/img/view/2018/10/20/1861317.png,2,0.938877284526825,1041,580,1291,830,250,250,applejack|fluttershy|mane six|pinkie pie|princess celestia|rainbow dash|rarity|spike|spitfire|starlight glimmer|twilight sparkle,sonofaskywalker
1861317.png,https://derpicdn.net/img/view/2018/10/20/1861317.png,3,0.9205514192581176,184,2632,510,2958,326,326,applejack|fluttershy|mane six|pinkie pie|princess celestia|rainbow dash|rarity|spike|spitfire|starlight glimmer|twilight sparkle,sonofaskywalker
1861317.png,https://derpicdn.net/img/view/2018/10/20/1861317.png,4,0.9088796377182008,267,806,689,1228,422,422,applejack|fluttershy|mane six|pinkie pie|princess celestia|rainbow dash|rarity|spike|spitfire|starlight glimmer|twilight sparkle,sonofaskywalker
1862727.png,https://derpicdn.net/img/view/2018/10/22/1862727.png,0,0.9590002298355104,831,457,1429,1055,598,598,spike|twilight sparkle,mandy1412
1862752.png,https://derpicdn.net/img/view/2018/10/22/1862752.png,0,0.9933075904846193,423,178,635,390,212,212,applejack|rainbow dash|twilight sparkle,mandy1412
1862752.png,https://derpicdn.net/img/view/2018/10/22/1862752.png,1,0.99056077003479,740,193,978,431,238,238,applejack|rainbow dash|twilight sparkle,mandy1412
1862752.png,https://derpicdn.net/img/view/2018/10/22/1862752.png,2,0.9903083443641664,396,687,642,933,246,246,applejack|rainbow dash|twilight sparkle,mandy1412
1862752.png,https://derpicdn.net/img/view/2018/10/22/1862752.png,3,0.978103518486023,86,752,302,968,216,216,applejack|rainbow dash|twilight sparkle,mandy1412
1862752.png,https://derpicdn.net/img/view/2018/10/22/1862752.png,4,0.953019917011261,719,677,1005,963,286,286,applejack|rainbow dash|twilight sparkle,mandy1412
1862752.png,https://derpicdn.net/img/view/2018/10/22/1862752.png,5,0.9458013772964478,0,202,216,422,216,220,applejack|rainbow dash|twilight sparkle,mandy1412
1865639.png,https://derpicdn.net/img/view/2018/10/25/1865639.png,0,0.9789555668830872,141,0,523,372,382,372,applejack|twilight sparkle,rwl
1870017.png,https://derpicdn.net/img/view/2018/10/30/1870017.png,1,0.9772918224334716,1569,384,1920,744,351,360,applejack|fluttershy|pinkie pie|rainbow dash|rarity|sunset shimmer|twilight sparkle,
1871390.png,https://derpicdn.net/img/view/2018/10/31/1871390.png,0,0.9552677869796752,931,348,1125,542,194,194,applejack|fluttershy|pinkie pie|rainbow dash|rarity|sunset shimmer|twilight sparkle,
1873625.png,https://derpicdn.net/img/view/2018/11/2/1873625.png,0,0.9997753500938416,1559,1268,2549,2258,990,990,princess celestia|twilight sparkle,shaslan
1876302.png,https://derpicdn.net/img/view/2018/11/6/1876302.png,0,0.9989027976989746,338,945,1078,1685,740,740,sunset shimmer|twilight sparkle,little-tweenframes
1876302.png,https://derpicdn.net/img/view/2018/11/6/1876302.png,1,0.9985647797584534,1348,1805,2040,2497,692,692,sunset shimmer|twilight sparkle,little-tweenframes
1876302.png,https://derpicdn.net/img/view/2018/11/6/1876302.png,2,0.9946068525314332,1815,247,2205,637,390,390,sunset shimmer|twilight sparkle,little-tweenframes
1878209.png,https://derpicdn.net/img/view/2018/11/9/1878209.png,0,0.9410145878791808,476,478,742,744,266,266,princess celestia|sunset shimmer|twilight sparkle,
1882203.png,https://derpicdn.net/img/view/2018/11/14/1882203.png,0,0.9859499931335448,1137,2857,1946,3817,809,960,fluttershy|starlight glimmer|twilight sparkle,artiks
1882657.png,https://derpicdn.net/img/view/2018/11/15/1882657.png,0,0.9958223700523376,439,705,673,939,234,234,applejack|fluttershy|mane six|pinkie pie|rainbow dash|rarity|spike|twilight sparkle,hardwaybet|hardway bet
1882657.png,https://derpicdn.net/img/view/2018/11/15/1882657.png,1,0.9924033284187316,276,0,490,211,214,211,applejack|fluttershy|mane six|pinkie pie|rainbow dash|rarity|spike|twilight sparkle,hardwaybet|hardway bet
1882657.png,https://derpicdn.net/img/view/2018/11/15/1882657.png,2,0.9493597745895386,527,90,695,258,168,168,applejack|fluttershy|mane six|pinkie pie|rainbow dash|rarity|spike|twilight sparkle,hardwaybet|hardway bet
1883687.png,https://derpicdn.net/img/view/2018/11/16/1883687.png,0,0.9886180758476256,251,0,725,452,474,452,rarity|twilight sparkle,skuuma2511
1884027.png,https://derpicdn.net/img/view/2018/11/17/1884027.png,0,0.9406183958053588,1109,385,1811,1080,702,695,sunset shimmer|twilight sparkle,
1891406.png,https://derpicdn.net/img/view/2018/11/26/1891406.png,0,0.9932973384857178,307,34,791,518,484,484,spike|twilight sparkle,virtualcipher
189300.jpg,https://derpicdn.net/img/view/2012/12/21/189300.jpg,0,0.9773086905479432,869,177,1083,391,214,214,applejack|fluttershy|mane six|pinkie pie|rainbow dash|rarity|twilight sparkle,wazzart
1896535.png,https://derpicdn.net/img/view/2018/12/2/1896535.png,0,0.9791757464408876,837,111,1073,347,236,236,applejack|fluttershy|mane six|pinkie pie|rainbow dash|rarity|twilight sparkle,hiyori-yamada
1896535.png,https://derpicdn.net/img/view/2018/12/2/1896535.png,1,0.9348249435424804,1034,71,1280,359,246,288,applejack|fluttershy|mane six|pinkie pie|rainbow dash|rarity|twilight sparkle,hiyori-yamada
1897126.png,https://derpicdn.net/img/view/2018/12/3/1897126.png,1,0.977294385433197,186,19,564,397,378,378,princess cadance|princess flurry heart|shining armor|twilight sparkle,
1897126.png,https://derpicdn.net/img/view/2018/12/3/1897126.png,2,0.947446882724762,871,181,1107,417,236,236,princess cadance|princess flurry heart|shining armor|twilight sparkle,
1899731.png,https://derpicdn.net/img/view/2018/12/6/1899731.png,0,0.9993465542793274,3313,282,4500,1514,1187,1232,princess luna|twilight sparkle,silverhopexiii
1899731.png,https://derpicdn.net/img/view/2018/12/6/1899731.png,1,0.998471200466156,266,2219,1324,3200,1058,981,princess luna|twilight sparkle,silverhopexiii
1899731.png,https://derpicdn.net/img/view/2018/12/6/1899731.png,2,0.9463671445846558,2035,0,2951,779,916,779,princess luna|twilight sparkle,silverhopexiii
1902744.png,https://derpicdn.net/img/view/2018/12/8/1902744.png,0,0.9889416694641112,40,201,418,579,378,378,applejack|fluttershy|pinkie pie|rainbow dash|rarity|twilight sparkle,castaspellliana
1904386.png,https://derpicdn.net/img/view/2018/12/10/1904386.png,0,0.9995210766792296,156,0,674,491,518,491,trixie|twilight sparkle,mabo3
1911543.png,https://derpicdn.net/img/view/2018/12/17/1911543.png,0,0.9993562698364258,82,335,1302,1555,1220,1220,starlight glimmer|sunset shimmer|twilight sparkle,schokocream
1911543.png,https://derpicdn.net/img/view/2018/12/17/1911543.png,2,0.9651328325271606,2064,197,3265,1421,1201,1224,starlight glimmer|sunset shimmer|twilight sparkle,schokocream
1916323.png,https://derpicdn.net/img/view/2018/12/23/1916323.png,0,0.9886906743049622,78,1128,592,1642,514,514,applejack|fluttershy|pinkie pie|rainbow dash|rarity|twilight sparkle,ironm17
1916323.png,https://derpicdn.net/img/view/2018/12/23/1916323.png,2,0.9499311447143556,2051,1003,2769,1721,718,718,applejack|fluttershy|pinkie pie|rainbow dash|rarity|twilight sparkle,ironm17
1916482.png,https://derpicdn.net/img/view/2018/12/23/1916482.png,1,0.9953036904335022,897,0,1695,716,798,716,applejack|fluttershy|mane six|pinkie pie|rainbow dash|rarity|spike|twilight sparkle,zoxriver503
1918095.png,https://derpicdn.net/img/view/2018/12/25/1918095.png,1,0.9931705594062804,473,1262,749,1538,276,276,applejack|fluttershy|mane six|pinkie pie|rainbow dash|rarity|twilight sparkle,kiarawizard01
1918095.png,https://derpicdn.net/img/view/2018/12/25/1918095.png,2,0.9809655547142028,259,3090,549,3380,290,290,applejack|fluttershy|mane six|pinkie pie|rainbow dash|rarity|twilight sparkle,kiarawizard01
1918095.png,https://derpicdn.net/img/view/2018/12/25/1918095.png,3,0.9644813537597656,153,1706,453,2006,300,300,applejack|fluttershy|mane six|pinkie pie|rainbow dash|rarity|twilight sparkle,kiarawizard01
1920325.png,https://derpicdn.net/img/view/2018/12/27/1920325.png,0,0.972691535949707,54,0,800,571,746,571,rainbow dash|twilight sparkle,bb-cumming
1927590.png,https://derpicdn.net/img/view/2019/1/5/1927590.png,0,0.9892448782920836,397,0,1453,893,1056,893,sunset shimmer|twilight sparkle,flushthebatsanta
1934104.png,https://derpicdn.net/img/view/2019/1/13/1934104.png,0,0.9837361574172974,1252,682,1752,1182,500,500,applejack|fluttershy|mane six|pinkie pie|rainbow dash|rarity|twilight sparkle,theunconsistentone
1935497.png,https://derpicdn.net/img/view/2019/1/14/1935497.png,0,0.9959786534309388,4008,0,5950,1862,1942,1862,applejack|fluttershy|mane six|pinkie pie|rainbow dash|rarity|twilight sparkle,apexpredator923
1935497.png,https://derpicdn.net/img/view/2019/1/14/1935497.png,1,0.9889135360717772,2148,25,3916,1793,1768,1768,applejack|fluttershy|mane six|pinkie pie|rainbow dash|rarity|twilight sparkle,apexpredator923
1935497.png,https://derpicdn.net/img/view/2019/1/14/1935497.png,2,0.9830882549285888,0,1670,1926,3604,1926,1934,applejack|fluttershy|mane six|pinkie pie|rainbow dash|rarity|twilight sparkle,apexpredator923
1935497.png,https://derpicdn.net/img/view/2019/1/14/1935497.png,3,0.9785528779029846,284,3469,2132,5313,1848,1844,applejack|fluttershy|mane six|pinkie pie|rainbow dash|rarity|twilight sparkle,apexpredator923
1935497.png,https://derpicdn.net/img/view/2019/1/14/1935497.png,4,0.9295457005500792,4110,1919,5712,3521,1602,1602,applejack|fluttershy|mane six|pinkie pie|rainbow dash|rarity|twilight sparkle,apexpredator923
1935497.png,https://derpicdn.net/img/view/2019/1/14/1935497.png,5,0.9076408147811892,0,0,2019,2001,2019,2001,applejack|fluttershy|mane six|pinkie pie|rainbow dash|rarity|twilight sparkle,apexpredator923
1939174.png,https://derpicdn.net/img/view/2019/1/19/1939174.png,0,0.942895233631134,791,0,1024,225,233,225,applejack|fluttershy|mane six|pinkie pie|rainbow dash|rarity|twilight sparkle,sandwichbuns
1942183.png,https://derpicdn.net/img/view/2019/1/23/1942183.png,0,0.991712749004364,0,0,1098,1082,1098,1082,trixie|twilight sparkle,blackbewhite2k7
1949258.png,https://derpicdn.net/img/view/2019/1/31/1949258.png,0,0.9957857728004456,540,269,728,457,188,188,applejack|fluttershy|mane six|pinkie pie|rainbow dash|rarity|twilight sparkle,zaphy1415926
1951034.png,https://derpicdn.net/img/view/2019/2/2/1951034.png,1,0.9884718060493468,1679,276,2659,1256,980,980,sunset shimmer|twilight sparkle,spinoffjoe
1956611.png,https://derpicdn.net/img/view/2019/2/8/1956611.png,0,0.9658455848693848,26,68,430,472,404,404,applejack|rarity|twilight sparkle,rubysplash2018
1956611.png,https://derpicdn.net/img/view/2019/2/8/1956611.png,2,0.9274995923042296,600,103,934,437,334,334,applejack|rarity|twilight sparkle,rubysplash2018
19597.jpg,https://derpicdn.net/img/view/2012/6/25/19597.jpg,1,0.9815551042556764,188,127,400,339,212,212,princess celestia|twilight sparkle,yubi
1962854.png,https://derpicdn.net/img/view/2019/2/15/1962854.png,0,0.9595671892166138,767,392,1119,744,352,352,princess celestia|princess luna|twilight sparkle,rainbow eevee
1965428.png,https://derpicdn.net/img/view/2019/2/18/1965428.png,0,0.9446136355400084,188,58,484,354,296,296,spike|twilight sparkle,
1966153.png,https://derpicdn.net/img/view/2019/2/19/1966153.png,0,0.9865652918815612,0,0,844,720,844,720,pinkie pie|starlight glimmer|twilight sparkle,
1968077.png,https://derpicdn.net/img/view/2019/2/21/1968077.png,2,0.9922018647193908,1084,59,1554,529,470,470,applejack|rainbow dash|rarity|twilight sparkle,urpone
196827.png,https://derpicdn.net/img/view/2012/12/29/196827.png,0,0.9796640276908876,17,0,617,505,600,505,spike|twilight sparkle,
1973092.png,https://derpicdn.net/img/view/2019/2/27/1973092.png,0,0.9645612239837646,934,167,1256,489,322,322,spike|twilight sparkle,eqq_scremble
1973538.png,https://derpicdn.net/img/view/2019/2/28/1973538.png,0,0.991370677947998,83,1124,385,1426,302,302,apple bloom|princess cadance|rainbow dash|twilight sparkle,saphi-boo
1973538.png,https://derpicdn.net/img/view/2019/2/28/1973538.png,1,0.9766291379928588,156,251,570,665,414,414,apple bloom|princess cadance|rainbow dash|twilight sparkle,saphi-boo
1973538.png,https://derpicdn.net/img/view/2019/2/28/1973538.png,2,0.96375972032547,1052,19,1794,761,742,742,apple bloom|princess cadance|rainbow dash|twilight sparkle,saphi-boo
1973682.png,https://derpicdn.net/img/view/2019/2/28/1973682.png,0,0.9989963173866272,738,0,1140,320,402,320,princess cadance|princess celestia|princess flurry heart|princess luna|twilight sparkle,lightning stripe
1973682.png,https://derpicdn.net/img/view/2019/2/28/1973682.png,3,0.944971203804016,384,0,758,307,374,307,princess cadance|princess celestia|princess flurry heart|princess luna|twilight sparkle,lightning stripe
1979737.png,https://derpicdn.net/img/view/2019/3/7/1979737.png,0,0.996379017829895,1341,492,1668,822,327,330,fluttershy|pinkie pie|rainbow dash|rarity|twilight sparkle,
1979737.png,https://derpicdn.net/img/view/2019/3/7/1979737.png,1,0.9594621658325196,53,522,361,830,308,308,fluttershy|pinkie pie|rainbow dash|rarity|twilight sparkle,
1980136.png,https://derpicdn.net/img/view/2019/3/8/1980136.png,0,0.9957302212715148,116,0,854,707,738,707,rainbow dash|twilight sparkle,
1981215.png,https://derpicdn.net/img/view/2019/3/9/1981215.png,0,0.99750554561615,283,105,581,403,298,298,rarity|twilight sparkle,rossignolet
1989846.png,https://derpicdn.net/img/view/2019/3/19/1989846.png,0,0.9613491296768188,0,0,425,403,425,403,fluttershy|twilight sparkle,
1997354.png,https://derpicdn.net/img/view/2019/3/29/1997354.png,0,0.9520360827445984,667,0,1600,730,933,730,pinkie pie|twilight sparkle,zsparkonequus
2000006.png,https://derpicdn.net/img/view/2019/4/1/2000006.png,0,0.9897555708885192,1200,375,1808,983,608,608,rainbow dash|sunset shimmer|twilight sparkle,
2000015.png,https://derpicdn.net/img/view/2019/4/1/2000015.png,0,0.9947280883789062,268,0,946,659,678,659,sunset shimmer|twilight sparkle,
2000853.png,https://derpicdn.net/img/view/2019/4/2/2000853.png,0,0.9983306527137756,756,594,1000,838,244,244,applejack|fluttershy|mane six|pinkie pie|rainbow dash|rarity|twilight sparkle,lynmunn
2000853.png,https://derpicdn.net/img/view/2019/4/2/2000853.png,1,0.9966830611228944,336,605,598,867,262,262,applejack|fluttershy|mane six|pinkie pie|rainbow dash|rarity|twilight sparkle,lynmunn
2000853.png,https://derpicdn.net/img/view/2019/4/2/2000853.png,2,0.9023768305778505,99,343,417,661,318,318,applejack|fluttershy|mane six|pinkie pie|rainbow dash|rarity|twilight sparkle,lynmunn
2001101.png,https://derpicdn.net/img/view/2019/4/2/2001101.png,1,0.9499632120132446,641,31,975,365,334,334,spike|sunset shimmer|twilight sparkle,
2001351.png,https://derpicdn.net/img/view/2019/4/2/2001351.png,0,0.991779327392578,1352,864,1960,1472,608,608,discord|rainbow dash|twilight sparkle,southparktaoist
2001518.png,https://derpicdn.net/img/view/2019/4/3/2001518.png,1,0.9820481538772584,814,752,998,936,184,184,rainbow dash|sunset shimmer|twilight sparkle,
2002069.png,https://derpicdn.net/img/view/2019/4/3/2002069.png,0,0.9373487830162048,171,1,454,297,283,296,sunset shimmer|twilight sparkle,
2002206.png,https://derpicdn.net/img/view/2019/4/3/2002206.png,0,0.9617799520492554,153,569,257,673,104,104,applejack|fluttershy|mane six|pinkie pie|rainbow dash|rarity|spike|starlight glimmer|twilight sparkle,
2002571.png,https://derpicdn.net/img/view/2019/4/4/2002571.png,0,0.9061355590820312,474,39,720,285,246,246,rainbow dash|twilight sparkle,foxysparkle
2003170.png,https://derpicdn.net/img/view/2019/4/5/2003170.png,0,0.9289340972900392,329,122,789,582,460,460,applejack|fluttershy|mane six|pinkie pie|rainbow dash|rarity|twilight sparkle,nootnuts
2005752.png,https://derpicdn.net/img/view/2019/4/7/2005752.png,0,0.9063360691070556,42,185,436,579,394,394,sunset shimmer|twilight sparkle,haretrinity
2006384.png,https://derpicdn.net/img/view/2019/4/8/2006384.png,0,0.987029492855072,324,222,826,724,502,502,fluttershy|twilight sparkle,fuzzypones
2006384.png,https://derpicdn.net/img/view/2019/4/8/2006384.png,1,0.9594147205352784,1097,157,1697,757,600,600,fluttershy|twilight sparkle,fuzzypones
2008423.png,https://derpicdn.net/img/view/2019/4/10/2008423.png,0,0.97262305021286,927,29,1351,453,424,424,applejack|fluttershy|mane six|pinkie pie|rainbow dash|rarity|twilight sparkle,rosefang16
2010452.png,https://derpicdn.net/img/view/2019/4/13/2010452.png,0,0.9923826456069946,1256,0,2768,1381,1512,1381,applejack|fluttershy|mane six|pinkie pie|rainbow dash|rarity|twilight sparkle,beardeddoomguy|hentype1
2013184.png,https://derpicdn.net/img/view/2019/4/15/2013184.png,0,0.9848009347915648,1698,1160,2046,1508,348,348,applejack|fluttershy|mane six|pinkie pie|rainbow dash|rarity|twilight sparkle,
2014345.png,https://derpicdn.net/img/view/2019/4/16/2014345.png,0,0.9343052506446838,368,0,722,277,354,277,sunset shimmer|twilight sparkle,ta-na
2016216.png,https://derpicdn.net/img/view/2019/4/18/2016216.png,0,0.9205195903778076,3936,1227,4454,1745,518,518,applejack|fluttershy|pinkie pie|rainbow dash|rarity|sunset shimmer|twilight sparkle,sparkling-sunset-s08
2016325.png,https://derpicdn.net/img/view/2019/4/19/2016325.png,0,0.9638882875442504,772,299,1394,921,622,622,sunset shimmer|twilight sparkle,
2016325.png,https://derpicdn.net/img/view/2019/4/19/2016325.png,1,0.9050122499465942,208,81,914,787,706,706,sunset shimmer|twilight sparkle,
2017369.png,https://derpicdn.net/img/view/2019/4/20/2017369.png,0,0.9418690204620358,2034,0,4292,2226,2258,2226,pinkie pie|twilight sparkle,mississippikite
2017395.png,https://derpicdn.net/img/view/2019/4/20/2017395.png,0,0.9962420463562012,1412,330,2556,1474,1144,1144,pinkie pie|twilight sparkle,mississippikite
2017875.png,https://derpicdn.net/img/view/2019/4/20/2017875.png,0,0.9775534868240356,260,3,934,677,674,674,shining armor|spike|twilight sparkle,
2018701.png,https://derpicdn.net/img/view/2019/4/21/2018701.png,0,0.9874138832092284,714,285,1256,827,542,542,shining armor|spike|twilight sparkle,
2020482.png,https://derpicdn.net/img/view/2019/4/23/2020482.png,0,0.9986132383346558,741,0,1547,792,806,792,applejack|shining armor|spike|twilight sparkle,
2023661.png,https://derpicdn.net/img/view/2019/4/26/2023661.png,0,0.990568459033966,448,2918,1692,4162,1244,1244,fluttershy|rainbow dash|twilight sparkle,cutepencilcase
2023661.png,https://derpicdn.net/img/view/2019/4/26/2023661.png,1,0.968651294708252,1857,742,3333,2218,1476,1476,fluttershy|rainbow dash|twilight sparkle,cutepencilcase
2024412.png,https://derpicdn.net/img/view/2019/4/27/2024412.png,0,0.927177667617798,389,170,843,624,454,454,spike|twilight sparkle,
2025400.png,https://derpicdn.net/img/view/2019/4/28/2025400.png,0,0.9898325800895692,630,223,1040,633,410,410,apple bloom|applejack|big macintosh|cutie mark crusaders|fluttershy|mane six|pinkie pie|princess cadance|princess celestia|princess luna|rainbow dash|rarity|scootaloo|spike|spitfire|starlight glimmer|sweetie belle|twilight sparkle,
2026692.png,https://derpicdn.net/img/view/2019/4/29/2026692.png,0,0.9892644882202148,1610,328,2166,884,556,556,rainbow dash|shining armor|spike|twilight sparkle,
2034745.png,https://derpicdn.net/img/view/2019/5/9/2034745.png,0,0.9975064992904664,2276,0,3124,791,848,791,applejack|fluttershy|mane six|pinkie pie|rainbow dash|rarity|twilight sparkle,cloudyglow
2034745.png,https://derpicdn.net/img/view/2019/5/9/2034745.png,1,0.974338948726654,1292,531,2198,1437,906,906,applejack|fluttershy|mane six|pinkie pie|rainbow dash|rarity|twilight sparkle,cloudyglow
2035835.png,https://derpicdn.net/img/view/2019/5/10/2035835.png,0,0.9761576652526855,0,40,613,692,613,652,sunset shimmer|twilight sparkle,
2039033.png,https://derpicdn.net/img/view/2019/5/14/2039033.png,0,0.9860692024230956,571,7,985,421,414,414,applejack|fluttershy|mane six|pinkie pie|rainbow dash|rarity|twilight sparkle,pink-pone|bb-and-the-boys
2039033.png,https://derpicdn.net/img/view/2019/5/14/2039033.png,1,0.9793042540550232,450,1094,1043,1740,593,646,applejack|fluttershy|mane six|pinkie pie|rainbow dash|rarity|twilight sparkle,pink-pone|bb-and-the-boys
2039033.png,https://derpicdn.net/img/view/2019/5/14/2039033.png,2,0.9789194464683532,508,533,1043,1101,535,568,applejack|fluttershy|mane six|pinkie pie|rainbow dash|rarity|twilight sparkle,pink-pone|bb-and-the-boys
2039033.png,https://derpicdn.net/img/view/2019/5/14/2039033.png,3,0.9626250863075256,9,558,527,1076,518,518,applejack|fluttershy|mane six|pinkie pie|rainbow dash|rarity|twilight sparkle,pink-pone|bb-and-the-boys
2039033.png,https://derpicdn.net/img/view/2019/5/14/2039033.png,4,0.91730135679245,40,18,392,370,352,352,applejack|fluttershy|mane six|pinkie pie|rainbow dash|rarity|twilight sparkle,pink-pone|bb-and-the-boys
2042422.png,https://derpicdn.net/img/view/2019/5/18/2042422.png,0,0.9951414465904236,604,333,1078,807,474,474,fluttershy|spike|twilight sparkle,
2042422.png,https://derpicdn.net/img/view/2019/5/18/2042422.png,1,0.9906957149505616,959,248,1393,682,434,434,fluttershy|spike|twilight sparkle,
2042422.png,https://derpicdn.net/img/view/2019/5/18/2042422.png,2,0.9715734720230104,1291,313,1621,643,330,330,fluttershy|spike|twilight sparkle,
2048317.png,https://derpicdn.net/img/view/2019/5/25/2048317.png,0,0.9996814727783204,0,75,342,467,342,392,applejack|twilight sparkle,vkyw
2048317.png,https://derpicdn.net/img/view/2019/5/25/2048317.png,1,0.9376100897789,617,0,1115,422,498,422,applejack|twilight sparkle,vkyw
2048802.png,https://derpicdn.net/img/view/2019/5/25/2048802.png,0,0.9912465214729308,548,0,1294,739,746,739,applejack|fluttershy|mane six|pinkie pie|rainbow dash|rarity|twilight sparkle,vnagato
2048802.png,https://derpicdn.net/img/view/2019/5/25/2048802.png,1,0.9357166290283204,3014,723,3566,1275,552,552,applejack|fluttershy|mane six|pinkie pie|rainbow dash|rarity|twilight sparkle,vnagato
2048802.png,https://derpicdn.net/img/view/2019/5/25/2048802.png,2,0.9259465932846068,2319,60,3089,830,770,770,applejack|fluttershy|mane six|pinkie pie|rainbow dash|rarity|twilight sparkle,vnagato
2056765.png,https://derpicdn.net/img/view/2019/6/3/2056765.png,0,0.9913915395736694,691,338,949,596,258,258,applejack|fluttershy|mane six|pinkie pie|rainbow dash|rarity|twilight sparkle,rainbowdashsnipers
2056765.png,https://derpicdn.net/img/view/2019/6/3/2056765.png,1,0.9793201088905334,109,159,553,603,444,444,applejack|fluttershy|mane six|pinkie pie|rainbow dash|rarity|twilight sparkle,rainbowdashsnipers
2056765.png,https://derpicdn.net/img/view/2019/6/3/2056765.png,3,0.9476237297058104,1355,122,1920,688,565,566,applejack|fluttershy|mane six|pinkie pie|rainbow dash|rarity|twilight sparkle,rainbowdashsnipers
2056765.png,https://derpicdn.net/img/view/2019/6/3/2056765.png,4,0.9179388284683228,395,284,723,612,328,328,applejack|fluttershy|mane six|pinkie pie|rainbow dash|rarity|twilight sparkle,rainbowdashsnipers
2057705.png,https://derpicdn.net/img/view/2019/6/4/2057705.png,3,0.976902961730957,2323,1148,2969,1794,646,646,applejack|discord|pinkie pie|princess celestia|princess luna|rainbow dash|rarity|shining armor|spitfire|starlight glimmer|twilight sparkle,xxhuntersguardianxx
2057705.png,https://derpicdn.net/img/view/2019/6/4/2057705.png,4,0.9666897058486938,146,82,854,790,708,708,applejack|discord|pinkie pie|princess celestia|princess luna|rainbow dash|rarity|shining armor|spitfire|starlight glimmer|twilight sparkle,xxhuntersguardianxx
2057705.png,https://derpicdn.net/img/view/2019/6/4/2057705.png,5,0.9651822447776794,2739,929,3467,1657,728,728,applejack|discord|pinkie pie|princess celestia|princess luna|rainbow dash|rarity|shining armor|spitfire|starlight glimmer|twilight sparkle,xxhuntersguardianxx
2057705.png,https://derpicdn.net/img/view/2019/6/4/2057705.png,9,0.9097999930381776,196,1400,742,1946,546,546,applejack|discord|pinkie pie|princess celestia|princess luna|rainbow dash|rarity|shining armor|spitfire|starlight glimmer|twilight sparkle,xxhuntersguardianxx
2058483.png,https://derpicdn.net/img/view/2019/6/5/2058483.png,0,0.9957430958747864,439,618,793,972,354,354,applejack|fluttershy|mane six|pinkie pie|rainbow dash|rarity|twilight sparkle,ryuu
2058483.png,https://derpicdn.net/img/view/2019/6/5/2058483.png,2,0.9827433228492736,1010,346,1366,702,356,356,applejack|fluttershy|mane six|pinkie pie|rainbow dash|rarity|twilight sparkle,ryuu
2058483.png,https://derpicdn.net/img/view/2019/6/5/2058483.png,3,0.9609888792037964,94,350,404,660,310,310,applejack|fluttershy|mane six|pinkie pie|rainbow dash|rarity|twilight sparkle,ryuu
2058483.png,https://derpicdn.net/img/view/2019/6/5/2058483.png,5,0.9277940988540648,659,396,1073,810,414,414,applejack|fluttershy|mane six|pinkie pie|rainbow dash|rarity|twilight sparkle,ryuu
2058483.png,https://derpicdn.net/img/view/2019/6/5/2058483.png,6,0.9185671210289,970,127,1216,373,246,246,applejack|fluttershy|mane six|pinkie pie|rainbow dash|rarity|twilight sparkle,ryuu
2059159.png,https://derpicdn.net/img/view/2019/6/6/2059159.png,0,0.9272094368934632,1880,403,2130,687,250,284,applejack|fluttershy|mane six|pinkie pie|rainbow dash|rarity|twilight sparkle,horsepowerred
2059159.png,https://derpicdn.net/img/view/2019/6/6/2059159.png,1,0.9186581373214722,851,265,1233,647,382,382,applejack|fluttershy|mane six|pinkie pie|rainbow dash|rarity|twilight sparkle,horsepowerred
2062935.png,https://derpicdn.net/img/view/2019/6/11/2062935.png,0,0.9906262755393982,52,2546,1726,4220,1674,1674,applejack|fluttershy|lightning dust|mane six|pinkie pie|rainbow dash|rarity|starlight glimmer|sunset shimmer|trixie|twilight sparkle,movieskywalker
2063411.png,https://derpicdn.net/img/view/2019/6/12/2063411.png,0,0.9742572903633118,777,211,1199,633,422,422,rainbow dash|sunset shimmer|twilight sparkle,winter-scarf|90sigma
2063411.png,https://derpicdn.net/img/view/2019/6/12/2063411.png,1,0.9258811473846436,58,186,470,598,412,412,rainbow dash|sunset shimmer|twilight sparkle,winter-scarf|90sigma
2063415.png,https://derpicdn.net/img/view/2019/6/12/2063415.png,0,0.9231276512145996,11095,1100,16403,6412,5308,5312,pinkie pie|twilight sparkle,faitheverlasting
2063415.png,https://derpicdn.net/img/view/2019/6/12/2063415.png,1,0.9116700887680054,0,818,4882,6344,4882,5526,pinkie pie|twilight sparkle,faitheverlasting
2063463.png,https://derpicdn.net/img/view/2019/6/12/2063463.png,0,0.9961709976196288,3,389,271,657,268,268,applejack|fluttershy|mane six|pinkie pie|rainbow dash|rarity|twilight sparkle,derpydinosaurus|selenaede
2063463.png,https://derpicdn.net/img/view/2019/6/12/2063463.png,1,0.9883716106414796,757,380,1037,660,280,280,applejack|fluttershy|mane six|pinkie pie|rainbow dash|rarity|twilight sparkle,derpydinosaurus|selenaede
206564.png,https://derpicdn.net/img/view/2013/1/8/206564.png,0,0.9843122959136964,107,95,971,959,864,864,princess cadance|shining armor|twilight sparkle,dawnmistpony
2066695.png,https://derpicdn.net/img/view/2019/6/16/2066695.png,0,0.9933146834373474,589,0,851,208,262,208,applejack|fluttershy|mane six|pinkie pie|rainbow dash|rarity|twilight sparkle,
2067308.png,https://derpicdn.net/img/view/2019/6/16/2067308.png,0,0.9654598236083984,400,81,720,401,320,320,fluttershy|twilight sparkle,
2071196.png,https://derpicdn.net/img/view/2019/6/21/2071196.png,0,0.9294841885566713,0,0,281,529,281,529,applejack|pinkie pie|twilight sparkle,
2072263.png,https://derpicdn.net/img/view/2019/6/22/2072263.png,0,0.9982456564903259,758,109,1510,861,752,752,applejack|fluttershy|mane six|pinkie pie|rainbow dash|rarity|twilight sparkle,
2074781.png,https://derpicdn.net/img/view/2019/6/25/2074781.png,0,0.9652996659278872,160,1587,1156,2583,996,996,applejack|fluttershy|mane six|pinkie pie|rainbow dash|rarity|twilight sparkle,eillahwolf
2074781.png,https://derpicdn.net/img/view/2019/6/25/2074781.png,1,0.9608508944511414,2315,1643,3229,2557,914,914,applejack|fluttershy|mane six|pinkie pie|rainbow dash|rarity|twilight sparkle,eillahwolf
2074781.png,https://derpicdn.net/img/view/2019/6/25/2074781.png,2,0.931649088859558,575,0,1571,968,996,968,applejack|fluttershy|mane six|pinkie pie|rainbow dash|rarity|twilight sparkle,eillahwolf
2074781.png,https://derpicdn.net/img/view/2019/6/25/2074781.png,3,0.9041529297828674,1680,0,2706,997,1026,997,applejack|fluttershy|mane six|pinkie pie|rainbow dash|rarity|twilight sparkle,eillahwolf
2075858.png,https://derpicdn.net/img/view/2019/6/26/2075858.png,0,0.9520243406295776,360,0,1092,623,732,623,princess flurry heart|twilight sparkle,rosebuddity
2076302.png,https://derpicdn.net/img/view/2019/6/27/2076302.png,0,0.9713687300682068,258,37,668,447,410,410,rarity|spike|twilight sparkle,
2078374.png,https://derpicdn.net/img/view/2019/6/29/2078374.png,0,0.9884864091873168,31,0,268,260,237,260,fluttershy|pinkie pie|rainbow dash|twilight sparkle,
2078374.png,https://derpicdn.net/img/view/2019/6/29/2078374.png,1,0.9662651419639589,0,6,226,264,226,258,fluttershy|pinkie pie|rainbow dash|twilight sparkle,
2078377.png,https://derpicdn.net/img/view/2019/6/29/2078377.png,0,0.9866678714752196,77,4,262,216,185,212,applejack|fluttershy|rainbow dash|twilight sparkle,
2078869.png,https://derpicdn.net/img/view/2019/6/29/2078869.png,0,0.9956546425819396,560,219,848,507,288,288,applejack|fluttershy|pinkie pie|rarity|twilight sparkle,
2084590.png,https://derpicdn.net/img/view/2019/7/6/2084590.png,0,0.9985433220863342,1130,53,2016,981,886,928,applejack|fluttershy|mane six|pinkie pie|rainbow dash|rarity|twilight sparkle,oinktweetstudios
2084590.png,https://derpicdn.net/img/view/2019/7/6/2084590.png,2,0.9961163997650146,14,80,952,1018,938,938,applejack|fluttershy|mane six|pinkie pie|rainbow dash|rarity|twilight sparkle,oinktweetstudios
2084590.png,https://derpicdn.net/img/view/2019/7/6/2084590.png,3,0.9872925877571106,1157,1875,2016,2933,859,1058,applejack|fluttershy|mane six|pinkie pie|rainbow dash|rarity|twilight sparkle,oinktweetstudios
2088136.png,https://derpicdn.net/img/view/2019/7/10/2088136.png,1,0.9541822671890259,1388,2279,2158,3049,770,770,applejack|fluttershy|mane six|pinkie pie|rainbow dash|rarity|twilight sparkle,小huhu狸君呀
2090496.png,https://derpicdn.net/img/view/2019/7/13/2090496.png,0,0.9783247709274292,66,122,282,338,216,216,applejack|fluttershy|pinkie pie|rainbow dash|rarity|twilight sparkle,bezziie
2093215.png,https://derpicdn.net/img/view/2019/7/16/2093215.png,0,0.9762809276580808,131,0,1115,789,984,789,pinkie pie|twilight sparkle,niggerfaggot
2095944.png,https://derpicdn.net/img/view/2019/7/19/2095944.png,0,0.9261524081230164,854,0,1888,952,1034,952,rarity|twilight sparkle,
2096202.png,https://derpicdn.net/img/view/2019/7/19/2096202.png,0,0.9432753324508668,183,0,589,328,406,328,applejack|fluttershy|mane six|pinkie pie|rainbow dash|rarity|twilight sparkle,ravenevert
2096784.png,https://derpicdn.net/img/view/2019/7/20/2096784.png,0,0.9925531148910522,3141,0,4331,1079,1190,1079,applejack|fluttershy|mane six|pinkie pie|rainbow dash|rarity|spike|twilight sparkle,andoanimalia
2098308.png,https://derpicdn.net/img/view/2019/7/22/2098308.png,0,0.9904986023902892,372,172,1210,1010,838,838,princess celestia|sunset shimmer|twilight sparkle,fallenandscattered
2100060.png,https://derpicdn.net/img/view/2019/7/24/2100060.png,2,0.904318630695343,1735,203,2219,687,484,484,starlight glimmer|trixie|twilight sparkle,natashafenik
2101968.png,https://derpicdn.net/img/view/2019/7/26/2101968.png,0,0.9866931438446044,350,0,708,356,358,356,rarity|twilight sparkle,sodaaz
2106550.png,https://derpicdn.net/img/view/2019/8/1/2106550.png,0,0.9841637015342712,1654,0,3132,1464,1478,1464,starlight glimmer|twilight sparkle,illumnious|deratrox|sketchmcreations
2107378.png,https://derpicdn.net/img/view/2019/8/2/2107378.png,0,0.9586419463157654,408,196,640,428,232,232,applejack|discord|fluttershy|mane six|pinkie pie|princess celestia|princess luna|rainbow dash|rarity|spike|twilight sparkle,
2107378.png,https://derpicdn.net/img/view/2019/8/2/2107378.png,1,0.9014195203781128,725,349,879,503,154,154,applejack|discord|fluttershy|mane six|pinkie pie|princess celestia|princess luna|rainbow dash|rarity|spike|twilight sparkle,
2107393.png,https://derpicdn.net/img/view/2019/8/2/2107393.png,0,0.9980231523513794,445,0,909,413,464,413,spike|twilight sparkle,j5a4
2109374.png,https://derpicdn.net/img/view/2019/8/5/2109374.png,0,0.9989193677902222,1526,468,2204,1146,678,678,sunset shimmer|twilight sparkle,supra80
2110423.png,https://derpicdn.net/img/view/2019/8/6/2110423.png,0,0.9896299839019777,0,88,238,370,238,282,applejack|fluttershy|mane six|pinkie pie|rainbow dash|rarity|twilight sparkle,honkinghighblood
2112717.png,https://derpicdn.net/img/view/2019/8/9/2112717.png,0,0.9989358186721802,312,645,758,1091,446,446,applejack|fluttershy|mane six|pinkie pie|rainbow dash|rarity|twilight sparkle,unoriginai
2112717.png,https://derpicdn.net/img/view/2019/8/9/2112717.png,1,0.9962769150733948,790,309,1232,751,442,442,applejack|fluttershy|mane six|pinkie pie|rainbow dash|rarity|twilight sparkle,unoriginai
2112717.png,https://derpicdn.net/img/view/2019/8/9/2112717.png,2,0.9939471483230592,633,714,1051,1132,418,418,applejack|fluttershy|mane six|pinkie pie|rainbow dash|rarity|twilight sparkle,unoriginai
2112717.png,https://derpicdn.net/img/view/2019/8/9/2112717.png,3,0.9850228428840636,671,1195,1049,1573,378,378,applejack|fluttershy|mane six|pinkie pie|rainbow dash|rarity|twilight sparkle,unoriginai
2112717.png,https://derpicdn.net/img/view/2019/8/9/2112717.png,4,0.9625547528266908,967,1044,1299,1376,332,332,applejack|fluttershy|mane six|pinkie pie|rainbow dash|rarity|twilight sparkle,unoriginai
2112717.png,https://derpicdn.net/img/view/2019/8/9/2112717.png,5,0.961153507232666,323,1118,737,1532,414,414,applejack|fluttershy|mane six|pinkie pie|rainbow dash|rarity|twilight sparkle,unoriginai
2114005.png,https://derpicdn.net/img/view/2019/8/10/2114005.png,0,0.9940558671951294,389,1318,771,1700,382,382,princess cadance|princess celestia|princess luna|trixie|twilight sparkle,3d4d
2114005.png,https://derpicdn.net/img/view/2019/8/10/2114005.png,1,0.9922908544540404,740,1054,1214,1528,474,474,princess cadance|princess celestia|princess luna|trixie|twilight sparkle,3d4d
2114005.png,https://derpicdn.net/img/view/2019/8/10/2114005.png,2,0.9698914885520936,46,1494,416,1864,370,370,princess cadance|princess celestia|princess luna|trixie|twilight sparkle,3d4d
2114005.png,https://derpicdn.net/img/view/2019/8/10/2114005.png,3,0.9314422011375428,1416,1266,1798,1648,382,382,princess cadance|princess celestia|princess luna|trixie|twilight sparkle,3d4d
2114244.png,https://derpicdn.net/img/view/2019/8/10/2114244.png,0,0.9877251386642456,4144,0,5100,775,956,775,applejack|fluttershy|mane six|pinkie pie|rainbow dash|rarity|starlight glimmer|sunset shimmer|twilight sparkle,corporalvortex
2114244.png,https://derpicdn.net/img/view/2019/8/10/2114244.png,1,0.9626250863075256,1497,1431,2199,2133,702,702,applejack|fluttershy|mane six|pinkie pie|rainbow dash|rarity|starlight glimmer|sunset shimmer|twilight sparkle,corporalvortex
2114244.png,https://derpicdn.net/img/view/2019/8/10/2114244.png,2,0.9388691186904908,1314,0,2218,721,904,721,applejack|fluttershy|mane six|pinkie pie|rainbow dash|rarity|starlight glimmer|sunset shimmer|twilight sparkle,corporalvortex
2114244.png,https://derpicdn.net/img/view/2019/8/10/2114244.png,3,0.9198645949363708,80,1458,674,2052,594,594,applejack|fluttershy|mane six|pinkie pie|rainbow dash|rarity|starlight glimmer|sunset shimmer|twilight sparkle,corporalvortex
2120115.png,https://derpicdn.net/img/view/2019/8/17/2120115.png,0,0.9312955141067504,2,0,354,345,352,345,pinkie pie|twilight sparkle,vanillaswirl6
2120476.png,https://derpicdn.net/img/view/2019/8/17/2120476.png,0,0.918371319770813,2649,1537,4353,3241,1704,1704,big macintosh|princess cadance|princess celestia|princess luna|twilight sparkle,vvolllovv
2123218.png,https://derpicdn.net/img/view/2019/8/20/2123218.png,0,0.9956268668174744,1597,0,2495,868,898,868,applejack|fluttershy|mane six|pinkie pie|rainbow dash|rarity|twilight sparkle,pixsoda
2127599.png,https://derpicdn.net/img/view/2019/8/25/2127599.png,0,0.9966446161270142,83,140,745,802,662,662,applejack|twilight sparkle,saturdaymorningproj
2130759.png,https://derpicdn.net/img/view/2019/8/29/2130759.png,3,0.9675059914588928,2267,142,2889,764,622,622,applejack|fluttershy|pinkie pie|rainbow dash|rarity|twilight sparkle,ringamon
2130759.png,https://derpicdn.net/img/view/2019/8/29/2130759.png,4,0.949233055114746,729,0,1613,844,884,844,applejack|fluttershy|pinkie pie|rainbow dash|rarity|twilight sparkle,ringamon
2131892.png,https://derpicdn.net/img/view/2019/8/30/2131892.png,0,0.929568886756897,440,0,1690,1113,1250,1113,rainbow dash|twilight sparkle,stuwor-art|stupid works-stuwor
2135142.png,https://derpicdn.net/img/view/2019/9/3/2135142.png,0,0.9965910315513612,513,529,781,797,268,268,spike|twilight sparkle,eeelt
2135142.png,https://derpicdn.net/img/view/2019/9/3/2135142.png,2,0.9548711180686952,1281,875,2000,1613,719,738,spike|twilight sparkle,eeelt
2135142.png,https://derpicdn.net/img/view/2019/9/3/2135142.png,3,0.9259338974952698,830,0,1836,914,1006,914,spike|twilight sparkle,eeelt
2135806.png,https://derpicdn.net/img/view/2019/9/3/2135806.png,0,0.9708628058433532,216,12,400,196,184,184,applejack|discord|fluttershy|pinkie pie|rainbow dash|rarity|twilight sparkle,artsiepeach
2135806.png,https://derpicdn.net/img/view/2019/9/3/2135806.png,1,0.9176706075668336,202,312,380,490,178,178,applejack|discord|fluttershy|pinkie pie|rainbow dash|rarity|twilight sparkle,artsiepeach
2136653.png,https://derpicdn.net/img/view/2019/9/4/2136653.png,0,0.9086787700653076,1215,120,1537,442,322,322,applejack|princess cadance|princess celestia|princess luna|queen chrysalis|twilight sparkle,vird-gi
2139496.png,https://derpicdn.net/img/view/2019/9/8/2139496.png,0,0.95638769865036,1203,581,1611,989,408,408,applejack|fluttershy|mane six|pinkie pie|rainbow dash|rarity|spike|twilight sparkle,
2140389.png,https://derpicdn.net/img/view/2019/9/9/2140389.png,0,0.9930459260940552,354,13,743,425,389,412,spike|twilight sparkle,
2140576.png,https://derpicdn.net/img/view/2019/9/10/2140576.png,0,0.9865879416465759,0,0,422,433,422,433,fluttershy|twilight sparkle,
2140613.png,https://derpicdn.net/img/view/2019/9/10/2140613.png,0,0.9815185666084292,421,950,727,1256,306,306,fluttershy|princess celestia|princess luna|sunset shimmer|twilight sparkle,unoriginai
2140613.png,https://derpicdn.net/img/view/2019/9/10/2140613.png,1,0.9490804076194764,589,516,1013,940,424,424,fluttershy|princess celestia|princess luna|sunset shimmer|twilight sparkle,unoriginai
2145115.png,https://derpicdn.net/img/view/2019/9/15/2145115.png,0,0.9281051158905028,886,101,1114,329,228,228,applejack|fluttershy|mane six|pinkie pie|rainbow dash|rarity|spike|twilight sparkle,
2146882.png,https://derpicdn.net/img/view/2019/9/18/2146882.png,1,0.963526725769043,828,0,2980,1696,2152,1696,applejack|fluttershy|mane six|pinkie pie|rainbow dash|rarity|twilight sparkle,evilfrenzy
2146882.png,https://derpicdn.net/img/view/2019/9/18/2146882.png,2,0.9492036700248718,9714,3050,10832,4168,1118,1118,applejack|fluttershy|mane six|pinkie pie|rainbow dash|rarity|twilight sparkle,evilfrenzy
2146882.png,https://derpicdn.net/img/view/2019/9/18/2146882.png,3,0.9033082723617554,9358,1429,10618,2689,1260,1260,applejack|fluttershy|mane six|pinkie pie|rainbow dash|rarity|twilight sparkle,evilfrenzy
2147084.png,https://derpicdn.net/img/view/2019/9/18/2147084.png,0,0.9641932249069214,27,1,581,555,554,554,starlight glimmer|twilight sparkle,
2151651.png,https://derpicdn.net/img/view/2019/9/24/2151651.png,0,0.9775051474571228,461,1742,663,1944,202,202,applejack|fluttershy|mane six|pinkie pie|rainbow dash|rarity|sunset shimmer|twilight sparkle,zetapold
2151651.png,https://derpicdn.net/img/view/2019/9/24/2151651.png,1,0.9754369854927064,244,3,446,205,202,202,applejack|fluttershy|mane six|pinkie pie|rainbow dash|rarity|sunset shimmer|twilight sparkle,zetapold
2151651.png,https://derpicdn.net/img/view/2019/9/24/2151651.png,2,0.9550034403800964,133,316,345,528,212,212,applejack|fluttershy|mane six|pinkie pie|rainbow dash|rarity|sunset shimmer|twilight sparkle,zetapold
2153379.png,https://derpicdn.net/img/view/2019/9/26/2153379.png,0,0.9781530499458312,1175,220,1759,804,584,584,rainbow dash|twilight sparkle,55xxglai-s-z-s-exx55
2156875.png,https://derpicdn.net/img/view/2019/9/30/2156875.png,0,0.9250840544700624,719,381,1047,709,328,328,apple bloom|applejack|fluttershy|pinkie pie|rainbow dash|rarity|scootaloo|sweetie belle|twilight sparkle,jhayarr23|abion47|arifproject|ocarina0ftimelord|cyanlightning|slb94
2156875.png,https://derpicdn.net/img/view/2019/9/30/2156875.png,1,0.922839879989624,515,586,779,850,264,264,apple bloom|applejack|fluttershy|pinkie pie|rainbow dash|rarity|scootaloo|sweetie belle|twilight sparkle,jhayarr23|abion47|arifproject|ocarina0ftimelord|cyanlightning|slb94
2158847.png,https://derpicdn.net/img/view/2019/10/3/2158847.png,0,0.9940816760063172,193,322,675,804,482,482,applejack|fluttershy|mane six|pinkie pie|queen chrysalis|rainbow dash|rarity|twilight sparkle,
2165490.png,https://derpicdn.net/img/view/2019/10/11/2165490.png,1,0.975472927093506,647,81,1337,771,690,690,fluttershy|twilight sparkle,mistleinn
2167238.png,https://derpicdn.net/img/view/2019/10/13/2167238.png,0,0.9880135059356692,423,164,629,370,206,206,applejack|fluttershy|mane six|pinkie pie|rainbow dash|rarity|twilight sparkle,santamouse23
2168628.png,https://derpicdn.net/img/view/2019/10/14/2168628.png,0,0.9952878952026368,227,0,1103,803,876,803,rainbow dash|twilight sparkle,stupid works-stuwor
2169944.png,https://derpicdn.net/img/view/2019/10/15/2169944.png,0,0.9874981641769408,491,0,957,355,466,355,applejack|fluttershy|mane six|pinkie pie|rainbow dash|rarity|spike|starlight glimmer|twilight sparkle,
2169946.png,https://derpicdn.net/img/view/2019/10/15/2169946.png,0,0.9948144555091858,936,292,1344,700,408,408,applejack|fluttershy|mane six|pinkie pie|rainbow dash|rarity|spike|starlight glimmer|twilight sparkle,
2169946.png,https://derpicdn.net/img/view/2019/10/15/2169946.png,1,0.9324003458023072,1228,304,1614,690,386,386,applejack|fluttershy|mane six|pinkie pie|rainbow dash|rarity|spike|starlight glimmer|twilight sparkle,
2169946.png,https://derpicdn.net/img/view/2019/10/15/2169946.png,2,0.920306921005249,157,398,425,666,268,268,applejack|fluttershy|mane six|pinkie pie|rainbow dash|rarity|spike|starlight glimmer|twilight sparkle,
2171588.png,https://derpicdn.net/img/view/2019/10/17/2171588.png,0,0.9976487159729004,1157,0,1743,468,586,468,rarity|twilight sparkle,
2172720.png,https://derpicdn.net/img/view/2019/10/18/2172720.png,0,0.9790099859237672,883,216,1535,868,652,652,applejack|fluttershy|mane six|pinkie pie|princess celestia|princess luna|rainbow dash|rarity|twilight sparkle,c0pter
2172938.png,https://derpicdn.net/img/view/2019/10/18/2172938.png,0,0.9349252581596376,41,404,253,616,212,212,applejack|fluttershy|mane six|pinkie pie|rainbow dash|rarity|spike|starlight glimmer|twilight sparkle,
2172938.png,https://derpicdn.net/img/view/2019/10/18/2172938.png,1,0.9047211408615112,1152,374,1366,620,214,246,applejack|fluttershy|mane six|pinkie pie|rainbow dash|rarity|spike|starlight glimmer|twilight sparkle,
2174176.png,https://derpicdn.net/img/view/2019/10/20/2174176.png,0,0.9958040714263916,4131,521,5184,1605,1053,1084,applejack|fluttershy|mane six|pinkie pie|rainbow dash|rarity|twilight sparkle,mlpskyflyer
2174176.png,https://derpicdn.net/img/view/2019/10/20/2174176.png,2,0.9864102005958556,1005,618,2109,1722,1104,1104,applejack|fluttershy|mane six|pinkie pie|rainbow dash|rarity|twilight sparkle,mlpskyflyer
2175263.png,https://derpicdn.net/img/view/2019/10/21/2175263.png,0,0.9905446171760559,378,249,602,473,224,224,applejack|fluttershy|mane six|pinkie pie|rainbow dash|rarity|spike|twilight sparkle,
2177974.png,https://derpicdn.net/img/view/2019/10/24/2177974.png,0,0.9673473834991456,418,41,816,439,398,398,princess celestia|princess luna|twilight sparkle,
2177974.png,https://derpicdn.net/img/view/2019/10/24/2177974.png,1,0.9558194875717164,244,310,578,644,334,334,princess celestia|princess luna|twilight sparkle,
2178530.png,https://derpicdn.net/img/view/2019/10/25/2178530.png,1,0.9911261796951294,540,555,1392,1407,852,852,applejack|fluttershy|mane six|pinkie pie|rainbow dash|rarity|twilight sparkle,joemasterpencil|jhayarr23|shutterflyeqd|suramii|andoanimalia|aqua-pony|cheezedoodle96
2178823.png,https://derpicdn.net/img/view/2019/10/25/2178823.png,0,0.9954050183296204,422,299,652,529,230,230,starlight glimmer|twilight sparkle,
2178823.png,https://derpicdn.net/img/view/2019/10/25/2178823.png,1,0.9604021906852722,811,969,1003,1161,192,192,starlight glimmer|twilight sparkle,
2179451.png,https://derpicdn.net/img/view/2019/10/26/2179451.png,0,0.987656831741333,513,108,897,492,384,384,princess celestia|princess luna|twilight sparkle,
2179585.png,https://derpicdn.net/img/view/2019/10/26/2179585.png,0,0.9930009841918944,305,0,1003,671,698,671,spike|twilight sparkle,
2180518.png,https://derpicdn.net/img/view/2019/10/27/2180518.png,1,0.9512410759925842,655,46,1167,558,512,512,applejack|fluttershy|mane six|pinkie pie|rainbow dash|rarity|spike|twilight sparkle,
2180518.png,https://derpicdn.net/img/view/2019/10/27/2180518.png,2,0.9156390428543092,76,545,434,903,358,358,applejack|fluttershy|mane six|pinkie pie|rainbow dash|rarity|spike|twilight sparkle,
2180875.png,https://derpicdn.net/img/view/2019/10/28/2180875.png,0,0.9026864767074584,851,354,1045,548,194,194,applejack|fluttershy|mane six|pinkie pie|rainbow dash|rarity|spike|twilight sparkle,
2181227.png,https://derpicdn.net/img/view/2019/10/28/2181227.png,0,0.978161096572876,1278,589,1834,1145,556,556,rainbow dash|twilight sparkle,ultrathehedgetoaster
2181227.png,https://derpicdn.net/img/view/2019/10/28/2181227.png,1,0.9675754904747008,601,990,1079,1468,478,478,rainbow dash|twilight sparkle,ultrathehedgetoaster
2182601.png,https://derpicdn.net/img/view/2019/10/30/2182601.png,0,0.9975206851959229,625,1067,875,1317,250,250,applejack|fluttershy|mane six|pinkie pie|rainbow dash|rarity|spike|twilight sparkle,hakunohamikage
2182601.png,https://derpicdn.net/img/view/2019/10/30/2182601.png,1,0.988041877746582,925,371,1125,571,200,200,applejack|fluttershy|mane six|pinkie pie|rainbow dash|rarity|spike|twilight sparkle,hakunohamikage
2182601.png,https://derpicdn.net/img/view/2019/10/30/2182601.png,2,0.9856521487236024,257,308,503,554,246,246,applejack|fluttershy|mane six|pinkie pie|rainbow dash|rarity|spike|twilight sparkle,hakunohamikage
2182601.png,https://derpicdn.net/img/view/2019/10/30/2182601.png,3,0.9688979983329772,550,134,820,404,270,270,applejack|fluttershy|mane six|pinkie pie|rainbow dash|rarity|spike|twilight sparkle,hakunohamikage
2182601.png,https://derpicdn.net/img/view/2019/10/30/2182601.png,4,0.9119578003883362,311,1069,623,1381,312,312,applejack|fluttershy|mane six|pinkie pie|rainbow dash|rarity|spike|twilight sparkle,hakunohamikage
2183068.png,https://derpicdn.net/img/view/2019/10/30/2183068.png,0,0.9832441806793212,1610,919,1898,1207,288,288,applejack|fluttershy|mane six|pinkie pie|rainbow dash|rarity|starlight glimmer|sunset shimmer|twilight sparkle,creativeli3|djbit-3
2183068.png,https://derpicdn.net/img/view/2019/10/30/2183068.png,2,0.9578973650932312,889,852,1265,1228,376,376,applejack|fluttershy|mane six|pinkie pie|rainbow dash|rarity|starlight glimmer|sunset shimmer|twilight sparkle,creativeli3|djbit-3
2185025.png,https://derpicdn.net/img/view/2019/11/1/2185025.png,0,0.9356259107589722,411,37,689,315,278,278,rarity|twilight sparkle,
2185351.png,https://derpicdn.net/img/view/2019/11/2/2185351.png,0,0.954388439655304,1088,0,1954,720,866,720,applejack|fluttershy|mane six|pinkie pie|rainbow dash|rarity|spike|twilight sparkle,steamflash
2186397.png,https://derpicdn.net/img/view/2019/11/3/2186397.png,0,0.996492564678192,185,0,475,271,290,271,rarity|twilight sparkle,
2188638.png,https://derpicdn.net/img/view/2019/11/6/2188638.png,0,0.9337856769561768,0,0,421,507,421,507,applejack|fluttershy|rarity|twilight sparkle,
2188740.png,https://derpicdn.net/img/view/2019/11/6/2188740.png,0,0.9319851398468018,1331,223,2629,1521,1298,1298,applejack|fluttershy|pinkie pie|princess celestia|princess luna|rainbow dash|rarity|starlight glimmer|trixie|twilight sparkle,alicorntwilysparkle
2189630.png,https://derpicdn.net/img/view/2019/11/7/2189630.png,0,0.9789235591888428,784,104,1140,460,356,356,princess celestia|princess luna|twilight sparkle,
2191452.png,https://derpicdn.net/img/view/2019/11/9/2191452.png,0,0.9618674516677856,1317,714,2797,2194,1480,1480,spike|twilight sparkle,aleximusprime
2192521.png,https://derpicdn.net/img/view/2019/11/10/2192521.png,0,0.9928557872772216,426,720,650,944,224,224,applejack|fluttershy|mane six|pinkie pie|rainbow dash|rarity|twilight sparkle,inkie-heart
2192521.png,https://derpicdn.net/img/view/2019/11/10/2192521.png,1,0.9010336995124816,598,227,936,565,338,338,applejack|fluttershy|mane six|pinkie pie|rainbow dash|rarity|twilight sparkle,inkie-heart
2192884.png,https://derpicdn.net/img/view/2019/11/11/2192884.png,1,0.9731839895248412,1316,369,2630,1683,1314,1314,sunset shimmer|twilight sparkle,ejlightning007arts
2196524.png,https://derpicdn.net/img/view/2019/11/15/2196524.png,0,0.9965013861656188,343,1089,677,1423,334,334,applejack|fluttershy|mane six|pinkie pie|rainbow dash|rarity|spike|twilight sparkle,dirtyker
2197013.png,https://derpicdn.net/img/view/2019/11/15/2197013.png,0,0.9826610088348388,1137,0,1755,491,618,491,applejack|fluttershy|mane six|pinkie pie|rainbow dash|rarity|twilight sparkle,
2197013.png,https://derpicdn.net/img/view/2019/11/15/2197013.png,1,0.9670459032058716,1923,831,2377,1285,454,454,applejack|fluttershy|mane six|pinkie pie|rainbow dash|rarity|twilight sparkle,
2197013.png,https://derpicdn.net/img/view/2019/11/15/2197013.png,2,0.9577484726905824,554,0,1260,632,706,632,applejack|fluttershy|mane six|pinkie pie|rainbow dash|rarity|twilight sparkle,
2197975.png,https://derpicdn.net/img/view/2019/11/16/2197975.png,0,0.925998330116272,98,0,680,528,582,528,pinkie pie|spike|twilight sparkle,
2208809.png,https://derpicdn.net/img/view/2019/11/30/2208809.png,0,0.9977014064788818,298,32,630,364,332,332,starlight glimmer|twilight sparkle,renarde-louve
2209032.png,https://derpicdn.net/img/view/2019/11/30/2209032.png,0,0.9776999950408936,2289,850,2813,1374,524,524,princess cadance|princess flurry heart|shining armor|twilight sparkle,velveagicsentryyt
2213146.png,https://derpicdn.net/img/view/2019/12/5/2213146.png,0,0.9785498380661012,1599,226,1883,510,284,284,applejack|fluttershy|mane six|pinkie pie|rainbow dash|rarity|twilight sparkle,jbond
2213146.png,https://derpicdn.net/img/view/2019/12/5/2213146.png,1,0.9601410031318665,454,86,966,598,512,512,applejack|fluttershy|mane six|pinkie pie|rainbow dash|rarity|twilight sparkle,jbond
2221901.png,https://derpicdn.net/img/view/2019/12/16/2221901.png,0,0.9884706139564514,603,482,737,616,134,134,discord|twilight sparkle,bazibalba
2225725.png,https://derpicdn.net/img/view/2019/12/21/2225725.png,0,0.9850017428398132,2450,0,3467,1184,1017,1184,princess celestia|twilight sparkle,freehdmcgee
2228064.png,https://derpicdn.net/img/view/2019/12/23/2228064.png,0,0.9789140820503236,197,0,407,209,210,209,princess cadance|princess celestia|princess flurry heart|princess luna|shining armor|starlight glimmer|sunset shimmer|twilight sparkle,
2229605.png,https://derpicdn.net/img/view/2019/12/25/2229605.png,0,0.9935811161994934,1552,1106,2212,1766,660,660,applejack|fluttershy|pinkie pie|princess luna|twilight sparkle,djkaskan
2229605.png,https://derpicdn.net/img/view/2019/12/25/2229605.png,3,0.9002265334129333,400,501,1230,1331,830,830,applejack|fluttershy|pinkie pie|princess luna|twilight sparkle,djkaskan
2230566.png,https://derpicdn.net/img/view/2019/12/26/2230566.png,0,0.9927769899368286,438,261,758,581,320,320,pinkie pie|twilight sparkle,pippy
2234483.png,https://derpicdn.net/img/view/2019/12/31/2234483.png,0,0.9936256408691406,225,556,573,904,348,348,applejack|fluttershy|mane six|pinkie pie|rainbow dash|rarity|spike|starlight glimmer|twilight sparkle,
2234483.png,https://derpicdn.net/img/view/2019/12/31/2234483.png,1,0.987652063369751,1650,579,1920,849,270,270,applejack|fluttershy|mane six|pinkie pie|rainbow dash|rarity|spike|starlight glimmer|twilight sparkle,
2234483.png,https://derpicdn.net/img/view/2019/12/31/2234483.png,2,0.9811322093009948,22,576,322,876,300,300,applejack|fluttershy|mane six|pinkie pie|rainbow dash|rarity|spike|starlight glimmer|twilight sparkle,
2234483.png,https://derpicdn.net/img/view/2019/12/31/2234483.png,3,0.9809936881065368,1176,373,1440,637,264,264,applejack|fluttershy|mane six|pinkie pie|rainbow dash|rarity|spike|starlight glimmer|twilight sparkle,
2234483.png,https://derpicdn.net/img/view/2019/12/31/2234483.png,5,0.9086683988571168,1360,541,1706,887,346,346,applejack|fluttershy|mane six|pinkie pie|rainbow dash|rarity|spike|starlight glimmer|twilight sparkle,
2237145.png,https://derpicdn.net/img/view/2020/1/3/2237145.png,1,0.916619062423706,200,75,582,457,382,382,applejack|fluttershy|mane six|pinkie pie|rainbow dash|rarity|spike|twilight sparkle,
2240666.jpg,https://derpicdn.net/img/view/2020/1/7/2240666.jpg,0,0.990157961845398,54,63,712,721,658,658,applejack|fluttershy|mane six|pinkie pie|rainbow dash|rarity|twilight sparkle,ayahana
2240666.jpg,https://derpicdn.net/img/view/2020/1/7/2240666.jpg,2,0.9696390628814696,2428,48,3014,634,586,586,applejack|fluttershy|mane six|pinkie pie|rainbow dash|rarity|twilight sparkle,ayahana
2240666.jpg,https://derpicdn.net/img/view/2020/1/7/2240666.jpg,3,0.9595347046852112,1018,305,1578,865,560,560,applejack|fluttershy|mane six|pinkie pie|rainbow dash|rarity|twilight sparkle,ayahana
2248691.png,https://derpicdn.net/img/view/2020/1/16/2248691.png,0,0.965859055519104,643,49,1059,465,416,416,rainbow dash|twilight sparkle,koloredkat
2249266.jpg,https://derpicdn.net/img/view/2020/1/16/2249266.jpg,0,0.9779720306396484,590,32,822,264,232,232,applejack|fluttershy|mane six|pinkie pie|rainbow dash|rarity|twilight sparkle,sanata-angel
2249266.jpg,https://derpicdn.net/img/view/2020/1/16/2249266.jpg,1,0.969251036643982,371,169,653,451,282,282,applejack|fluttershy|mane six|pinkie pie|rainbow dash|rarity|twilight sparkle,sanata-angel
2250405.jpg,https://derpicdn.net/img/view/2020/1/18/2250405.jpg,2,0.9483141899108888,288,2631,1338,3681,1050,1050,applejack|fluttershy|mane six|pinkie pie|rainbow dash|rarity|twilight sparkle,robbieierubino|turnipberry
2256493.png,https://derpicdn.net/img/view/2020/1/25/2256493.png,0,0.9882906675338744,523,1804,1891,3172,1368,1368,spike|twilight sparkle,
2258613.png,https://derpicdn.net/img/view/2020/1/27/2258613.png,0,0.976711630821228,893,0,1669,760,776,760,rainbow dash|twilight sparkle,jxstmargaret
2259213.png,https://derpicdn.net/img/view/2020/1/28/2259213.png,0,0.9792231917381288,1678,184,2096,602,418,418,applejack|fluttershy|mane six|pinkie pie|rainbow dash|rarity|twilight sparkle,kayotanv87
2260935.jpg,https://derpicdn.net/img/view/2020/1/30/2260935.jpg,0,0.9604640007019044,218,84,1336,1380,1118,1296,trixie|twilight sparkle,tenebrousmelancholy
22635.png,https://derpicdn.net/img/view/2012/6/27/22635.png,0,0.998314380645752,713,250,1265,802,552,552,apple bloom|applejack|cutie mark crusaders|fluttershy|pinkie pie|rainbow dash|rarity|scootaloo|sweetie belle|twilight sparkle,
22635.png,https://derpicdn.net/img/view/2012/6/27/22635.png,1,0.9939446449279784,1286,1829,1786,2329,500,500,apple bloom|applejack|cutie mark crusaders|fluttershy|pinkie pie|rainbow dash|rarity|scootaloo|sweetie belle|twilight sparkle,
22635.png,https://derpicdn.net/img/view/2012/6/27/22635.png,2,0.9906251430511476,1467,1015,2027,1583,560,568,apple bloom|applejack|cutie mark crusaders|fluttershy|pinkie pie|rainbow dash|rarity|scootaloo|sweetie belle|twilight sparkle,
22635.png,https://derpicdn.net/img/view/2012/6/27/22635.png,3,0.9906005859375,1181,211,1755,785,574,574,apple bloom|applejack|cutie mark crusaders|fluttershy|pinkie pie|rainbow dash|rarity|scootaloo|sweetie belle|twilight sparkle,
22635.png,https://derpicdn.net/img/view/2012/6/27/22635.png,4,0.985495626926422,1007,1049,1537,1579,530,530,apple bloom|applejack|cutie mark crusaders|fluttershy|pinkie pie|rainbow dash|rarity|scootaloo|sweetie belle|twilight sparkle,
22635.png,https://derpicdn.net/img/view/2012/6/27/22635.png,5,0.9178122878074646,0,1031,484,1567,484,536,apple bloom|applejack|cutie mark crusaders|fluttershy|pinkie pie|rainbow dash|rarity|scootaloo|sweetie belle|twilight sparkle,
22635.png,https://derpicdn.net/img/view/2012/6/27/22635.png,6,0.9150257706642152,736,1796,1314,2374,578,578,apple bloom|applejack|cutie mark crusaders|fluttershy|pinkie pie|rainbow dash|rarity|scootaloo|sweetie belle|twilight sparkle,
2269833.jpg,https://derpicdn.net/img/view/2020/2/9/2269833.jpg,0,0.9908537268638612,943,299,1251,607,308,308,applejack|fluttershy|pinkie pie|rainbow dash|rarity|twilight sparkle,
2271098.png,https://derpicdn.net/img/view/2020/2/11/2271098.png,0,0.9461389780044556,634,70,1394,830,760,760,applejack|pinkie pie|rarity|twilight sparkle,
2271342.png,https://derpicdn.net/img/view/2020/2/11/2271342.png,0,0.954578161239624,1424,562,1624,762,200,200,fluttershy|rarity|twilight sparkle,
2274823.jpg,https://derpicdn.net/img/view/2020/2/15/2274823.jpg,0,0.9595783352851868,276,128,1014,866,738,738,princess celestia|twilight sparkle,valeriamagicart
2275707.png,https://derpicdn.net/img/view/2020/2/16/2275707.png,0,0.9938192367553712,1711,0,2159,439,448,439,applejack|fluttershy|mane six|pinkie pie|rainbow dash|rarity|twilight sparkle,rainbow eevee
2275707.png,https://derpicdn.net/img/view/2020/2/16/2275707.png,1,0.9189414978027344,0,165,326,495,326,330,applejack|fluttershy|mane six|pinkie pie|rainbow dash|rarity|twilight sparkle,rainbow eevee
2276544.png,https://derpicdn.net/img/view/2020/2/17/2276544.png,0,0.971656620502472,0,0,633,660,633,660,sweetie belle|twilight sparkle,
2278143.png,https://derpicdn.net/img/view/2020/2/19/2278143.png,0,0.9995817542076112,31,25,399,393,368,368,fluttershy|rarity|twilight sparkle,kurocaze-s
2284303.png,https://derpicdn.net/img/view/2020/2/26/2284303.png,0,0.987718403339386,193,124,831,794,638,670,pinkie pie|twilight sparkle,
2284848.jpg,https://derpicdn.net/img/view/2020/2/27/2284848.jpg,0,0.9932586550712584,1382,1503,2179,2369,797,866,applejack|fluttershy|mane six|pinkie pie|rainbow dash|rarity|twilight sparkle,
2290499.png,https://derpicdn.net/img/view/2020/3/5/2290499.png,1,0.97117680311203,1163,215,1719,771,556,556,starlight glimmer|trixie|twilight sparkle,frownfactory|estories|slb94|sofunnyguy
2291778.png,https://derpicdn.net/img/view/2020/3/7/2291778.png,0,0.9800811409950256,0,283,140,429,140,146,applejack|fluttershy|mane six|pinkie pie|rainbow dash|rarity|twilight sparkle,magnetvox
2292853.png,https://derpicdn.net/img/view/2020/3/8/2292853.png,0,0.9353657364845276,177,36,293,152,116,116,discord|starlight glimmer|trixie|twilight sparkle,pencils
2292994.png,https://derpicdn.net/img/view/2020/3/8/2292994.png,0,0.9981608986854552,2376,431,2964,1019,588,588,applejack|fluttershy|mane six|pinkie pie|rainbow dash|rarity|twilight sparkle,0okami-0ni
2292994.png,https://derpicdn.net/img/view/2020/3/8/2292994.png,1,0.9969772696495056,1813,402,2477,1066,664,664,applejack|fluttershy|mane six|pinkie pie|rainbow dash|rarity|twilight sparkle,0okami-0ni
2292994.png,https://derpicdn.net/img/view/2020/3/8/2292994.png,2,0.9960668087005616,878,395,1566,1083,688,688,applejack|fluttershy|mane six|pinkie pie|rainbow dash|rarity|twilight sparkle,0okami-0ni
2292994.png,https://derpicdn.net/img/view/2020/3/8/2292994.png,3,0.9953557848930359,412,379,1084,1051,672,672,applejack|fluttershy|mane six|pinkie pie|rainbow dash|rarity|twilight sparkle,0okami-0ni
2292994.png,https://derpicdn.net/img/view/2020/3/8/2292994.png,5,0.9812827110290528,0,386,566,1014,566,628,applejack|fluttershy|mane six|pinkie pie|rainbow dash|rarity|twilight sparkle,0okami-0ni
2295753.png,https://derpicdn.net/img/view/2020/3/12/2295753.png,0,0.979205846786499,0,0,387,382,387,382,fluttershy|twilight sparkle,
2297531.jpg,https://derpicdn.net/img/view/2020/3/14/2297531.jpg,1,0.966206431388855,30,161,550,681,520,520,applejack|rarity|sunset shimmer|twilight sparkle,5mmumm5
2297531.jpg,https://derpicdn.net/img/view/2020/3/14/2297531.jpg,2,0.9588471055030824,565,257,985,677,420,420,applejack|rarity|sunset shimmer|twilight sparkle,5mmumm5
2298009.jpg,https://derpicdn.net/img/view/2020/3/15/2298009.jpg,0,0.9990695714950562,340,499,576,735,236,236,applejack|fluttershy|mane six|pinkie pie|rainbow dash|rarity|twilight sparkle,kenisu-of-dragons
2298009.jpg,https://derpicdn.net/img/view/2020/3/15/2298009.jpg,1,0.9984248280525208,280,13,524,257,244,244,applejack|fluttershy|mane six|pinkie pie|rainbow dash|rarity|twilight sparkle,kenisu-of-dragons
2298009.jpg,https://derpicdn.net/img/view/2020/3/15/2298009.jpg,2,0.9982579350471495,105,531,315,741,210,210,applejack|fluttershy|mane six|pinkie pie|rainbow dash|rarity|twilight sparkle,kenisu-of-dragons
2298009.jpg,https://derpicdn.net/img/view/2020/3/15/2298009.jpg,3,0.9976983070373536,92,0,334,232,242,232,applejack|fluttershy|mane six|pinkie pie|rainbow dash|rarity|twilight sparkle,kenisu-of-dragons
2298009.jpg,https://derpicdn.net/img/view/2020/3/15/2298009.jpg,4,0.9976689219474792,627,5,887,265,260,260,applejack|fluttershy|mane six|pinkie pie|rainbow dash|rarity|twilight sparkle,kenisu-of-dragons
2303338.png,https://derpicdn.net/img/view/2020/3/22/2303338.png,0,0.9864452481269836,1745,0,4157,2303,2412,2303,pinkie pie|twilight sparkle,tomboygirl45
2304552.jpg,https://derpicdn.net/img/view/2020/3/23/2304552.jpg,0,0.964804708957672,294,294,402,402,108,108,discord|fluttershy|twilight sparkle,kkmrarar
2305735.png,https://derpicdn.net/img/view/2020/3/25/2305735.png,0,0.9925206899642944,1387,26,1864,526,477,500,rarity|twilight sparkle,arcticwaters
2314052.jpg,https://derpicdn.net/img/view/2020/4/4/2314052.jpg,0,0.991260826587677,1208,426,1780,998,572,572,princess celestia|twilight sparkle,valeriamagicart
2314052.jpg,https://derpicdn.net/img/view/2020/4/4/2314052.jpg,1,0.9679001569747924,555,193,1189,827,634,634,princess celestia|twilight sparkle,valeriamagicart
2314152.png,https://derpicdn.net/img/view/2020/4/4/2314152.png,0,0.9538080096244812,1500,0,1970,451,470,451,princess celestia|twilight sparkle,pencils
2314758.jpg,https://derpicdn.net/img/view/2020/4/5/2314758.jpg,0,0.9801412224769592,386,278,710,602,324,324,fluttershy|twilight sparkle,navokin
2315639.png,https://derpicdn.net/img/view/2020/4/6/2315639.png,0,0.9973248839378356,1625,1281,2123,1779,498,498,applejack|fluttershy|mane six|pinkie pie|rainbow dash|rarity|starlight glimmer|twilight sparkle,cloud-drawings
2316557.png,https://derpicdn.net/img/view/2020/4/7/2316557.png,0,0.9967600107192992,230,249,1022,1041,792,792,shining armor|twilight sparkle,uunicornicc
2316557.png,https://derpicdn.net/img/view/2020/4/7/2316557.png,2,0.9901021122932434,786,832,1324,1370,538,538,shining armor|twilight sparkle,uunicornicc
2317216.jpg,https://derpicdn.net/img/view/2020/4/8/2317216.jpg,1,0.9797946810722352,130,259,378,507,248,248,applejack|twilight sparkle,theowlcan
2320261.jpg,https://derpicdn.net/img/view/2020/4/12/2320261.jpg,0,0.9913042783737184,504,0,886,312,382,312,applejack|fluttershy|mane six|pinkie pie|rainbow dash|rarity|twilight sparkle,oatmeaio
2320261.jpg,https://derpicdn.net/img/view/2020/4/12/2320261.jpg,1,0.982869029045105,23,16,303,296,280,280,applejack|fluttershy|mane six|pinkie pie|rainbow dash|rarity|twilight sparkle,oatmeaio
2320261.jpg,https://derpicdn.net/img/view/2020/4/12/2320261.jpg,2,0.9471503496170044,1059,50,1337,328,278,278,applejack|fluttershy|mane six|pinkie pie|rainbow dash|rarity|twilight sparkle,oatmeaio
2322510.png,https://derpicdn.net/img/view/2020/4/14/2322510.png,0,0.9659739136695862,860,1062,1228,1430,368,368,spike|twilight sparkle,amarthgul
2324550.png,https://derpicdn.net/img/view/2020/4/17/2324550.png,0,0.9200427532196044,1256,640,1806,1190,550,550,applejack|fluttershy|mane six|pinkie pie|rainbow dash|rarity|twilight sparkle,varwing
2325589.jpg,https://derpicdn.net/img/view/2020/4/18/2325589.jpg,1,0.9969029426574708,742,0,1436,672,694,672,rarity|twilight sparkle,amphoera
232759.png,https://derpicdn.net/img/view/2013/2/3/232759.png,2,0.9029937386512756,300,484,514,698,214,214,princess celestia|princess luna|twilight sparkle,tiberiusekas
2329122.jpg,https://derpicdn.net/img/view/2020/4/22/2329122.jpg,0,0.9985517859458924,9,48,311,350,302,302,applejack|fluttershy|mane six|pinkie pie|rainbow dash|rarity|twilight sparkle,peachy-pony
2330987.png,https://derpicdn.net/img/view/2020/4/25/2330987.png,0,0.9961345791816713,1414,663,2288,1537,874,874,fluttershy|pinkie pie|princess luna|rarity|sweetie belle|twilight sparkle,scribs
2331409.jpg,https://derpicdn.net/img/view/2020/4/25/2331409.jpg,0,0.9495677947998048,625,37,1175,587,550,550,rainbow dash|twilight sparkle,gooomys
2332412.png,https://derpicdn.net/img/view/2020/4/26/2332412.png,0,0.9824272394180298,738,1,1032,295,294,294,applejack|fluttershy|mane six|pinkie pie|rainbow dash|rarity|twilight sparkle,rigis-ut|jisuppe
2335397.png,https://derpicdn.net/img/view/2020/4/30/2335397.png,1,0.9877496361732484,1252,1024,1894,1666,642,642,applejack|fluttershy|mane six|pinkie pie|rainbow dash|rarity|twilight sparkle,taaffeiite
2335397.png,https://derpicdn.net/img/view/2020/4/30/2335397.png,2,0.9856489896774292,0,957,614,1653,614,696,applejack|fluttershy|mane six|pinkie pie|rainbow dash|rarity|twilight sparkle,taaffeiite
2335397.png,https://derpicdn.net/img/view/2020/4/30/2335397.png,3,0.979229211807251,1234,0,1774,502,540,502,applejack|fluttershy|mane six|pinkie pie|rainbow dash|rarity|twilight sparkle,taaffeiite
2335397.png,https://derpicdn.net/img/view/2020/4/30/2335397.png,4,0.9776225686073304,46,0,548,491,502,491,applejack|fluttershy|mane six|pinkie pie|rainbow dash|rarity|twilight sparkle,taaffeiite
2338118.jpg,https://derpicdn.net/img/view/2020/5/3/2338118.jpg,0,0.991803765296936,801,1329,1280,1831,479,502,pinkie pie|princess cadance|princess celestia|princess flurry heart|princess luna|twilight sparkle,snowballflo
2338118.jpg,https://derpicdn.net/img/view/2020/5/3/2338118.jpg,1,0.9906961917877196,85,35,625,575,540,540,pinkie pie|princess cadance|princess celestia|princess flurry heart|princess luna|twilight sparkle,snowballflo
2338118.jpg,https://derpicdn.net/img/view/2020/5/3/2338118.jpg,2,0.9892886281013488,697,0,1280,611,583,611,pinkie pie|princess cadance|princess celestia|princess flurry heart|princess luna|twilight sparkle,snowballflo
2338118.jpg,https://derpicdn.net/img/view/2020/5/3/2338118.jpg,3,0.9858512878417968,18,4096,486,4564,468,468,pinkie pie|princess cadance|princess celestia|princess flurry heart|princess luna|twilight sparkle,snowballflo
2338374.jpg,https://derpicdn.net/img/view/2020/5/3/2338374.jpg,0,0.9535700678825378,825,0,1024,177,199,177,applejack|fluttershy|mane six|pinkie pie|princess cadance|princess celestia|princess flurry heart|princess luna|rainbow dash|rarity|spike|starlight glimmer|sunset shimmer|trixie|twilight sparkle,silverbuller
2338374.jpg,https://derpicdn.net/img/view/2020/5/3/2338374.jpg,1,0.9406907558441162,132,79,366,313,234,234,applejack|fluttershy|mane six|pinkie pie|princess cadance|princess celestia|princess flurry heart|princess luna|rainbow dash|rarity|spike|starlight glimmer|sunset shimmer|trixie|twilight sparkle,silverbuller
2339831.png,https://derpicdn.net/img/view/2020/5/5/2339831.png,0,0.9753466844558716,41,471,221,651,180,180,princess cadance|princess celestia|princess flurry heart|princess luna|shining armor|starlight glimmer|sunset shimmer|trixie|twilight sparkle,
2339831.png,https://derpicdn.net/img/view/2020/5/5/2339831.png,1,0.9491576552391052,193,4,383,194,190,190,princess cadance|princess celestia|princess flurry heart|princess luna|shining armor|starlight glimmer|sunset shimmer|trixie|twilight sparkle,
2340431.png,https://derpicdn.net/img/view/2020/5/5/2340431.png,0,0.9448702931404114,230,279,450,499,220,220,applejack|fluttershy|mane six|pinkie pie|rainbow dash|rarity|twilight sparkle,ririsqueak
2340615.jpg,https://derpicdn.net/img/view/2020/5/6/2340615.jpg,0,0.9945626854896544,53,0,705,634,652,634,rainbow dash|twilight sparkle,delphoart
2342953.jpg,https://derpicdn.net/img/view/2020/5/8/2342953.jpg,0,0.9972996115684508,2818,2307,3436,2925,618,618,starlight glimmer|twilight sparkle,valeriamagicart
2342953.jpg,https://derpicdn.net/img/view/2020/5/8/2342953.jpg,1,0.9165492057800292,3259,2232,3939,2924,680,692,starlight glimmer|twilight sparkle,valeriamagicart
2342953.jpg,https://derpicdn.net/img/view/2020/5/8/2342953.jpg,2,0.9160498976707458,1988,562,2826,1400,838,838,starlight glimmer|twilight sparkle,valeriamagicart
2343893.png,https://derpicdn.net/img/view/2020/5/9/2343893.png,0,0.9977726340293884,867,193,1691,1017,824,824,sunset shimmer|twilight sparkle,ejlightning007arts
2343893.png,https://derpicdn.net/img/view/2020/5/9/2343893.png,1,0.9763537049293518,1946,489,2412,955,466,466,sunset shimmer|twilight sparkle,ejlightning007arts
2345049.png,https://derpicdn.net/img/view/2020/5/10/2345049.png,0,0.9264745116233826,0,0,749,898,749,898,rainbow dash|twilight sparkle,
2345141.png,https://derpicdn.net/img/view/2020/5/11/2345141.png,0,0.9960315227508544,0,0,838,833,838,833,rainbow dash|twilight sparkle,
2345142.png,https://derpicdn.net/img/view/2020/5/11/2345142.png,0,0.9113551378250122,73,0,1015,909,942,909,rainbow dash|twilight sparkle,
2345302.png,https://derpicdn.net/img/view/2020/5/11/2345302.png,0,0.9560868740081788,100,0,822,698,722,698,rainbow dash|twilight sparkle,
2345424.png,https://derpicdn.net/img/view/2020/5/11/2345424.png,0,0.9902679324150084,2395,765,4865,3235,2470,2470,sunset shimmer|twilight sparkle,emeraldblast63
2346451.jpg,https://derpicdn.net/img/view/2020/5/12/2346451.jpg,1,0.981036365032196,321,92,707,478,386,386,trixie|twilight sparkle,limpurtikles
2346945.jpg,https://derpicdn.net/img/view/2020/5/12/2346945.jpg,0,0.9564018845558168,179,116,567,504,388,388,pinkie pie|twilight sparkle,waackery
2350274.png,https://derpicdn.net/img/view/2020/5/16/2350274.png,0,0.9965919852256776,388,3,674,289,286,286,applejack|fluttershy|mane six|pinkie pie|rainbow dash|rarity|spike|starlight glimmer|sunset shimmer|trixie|twilight sparkle,emeraldblast63
2350274.png,https://derpicdn.net/img/view/2020/5/16/2350274.png,1,0.9880743622779846,618,13,910,305,292,292,applejack|fluttershy|mane six|pinkie pie|rainbow dash|rarity|spike|starlight glimmer|sunset shimmer|trixie|twilight sparkle,emeraldblast63
2350274.png,https://derpicdn.net/img/view/2020/5/16/2350274.png,2,0.948442041873932,817,389,1081,653,264,264,applejack|fluttershy|mane six|pinkie pie|rainbow dash|rarity|spike|starlight glimmer|sunset shimmer|trixie|twilight sparkle,emeraldblast63
2350605.jpg,https://derpicdn.net/img/view/2020/5/17/2350605.jpg,0,0.9991051554679872,30,0,384,329,354,329,applejack|fluttershy|pinkie pie|rainbow dash|rarity|twilight sparkle,araiiara123
2350605.jpg,https://derpicdn.net/img/view/2020/5/17/2350605.jpg,1,0.997694194316864,687,6,1017,336,330,330,applejack|fluttershy|pinkie pie|rainbow dash|rarity|twilight sparkle,araiiara123
2350605.jpg,https://derpicdn.net/img/view/2020/5/17/2350605.jpg,2,0.963786780834198,308,0,690,375,382,375,applejack|fluttershy|pinkie pie|rainbow dash|rarity|twilight sparkle,araiiara123
2351078.png,https://derpicdn.net/img/view/2020/5/17/2351078.png,0,0.947773277759552,219,0,4605,4000,4386,4000,rarity|twilight sparkle,limedazzle
2351532.png,https://derpicdn.net/img/view/2020/5/18/2351532.png,0,0.990452766418457,0,5,205,241,205,236,starlight glimmer|twilight sparkle,
2353771.jpg,https://derpicdn.net/img/view/2020/5/20/2353771.jpg,0,0.9971268177032472,699,1002,1029,1332,330,330,applejack|fluttershy|rainbow dash|rarity|starlight glimmer|twilight sparkle,gor1ck
2353771.jpg,https://derpicdn.net/img/view/2020/5/20/2353771.jpg,1,0.942668080329895,435,955,705,1225,270,270,applejack|fluttershy|rainbow dash|rarity|starlight glimmer|twilight sparkle,gor1ck
2354791.png,https://derpicdn.net/img/view/2020/5/22/2354791.png,0,0.9834543466567992,615,1506,1249,2140,634,634,applejack|fluttershy|mane six|pinkie pie|rainbow dash|rarity|twilight sparkle,olivecow
2354791.png,https://derpicdn.net/img/view/2020/5/22/2354791.png,1,0.9807441830635072,790,359,1534,1103,744,744,applejack|fluttershy|mane six|pinkie pie|rainbow dash|rarity|twilight sparkle,olivecow
2354791.png,https://derpicdn.net/img/view/2020/5/22/2354791.png,4,0.9142062067985536,2285,1754,2947,2416,662,662,applejack|fluttershy|mane six|pinkie pie|rainbow dash|rarity|twilight sparkle,olivecow
2355620.png,https://derpicdn.net/img/view/2020/5/22/2355620.png,0,0.9910374283790588,996,0,1436,392,440,392,applejack|fluttershy|mane six|pinkie pie|rainbow dash|rarity|twilight sparkle,themaiah
2355620.png,https://derpicdn.net/img/view/2020/5/22/2355620.png,1,0.977141261100769,182,7,486,311,304,304,applejack|fluttershy|mane six|pinkie pie|rainbow dash|rarity|twilight sparkle,themaiah
2355620.png,https://derpicdn.net/img/view/2020/5/22/2355620.png,2,0.9139150977134703,355,728,693,1066,338,338,applejack|fluttershy|mane six|pinkie pie|rainbow dash|rarity|twilight sparkle,themaiah
235827.png,https://derpicdn.net/img/view/2013/2/7/235827.png,0,0.9933683276176452,96,783,662,1349,566,566,applejack|fluttershy|pinkie pie|rainbow dash|rarity|trixie|twilight sparkle,terra-aquis
235827.png,https://derpicdn.net/img/view/2013/2/7/235827.png,1,0.9013727903366088,1583,344,1905,666,322,322,applejack|fluttershy|pinkie pie|rainbow dash|rarity|trixie|twilight sparkle,terra-aquis
245744.png,https://derpicdn.net/img/view/2013/2/16/245744.png,0,0.9583951830863952,649,683,1000,1061,351,378,pinkie pie|rainbow dash|twilight sparkle,alasou
245785.png,https://derpicdn.net/img/view/2013/2/16/245785.png,0,0.9441428780555724,1169,1321,1405,1557,236,236,applejack|fluttershy|mane six|pinkie pie|princess celestia|rainbow dash|rarity|twilight sparkle,
245956.png,https://derpicdn.net/img/view/2013/2/16/245956.png,0,0.9076432585716248,413,261,1029,877,616,616,princess celestia|twilight sparkle,foxy-noxy
248770.png,https://derpicdn.net/img/view/2013/2/19/248770.png,0,0.9947223663330078,873,0,2259,1198,1386,1198,princess cadance|princess celestia|princess luna|twilight sparkle,kawaiicutie-chan
248770.png,https://derpicdn.net/img/view/2013/2/19/248770.png,1,0.9319195747375488,812,928,2270,2386,1458,1458,princess cadance|princess celestia|princess luna|twilight sparkle,kawaiicutie-chan
252156.png,https://derpicdn.net/img/view/2013/2/22/252156.png,0,0.9979931116104126,1022,418,1336,732,314,314,applejack|fluttershy|mane six|pinkie pie|rainbow dash|rarity|twilight sparkle,danmakuman
252156.png,https://derpicdn.net/img/view/2013/2/22/252156.png,1,0.992491602897644,1879,352,2275,748,396,396,applejack|fluttershy|mane six|pinkie pie|rainbow dash|rarity|twilight sparkle,danmakuman
252852.jpg,https://derpicdn.net/img/view/2013/2/23/252852.jpg,0,0.9684795141220092,0,0,169,173,169,173,princess luna|rarity|twilight sparkle,
257357.png,https://derpicdn.net/img/view/2013/2/27/257357.png,2,0.924407124519348,307,2488,2425,4606,2118,2118,applejack|fluttershy|mane six|pinkie pie|princess cadance|princess celestia|princess luna|rainbow dash|rarity|shining armor|spike|twilight sparkle,bronytoss
2601.png,https://derpicdn.net/img/view/2012/1/29/2601.png,0,0.9958757162094116,340,658,480,798,140,140,apple bloom|applejack|big macintosh|cutie mark crusaders|discord|fluttershy|mane six|pinkie pie|princess celestia|princess luna|rainbow dash|rarity|scootaloo|spike|sweetie belle|trixie|twilight sparkle,
260879.png,https://derpicdn.net/img/view/2013/3/3/260879.png,0,0.9964998364448548,102,126,492,516,390,390,rainbow dash|twilight sparkle,kinga
260879.png,https://derpicdn.net/img/view/2013/3/3/260879.png,1,0.9865877628326416,401,116,783,498,382,382,rainbow dash|twilight sparkle,kinga
262768.png,https://derpicdn.net/img/view/2013/3/5/262768.png,0,0.9346069693565368,590,12,832,254,242,242,applejack|babs seed|fluttershy|pinkie pie|princess celestia|rainbow dash|rarity|spike|sweetie belle|twilight sparkle,
262768.png,https://derpicdn.net/img/view/2013/3/5/262768.png,1,0.9069560170173644,856,429,1090,663,234,234,applejack|babs seed|fluttershy|pinkie pie|princess celestia|rainbow dash|rarity|spike|sweetie belle|twilight sparkle,
265071.png,https://derpicdn.net/img/view/2013/3/7/265071.png,0,0.998323142528534,858,0,2204,1261,1346,1261,rainbow dash|twilight sparkle,he4rtofcourage
273604.png,https://derpicdn.net/img/view/2013/3/18/273604.png,0,0.9914413094520568,357,395,749,787,392,392,princess cadance|princess celestia|princess luna|shining armor|twilight sparkle,miroslav46
276628.png,https://derpicdn.net/img/view/2013/3/22/276628.png,1,0.9461928009986876,1383,367,3665,2649,2282,2282,applejack|fluttershy|pinkie pie|rainbow dash|rarity|twilight sparkle,beavernator
284580.png,https://derpicdn.net/img/view/2013/3/31/284580.png,0,0.9737476110458374,502,81,926,505,424,424,applejack|fluttershy|mane six|pinkie pie|rainbow dash|rarity|twilight sparkle,phyllismi
284580.png,https://derpicdn.net/img/view/2013/3/31/284580.png,1,0.9542720913887024,769,652,1137,1020,368,368,applejack|fluttershy|mane six|pinkie pie|rainbow dash|rarity|twilight sparkle,phyllismi
284580.png,https://derpicdn.net/img/view/2013/3/31/284580.png,2,0.9278739094734192,238,659,630,1051,392,392,applejack|fluttershy|mane six|pinkie pie|rainbow dash|rarity|twilight sparkle,phyllismi
284666.png,https://derpicdn.net/img/view/2013/3/31/284666.png,0,0.9801851511001588,0,25,554,557,554,532,rainbow dash|twilight sparkle,
285265.png,https://derpicdn.net/img/view/2013/4/1/285265.png,1,0.9013093113899232,1709,561,2013,865,304,304,apple bloom|applejack|babs seed|big macintosh|cutie mark crusaders|diamond tiara|discord|fluttershy|lightning dust|mane six|pinkie pie|princess cadance|princess celestia|princess luna|queen chrysalis|rainbow dash|rarity|scootaloo|shining armor|silver spoon|soarin'|spike|spitfire|sweetie belle|trixie|twilight sparkle,kiwi|zaxsya97|akira bano|aruurara|moyamoya kuroi|seidouryu|miike rimuru|yuki endo|yutoraru|smallboy322|koppepanwanwa41|h2o|hamuchiki|patoriotto|rairarai|ino|sukaponta|moka|grand|tenmusfox|doubt|masak9|snownown|zokkili|erikura|wonton soup|garu2|zokoira|momo|isomaru|tina|zuu|ichigoaimin|30clock|ayahana|landrace17970|sfear222|despair-dog|azumi_haruhito|sfear|kushina13|iizuna|footsam|kiisuke|kamomenotamago@hanbookinitsukikyuushi
285754.png,https://derpicdn.net/img/view/2013/4/2/285754.png,0,0.9861945509910583,38,0,1338,1074,1300,1074,rainbow dash|twilight sparkle,awengrocks
28721.jpg,https://derpicdn.net/img/view/2012/7/2/28721.jpg,1,0.9368626475334167,5588,1420,6332,2164,744,744,apple bloom|applejack|big macintosh|braeburn|cutie mark crusaders|discord|fluttershy|pinkie pie|princess celestia|princess luna|rainbow dash|rarity|scootaloo|soarin'|spike|spitfire|sweetie belle|trixie|twilight sparkle,
290259.png,https://derpicdn.net/img/view/2013/4/6/290259.png,0,0.9986823201179504,223,0,565,335,342,335,rainbow dash|twilight sparkle,bunnini
296129.png,https://derpicdn.net/img/view/2013/4/13/296129.png,0,0.998555600643158,871,194,1171,494,300,300,applejack|fluttershy|mane six|pinkie pie|rainbow dash|rarity|twilight sparkle,php94
296129.png,https://derpicdn.net/img/view/2013/4/13/296129.png,1,0.9930921792984008,1106,187,1454,535,348,348,applejack|fluttershy|mane six|pinkie pie|rainbow dash|rarity|twilight sparkle,php94
296129.png,https://derpicdn.net/img/view/2013/4/13/296129.png,2,0.9830064177513124,127,189,429,491,302,302,applejack|fluttershy|mane six|pinkie pie|rainbow dash|rarity|twilight sparkle,php94
296129.png,https://derpicdn.net/img/view/2013/4/13/296129.png,3,0.9557796716690063,582,141,952,511,370,370,applejack|fluttershy|mane six|pinkie pie|rainbow dash|rarity|twilight sparkle,php94
299832.png,https://derpicdn.net/img/view/2013/4/16/299832.png,1,0.9704223275184632,1723,192,2531,1000,808,808,princess celestia|twilight sparkle,kitsunehino
310237.jpg,https://derpicdn.net/img/view/2013/4/28/310237.jpg,0,0.996405303478241,1057,142,1411,496,354,354,princess celestia|princess luna|twilight sparkle,thepleonasticpotato
311552.jpg,https://derpicdn.net/img/view/2013/4/29/311552.jpg,1,0.9936479330062866,671,0,1003,294,332,294,applejack|fluttershy|mane six|pinkie pie|rainbow dash|rarity|twilight sparkle,paulina-ap
316292.png,https://derpicdn.net/img/view/2013/5/4/316292.png,0,0.9472145438194276,326,0,500,174,174,174,applejack|fluttershy|mane six|pinkie pie|rainbow dash|rarity|twilight sparkle,karzahnii
319839.png,https://derpicdn.net/img/view/2013/5/8/319839.png,0,0.9003158211708069,638,0,1140,480,502,480,princess celestia|spike|twilight sparkle,dolenore
32928.jpg,https://derpicdn.net/img/view/2012/7/5/32928.jpg,1,0.9778167009353638,0,114,467,584,467,470,princess cadance|shining armor|twilight sparkle,spiggy-the-cat
3303.png,https://derpicdn.net/img/view/2012/2/20/3303.png,0,0.9956872463226318,895,0,1479,566,584,566,applejack|fluttershy|mane six|pinkie pie|rainbow dash|rarity|twilight sparkle,glancojusticar
3303.png,https://derpicdn.net/img/view/2012/2/20/3303.png,1,0.977073848247528,1355,760,1907,1312,552,552,applejack|fluttershy|mane six|pinkie pie|rainbow dash|rarity|twilight sparkle,glancojusticar
3304.png,https://derpicdn.net/img/view/2012/2/20/3304.png,0,0.9920442700386048,96,6,690,600,594,594,applejack|fluttershy|mane six|pinkie pie|rainbow dash|rarity|twilight sparkle,glancojusticar
332726.png,https://derpicdn.net/img/view/2013/5/24/332726.png,0,0.9420422911643982,165,9,536,321,371,312,rainbow dash|twilight sparkle,redapropos
334189.png,https://derpicdn.net/img/view/2013/5/26/334189.png,1,0.9673522114753724,277,453,437,613,160,160,applejack|fluttershy|mane six|pinkie pie|princess celestia|princess luna|rainbow dash|rarity|spike|twilight sparkle,nikkiwardart
334499.png,https://derpicdn.net/img/view/2013/5/27/334499.png,0,0.9760916829109192,1521,241,1889,609,368,368,trixie|twilight sparkle,adcoon
336133.png,https://derpicdn.net/img/view/2013/5/29/336133.png,0,0.9846226572990416,824,41,1078,295,254,254,applejack|fluttershy|pinkie pie|rainbow dash|rarity|spike|twilight sparkle,dm29
336133.png,https://derpicdn.net/img/view/2013/5/29/336133.png,1,0.9710096716880798,1036,79,1272,315,236,236,applejack|fluttershy|pinkie pie|rainbow dash|rarity|spike|twilight sparkle,dm29
337010.png,https://derpicdn.net/img/view/2013/5/30/337010.png,0,0.9018278121948242,520,0,1344,824,824,824,spike|twilight sparkle,crispokefan
337760.png,https://derpicdn.net/img/view/2013/5/31/337760.png,0,0.9807755351066588,683,0,1137,419,454,419,fluttershy|rainbow dash|twilight sparkle,graphic-lee
337760.png,https://derpicdn.net/img/view/2013/5/31/337760.png,1,0.9079626202583312,0,729,532,1337,532,608,fluttershy|rainbow dash|twilight sparkle,graphic-lee
338230.png,https://derpicdn.net/img/view/2013/6/1/338230.png,0,0.9982216954231262,58,55,264,261,206,206,applejack|fluttershy|mane six|pinkie pie|rainbow dash|rarity|twilight sparkle,choco-pup
338230.png,https://derpicdn.net/img/view/2013/6/1/338230.png,1,0.9842408895492554,841,151,1053,363,212,212,applejack|fluttershy|mane six|pinkie pie|rainbow dash|rarity|twilight sparkle,choco-pup
338230.png,https://derpicdn.net/img/view/2013/6/1/338230.png,2,0.9192721843719482,413,220,635,442,222,222,applejack|fluttershy|mane six|pinkie pie|rainbow dash|rarity|twilight sparkle,choco-pup
33908.png,https://derpicdn.net/img/view/2012/7/6/33908.png,0,0.9930200576782228,346,0,792,415,446,415,apple bloom|applejack|big macintosh|fluttershy|mane six|pinkie pie|rainbow dash|rarity|scootaloo|silver spoon|spike|trixie|twilight sparkle,navitaserussirus
34206.jpg,https://derpicdn.net/img/view/2012/7/6/34206.jpg,0,0.981833517551422,586,1004,914,1332,328,328,fluttershy|rainbow dash|twilight sparkle,danleman14
34229.png,https://derpicdn.net/img/view/2012/7/6/34229.png,0,0.913815140724182,82,331,328,577,246,246,applejack|fluttershy|mane six|pinkie pie|rainbow dash|rarity|twilight sparkle,elosande
344754.png,https://derpicdn.net/img/view/2013/6/10/344754.png,0,0.9942370653152466,336,5,574,243,238,238,applejack|twilight sparkle,cartoonlion
344931.png,https://derpicdn.net/img/view/2013/6/10/344931.png,0,0.99934184551239,1778,581,3304,2107,1526,1526,spike|twilight sparkle,nac0n
345238.png,https://derpicdn.net/img/view/2013/6/10/345238.png,0,0.9915472865104676,552,72,998,518,446,446,rainbow dash|twilight sparkle,glacierchannel01
345238.png,https://derpicdn.net/img/view/2013/6/10/345238.png,1,0.9168446660041808,182,122,476,416,294,294,rainbow dash|twilight sparkle,glacierchannel01
345725.png,https://derpicdn.net/img/view/2013/6/11/345725.png,0,0.9998148083686828,611,759,1407,1555,796,796,applejack|fluttershy|mane six|pinkie pie|rainbow dash|rarity|twilight sparkle,scapegoat
345725.png,https://derpicdn.net/img/view/2013/6/11/345725.png,1,0.9661524295806884,287,1495,999,2207,712,712,applejack|fluttershy|mane six|pinkie pie|rainbow dash|rarity|twilight sparkle,scapegoat
346272.png,https://derpicdn.net/img/view/2013/6/11/346272.png,0,0.9873440861701964,0,0,1434,1080,1434,1080,rainbow dash|twilight sparkle,the4thaggie
347653.png,https://derpicdn.net/img/view/2013/6/13/347653.png,0,0.9982993006706238,395,0,1127,730,732,730,princess luna|twilight sparkle,desert-sage
348363.jpg,https://derpicdn.net/img/view/2013/6/14/348363.jpg,0,0.9965363144874572,32,231,190,389,158,158,applejack|fluttershy|pinkie pie|princess cadance|princess celestia|queen chrysalis|rainbow dash|rarity|shining armor|twilight sparkle,sirartemisderpington
35106.jpg,https://derpicdn.net/img/view/2012/7/7/35106.jpg,0,0.9971162676811218,383,6,639,262,256,256,applejack|fluttershy|mane six|pinkie pie|rainbow dash|rarity|twilight sparkle,reituki
35106.jpg,https://derpicdn.net/img/view/2012/7/7/35106.jpg,3,0.9785647988319396,239,443,487,691,248,248,applejack|fluttershy|mane six|pinkie pie|rainbow dash|rarity|twilight sparkle,reituki
35106.jpg,https://derpicdn.net/img/view/2012/7/7/35106.jpg,4,0.9161456227302552,216,170,472,426,256,256,applejack|fluttershy|mane six|pinkie pie|rainbow dash|rarity|twilight sparkle,reituki
351317.png,https://derpicdn.net/img/view/2013/6/18/351317.png,0,0.9793869853019714,0,849,195,1075,195,226,applejack|fluttershy|mane six|pinkie pie|rainbow dash|rarity|twilight sparkle,
351317.png,https://derpicdn.net/img/view/2013/6/18/351317.png,1,0.9713520407676696,535,887,723,1075,188,188,applejack|fluttershy|mane six|pinkie pie|rainbow dash|rarity|twilight sparkle,
351317.png,https://derpicdn.net/img/view/2013/6/18/351317.png,2,0.9514633417129515,397,385,819,807,422,422,applejack|fluttershy|mane six|pinkie pie|rainbow dash|rarity|twilight sparkle,
353349.png,https://derpicdn.net/img/view/2013/6/21/353349.png,0,0.9761293530464172,492,0,772,210,280,210,trixie|twilight sparkle,wouhlven
355947.png,https://derpicdn.net/img/view/2013/6/24/355947.png,0,0.9915026426315308,636,0,1512,773,876,773,rarity|twilight sparkle,robynne
361049.png,https://derpicdn.net/img/view/2013/6/30/361049.png,0,0.9919788837432858,1371,0,2419,873,1048,873,spike|twilight sparkle,dinoderp
361049.png,https://derpicdn.net/img/view/2013/6/30/361049.png,1,0.980871081352234,301,217,939,855,638,638,spike|twilight sparkle,dinoderp
363940.png,https://derpicdn.net/img/view/2013/7/4/363940.png,0,0.95809143781662,0,54,297,368,297,314,trixie|twilight sparkle,icy wings
364583.png,https://derpicdn.net/img/view/2013/7/4/364583.png,0,0.9509041905403136,310,0,1080,718,770,718,rarity|twilight sparkle,php50
365074.png,https://derpicdn.net/img/view/2013/7/5/365074.png,0,0.9956366419792176,0,977,1014,2077,1014,1100,trixie|twilight sparkle,fauxsquared
3658.jpg,https://derpicdn.net/img/view/2012/2/29/3658.jpg,1,0.9699404835700988,602,0,1108,437,506,437,pinkie pie|rarity|twilight sparkle,gsphere
366372.png,https://derpicdn.net/img/view/2013/7/7/366372.png,0,0.9994658827781676,636,249,956,569,320,320,trixie|twilight sparkle,philith
37160.png,https://derpicdn.net/img/view/2012/7/8/37160.png,0,0.997341811656952,140,69,306,235,166,166,spike|twilight sparkle,lulubell
374772.jpg,https://derpicdn.net/img/view/2013/7/15/374772.jpg,0,0.9950010776519777,509,39,927,457,418,418,princess luna|twilight sparkle,thorn
376320.jpg,https://derpicdn.net/img/view/2013/7/17/376320.jpg,0,0.9419191479682922,68,408,262,602,194,194,rainbow dash|scootaloo|twilight sparkle,choedan-kal
377025.png,https://derpicdn.net/img/view/2013/7/18/377025.png,0,0.9994760155677797,31,65,331,365,300,300,rarity|twilight sparkle,
381627.jpg,https://derpicdn.net/img/view/2013/7/22/381627.jpg,0,0.9918114542961121,395,13,689,307,294,294,princess cadance|twilight sparkle,tierafoxglove
383613.png,https://derpicdn.net/img/view/2013/7/25/383613.png,0,0.9942493438720704,0,0,577,593,577,593,pinkie pie|twilight sparkle,pyupew
383920.jpg,https://derpicdn.net/img/view/2013/7/29/383920.jpg,0,0.9414091110229492,5149,709,6609,2169,1460,1460,applejack|fluttershy|mane six|pinkie pie|rainbow dash|rarity|twilight sparkle,joakaha
387317.png,https://derpicdn.net/img/view/2013/7/31/387317.png,0,0.9850230813026428,1314,223,1810,719,496,496,pinkie pie|twilight sparkle,geomancing
390623.png,https://derpicdn.net/img/view/2013/8/4/390623.png,0,0.974718689918518,511,229,1025,743,514,514,spike|twilight sparkle,lelittleluna
39256.jpg,https://derpicdn.net/img/view/2012/7/10/39256.jpg,0,0.9916247129440308,648,113,946,411,298,298,applejack|fluttershy|mane six|pinkie pie|princess celestia|princess luna|rainbow dash|rarity|spike|twilight sparkle,vertizontal
39256.jpg,https://derpicdn.net/img/view/2012/7/10/39256.jpg,1,0.9905173778533936,546,620,810,884,264,264,applejack|fluttershy|mane six|pinkie pie|princess celestia|princess luna|rainbow dash|rarity|spike|twilight sparkle,vertizontal
393819.png,https://derpicdn.net/img/view/2013/8/7/393819.png,0,0.9967091679573059,511,582,809,880,298,298,applejack|fluttershy|mane six|pinkie pie|rainbow dash|rarity|twilight sparkle,kriversky
393819.png,https://derpicdn.net/img/view/2013/8/7/393819.png,1,0.9500548839569092,679,89,917,327,238,238,applejack|fluttershy|mane six|pinkie pie|rainbow dash|rarity|twilight sparkle,kriversky
396424.png,https://derpicdn.net/img/view/2013/8/10/396424.png,0,0.9956786632537842,268,33,622,387,354,354,applejack|fluttershy|mane six|pinkie pie|rainbow dash|rarity|twilight sparkle,jessy
39957.jpg,https://derpicdn.net/img/view/2012/7/11/39957.jpg,0,0.9947171807289124,96,16,366,286,270,270,applejack|fluttershy|mane six|pinkie pie|rainbow dash|rarity|twilight sparkle,steffy-beff
39957.jpg,https://derpicdn.net/img/view/2012/7/11/39957.jpg,1,0.9827214479446412,295,1149,800,1693,505,544,applejack|fluttershy|mane six|pinkie pie|rainbow dash|rarity|twilight sparkle,steffy-beff
39957.jpg,https://derpicdn.net/img/view/2012/7/11/39957.jpg,2,0.9151049256324768,371,808,627,1064,256,256,applejack|fluttershy|mane six|pinkie pie|rainbow dash|rarity|twilight sparkle,steffy-beff
405694.png,https://derpicdn.net/img/view/2013/8/20/405694.png,0,0.9785143733024596,339,219,621,501,282,282,fluttershy|trixie|twilight sparkle,hengebellika
405694.png,https://derpicdn.net/img/view/2013/8/20/405694.png,1,0.964094579219818,168,76,440,348,272,272,fluttershy|trixie|twilight sparkle,hengebellika
405944.jpg,https://derpicdn.net/img/view/2013/8/21/405944.jpg,0,0.9585631489753724,252,0,1560,1274,1308,1274,pinkie pie|spike|twilight sparkle,mricantdraw
405944.jpg,https://derpicdn.net/img/view/2013/8/21/405944.jpg,1,0.9008148312568665,2031,250,3307,1526,1276,1276,pinkie pie|spike|twilight sparkle,mricantdraw
406759.png,https://derpicdn.net/img/view/2013/8/22/406759.png,0,0.9992712140083312,548,196,974,622,426,426,rainbow dash|twilight sparkle,ambris
406759.png,https://derpicdn.net/img/view/2013/8/22/406759.png,1,0.9920331835746764,180,185,584,589,404,404,rainbow dash|twilight sparkle,ambris
407027.png,https://derpicdn.net/img/view/2013/8/22/407027.png,0,0.9870916604995728,197,410,543,756,346,346,rarity|twilight sparkle,the-butch-x
407302.png,https://derpicdn.net/img/view/2013/8/22/407302.png,0,0.9281358122825624,650,243,1192,785,542,542,big macintosh|shining armor|twilight sparkle,nekocrispy
408984.png,https://derpicdn.net/img/view/2013/8/24/408984.png,3,0.9907631278038024,1411,792,1813,1194,402,402,applejack|big macintosh|discord|fluttershy|mane six|pinkie pie|princess cadance|princess celestia|princess luna|queen chrysalis|rainbow dash|rarity|shining armor|spike|trixie|twilight sparkle,himanuts
408984.png,https://derpicdn.net/img/view/2013/8/24/408984.png,6,0.9794723987579346,1332,2734,1820,3222,488,488,applejack|big macintosh|discord|fluttershy|mane six|pinkie pie|princess cadance|princess celestia|princess luna|queen chrysalis|rainbow dash|rarity|shining armor|spike|trixie|twilight sparkle,himanuts
408984.png,https://derpicdn.net/img/view/2013/8/24/408984.png,9,0.9537472724914552,0,2650,723,3480,723,830,applejack|big macintosh|discord|fluttershy|mane six|pinkie pie|princess cadance|princess celestia|princess luna|queen chrysalis|rainbow dash|rarity|shining armor|spike|trixie|twilight sparkle,himanuts
408984.png,https://derpicdn.net/img/view/2013/8/24/408984.png,10,0.9430614709854126,12,292,394,674,382,382,applejack|big macintosh|discord|fluttershy|mane six|pinkie pie|princess cadance|princess celestia|princess luna|queen chrysalis|rainbow dash|rarity|shining armor|spike|trixie|twilight sparkle,himanuts
408984.png,https://derpicdn.net/img/view/2013/8/24/408984.png,11,0.9336164593696594,46,849,486,1289,440,440,applejack|big macintosh|discord|fluttershy|mane six|pinkie pie|princess cadance|princess celestia|princess luna|queen chrysalis|rainbow dash|rarity|shining armor|spike|trixie|twilight sparkle,himanuts
410056.png,https://derpicdn.net/img/view/2013/8/25/410056.png,0,0.9968897104263306,1841,129,2401,689,560,560,fluttershy|pinkie pie|twilight sparkle,vird-gi
410056.png,https://derpicdn.net/img/view/2013/8/25/410056.png,1,0.9961732625961304,0,0,861,846,861,846,fluttershy|pinkie pie|twilight sparkle,vird-gi
410465.png,https://derpicdn.net/img/view/2013/8/25/410465.png,0,0.9818577170372008,437,153,835,551,398,398,princess luna|twilight sparkle,matrosha123
411752.png,https://derpicdn.net/img/view/2013/8/27/411752.png,0,0.9986237883567808,50,365,366,635,316,270,rainbow dash|twilight sparkle,queenbloodysky
41510.png,https://derpicdn.net/img/view/2012/7/12/41510.png,0,0.9863882064819336,805,0,3091,1893,2286,1893,shining armor|twilight sparkle,beavernator
41510.png,https://derpicdn.net/img/view/2012/7/12/41510.png,1,0.9660638570785522,2325,1088,3721,2484,1396,1396,shining armor|twilight sparkle,beavernator
419966.png,https://derpicdn.net/img/view/2013/9/5/419966.png,0,0.9925388693809508,0,220,482,710,482,490,rainbow dash|twilight sparkle,jcking101
419966.png,https://derpicdn.net/img/view/2013/9/5/419966.png,1,0.9847687482833862,462,5,942,485,480,480,rainbow dash|twilight sparkle,jcking101
42278.png,https://derpicdn.net/img/view/2012/7/13/42278.png,0,0.9971563816070556,334,378,744,788,410,410,pinkie pie|rainbow dash|twilight sparkle,valcron
42278.png,https://derpicdn.net/img/view/2012/7/13/42278.png,1,0.9893304705619812,703,408,1061,766,358,358,pinkie pie|rainbow dash|twilight sparkle,valcron
426113.jpg,https://derpicdn.net/img/view/2013/9/12/426113.jpg,1,0.9912606477737428,276,42,570,336,294,294,applejack|fluttershy|mane six|pinkie pie|rainbow dash|rarity|spike|sunset shimmer|twilight sparkle,
426113.jpg,https://derpicdn.net/img/view/2013/9/12/426113.jpg,2,0.964377462863922,460,0,748,235,288,235,applejack|fluttershy|mane six|pinkie pie|rainbow dash|rarity|spike|sunset shimmer|twilight sparkle,
426113.jpg,https://derpicdn.net/img/view/2013/9/12/426113.jpg,4,0.9101034998893738,670,395,846,571,176,176,applejack|fluttershy|mane six|pinkie pie|rainbow dash|rarity|spike|sunset shimmer|twilight sparkle,
426193.png,https://derpicdn.net/img/view/2013/9/12/426193.png,1,0.972602605819702,59,311,285,537,226,226,fluttershy|twilight sparkle,gingermint|icekatze
426193.png,https://derpicdn.net/img/view/2013/9/12/426193.png,2,0.962110698223114,544,0,832,285,288,285,fluttershy|twilight sparkle,gingermint|icekatze
44417.png,https://derpicdn.net/img/view/2012/7/14/44417.png,1,0.9067602157592772,3589,606,4127,1144,538,538,applejack|fluttershy|mane six|pinkie pie|rainbow dash|rarity|spike|twilight sparkle,multiversecafe
447922.png,https://derpicdn.net/img/view/2013/10/13/447922.png,0,0.9154178500175476,128,0,854,603,726,603,rainbow dash|twilight sparkle,ponymonster
454050.png,https://derpicdn.net/img/view/2013/10/22/454050.png,0,0.9860312938690186,627,99,1063,535,436,436,rainbow dash|twilight sparkle,ambris
454932.png,https://derpicdn.net/img/view/2013/10/23/454932.png,0,0.916386067867279,687,762,961,1036,274,274,applejack|fluttershy|mane six|pinkie pie|rainbow dash|rarity|spike|twilight sparkle,
4576.jpg,https://derpicdn.net/img/view/2012/6/17/4576.jpg,0,0.9988560676574708,2721,1338,3838,2478,1117,1140,applejack|fluttershy|mane six|pinkie pie|rainbow dash|rarity|twilight sparkle,iamthecowboysmuggler
4576.jpg,https://derpicdn.net/img/view/2012/6/17/4576.jpg,1,0.903409481048584,2724,656,3610,1542,886,886,applejack|fluttershy|mane six|pinkie pie|rainbow dash|rarity|twilight sparkle,iamthecowboysmuggler
458474.png,https://derpicdn.net/img/view/2013/10/28/458474.png,0,0.9493871331214904,722,657,1352,1287,630,630,fluttershy|pinkie pie|princess luna|twilight sparkle,boyindahaus
461160.png,https://derpicdn.net/img/view/2013/10/31/461160.png,0,0.9833230376243592,95,0,653,532,558,532,queen chrysalis|twilight sparkle,bajanic
463182.jpg,https://derpicdn.net/img/view/2013/11/3/463182.jpg,1,0.962663471698761,652,29,958,335,306,306,applejack|fluttershy|mane six|pinkie pie|rainbow dash|rarity|twilight sparkle,abbystarling
463209.png,https://derpicdn.net/img/view/2013/11/3/463209.png,0,0.9899108409881592,292,0,498,191,206,191,applejack|fluttershy|mane six|pinkie pie|rainbow dash|rarity|spike|twilight sparkle,the weaver
464161.png,https://derpicdn.net/img/view/2013/11/4/464161.png,0,0.9997524619102478,252,639,736,1123,484,484,applejack|fluttershy|mane six|pinkie pie|rainbow dash|rarity|twilight sparkle,abbystarling
464161.png,https://derpicdn.net/img/view/2013/11/4/464161.png,1,0.9982731342315674,445,346,929,830,484,484,applejack|fluttershy|mane six|pinkie pie|rainbow dash|rarity|twilight sparkle,abbystarling
464161.png,https://derpicdn.net/img/view/2013/11/4/464161.png,2,0.997031033039093,95,298,561,764,466,466,applejack|fluttershy|mane six|pinkie pie|rainbow dash|rarity|twilight sparkle,abbystarling
464161.png,https://derpicdn.net/img/view/2013/11/4/464161.png,3,0.9909398555755616,0,953,431,1445,431,492,applejack|fluttershy|mane six|pinkie pie|rainbow dash|rarity|twilight sparkle,abbystarling
464161.png,https://derpicdn.net/img/view/2013/11/4/464161.png,4,0.9866399765014648,587,1007,1024,1465,437,458,applejack|fluttershy|mane six|pinkie pie|rainbow dash|rarity|twilight sparkle,abbystarling
464161.png,https://derpicdn.net/img/view/2013/11/4/464161.png,5,0.9789978265762328,457,10,761,314,304,304,applejack|fluttershy|mane six|pinkie pie|rainbow dash|rarity|twilight sparkle,abbystarling
471256.png,https://derpicdn.net/img/view/2013/11/12/471256.png,0,0.9996116757392884,372,0,674,296,302,296,fluttershy|rainbow dash|twilight sparkle,soullessteddybear
471256.png,https://derpicdn.net/img/view/2013/11/12/471256.png,1,0.981059730052948,612,0,1030,331,418,331,fluttershy|rainbow dash|twilight sparkle,soullessteddybear
471256.png,https://derpicdn.net/img/view/2013/11/12/471256.png,2,0.968112289905548,36,23,318,305,282,282,fluttershy|rainbow dash|twilight sparkle,soullessteddybear
472230.png,https://derpicdn.net/img/view/2013/11/14/472230.png,0,0.9946281313896179,677,2845,1263,3431,586,586,applejack|big macintosh|braeburn|fluttershy|lightning dust|mane six|pinkie pie|princess celestia|princess luna|rainbow dash|rarity|shining armor|soarin'|spitfire|trixie|twilight sparkle,sinkingstone
472230.png,https://derpicdn.net/img/view/2013/11/14/472230.png,1,0.9917512536048888,1507,1456,2063,2012,556,556,applejack|big macintosh|braeburn|fluttershy|lightning dust|mane six|pinkie pie|princess celestia|princess luna|rainbow dash|rarity|shining armor|soarin'|spitfire|trixie|twilight sparkle,sinkingstone
472230.png,https://derpicdn.net/img/view/2013/11/14/472230.png,2,0.9872326254844666,763,1408,1281,1926,518,518,applejack|big macintosh|braeburn|fluttershy|lightning dust|mane six|pinkie pie|princess celestia|princess luna|rainbow dash|rarity|shining armor|soarin'|spitfire|trixie|twilight sparkle,sinkingstone
472230.png,https://derpicdn.net/img/view/2013/11/14/472230.png,3,0.9794363379478456,0,2876,499,3382,499,506,applejack|big macintosh|braeburn|fluttershy|lightning dust|mane six|pinkie pie|princess celestia|princess luna|rainbow dash|rarity|shining armor|soarin'|spitfire|trixie|twilight sparkle,sinkingstone
472230.png,https://derpicdn.net/img/view/2013/11/14/472230.png,4,0.9708528518676758,2999,2158,3493,2652,494,494,applejack|big macintosh|braeburn|fluttershy|lightning dust|mane six|pinkie pie|princess celestia|princess luna|rainbow dash|rarity|shining armor|soarin'|spitfire|trixie|twilight sparkle,sinkingstone
472230.png,https://derpicdn.net/img/view/2013/11/14/472230.png,5,0.9477713704109192,2973,742,3469,1238,496,496,applejack|big macintosh|braeburn|fluttershy|lightning dust|mane six|pinkie pie|princess celestia|princess luna|rainbow dash|rarity|shining armor|soarin'|spitfire|trixie|twilight sparkle,sinkingstone
472230.png,https://derpicdn.net/img/view/2013/11/14/472230.png,6,0.9298146963119508,2899,0,3455,521,556,521,applejack|big macintosh|braeburn|fluttershy|lightning dust|mane six|pinkie pie|princess celestia|princess luna|rainbow dash|rarity|shining armor|soarin'|spitfire|trixie|twilight sparkle,sinkingstone
472291.png,https://derpicdn.net/img/view/2013/11/14/472291.png,1,0.9686075448989868,2,1184,180,1362,178,178,apple bloom|applejack|babs seed|big macintosh|braeburn|cutie mark crusaders|diamond tiara|fluttershy|lightning dust|mane six|pinkie pie|princess celestia|princess luna|rainbow dash|rarity|scootaloo|shining armor|silver spoon|soarin'|spitfire|sweetie belle|trixie|twilight sparkle,sinkingstone
472291.png,https://derpicdn.net/img/view/2013/11/14/472291.png,2,0.9284521341323853,243,1190,403,1350,160,160,apple bloom|applejack|babs seed|big macintosh|braeburn|cutie mark crusaders|diamond tiara|fluttershy|lightning dust|mane six|pinkie pie|princess celestia|princess luna|rainbow dash|rarity|scootaloo|shining armor|silver spoon|soarin'|spitfire|sweetie belle|trixie|twilight sparkle,sinkingstone
474056.png,https://derpicdn.net/img/view/2013/11/16/474056.png,0,0.9907190799713136,263,174,399,310,136,136,trixie|twilight sparkle,autumnbramble
476912.png,https://derpicdn.net/img/view/2013/11/20/476912.png,0,0.9927401542663574,94,0,428,300,334,300,sunset shimmer|twilight sparkle,tigerprincesskaitlyn
478640.jpg,https://derpicdn.net/img/view/2013/11/22/478640.jpg,0,0.9752157330513,1285,1610,2448,2964,1163,1354,princess cadance|princess celestia|princess luna|twilight sparkle,frostykat13
478640.jpg,https://derpicdn.net/img/view/2013/11/22/478640.jpg,1,0.9139971137046814,91,211,1313,1433,1222,1222,princess cadance|princess celestia|princess luna|twilight sparkle,frostykat13
479004.png,https://derpicdn.net/img/view/2013/11/23/479004.png,0,0.9284372925758362,548,131,1632,1215,1084,1084,applejack|fluttershy|mane six|pinkie pie|rainbow dash|rarity|spike|twilight sparkle,saliantsunbreeze
483596.png,https://derpicdn.net/img/view/2013/11/27/483596.png,0,0.9178332090377808,940,222,2334,1616,1394,1394,spike|twilight sparkle,masem
48913.jpg,https://derpicdn.net/img/view/2012/7/19/48913.jpg,0,0.9348495602607728,1573,732,2351,1510,778,778,applejack|fluttershy|mane six|pinkie pie|princess celestia|rainbow dash|rarity|spike|twilight sparkle,glenbw
49028.png,https://derpicdn.net/img/view/2012/7/19/49028.png,0,0.9662935733795166,685,31,863,209,178,178,applejack|fluttershy|pinkie pie|rainbow dash|rarity|twilight sparkle,dm29
491812.png,https://derpicdn.net/img/view/2013/12/7/491812.png,0,0.9658766984939576,151,0,761,605,610,605,fluttershy|rainbow dash|twilight sparkle,hoyeechun
493258.png,https://derpicdn.net/img/view/2013/12/8/493258.png,0,0.9559127688407898,26,0,714,599,688,599,spike|twilight sparkle,
495903.jpg,https://derpicdn.net/img/view/2013/12/13/495903.jpg,1,0.9481652975082396,0,0,596,591,596,591,rainbow dash|twilight sparkle,riznof
50421.jpg,https://derpicdn.net/img/view/2012/7/20/50421.jpg,0,0.9805827736854552,823,379,1019,575,196,196,apple bloom|applejack|big macintosh|cutie mark crusaders|discord|fluttershy|granny smith|pinkie pie|princess cadance|princess celestia|princess luna|rainbow dash|rarity|scootaloo|shining armor|spike|sweetie belle|trixie|twilight sparkle,rannva
504454.jpg,https://derpicdn.net/img/view/2013/12/23/504454.jpg,0,0.9976209402084352,126,110,396,380,270,270,applejack|fluttershy|mane six|pinkie pie|rainbow dash|rarity|spike|twilight sparkle,pennygu
50683.png,https://derpicdn.net/img/view/2012/7/20/50683.png,0,0.9742085337638856,264,118,458,312,194,194,applejack|pinkie pie|rainbow dash|twilight sparkle,willdrawforfood1
508142.png,https://derpicdn.net/img/view/2013/12/28/508142.png,0,0.9709810614585876,612,1682,976,2046,364,364,applejack|fluttershy|mane six|pinkie pie|rainbow dash|rarity|twilight sparkle,quadren4
508142.png,https://derpicdn.net/img/view/2013/12/28/508142.png,1,0.9527824521064758,233,0,909,666,676,666,applejack|fluttershy|mane six|pinkie pie|rainbow dash|rarity|twilight sparkle,quadren4
511119.png,https://derpicdn.net/img/view/2013/12/31/511119.png,1,0.9375839829444884,0,327,302,655,302,328,fluttershy|spike|twilight sparkle,luigikirby64
511524.jpg,https://derpicdn.net/img/view/2014/1/1/511524.jpg,3,0.9913699626922609,688,1679,1000,2021,312,342,apple bloom|applejack|cutie mark crusaders|fluttershy|mane six|pinkie pie|princess celestia|princess luna|rainbow dash|rarity|scootaloo|spike|sweetie belle|twilight sparkle,jiiko
511524.jpg,https://derpicdn.net/img/view/2014/1/1/511524.jpg,5,0.9599336385726928,33,1253,401,1621,368,368,apple bloom|applejack|cutie mark crusaders|fluttershy|mane six|pinkie pie|princess celestia|princess luna|rainbow dash|rarity|scootaloo|spike|sweetie belle|twilight sparkle,jiiko
512251.png,https://derpicdn.net/img/view/2014/1/1/512251.png,0,0.9982599020004272,0,0,476,491,476,491,sunset shimmer|twilight sparkle,austiniousi
51780.jpg,https://derpicdn.net/img/view/2012/7/21/51780.jpg,0,0.9986649751663208,0,222,365,590,365,368,princess celestia|spike|twilight sparkle,cold-blooded-twilight
51884.png,https://derpicdn.net/img/view/2012/7/21/51884.png,0,0.9926847815513612,1171,416,1501,746,330,330,applejack|fluttershy|mane six|pinkie pie|rainbow dash|rarity|twilight sparkle,cartoonlion
51884.png,https://derpicdn.net/img/view/2012/7/21/51884.png,1,0.9628344178199768,971,553,1265,847,294,294,applejack|fluttershy|mane six|pinkie pie|rainbow dash|rarity|twilight sparkle,cartoonlion
51884.png,https://derpicdn.net/img/view/2012/7/21/51884.png,2,0.9390063285827636,88,76,348,336,260,260,applejack|fluttershy|mane six|pinkie pie|rainbow dash|rarity|twilight sparkle,cartoonlion
51884.png,https://derpicdn.net/img/view/2012/7/21/51884.png,3,0.9343437552452089,4,460,246,702,242,242,applejack|fluttershy|mane six|pinkie pie|rainbow dash|rarity|twilight sparkle,cartoonlion
518864.png,https://derpicdn.net/img/view/2014/1/8/518864.png,0,0.9935104250907898,127,113,293,279,166,166,pinkie pie|twilight sparkle,ranban
525946.png,https://derpicdn.net/img/view/2014/1/16/525946.png,0,0.9588666558265686,848,626,1280,1070,432,444,pinkie pie|twilight sparkle,penguinpotential
528416.png,https://derpicdn.net/img/view/2014/1/19/528416.png,0,0.9978379607200624,832,524,1188,880,356,356,fluttershy|pinkie pie|twilight sparkle,nocturnalmeteor
528416.png,https://derpicdn.net/img/view/2014/1/19/528416.png,1,0.9901695251464844,1243,177,1531,465,288,288,fluttershy|pinkie pie|twilight sparkle,nocturnalmeteor
528416.png,https://derpicdn.net/img/view/2014/1/19/528416.png,2,0.9890127182006836,671,1210,959,1498,288,288,fluttershy|pinkie pie|twilight sparkle,nocturnalmeteor
529108.png,https://derpicdn.net/img/view/2014/1/19/529108.png,0,0.9949572086334229,1158,89,1950,881,792,792,princess celestia|princess luna|twilight sparkle,weepysheep
52915.jpg,https://derpicdn.net/img/view/2012/7/22/52915.jpg,0,0.9687181115150452,49,32,341,324,292,292,discord|twilight sparkle,the weaver
532049.png,https://derpicdn.net/img/view/2014/1/23/532049.png,0,0.9774448871612548,1611,481,2355,1225,744,744,pinkie pie|trixie|twilight sparkle,fauxsquared
532049.png,https://derpicdn.net/img/view/2014/1/23/532049.png,1,0.9209437370300292,482,862,1272,1652,790,790,pinkie pie|trixie|twilight sparkle,fauxsquared
533941.png,https://derpicdn.net/img/view/2014/1/25/533941.png,0,0.9621196985244752,548,425,790,667,242,242,discord|twilight sparkle,norang94
533969.jpg,https://derpicdn.net/img/view/2014/1/25/533969.jpg,0,0.9877678751945496,262,22,592,352,330,330,discord|twilight sparkle,
534079.png,https://derpicdn.net/img/view/2014/1/25/534079.png,0,0.9882726073265076,21,30,287,296,266,266,princess cadance|twilight sparkle,
534477.png,https://derpicdn.net/img/view/2014/1/26/534477.png,0,0.9879099726676941,431,30,763,362,332,332,princess cadance|twilight sparkle,sketch-shepherd
534477.png,https://derpicdn.net/img/view/2014/1/26/534477.png,1,0.961232602596283,149,95,491,437,342,342,princess cadance|twilight sparkle,sketch-shepherd
536172.jpg,https://derpicdn.net/img/view/2014/1/27/536172.jpg,0,0.997880518436432,1112,731,1984,1603,872,872,discord|princess cadance|princess celestia|princess luna|twilight sparkle,plainoasis
538306.png,https://derpicdn.net/img/view/2014/1/30/538306.png,0,0.9888098239898682,3008,730,4504,2226,1496,1496,princess cadance|twilight sparkle,masem
539264.png,https://derpicdn.net/img/view/2014/1/31/539264.png,0,0.9974575042724608,724,104,2674,2054,1950,1950,princess cadance|twilight sparkle,vector-brony
543599.png,https://derpicdn.net/img/view/2014/2/5/543599.png,0,0.997114360332489,173,131,1513,1471,1340,1340,pinkie pie|twilight sparkle,clouddg
546990.png,https://derpicdn.net/img/view/2014/2/8/546990.png,0,0.967919647693634,103,0,507,382,404,382,rarity|twilight sparkle,
546990.png,https://derpicdn.net/img/view/2014/2/8/546990.png,1,0.9132941365242004,537,0,1055,513,518,513,rarity|twilight sparkle,
549369.png,https://derpicdn.net/img/view/2014/2/11/549369.png,0,0.9841876029968262,552,156,1758,1362,1206,1206,rainbow dash|twilight sparkle,ekrostrance
550198.png,https://derpicdn.net/img/view/2014/2/12/550198.png,0,0.9860687851905824,264,0,1270,1002,1006,1002,spike|twilight sparkle,itsunkownanon
5544.jpg,https://derpicdn.net/img/view/2012/6/17/5544.jpg,0,0.9910399317741394,78,0,580,441,502,441,spike|twilight sparkle,buttercupsaiyan
555141.jpg,https://derpicdn.net/img/view/2014/2/17/555141.jpg,0,0.9361288547515868,346,26,722,402,376,376,trixie|twilight sparkle,justalittleskye
557190.jpg,https://derpicdn.net/img/view/2014/2/20/557190.jpg,0,0.9509842991828918,1474,705,1982,1213,508,508,applejack|fluttershy|mane six|pinkie pie|rainbow dash|rarity|twilight sparkle,tahublade7
557527.jpg,https://derpicdn.net/img/view/2014/2/20/557527.jpg,0,0.9791012406349182,409,0,629,206,220,206,applejack|fluttershy|mane six|pinkie pie|rainbow dash|rarity|twilight sparkle,
559068.png,https://derpicdn.net/img/view/2014/2/22/559068.png,0,0.956956148147583,327,92,619,384,292,292,sweetie belle|twilight sparkle,silver1kunai
559068.png,https://derpicdn.net/img/view/2014/2/22/559068.png,1,0.9447126984596252,217,340,419,542,202,202,sweetie belle|twilight sparkle,silver1kunai
561547.png,https://derpicdn.net/img/view/2014/2/26/561547.png,0,0.9966093301773072,442,323,736,617,294,294,spike|twilight sparkle,aviantheatrics
561547.png,https://derpicdn.net/img/view/2014/2/26/561547.png,1,0.96519136428833,145,97,427,379,282,282,spike|twilight sparkle,aviantheatrics
562775.png,https://derpicdn.net/img/view/2014/2/27/562775.png,0,0.9325165748596193,767,140,1125,498,358,358,apple bloom|cutie mark crusaders|scootaloo|sweetie belle|twilight sparkle,hierozaki
569597.png,https://derpicdn.net/img/view/2014/3/8/569597.png,1,0.9086976051330566,925,339,1331,745,406,406,rainbow dash|twilight sparkle,mrlolcats17|joeycrick|tamalesyatole|the smiling pony|cthulhuandyou
571564.png,https://derpicdn.net/img/view/2014/3/10/571564.png,0,0.9319230318069458,641,559,869,787,228,228,applejack|pinkie pie|spike|twilight sparkle,cynos-zilla
573222.jpg,https://derpicdn.net/img/view/2014/3/12/573222.jpg,0,0.9829601645469666,1045,198,2041,1194,996,996,fluttershy|pinkie pie|princess luna|rainbow dash|rarity|scootaloo|twilight sparkle,artknorke
574790.png,https://derpicdn.net/img/view/2014/3/14/574790.png,0,0.9885649681091307,1313,814,1813,1314,500,500,applejack|fluttershy|mane six|pinkie pie|rainbow dash|rarity|twilight sparkle,thekattyart
57721.png,https://derpicdn.net/img/view/2012/7/26/57721.png,0,0.9743950366973876,265,238,599,572,334,334,applejack|fluttershy|pinkie pie|rainbow dash|rarity|trixie|twilight sparkle,aliasforrent
578890.png,https://derpicdn.net/img/view/2014/3/18/578890.png,0,0.9457189440727234,409,101,649,341,240,240,trixie|twilight sparkle,kyoshyu
579339.png,https://derpicdn.net/img/view/2014/3/19/579339.png,0,0.9459825754165648,494,208,936,650,442,442,rainbow dash|twilight sparkle,aelioszero
585947.png,https://derpicdn.net/img/view/2014/3/27/585947.png,0,0.9917784333229064,5,575,473,1043,468,468,princess cadance|princess celestia|princess luna|queen chrysalis|shining armor|twilight sparkle,donzatch
588838.png,https://derpicdn.net/img/view/2014/3/30/588838.png,0,0.9987967014312744,2243,447,2973,1177,730,730,sunset shimmer|twilight sparkle,flashlighthouse
588838.png,https://derpicdn.net/img/view/2014/3/30/588838.png,1,0.9918880462646484,1578,401,2354,1177,776,776,sunset shimmer|twilight sparkle,flashlighthouse
591056.png,https://derpicdn.net/img/view/2014/4/2/591056.png,0,0.9201790094375608,976,91,1676,791,700,700,trixie|twilight sparkle,icy wings
593696.png,https://derpicdn.net/img/view/2014/4/5/593696.png,0,0.9995086193084716,0,0,728,651,728,651,rainbow dash|twilight sparkle,cherivinca
595902.png,https://derpicdn.net/img/view/2014/4/8/595902.png,1,0.9623147249221802,4,13,268,277,264,264,rainbow dash|twilight sparkle,
597107.png,https://derpicdn.net/img/view/2014/4/10/597107.png,0,0.9915715456008912,968,373,1180,585,212,212,spike|twilight sparkle,
597629.png,https://derpicdn.net/img/view/2014/4/11/597629.png,0,0.9953873157501221,0,80,264,348,264,268,sunset shimmer|twilight sparkle,rob barba
597629.png,https://derpicdn.net/img/view/2014/4/11/597629.png,1,0.9687191843986512,497,97,731,331,234,234,sunset shimmer|twilight sparkle,rob barba
599792.jpg,https://derpicdn.net/img/view/2014/4/13/599792.jpg,1,0.9826810359954834,339,187,713,561,374,374,applejack|fluttershy|mane six|pinkie pie|rainbow dash|rarity|spike|twilight sparkle,meto30
600016.png,https://derpicdn.net/img/view/2014/4/14/600016.png,0,0.9622613191604614,283,101,600,439,317,338,trixie|twilight sparkle,wheatley
605186.png,https://derpicdn.net/img/view/2014/4/20/605186.png,0,0.9243181943893432,127,340,517,730,390,390,rarity|twilight sparkle,jankrys00
613773.png,https://derpicdn.net/img/view/2014/4/30/613773.png,0,0.9984353184700012,640,203,992,555,352,352,trixie|twilight sparkle,rad-girl
613773.png,https://derpicdn.net/img/view/2014/4/30/613773.png,1,0.9961684346199036,284,127,736,579,452,452,trixie|twilight sparkle,rad-girl
619348.jpg,https://derpicdn.net/img/view/2014/5/6/619348.jpg,0,0.9956509470939636,529,518,687,676,158,158,applejack|fluttershy|mane six|pinkie pie|rainbow dash|rarity|spike|twilight sparkle,
619348.jpg,https://derpicdn.net/img/view/2014/5/6/619348.jpg,1,0.9812126159667968,561,279,699,417,138,138,applejack|fluttershy|mane six|pinkie pie|rainbow dash|rarity|spike|twilight sparkle,
619348.jpg,https://derpicdn.net/img/view/2014/5/6/619348.jpg,2,0.9789942502975464,24,265,198,439,174,174,applejack|fluttershy|mane six|pinkie pie|rainbow dash|rarity|spike|twilight sparkle,
619348.jpg,https://derpicdn.net/img/view/2014/5/6/619348.jpg,3,0.9752768874168396,188,270,342,424,154,154,applejack|fluttershy|mane six|pinkie pie|rainbow dash|rarity|spike|twilight sparkle,
620959.jpg,https://derpicdn.net/img/view/2014/5/8/620959.jpg,0,0.991256833076477,540,964,1486,1910,946,946,princess cadance|princess celestia|princess luna|twilight sparkle,pumpkinkikile
626.png,https://derpicdn.net/img/view/2012/1/17/626.png,0,0.9551206827163696,348,0,854,485,506,485,spike|twilight sparkle,nastylady
626045.jpg,https://derpicdn.net/img/view/2014/5/13/626045.jpg,1,0.9910171627998352,287,712,829,1254,542,542,apple bloom|applejack|big macintosh|cutie mark crusaders|diamond tiara|discord|fluttershy|granny smith|mane six|pinkie pie|princess cadance|princess celestia|princess luna|rainbow dash|rarity|scootaloo|shining armor|silver spoon|spike|sweetie belle|trixie|twilight sparkle,jbwarner86
626045.jpg,https://derpicdn.net/img/view/2014/5/13/626045.jpg,3,0.9652414321899414,1088,1641,1474,2027,386,386,apple bloom|applejack|big macintosh|cutie mark crusaders|diamond tiara|discord|fluttershy|granny smith|mane six|pinkie pie|princess cadance|princess celestia|princess luna|rainbow dash|rarity|scootaloo|shining armor|silver spoon|spike|sweetie belle|trixie|twilight sparkle,jbwarner86
63029.jpg,https://derpicdn.net/img/view/2012/7/31/63029.jpg,0,0.9899315834045408,421,325,623,527,202,202,applejack|fluttershy|mane six|pinkie pie|rainbow dash|rarity|spike|twilight sparkle,x-chan-
63029.jpg,https://derpicdn.net/img/view/2012/7/31/63029.jpg,1,0.9856875538825988,127,290,375,538,248,248,applejack|fluttershy|mane six|pinkie pie|rainbow dash|rarity|spike|twilight sparkle,x-chan-
63029.jpg,https://derpicdn.net/img/view/2012/7/31/63029.jpg,3,0.9531370997428894,648,340,820,512,172,172,applejack|fluttershy|mane six|pinkie pie|rainbow dash|rarity|spike|twilight sparkle,x-chan-
634882.jpg,https://derpicdn.net/img/view/2014/5/24/634882.jpg,0,0.9974641203880308,202,424,536,758,334,334,applejack|discord|fluttershy|pinkie pie|rainbow dash|twilight sparkle,mirrorandimage
638412.png,https://derpicdn.net/img/view/2014/5/27/638412.png,0,0.9440606236457824,800,16,1150,366,350,350,applejack|fluttershy|mane six|pinkie pie|rainbow dash|rarity|twilight sparkle,meeoh
638910.png,https://derpicdn.net/img/view/2014/5/28/638910.png,0,0.9331191778182985,2,102,232,332,230,230,applejack|rarity|twilight sparkle,
642627.png,https://derpicdn.net/img/view/2014/6/2/642627.png,0,0.9418827891349792,913,320,1157,564,244,244,princess cadance|twilight sparkle,carnivorouscaribou
644134.png,https://derpicdn.net/img/view/2014/6/3/644134.png,1,0.9247378706932068,1100,354,1706,960,606,606,trixie|twilight sparkle,navitaserussirus
644239.png,https://derpicdn.net/img/view/2014/6/3/644239.png,0,0.9384369254112244,2408,650,2952,1194,544,544,applejack|fluttershy|mane six|pinkie pie|rainbow dash|rarity|spike|twilight sparkle,anarchemitis
646941.png,https://derpicdn.net/img/view/2014/6/6/646941.png,0,0.9326879382133484,629,793,865,1029,236,236,discord|twilight sparkle,shadowwolfhunter|darkarlett
647089.png,https://derpicdn.net/img/view/2014/6/7/647089.png,0,0.9177227020263672,290,86,1430,1226,1140,1140,soarin'|spitfire|twilight sparkle,blackfreya
654091.png,https://derpicdn.net/img/view/2014/6/15/654091.png,0,0.9204173684120178,444,43,776,375,332,332,rainbow dash|twilight sparkle,roseywingedcat
655007.png,https://derpicdn.net/img/view/2014/6/17/655007.png,0,0.994936227798462,0,0,396,386,396,386,queen chrysalis|twilight sparkle,mixermike622
656893.png,https://derpicdn.net/img/view/2014/6/19/656893.png,0,0.9496169090270996,727,120,963,356,236,236,applejack|fluttershy|pinkie pie|rainbow dash|rarity|twilight sparkle,
6581.png,https://derpicdn.net/img/view/2012/6/18/6581.png,0,0.9880350828170776,552,21,1508,977,956,956,princess cadance|twilight sparkle,xnightmelody
6581.png,https://derpicdn.net/img/view/2012/6/18/6581.png,1,0.9421787261962892,1065,771,1887,1593,822,822,princess cadance|twilight sparkle,xnightmelody
660255.png,https://derpicdn.net/img/view/2014/6/24/660255.png,1,0.944372296333313,665,100,985,420,320,320,princess luna|twilight sparkle,midnightsix3
660321.png,https://derpicdn.net/img/view/2014/6/24/660321.png,0,0.9946633577346802,0,0,668,630,668,630,shining armor|twilight sparkle,keira-chann
6630.jpg,https://derpicdn.net/img/view/2012/6/18/6630.jpg,0,0.9995409846305848,456,38,798,380,342,342,princess cadance|shining armor|twilight sparkle,honeyl17|honey-laurel17
664028.png,https://derpicdn.net/img/view/2014/6/29/664028.png,0,0.9883950352668762,395,0,1007,503,612,503,discord|fluttershy|lightning dust|princess cadance|princess celestia|princess luna|queen chrysalis|trixie|twilight sparkle,astrequin
664028.png,https://derpicdn.net/img/view/2014/6/29/664028.png,1,0.9478017687797546,10,850,608,1440,598,590,discord|fluttershy|lightning dust|princess cadance|princess celestia|princess luna|queen chrysalis|trixie|twilight sparkle,astrequin
664028.png,https://derpicdn.net/img/view/2014/6/29/664028.png,2,0.9407287836074828,1281,0,1920,529,639,529,discord|fluttershy|lightning dust|princess cadance|princess celestia|princess luna|queen chrysalis|trixie|twilight sparkle,astrequin
667204.png,https://derpicdn.net/img/view/2014/7/4/667204.png,0,0.995900571346283,1349,109,1559,319,210,210,applejack|fluttershy|mane six|pinkie pie|rainbow dash|rarity|twilight sparkle,strawberry-pannycake
667204.png,https://derpicdn.net/img/view/2014/7/4/667204.png,1,0.9253077507019044,874,149,1052,327,178,178,applejack|fluttershy|mane six|pinkie pie|rainbow dash|rarity|twilight sparkle,strawberry-pannycake
669038.png,https://derpicdn.net/img/view/2014/7/6/669038.png,0,0.9801806211471558,394,13,640,259,246,246,applejack|fluttershy|mane six|pinkie pie|rainbow dash|rarity|twilight sparkle,happy-heart-1
671063.png,https://derpicdn.net/img/view/2014/7/9/671063.png,0,0.988616943359375,12,459,226,673,214,214,discord|princess celestia|rainbow dash|twilight sparkle,pixelkitties
674115.png,https://derpicdn.net/img/view/2014/7/13/674115.png,0,0.9971439242362976,100,0,910,773,810,773,pinkie pie|twilight sparkle,wolfy-pony
674115.png,https://derpicdn.net/img/view/2014/7/13/674115.png,1,0.9938992857933044,997,95,1671,769,674,674,pinkie pie|twilight sparkle,wolfy-pony
674943.png,https://derpicdn.net/img/view/2014/7/14/674943.png,0,0.9918460845947266,826,4,1074,252,248,248,applejack|fluttershy|mane six|pinkie pie|rainbow dash|rarity|twilight sparkle,mellowlamb|phewmonster
679002.png,https://derpicdn.net/img/view/2014/7/20/679002.png,0,0.9000133872032166,476,123,912,559,436,436,princess cadance|princess celestia|princess luna|twilight sparkle,fairiegirl101
680532.png,https://derpicdn.net/img/view/2014/7/22/680532.png,0,0.9599977731704712,9,127,241,359,232,232,spike|twilight sparkle,meowing-ghost
682018.png,https://derpicdn.net/img/view/2014/7/24/682018.png,0,0.9754207730293274,286,469,548,731,262,262,princess luna|twilight sparkle,ponycide
683127.png,https://derpicdn.net/img/view/2014/7/25/683127.png,1,0.9887753129005432,1624,726,2268,1370,644,644,rarity|twilight sparkle,pridark
683442.jpg,https://derpicdn.net/img/view/2014/7/25/683442.jpg,1,0.948713719844818,298,458,862,1022,564,564,applejack|fluttershy|mane six|pinkie pie|princess celestia|rainbow dash|rarity|trixie|twilight sparkle,tahublade7
684504.png,https://derpicdn.net/img/view/2014/7/27/684504.png,0,0.9572741389274596,822,1015,1284,1477,462,462,applejack|fluttershy|mane six|pinkie pie|rainbow dash|rarity|spike|twilight sparkle,stormblaze-pegasus
684507.png,https://derpicdn.net/img/view/2014/7/27/684507.png,1,0.990365743637085,3597,1029,4727,2159,1130,1130,applejack|fluttershy|mane six|pinkie pie|rainbow dash|rarity|twilight sparkle,onceuponadoodle
684507.png,https://derpicdn.net/img/view/2014/7/27/684507.png,3,0.9713234901428224,1109,1076,2247,2214,1138,1138,applejack|fluttershy|mane six|pinkie pie|rainbow dash|rarity|twilight sparkle,onceuponadoodle
684507.png,https://derpicdn.net/img/view/2014/7/27/684507.png,4,0.9703036546707152,1638,300,2644,1306,1006,1006,applejack|fluttershy|mane six|pinkie pie|rainbow dash|rarity|twilight sparkle,onceuponadoodle
685056.png,https://derpicdn.net/img/view/2014/7/28/685056.png,0,0.9929872751235962,8,132,428,552,420,420,pinkie pie|rarity|twilight sparkle,empyu
685056.png,https://derpicdn.net/img/view/2014/7/28/685056.png,1,0.9807799458503724,723,211,1000,501,277,290,pinkie pie|rarity|twilight sparkle,empyu
685461.png,https://derpicdn.net/img/view/2014/7/28/685461.png,0,0.954185664653778,942,434,1456,948,514,514,applejack|fluttershy|mane six|pinkie pie|rainbow dash|rarity|twilight sparkle,redapropos
688900.png,https://derpicdn.net/img/view/2014/8/2/688900.png,0,0.9983475208282472,43,0,643,548,600,548,rarity|twilight sparkle,artiecanvas
688900.png,https://derpicdn.net/img/view/2014/8/2/688900.png,1,0.9955301880836488,615,0,1169,522,554,522,rarity|twilight sparkle,artiecanvas
690177.jpg,https://derpicdn.net/img/view/2014/8/3/690177.jpg,0,0.993921399116516,374,406,828,860,454,454,queen chrysalis|twilight sparkle,kukku pu
692705.png,https://derpicdn.net/img/view/2014/8/6/692705.png,0,0.9612123966217041,1134,465,1580,911,446,446,applejack|fluttershy|mane six|pinkie pie|rainbow dash|rarity|twilight sparkle,benybing|illumnious
694853.png,https://derpicdn.net/img/view/2014/8/8/694853.png,0,0.9936366677284241,2043,18,2319,294,276,276,applejack|fluttershy|mane six|pinkie pie|rainbow dash|rarity|twilight sparkle,maneribbons
698328.png,https://derpicdn.net/img/view/2014/8/13/698328.png,1,0.9768006205558776,171,157,497,483,326,326,applejack|fluttershy|mane six|pinkie pie|rainbow dash|rarity|twilight sparkle,sourcerabbit|whiteskypony
698948.jpg,https://derpicdn.net/img/view/2014/8/13/698948.jpg,0,0.97051739692688,321,0,699,350,378,350,pinkie pie|twilight sparkle,
701779.png,https://derpicdn.net/img/view/2014/8/17/701779.png,0,0.999723732471466,444,285,622,463,178,178,applejack|fluttershy|mane six|pinkie pie|rainbow dash|rarity|twilight sparkle,araiden
701779.png,https://derpicdn.net/img/view/2014/8/17/701779.png,1,0.9818505048751832,98,312,260,474,162,162,applejack|fluttershy|mane six|pinkie pie|rainbow dash|rarity|twilight sparkle,araiden
704167.png,https://derpicdn.net/img/view/2014/8/20/704167.png,0,0.9897552728652954,3473,1108,4457,2092,984,984,applejack|fluttershy|mane six|pinkie pie|rainbow dash|rarity|twilight sparkle,brainedbysaucepans
706547.png,https://derpicdn.net/img/view/2014/8/23/706547.png,0,0.9978455901145936,212,111,452,351,240,240,queen chrysalis|twilight sparkle,viraljp
706547.png,https://derpicdn.net/img/view/2014/8/23/706547.png,1,0.9953399896621704,707,310,957,560,250,250,queen chrysalis|twilight sparkle,viraljp
710905.png,https://derpicdn.net/img/view/2014/8/30/710905.png,1,0.9956508278846741,693,268,935,510,242,242,applejack|fluttershy|mane six|pinkie pie|rainbow dash|rarity|twilight sparkle,prk
710905.png,https://derpicdn.net/img/view/2014/8/30/710905.png,3,0.9666377902030944,400,156,648,404,248,248,applejack|fluttershy|mane six|pinkie pie|rainbow dash|rarity|twilight sparkle,prk
710905.png,https://derpicdn.net/img/view/2014/8/30/710905.png,4,0.93825501203537,213,317,455,559,242,242,applejack|fluttershy|mane six|pinkie pie|rainbow dash|rarity|twilight sparkle,prk
716913.png,https://derpicdn.net/img/view/2014/9/7/716913.png,0,0.9723323583602904,503,2131,1351,2979,848,848,applejack|fluttershy|mane six|pinkie pie|rainbow dash|rarity|twilight sparkle,shikanime
716913.png,https://derpicdn.net/img/view/2014/9/7/716913.png,1,0.9608596563339232,171,369,683,881,512,512,applejack|fluttershy|mane six|pinkie pie|rainbow dash|rarity|twilight sparkle,shikanime
718957.png,https://derpicdn.net/img/view/2014/9/9/718957.png,0,0.9556834101676941,99,80,365,346,266,266,sunset shimmer|twilight sparkle,light262
721905.png,https://derpicdn.net/img/view/2014/9/14/721905.png,0,0.9695598483085632,509,204,1701,1396,1192,1192,princess celestia|twilight sparkle,smilingm00n
722889.png,https://derpicdn.net/img/view/2014/9/15/722889.png,0,0.996208131313324,345,230,609,494,264,264,pinkie pie|twilight sparkle,empyu
723513.png,https://derpicdn.net/img/view/2014/9/16/723513.png,0,0.967249035835266,567,227,907,567,340,340,rainbow dash|spike|twilight sparkle,mindmusic
724691.png,https://derpicdn.net/img/view/2014/9/18/724691.png,0,0.9994266629219056,291,349,667,725,376,376,sunset shimmer|twilight sparkle,sion
724691.png,https://derpicdn.net/img/view/2014/9/18/724691.png,1,0.9982725977897644,662,0,994,287,332,287,sunset shimmer|twilight sparkle,sion
724691.png,https://derpicdn.net/img/view/2014/9/18/724691.png,3,0.9839786887168884,299,0,633,289,334,289,sunset shimmer|twilight sparkle,sion
728426.jpg,https://derpicdn.net/img/view/2014/9/24/728426.jpg,0,0.9858341217041016,1076,166,1254,344,178,178,applejack|fluttershy|mane six|pinkie pie|rainbow dash|rarity|spike|twilight sparkle,anarchpeace|sirfy
728426.jpg,https://derpicdn.net/img/view/2014/9/24/728426.jpg,1,0.981538951396942,520,29,854,363,334,334,applejack|fluttershy|mane six|pinkie pie|rainbow dash|rarity|spike|twilight sparkle,anarchpeace|sirfy
728426.jpg,https://derpicdn.net/img/view/2014/9/24/728426.jpg,2,0.969724714756012,844,562,1210,928,366,366,applejack|fluttershy|mane six|pinkie pie|rainbow dash|rarity|spike|twilight sparkle,anarchpeace|sirfy
729600.png,https://derpicdn.net/img/view/2014/9/26/729600.png,0,0.974714457988739,105,271,327,493,222,222,princess luna|twilight sparkle,deusexequus
731945.png,https://derpicdn.net/img/view/2014/9/29/731945.png,0,0.9155005216598512,880,140,1410,670,530,530,applejack|rainbow dash|twilight sparkle,dakishe
732167.jpg,https://derpicdn.net/img/view/2014/9/29/732167.jpg,0,0.9207715392112732,2681,440,3299,1058,618,618,applejack|fluttershy|mane six|pinkie pie|rainbow dash|rarity|twilight sparkle,mahoxyshoujo
733071.png,https://derpicdn.net/img/view/2014/10/1/733071.png,0,0.9951712489128112,101,73,633,605,532,532,rarity|twilight sparkle,mt
733071.png,https://derpicdn.net/img/view/2014/10/1/733071.png,1,0.989038348197937,495,13,1023,541,528,528,rarity|twilight sparkle,mt
73314.jpg,https://derpicdn.net/img/view/2012/8/13/73314.jpg,0,0.9804102778434752,199,619,333,753,134,134,applejack|big macintosh|fluttershy|pinkie pie|princess celestia|princess luna|rainbow dash|rarity|spitfire|trixie|twilight sparkle,
738025.png,https://derpicdn.net/img/view/2014/10/7/738025.png,0,0.9935840964317322,581,0,981,339,400,339,sunset shimmer|trixie|twilight sparkle,boyindahaus
738025.png,https://derpicdn.net/img/view/2014/10/7/738025.png,1,0.9874848127365112,1446,372,1980,948,534,576,sunset shimmer|trixie|twilight sparkle,boyindahaus
738864.jpg,https://derpicdn.net/img/view/2014/10/8/738864.jpg,0,0.9980905652046204,900,0,1502,590,602,590,applejack|fluttershy|mane six|pinkie pie|rainbow dash|rarity|twilight sparkle,my-magic-dream
738864.jpg,https://derpicdn.net/img/view/2014/10/8/738864.jpg,1,0.9927308559417723,1108,463,1631,1039,523,576,applejack|fluttershy|mane six|pinkie pie|rainbow dash|rarity|twilight sparkle,my-magic-dream
738864.jpg,https://derpicdn.net/img/view/2014/10/8/738864.jpg,2,0.9824018478393556,432,0,846,387,414,387,applejack|fluttershy|mane six|pinkie pie|rainbow dash|rarity|twilight sparkle,my-magic-dream
738864.jpg,https://derpicdn.net/img/view/2014/10/8/738864.jpg,3,0.9609980583190918,605,400,1081,876,476,476,applejack|fluttershy|mane six|pinkie pie|rainbow dash|rarity|twilight sparkle,my-magic-dream
739839.jpg,https://derpicdn.net/img/view/2014/10/10/739839.jpg,0,0.9618754982948304,531,1229,877,1575,346,346,princess celestia|twilight sparkle,
741298.png,https://derpicdn.net/img/view/2014/10/12/741298.png,0,0.9980679750442504,483,0,871,375,388,375,pinkie pie|twilight sparkle,marsminer
746340.png,https://derpicdn.net/img/view/2014/10/19/746340.png,0,0.9852998852729796,298,234,1488,1424,1190,1190,princess cadance|twilight sparkle,zoevulpez
746340.png,https://derpicdn.net/img/view/2014/10/19/746340.png,1,0.9687520265579224,2466,40,3892,1466,1426,1426,princess cadance|twilight sparkle,zoevulpez
746992.png,https://derpicdn.net/img/view/2014/10/20/746992.png,0,0.9878664016723632,62,516,496,950,434,434,trixie|twilight sparkle,fimlie
747726.png,https://derpicdn.net/img/view/2014/10/21/747726.png,1,0.9880841970443726,448,1649,954,2155,506,506,apple bloom|applejack|cutie mark crusaders|fluttershy|mane six|pinkie pie|rainbow dash|rarity|scootaloo|spike|sunset shimmer|sweetie belle|twilight sparkle,itoruna-the-platypus
747726.png,https://derpicdn.net/img/view/2014/10/21/747726.png,2,0.9875876307487488,4532,1795,5378,2641,846,846,apple bloom|applejack|cutie mark crusaders|fluttershy|mane six|pinkie pie|rainbow dash|rarity|scootaloo|spike|sunset shimmer|sweetie belle|twilight sparkle,itoruna-the-platypus
747726.png,https://derpicdn.net/img/view/2014/10/21/747726.png,3,0.9584940075874328,3727,1633,4293,2199,566,566,apple bloom|applejack|cutie mark crusaders|fluttershy|mane six|pinkie pie|rainbow dash|rarity|scootaloo|spike|sunset shimmer|sweetie belle|twilight sparkle,itoruna-the-platypus
748961.jpg,https://derpicdn.net/img/view/2014/10/23/748961.jpg,1,0.9885070323944092,1049,623,1318,905,269,282,applejack|fluttershy|mane six|pinkie pie|rainbow dash|rarity|spike|twilight sparkle,agnesgarbowska
748961.jpg,https://derpicdn.net/img/view/2014/10/23/748961.jpg,2,0.978518545627594,487,576,781,870,294,294,applejack|fluttershy|mane six|pinkie pie|rainbow dash|rarity|spike|twilight sparkle,agnesgarbowska
748961.jpg,https://derpicdn.net/img/view/2014/10/23/748961.jpg,3,0.962422251701355,148,30,406,288,258,258,applejack|fluttershy|mane six|pinkie pie|rainbow dash|rarity|spike|twilight sparkle,agnesgarbowska
748961.jpg,https://derpicdn.net/img/view/2014/10/23/748961.jpg,4,0.9609500765800476,144,585,414,855,270,270,applejack|fluttershy|mane six|pinkie pie|rainbow dash|rarity|spike|twilight sparkle,agnesgarbowska
748961.jpg,https://derpicdn.net/img/view/2014/10/23/748961.jpg,5,0.9481849074363708,490,20,764,294,274,274,applejack|fluttershy|mane six|pinkie pie|rainbow dash|rarity|spike|twilight sparkle,agnesgarbowska
749195.png,https://derpicdn.net/img/view/2014/10/23/749195.png,0,0.9381124377250672,349,371,537,559,188,188,applejack|pinkie pie|twilight sparkle,dekomaru
749321.png,https://derpicdn.net/img/view/2014/10/24/749321.png,0,0.9931665062904358,2417,680,2795,1124,378,444,applejack|discord|fluttershy|pinkie pie|princess celestia|princess luna|rainbow dash|rarity|spike|twilight sparkle,heedheed
753777.png,https://derpicdn.net/img/view/2014/10/30/753777.png,0,0.9241490364074708,429,7,763,341,334,334,trixie|twilight sparkle,zeldatriforce12
753839.png,https://derpicdn.net/img/view/2014/10/30/753839.png,1,0.9971140623092652,492,255,696,459,204,204,applejack|fluttershy|mane six|pinkie pie|rainbow dash|rarity|twilight sparkle,
756679.png,https://derpicdn.net/img/view/2014/11/3/756679.png,0,0.9884725213050842,306,145,540,379,234,234,spike|twilight sparkle,dm29
756997.jpg,https://derpicdn.net/img/view/2014/11/3/756997.jpg,0,0.9935093522071838,369,13,749,393,380,380,princess cadance|princess celestia|princess luna|spike|twilight sparkle,jbond
758155.png,https://derpicdn.net/img/view/2014/11/5/758155.png,0,0.996726393699646,366,175,984,793,618,618,discord|rainbow dash|soarin'|twilight sparkle,celinesparkle
758155.png,https://derpicdn.net/img/view/2014/11/5/758155.png,1,0.9883739352226256,84,188,604,708,520,520,discord|rainbow dash|soarin'|twilight sparkle,celinesparkle
758155.png,https://derpicdn.net/img/view/2014/11/5/758155.png,2,0.9608765244483948,1163,321,1653,811,490,490,discord|rainbow dash|soarin'|twilight sparkle,celinesparkle
759641.png,https://derpicdn.net/img/view/2014/11/7/759641.png,0,0.9401514530181884,1216,32,2294,1110,1078,1078,rainbow dash|twilight sparkle,icaron
759641.png,https://derpicdn.net/img/view/2014/11/7/759641.png,1,0.9396501779556274,1436,1542,2640,2746,1204,1204,rainbow dash|twilight sparkle,icaron
760131.png,https://derpicdn.net/img/view/2014/11/7/760131.png,0,0.9903230071067808,0,192,494,730,494,538,trixie|twilight sparkle,dazed-and-wandering
760131.png,https://derpicdn.net/img/view/2014/11/7/760131.png,1,0.9453969597816468,542,0,1280,727,738,727,trixie|twilight sparkle,dazed-and-wandering
760210.png,https://derpicdn.net/img/view/2014/11/8/760210.png,0,0.9567617774009703,774,431,978,635,204,204,applejack|fluttershy|pinkie pie|rainbow dash|rarity|twilight sparkle,empyu
762321.png,https://derpicdn.net/img/view/2014/11/11/762321.png,0,0.9114762544631958,2308,28,2762,482,454,454,applejack|fluttershy|mane six|pinkie pie|rainbow dash|rarity|twilight sparkle,asika-aida
762613.png,https://derpicdn.net/img/view/2014/11/11/762613.png,0,0.9790942072868348,905,0,1791,867,886,867,discord|twilight sparkle,silcybell
763205.png,https://derpicdn.net/img/view/2014/11/12/763205.png,0,0.9502671957015992,225,630,519,924,294,294,trixie|twilight sparkle,cold-blooded-twilight
765662.png,https://derpicdn.net/img/view/2014/11/16/765662.png,0,0.9623965620994568,310,0,676,314,366,314,applejack|fluttershy|mane six|pinkie pie|rainbow dash|rarity|spike|twilight sparkle,
766429.png,https://derpicdn.net/img/view/2014/11/17/766429.png,0,0.977730631828308,172,200,478,506,306,306,trixie|twilight sparkle,tlatophat
769438.png,https://derpicdn.net/img/view/2014/11/22/769438.png,0,0.9826004505157472,2845,1203,4133,2491,1288,1288,spike|twilight sparkle,farminilla
772697.png,https://derpicdn.net/img/view/2014/11/27/772697.png,0,0.9801997542381288,377,65,993,681,616,616,princess luna|twilight sparkle,blackfreya
778235.png,https://derpicdn.net/img/view/2014/12/5/778235.png,0,0.9733983874320984,30,234,216,420,186,186,applejack|fluttershy|mane six|pinkie pie|rainbow dash|rarity|twilight sparkle,everypone
778235.png,https://derpicdn.net/img/view/2014/12/5/778235.png,1,0.9712586402893066,177,178,387,388,210,210,applejack|fluttershy|mane six|pinkie pie|rainbow dash|rarity|twilight sparkle,everypone
778235.png,https://derpicdn.net/img/view/2014/12/5/778235.png,2,0.9316536188125608,470,233,666,429,196,196,applejack|fluttershy|mane six|pinkie pie|rainbow dash|rarity|twilight sparkle,everypone
778491.png,https://derpicdn.net/img/view/2014/12/5/778491.png,0,0.9526301622390748,535,126,1261,852,726,726,spike|twilight sparkle,puffpink
778880.png,https://derpicdn.net/img/view/2014/12/6/778880.png,0,0.9989815354347228,1790,117,2396,723,606,606,trixie|twilight sparkle,ohemo
778880.png,https://derpicdn.net/img/view/2014/12/6/778880.png,1,0.9928008913993835,149,244,693,788,544,544,trixie|twilight sparkle,ohemo
779453.png,https://derpicdn.net/img/view/2014/12/6/779453.png,0,0.9607600569725036,76,100,412,436,336,336,discord|twilight sparkle,artiecanvas
781959.png,https://derpicdn.net/img/view/2014/12/10/781959.png,0,0.97751122713089,2333,489,2801,957,468,468,applejack|fluttershy|mane six|pinkie pie|rainbow dash|rarity|spike|twilight sparkle,atariboy2600
781959.png,https://derpicdn.net/img/view/2014/12/10/781959.png,1,0.952830970287323,830,601,1066,837,236,236,applejack|fluttershy|mane six|pinkie pie|rainbow dash|rarity|spike|twilight sparkle,atariboy2600
783875.png,https://derpicdn.net/img/view/2014/12/13/783875.png,0,0.9885826706886292,0,37,421,467,421,430,sunset shimmer|twilight sparkle,foxxy-arts
784951.png,https://derpicdn.net/img/view/2014/12/14/784951.png,0,0.9938162565231324,116,0,3640,3039,3524,3039,rainbow dash|twilight sparkle,waveywaves
786914.png,https://derpicdn.net/img/view/2014/12/17/786914.png,0,0.9801201820373536,635,90,1241,696,606,606,rainbow dash|twilight sparkle,mutant-girl013
786914.png,https://derpicdn.net/img/view/2014/12/17/786914.png,1,0.978689968585968,832,534,1250,952,418,418,rainbow dash|twilight sparkle,mutant-girl013
789008.png,https://derpicdn.net/img/view/2014/12/20/789008.png,0,0.9804883003234864,255,0,603,305,348,305,princess cadance|princess celestia|princess luna|twilight sparkle,purrling
789659.png,https://derpicdn.net/img/view/2014/12/21/789659.png,0,0.994864284992218,30,169,318,457,288,288,trixie|twilight sparkle,ponycide
791190.png,https://derpicdn.net/img/view/2014/12/23/791190.png,1,0.9728494882583618,1012,144,1254,386,242,242,applejack|discord|fluttershy|mane six|pinkie pie|princess cadance|princess celestia|princess luna|queen chrysalis|rainbow dash|rarity|shining armor|spitfire|sunset shimmer|twilight sparkle,dashiemlpfim
791190.png,https://derpicdn.net/img/view/2014/12/23/791190.png,2,0.9389251470565796,0,190,482,746,482,556,applejack|discord|fluttershy|mane six|pinkie pie|princess cadance|princess celestia|princess luna|queen chrysalis|rainbow dash|rarity|shining armor|spitfire|sunset shimmer|twilight sparkle,dashiemlpfim
791190.png,https://derpicdn.net/img/view/2014/12/23/791190.png,3,0.92157644033432,1209,151,1431,373,222,222,applejack|discord|fluttershy|mane six|pinkie pie|princess cadance|princess celestia|princess luna|queen chrysalis|rainbow dash|rarity|shining armor|spitfire|sunset shimmer|twilight sparkle,dashiemlpfim
791459.png,https://derpicdn.net/img/view/2014/12/24/791459.png,0,0.9961239695549012,609,364,1065,820,456,456,pinkie pie|twilight sparkle,rapidstrike
791505.png,https://derpicdn.net/img/view/2014/12/24/791505.png,0,0.9985547065734864,283,1433,923,2073,640,640,rarity|twilight sparkle,pridark
791505.png,https://derpicdn.net/img/view/2014/12/24/791505.png,2,0.9811664819717408,3006,762,3586,1342,580,580,rarity|twilight sparkle,pridark
791505.png,https://derpicdn.net/img/view/2014/12/24/791505.png,3,0.9440510272979736,2311,783,2883,1355,572,572,rarity|twilight sparkle,pridark
791505.png,https://derpicdn.net/img/view/2014/12/24/791505.png,4,0.9174248576164246,1679,1354,2273,1948,594,594,rarity|twilight sparkle,pridark
792155.png,https://derpicdn.net/img/view/2014/12/25/792155.png,0,0.9995192289352416,1223,395,1677,849,454,454,applejack|fluttershy|mane six|pinkie pie|rainbow dash|rarity|twilight sparkle,timorikawa
792155.png,https://derpicdn.net/img/view/2014/12/25/792155.png,1,0.9962763786315918,117,65,449,397,332,332,applejack|fluttershy|mane six|pinkie pie|rainbow dash|rarity|twilight sparkle,timorikawa
792155.png,https://derpicdn.net/img/view/2014/12/25/792155.png,3,0.99002343416214,558,29,966,437,408,408,applejack|fluttershy|mane six|pinkie pie|rainbow dash|rarity|twilight sparkle,timorikawa
794139.png,https://derpicdn.net/img/view/2014/12/28/794139.png,0,0.9993498921394348,888,0,1410,398,522,398,applejack|fluttershy|mane six|pinkie pie|rainbow dash|rarity|twilight sparkle,fd-daylight
794139.png,https://derpicdn.net/img/view/2014/12/28/794139.png,1,0.995902955532074,1095,396,1439,740,344,344,applejack|fluttershy|mane six|pinkie pie|rainbow dash|rarity|twilight sparkle,fd-daylight
794167.png,https://derpicdn.net/img/view/2014/12/28/794167.png,0,0.981869339942932,185,165,373,353,188,188,princess cadance|queen chrysalis|twilight sparkle,
794167.png,https://derpicdn.net/img/view/2014/12/28/794167.png,1,0.9742418527603148,201,674,379,852,178,178,princess cadance|queen chrysalis|twilight sparkle,
794167.png,https://derpicdn.net/img/view/2014/12/28/794167.png,2,0.9615337252616882,380,178,552,350,172,172,princess cadance|queen chrysalis|twilight sparkle,
798460.jpg,https://derpicdn.net/img/view/2015/1/3/798460.jpg,0,0.9818587899208068,1325,882,1727,1284,402,402,applejack|fluttershy|mane six|pinkie pie|rainbow dash|rarity|twilight sparkle,spacechickennerd
798843.jpg,https://derpicdn.net/img/view/2015/1/3/798843.jpg,0,0.9842323064804076,384,12,802,430,418,418,rainbow dash|twilight sparkle,chrischin
801527.jpg,https://derpicdn.net/img/view/2015/1/7/801527.jpg,0,0.9918848872184752,226,174,562,510,336,336,princess celestia|twilight sparkle,milchik
801598.png,https://derpicdn.net/img/view/2015/1/7/801598.png,0,0.9983932375907898,1239,57,1771,589,532,532,sunset shimmer|twilight sparkle,silcybell
808317.jpg,https://derpicdn.net/img/view/2015/1/17/808317.jpg,0,0.9913086891174316,284,117,528,361,244,244,spike|twilight sparkle,yote
809711.png,https://derpicdn.net/img/view/2015/1/19/809711.png,0,0.9979254007339478,1557,749,2093,1285,536,536,applejack|fluttershy|mane six|pinkie pie|rainbow dash|rarity|twilight sparkle,haydee
809711.png,https://derpicdn.net/img/view/2015/1/19/809711.png,1,0.9929745197296144,205,757,763,1315,558,558,applejack|fluttershy|mane six|pinkie pie|rainbow dash|rarity|twilight sparkle,haydee
812496.jpg,https://derpicdn.net/img/view/2015/1/22/812496.jpg,0,0.9501134753227234,509,351,688,565,179,214,applejack|fluttershy|mane six|pinkie pie|rainbow dash|rarity|spike|twilight sparkle,marybellamy
815423.png,https://derpicdn.net/img/view/2015/1/27/815423.png,0,0.9106215834617616,64,217,456,609,392,392,princess celestia|princess luna|twilight sparkle,spacehunt
816015.png,https://derpicdn.net/img/view/2015/1/27/816015.png,0,0.9749754667282104,2043,208,2913,1078,870,870,sunset shimmer|twilight sparkle,tesla-stargrazer
816266.png,https://derpicdn.net/img/view/2015/1/28/816266.png,0,0.9816735982894896,423,438,639,654,216,216,applejack|fluttershy|mane six|pinkie pie|rainbow dash|rarity|spike|twilight sparkle,
816266.png,https://derpicdn.net/img/view/2015/1/28/816266.png,1,0.971783459186554,396,229,566,399,170,170,applejack|fluttershy|mane six|pinkie pie|rainbow dash|rarity|spike|twilight sparkle,
818939.png,https://derpicdn.net/img/view/2015/2/1/818939.png,0,0.997765064239502,1792,604,2180,992,388,388,applejack|fluttershy|mane six|pinkie pie|rainbow dash|rarity|twilight sparkle,sintakhra
818939.png,https://derpicdn.net/img/view/2015/2/1/818939.png,1,0.9968482851982116,705,266,1043,604,338,338,applejack|fluttershy|mane six|pinkie pie|rainbow dash|rarity|twilight sparkle,sintakhra
818939.png,https://derpicdn.net/img/view/2015/2/1/818939.png,2,0.9956278204917908,349,862,797,1310,448,448,applejack|fluttershy|mane six|pinkie pie|rainbow dash|rarity|twilight sparkle,sintakhra
818939.png,https://derpicdn.net/img/view/2015/2/1/818939.png,3,0.993649125099182,845,1051,1255,1461,410,410,applejack|fluttershy|mane six|pinkie pie|rainbow dash|rarity|twilight sparkle,sintakhra
818939.png,https://derpicdn.net/img/view/2015/2/1/818939.png,4,0.9898369312286376,1116,1284,1592,1760,476,476,applejack|fluttershy|mane six|pinkie pie|rainbow dash|rarity|twilight sparkle,sintakhra
821161.png,https://derpicdn.net/img/view/2015/2/4/821161.png,0,0.9799033999443054,58,0,798,712,740,712,applejack|fluttershy|mane six|pinkie pie|rainbow dash|rarity|twilight sparkle,posey-11
82230.png,https://derpicdn.net/img/view/2012/8/25/82230.png,0,0.9933223128318788,2898,0,4810,1487,1912,1487,applejack|fluttershy|pinkie pie|rainbow dash|rarity|twilight sparkle,emkay-mlp
82230.png,https://derpicdn.net/img/view/2012/8/25/82230.png,1,0.9215256571769714,1148,0,2856,1396,1708,1396,applejack|fluttershy|pinkie pie|rainbow dash|rarity|twilight sparkle,emkay-mlp
822821.jpg,https://derpicdn.net/img/view/2015/2/6/822821.jpg,0,0.9972106218338012,465,211,711,457,246,246,fluttershy|rainbow dash|twilight sparkle,amy2sa-fan
822821.jpg,https://derpicdn.net/img/view/2015/2/6/822821.jpg,1,0.976193368434906,259,195,497,433,238,238,fluttershy|rainbow dash|twilight sparkle,amy2sa-fan
822821.jpg,https://derpicdn.net/img/view/2015/2/6/822821.jpg,2,0.9584752321243286,778,191,1078,491,300,300,fluttershy|rainbow dash|twilight sparkle,amy2sa-fan
8234.png,https://derpicdn.net/img/view/2012/6/18/8234.png,0,0.9895169138908386,687,579,1047,939,360,360,trixie|twilight sparkle,cartoonlion
824830.png,https://derpicdn.net/img/view/2015/2/9/824830.png,1,0.9807483553886414,1004,24,1392,412,388,388,applejack|fluttershy|mane six|pinkie pie|rainbow dash|rarity|twilight sparkle,jorobro
824830.png,https://derpicdn.net/img/view/2015/2/9/824830.png,2,0.9767914414405824,0,895,412,1331,412,436,applejack|fluttershy|mane six|pinkie pie|rainbow dash|rarity|twilight sparkle,jorobro
827656.png,https://derpicdn.net/img/view/2015/2/13/827656.png,0,0.9882932305336,246,45,484,283,238,238,applejack|fluttershy|mane six|pinkie pie|rainbow dash|rarity|twilight sparkle,
828409.png,https://derpicdn.net/img/view/2015/2/14/828409.png,0,0.9930258989334106,841,143,1549,851,708,708,sunset shimmer|twilight sparkle,majkashinoda626
828409.png,https://derpicdn.net/img/view/2015/2/14/828409.png,1,0.9927651286125184,206,99,950,843,744,744,sunset shimmer|twilight sparkle,majkashinoda626
828409.png,https://derpicdn.net/img/view/2015/2/14/828409.png,2,0.9161390066146852,1081,1792,1725,2436,644,644,sunset shimmer|twilight sparkle,majkashinoda626
828411.jpg,https://derpicdn.net/img/view/2015/2/14/828411.jpg,0,0.9514794945716858,228,164,466,402,238,238,rainbow dash|twilight sparkle,canvymamamoo
831390.png,https://derpicdn.net/img/view/2015/2/17/831390.png,0,0.9594659209251404,0,706,1045,1880,1045,1174,princess cadance|twilight sparkle,
832600.png,https://derpicdn.net/img/view/2015/2/19/832600.png,0,0.9927351474761964,409,9,631,231,222,222,applejack|fluttershy|mane six|pinkie pie|rainbow dash|rarity|twilight sparkle,empyu
832600.png,https://derpicdn.net/img/view/2015/2/19/832600.png,1,0.9902607202529908,622,30,828,236,206,206,applejack|fluttershy|mane six|pinkie pie|rainbow dash|rarity|twilight sparkle,empyu
838472.png,https://derpicdn.net/img/view/2015/2/27/838472.png,0,0.914173185825348,2922,512,3214,804,292,292,applejack|discord|fluttershy|mane six|pinkie pie|rainbow dash|rarity|twilight sparkle,amante56
839188.png,https://derpicdn.net/img/view/2015/2/28/839188.png,0,0.9960710406303406,745,169,975,399,230,230,applejack|fluttershy|mane six|pinkie pie|rainbow dash|rarity|twilight sparkle,peachiekeenie
841563.png,https://derpicdn.net/img/view/2015/3/3/841563.png,0,0.982922911643982,95,0,661,449,566,449,princess luna|twilight sparkle,blackfreya
841563.png,https://derpicdn.net/img/view/2015/3/3/841563.png,1,0.9727931618690492,649,81,919,351,270,270,princess luna|twilight sparkle,blackfreya
841563.png,https://derpicdn.net/img/view/2015/3/3/841563.png,2,0.9722239375114441,942,0,1430,443,488,443,princess luna|twilight sparkle,blackfreya
84793.jpg,https://derpicdn.net/img/view/2012/8/28/84793.jpg,0,0.9122257828712464,44,0,576,524,532,524,apple bloom|twilight sparkle,gsphere
848668.png,https://derpicdn.net/img/view/2015/3/13/848668.png,0,0.9997238516807556,28,57,570,599,542,542,pinkie pie|twilight sparkle,adlaz
852003.png,https://derpicdn.net/img/view/2015/3/18/852003.png,0,0.9840343594551086,4,0,230,224,226,224,rarity|spike|twilight sparkle,andypriceart
854472.png,https://derpicdn.net/img/view/2015/3/21/854472.png,0,0.9985682964324952,846,241,1054,449,208,208,applejack|fluttershy|mane six|pinkie pie|rainbow dash|rarity|spike|sunset shimmer|twilight sparkle,
854472.png,https://derpicdn.net/img/view/2015/3/21/854472.png,1,0.985164225101471,345,106,649,410,304,304,applejack|fluttershy|mane six|pinkie pie|rainbow dash|rarity|spike|sunset shimmer|twilight sparkle,
854472.png,https://derpicdn.net/img/view/2015/3/21/854472.png,2,0.9553773999214172,63,244,345,526,282,282,applejack|fluttershy|mane six|pinkie pie|rainbow dash|rarity|spike|sunset shimmer|twilight sparkle,
855232.png,https://derpicdn.net/img/view/2015/3/22/855232.png,0,0.9945412278175354,0,49,374,437,374,388,princess celestia|sunset shimmer|twilight sparkle,partycannoninc
856809.png,https://derpicdn.net/img/view/2015/3/25/856809.png,0,0.9979729652404784,1107,48,1566,524,459,476,pinkie pie|twilight sparkle,mylittlepon3lov3
858241.png,https://derpicdn.net/img/view/2015/3/27/858241.png,0,0.9997101426124572,225,13,491,279,266,266,applejack|rainbow dash|twilight sparkle,hashioaryut
858241.png,https://derpicdn.net/img/view/2015/3/27/858241.png,1,0.989603579044342,606,11,926,331,320,320,applejack|rainbow dash|twilight sparkle,hashioaryut
858241.png,https://derpicdn.net/img/view/2015/3/27/858241.png,2,0.9863516688346864,1115,0,1731,449,616,449,applejack|rainbow dash|twilight sparkle,hashioaryut
8586.jpg,https://derpicdn.net/img/view/2012/6/18/8586.jpg,0,0.9243886470794678,36,43,302,309,266,266,applejack|fluttershy|mane six|pinkie pie|rainbow dash|rarity|twilight sparkle,nemurism
862993.png,https://derpicdn.net/img/view/2015/4/2/862993.png,0,0.9978955984115601,566,25,1042,501,476,476,princess celestia|rainbow dash|shining armor|twilight sparkle,zaphy1415926
865376.png,https://derpicdn.net/img/view/2015/4/5/865376.png,0,0.967922866344452,8,5,144,141,136,136,pinkie pie|rarity|twilight sparkle,
866080.png,https://derpicdn.net/img/view/2015/4/5/866080.png,0,0.9825170636177064,666,372,1292,998,626,626,applejack|fluttershy|mane six|pinkie pie|rainbow dash|rarity|spike|sunset shimmer|twilight sparkle,araiden
866686.png,https://derpicdn.net/img/view/2015/4/6/866686.png,0,0.997291386127472,962,0,1290,320,328,320,rainbow dash|twilight sparkle,shipislove shipislife|creatorofpony
868019.png,https://derpicdn.net/img/view/2015/4/7/868019.png,0,0.9643843173980712,1556,2230,2488,3162,932,932,spike|twilight sparkle,vinicius040598
871110.png,https://derpicdn.net/img/view/2015/4/11/871110.png,0,0.9161196947097778,93,4,419,330,326,326,shining armor|twilight sparkle,jargon scott
873936.png,https://derpicdn.net/img/view/2015/4/14/873936.png,2,0.985781729221344,163,164,591,592,428,428,applejack|fluttershy|mane six|pinkie pie|rainbow dash|rarity|starlight glimmer|twilight sparkle,9de-light6
873936.png,https://derpicdn.net/img/view/2015/4/14/873936.png,3,0.9499416947364808,1657,232,1911,486,254,254,applejack|fluttershy|mane six|pinkie pie|rainbow dash|rarity|starlight glimmer|twilight sparkle,9de-light6
873936.png,https://derpicdn.net/img/view/2015/4/14/873936.png,4,0.9342294335365297,23,471,447,895,424,424,applejack|fluttershy|mane six|pinkie pie|rainbow dash|rarity|starlight glimmer|twilight sparkle,9de-light6
876036.png,https://derpicdn.net/img/view/2015/4/17/876036.png,0,0.9614335298538208,528,579,1182,1233,654,654,discord|twilight sparkle,silcybell
877067.png,https://derpicdn.net/img/view/2015/4/18/877067.png,0,0.9818581938743592,263,172,539,448,276,276,applejack|fluttershy|mane six|pinkie pie|rainbow dash|rarity|spike|twilight sparkle,3d thread
877402.jpg,https://derpicdn.net/img/view/2015/4/18/877402.jpg,0,0.9994051456451416,694,0,1004,288,310,288,applejack|fluttershy|mane six|pinkie pie|rainbow dash|rarity|twilight sparkle,solitaryzombie
877402.jpg,https://derpicdn.net/img/view/2015/4/18/877402.jpg,1,0.9980014562606812,333,0,669,315,336,315,applejack|fluttershy|mane six|pinkie pie|rainbow dash|rarity|twilight sparkle,solitaryzombie
877402.jpg,https://derpicdn.net/img/view/2015/4/18/877402.jpg,2,0.9927576184272766,0,424,325,750,325,326,applejack|fluttershy|mane six|pinkie pie|rainbow dash|rarity|twilight sparkle,solitaryzombie
878853.png,https://derpicdn.net/img/view/2015/4/20/878853.png,0,0.9858450889587402,2744,268,3060,584,316,316,princess cadance|princess luna|queen chrysalis|sunset shimmer|trixie|twilight sparkle,cloureed
878853.png,https://derpicdn.net/img/view/2015/4/20/878853.png,1,0.976119875907898,1043,968,1719,1644,676,676,princess cadance|princess luna|queen chrysalis|sunset shimmer|trixie|twilight sparkle,cloureed
878853.png,https://derpicdn.net/img/view/2015/4/20/878853.png,2,0.9082356691360474,2567,938,3177,1548,610,610,princess cadance|princess luna|queen chrysalis|sunset shimmer|trixie|twilight sparkle,cloureed
883280.png,https://derpicdn.net/img/view/2015/4/26/883280.png,0,0.982316792011261,1282,296,2044,1058,762,762,applejack|fluttershy|pinkie pie|rarity|twilight sparkle,evanzblack
897247.png,https://derpicdn.net/img/view/2015/5/16/897247.png,0,0.9755824208259584,119,446,295,622,176,176,princess celestia|twilight sparkle,
897247.png,https://derpicdn.net/img/view/2015/5/16/897247.png,1,0.9019339680671692,73,139,233,299,160,160,princess celestia|twilight sparkle,
897781.png,https://derpicdn.net/img/view/2015/5/17/897781.png,0,0.9615535140037536,0,147,656,813,656,666,fluttershy|rainbow dash|twilight sparkle,soulspade
898518.jpg,https://derpicdn.net/img/view/2015/5/17/898518.jpg,0,0.9896304607391356,689,8,849,168,160,160,applejack|big macintosh|fluttershy|mane six|pinkie pie|princess celestia|princess luna|rainbow dash|rarity|spike|trixie|twilight sparkle,mittymandi
898518.jpg,https://derpicdn.net/img/view/2015/5/17/898518.jpg,1,0.988105058670044,444,655,570,781,126,126,applejack|big macintosh|fluttershy|mane six|pinkie pie|princess celestia|princess luna|rainbow dash|rarity|spike|trixie|twilight sparkle,mittymandi
898518.jpg,https://derpicdn.net/img/view/2015/5/17/898518.jpg,2,0.939922332763672,319,18,449,148,130,130,applejack|big macintosh|fluttershy|mane six|pinkie pie|princess celestia|princess luna|rainbow dash|rarity|spike|trixie|twilight sparkle,mittymandi
898518.jpg,https://derpicdn.net/img/view/2015/5/17/898518.jpg,3,0.9112211465835572,522,357,660,495,138,138,applejack|big macintosh|fluttershy|mane six|pinkie pie|princess celestia|princess luna|rainbow dash|rarity|spike|trixie|twilight sparkle,mittymandi
903865.png,https://derpicdn.net/img/view/2015/5/25/903865.png,0,0.9952126741409302,205,11,435,241,230,230,pinkie pie|rainbow dash|twilight sparkle,wan
9048.png,https://derpicdn.net/img/view/2012/6/19/9048.png,0,0.9810805916786194,71,0,800,690,729,690,pinkie pie|rainbow dash|twilight sparkle,nyuuchandiannepie
905.png,https://derpicdn.net/img/view/2012/1/20/905.png,0,0.9975749254226683,789,0,1105,271,316,271,applejack|fluttershy|mane six|pinkie pie|rainbow dash|rarity|twilight sparkle,mikibipony
905.png,https://derpicdn.net/img/view/2012/1/20/905.png,1,0.9964240789413452,393,323,733,663,340,340,applejack|fluttershy|mane six|pinkie pie|rainbow dash|rarity|twilight sparkle,mikibipony
905.png,https://derpicdn.net/img/view/2012/1/20/905.png,2,0.9934369921684264,748,331,1068,651,320,320,applejack|fluttershy|mane six|pinkie pie|rainbow dash|rarity|twilight sparkle,mikibipony
905.png,https://derpicdn.net/img/view/2012/1/20/905.png,3,0.9926174283027648,76,0,430,293,354,293,applejack|fluttershy|mane six|pinkie pie|rainbow dash|rarity|twilight sparkle,mikibipony
905.png,https://derpicdn.net/img/view/2012/1/20/905.png,4,0.9793338775634766,434,0,786,304,352,304,applejack|fluttershy|mane six|pinkie pie|rainbow dash|rarity|twilight sparkle,mikibipony
905184.png,https://derpicdn.net/img/view/2015/5/27/905184.png,0,0.9791755676269532,196,231,332,367,136,136,apple bloom|applejack|cutie mark crusaders|fluttershy|mane six|pinkie pie|rainbow dash|rarity|scootaloo|sweetie belle|twilight sparkle,frog&cog
906043.png,https://derpicdn.net/img/view/2015/5/29/906043.png,0,0.9826078414916992,1075,0,2357,1270,1282,1270,sunset shimmer|twilight sparkle,vixelzf
908.jpg,https://derpicdn.net/img/view/2012/1/20/908.jpg,0,0.980296552181244,634,181,840,387,206,206,applejack|fluttershy|mane six|pinkie pie|rainbow dash|rarity|twilight sparkle,olegsavoskin
911927.png,https://derpicdn.net/img/view/2015/6/7/911927.png,0,0.9762046933174132,935,334,1335,734,400,400,applejack|discord|fluttershy|mane six|pinkie pie|rainbow dash|rarity|twilight sparkle,the-paper-pony
912797.png,https://derpicdn.net/img/view/2015/6/8/912797.png,0,0.9728221893310548,68,0,786,643,718,643,princess celestia|twilight sparkle,
915555.png,https://derpicdn.net/img/view/2015/6/12/915555.png,0,0.9636775255203248,355,0,1131,673,776,673,fluttershy|twilight sparkle,balaraika
921054.png,https://derpicdn.net/img/view/2015/6/21/921054.png,0,0.9895430207252502,3025,25,4151,1151,1126,1126,applejack|fluttershy|mane six|pinkie pie|rainbow dash|rarity|twilight sparkle,mirry92
921054.png,https://derpicdn.net/img/view/2015/6/21/921054.png,1,0.9893323183059692,2998,1416,4126,2544,1128,1128,applejack|fluttershy|mane six|pinkie pie|rainbow dash|rarity|twilight sparkle,mirry92
921054.png,https://derpicdn.net/img/view/2015/6/21/921054.png,2,0.9872652888298036,1274,1216,2922,2864,1648,1648,applejack|fluttershy|mane six|pinkie pie|rainbow dash|rarity|twilight sparkle,mirry92
921054.png,https://derpicdn.net/img/view/2015/6/21/921054.png,3,0.9527464509010316,165,57,1213,1105,1048,1048,applejack|fluttershy|mane six|pinkie pie|rainbow dash|rarity|twilight sparkle,mirry92
921054.png,https://derpicdn.net/img/view/2015/6/21/921054.png,4,0.9394327402114868,72,1413,1188,2529,1116,1116,applejack|fluttershy|mane six|pinkie pie|rainbow dash|rarity|twilight sparkle,mirry92
922256.png,https://derpicdn.net/img/view/2015/6/23/922256.png,0,0.9948012828826904,2258,4136,3000,5028,742,892,applejack|fluttershy|mane six|pinkie pie|rainbow dash|rarity|sunset shimmer|twilight sparkle,theshadowstone
922256.png,https://derpicdn.net/img/view/2015/6/23/922256.png,2,0.9910082817077636,1547,3317,2517,4287,970,970,applejack|fluttershy|mane six|pinkie pie|rainbow dash|rarity|sunset shimmer|twilight sparkle,theshadowstone
923278.png,https://derpicdn.net/img/view/2015/6/25/923278.png,0,0.943330466747284,128,474,246,592,118,118,spike|twilight sparkle,
92608.png,https://derpicdn.net/img/view/2012/9/8/92608.png,0,0.9328094124794006,399,0,955,534,556,534,shining armor|spike|twilight sparkle,dm29
926704.png,https://derpicdn.net/img/view/2015/6/30/926704.png,0,0.9808085560798644,168,7,482,321,314,314,pinkie pie|rainbow dash|rarity|twilight sparkle,octanbearcat
931549.jpg,https://derpicdn.net/img/view/2015/7/6/931549.jpg,0,0.9891407489776612,152,373,512,733,360,360,spike|twilight sparkle,edplus
931549.jpg,https://derpicdn.net/img/view/2015/7/6/931549.jpg,1,0.9769195318222046,1155,170,1851,866,696,696,spike|twilight sparkle,edplus
935376.png,https://derpicdn.net/img/view/2015/7/12/935376.png,0,0.9938034415245056,478,0,812,320,334,320,trixie|twilight sparkle,
935588.png,https://derpicdn.net/img/view/2015/7/12/935588.png,0,0.9797021746635436,439,0,1197,747,758,747,applejack|fluttershy|mane six|pinkie pie|rainbow dash|rarity|twilight sparkle,
935588.png,https://derpicdn.net/img/view/2015/7/12/935588.png,1,0.9027866125106812,840,993,1160,1313,320,320,applejack|fluttershy|mane six|pinkie pie|rainbow dash|rarity|twilight sparkle,
938369.png,https://derpicdn.net/img/view/2015/7/17/938369.png,0,0.9958710074424744,102,0,1966,1834,1864,1834,trixie|twilight sparkle,jemanite
941729.png,https://derpicdn.net/img/view/2015/7/22/941729.png,0,0.9992790818214417,328,447,1178,1297,850,850,applejack|fluttershy|mane six|pinkie pie|rainbow dash|rarity|twilight sparkle,theshadowstone
941729.png,https://derpicdn.net/img/view/2015/7/22/941729.png,1,0.9946219325065612,1232,950,1920,1638,688,688,applejack|fluttershy|mane six|pinkie pie|rainbow dash|rarity|twilight sparkle,theshadowstone
941729.png,https://derpicdn.net/img/view/2015/7/22/941729.png,2,0.9917519092559814,386,1594,1150,2358,764,764,applejack|fluttershy|mane six|pinkie pie|rainbow dash|rarity|twilight sparkle,theshadowstone
941729.png,https://derpicdn.net/img/view/2015/7/22/941729.png,3,0.9915751814842224,2187,1555,3057,2425,870,870,applejack|fluttershy|mane six|pinkie pie|rainbow dash|rarity|twilight sparkle,theshadowstone
941729.png,https://derpicdn.net/img/view/2015/7/22/941729.png,4,0.9778015613555908,2354,529,3160,1335,806,806,applejack|fluttershy|mane six|pinkie pie|rainbow dash|rarity|twilight sparkle,theshadowstone
941729.png,https://derpicdn.net/img/view/2015/7/22/941729.png,5,0.9379823803901672,1247,0,2053,695,806,695,applejack|fluttershy|mane six|pinkie pie|rainbow dash|rarity|twilight sparkle,theshadowstone
9430.png,https://derpicdn.net/img/view/2012/6/19/9430.png,0,0.9971843361854552,373,29,591,247,218,218,applejack|fluttershy|mane six|pinkie pie|rainbow dash|rarity|twilight sparkle,mewball
9430.png,https://derpicdn.net/img/view/2012/6/19/9430.png,1,0.988726019859314,1287,38,1493,244,206,206,applejack|fluttershy|mane six|pinkie pie|rainbow dash|rarity|twilight sparkle,mewball
9430.png,https://derpicdn.net/img/view/2012/6/19/9430.png,2,0.9651464819908142,1027,42,1223,238,196,196,applejack|fluttershy|mane six|pinkie pie|rainbow dash|rarity|twilight sparkle,mewball
9430.png,https://derpicdn.net/img/view/2012/6/19/9430.png,3,0.9180819392204284,732,31,934,233,202,202,applejack|fluttershy|mane six|pinkie pie|rainbow dash|rarity|twilight sparkle,mewball
9430.png,https://derpicdn.net/img/view/2012/6/19/9430.png,4,0.9019567966461182,153,40,335,222,182,182,applejack|fluttershy|mane six|pinkie pie|rainbow dash|rarity|twilight sparkle,mewball
944323.jpg,https://derpicdn.net/img/view/2015/7/26/944323.jpg,0,0.9845360517501832,438,0,900,423,462,423,rarity|twilight sparkle,invisibleguy-ponyman
944323.jpg,https://derpicdn.net/img/view/2015/7/26/944323.jpg,1,0.9676400423049928,44,308,448,712,404,404,rarity|twilight sparkle,invisibleguy-ponyman
944946.png,https://derpicdn.net/img/view/2015/7/27/944946.png,1,0.953133225440979,798,661,1076,939,278,278,princess cadance|twilight sparkle,estherenn
945028.png,https://derpicdn.net/img/view/2015/7/27/945028.png,0,0.9949867129325868,129,43,317,231,188,188,applejack|fluttershy|mane six|pinkie pie|princess celestia|princess luna|rainbow dash|rarity|spike|twilight sparkle,fly-sky-high
949411.png,https://derpicdn.net/img/view/2015/8/3/949411.png,0,0.9987459778785706,138,0,458,292,320,292,sunset shimmer|twilight sparkle,rmzero|paulysentry
949411.png,https://derpicdn.net/img/view/2015/8/3/949411.png,1,0.9663681983947754,573,0,889,303,316,303,sunset shimmer|twilight sparkle,rmzero|paulysentry
949523.png,https://derpicdn.net/img/view/2015/8/3/949523.png,0,0.9962897896766664,0,142,484,642,484,500,applejack|fluttershy|mane six|pinkie pie|rainbow dash|rarity|spike|twilight sparkle,rmzero|boastudio
949523.png,https://derpicdn.net/img/view/2015/8/3/949523.png,1,0.994471549987793,990,270,1512,792,522,522,applejack|fluttershy|mane six|pinkie pie|rainbow dash|rarity|spike|twilight sparkle,rmzero|boastudio
949523.png,https://derpicdn.net/img/view/2015/8/3/949523.png,2,0.9919934272766112,660,379,1102,821,442,442,applejack|fluttershy|mane six|pinkie pie|rainbow dash|rarity|spike|twilight sparkle,rmzero|boastudio
949741.png,https://derpicdn.net/img/view/2015/8/3/949741.png,0,0.9856470227241516,471,402,1725,1656,1254,1254,rainbow dash|twilight sparkle,chibadeer
949741.png,https://derpicdn.net/img/view/2015/8/3/949741.png,1,0.9408920407295228,1954,559,3182,1787,1228,1228,rainbow dash|twilight sparkle,chibadeer
950617.jpg,https://derpicdn.net/img/view/2015/8/4/950617.jpg,1,0.9449209570884703,562,294,816,548,254,254,applejack|fluttershy|mane six|pinkie pie|rainbow dash|rarity|twilight sparkle,clumsyhermit
9530.png,https://derpicdn.net/img/view/2012/6/19/9530.png,1,0.9605239629745485,910,216,1264,570,354,354,applejack|fluttershy|twilight sparkle,
95342.png,https://derpicdn.net/img/view/2012/9/11/95342.png,1,0.918006718158722,626,587,1062,1023,436,436,applejack|fluttershy|mane six|pinkie pie|rainbow dash|rarity|twilight sparkle,cartoonlion
95342.png,https://derpicdn.net/img/view/2012/9/11/95342.png,2,0.90549236536026,1734,114,2192,572,458,458,applejack|fluttershy|mane six|pinkie pie|rainbow dash|rarity|twilight sparkle,cartoonlion
954390.png,https://derpicdn.net/img/view/2015/8/9/954390.png,0,0.9578620791435242,214,5,1156,947,942,942,applejack|fluttershy|pinkie pie|rainbow dash|rarity|twilight sparkle,blueblaze95
957463.png,https://derpicdn.net/img/view/2015/8/14/957463.png,1,0.9600133299827576,564,11,1276,720,712,709,princess cadance|princess luna|twilight sparkle,
957676.png,https://derpicdn.net/img/view/2015/8/14/957676.png,1,0.9759619235992432,557,5,1280,720,723,715,princess cadance|princess luna|twilight sparkle,
957785.png,https://derpicdn.net/img/view/2015/8/14/957785.png,0,0.9009143710136414,436,123,860,547,424,424,pinkie pie|twilight sparkle,inkblu
960655.png,https://derpicdn.net/img/view/2015/8/19/960655.png,0,0.9885455369949341,623,179,1031,587,408,408,pinkie pie|twilight sparkle,campus-cats
969471.png,https://derpicdn.net/img/view/2015/8/31/969471.png,0,0.9986042380332948,17,317,321,621,304,304,pinkie pie|twilight sparkle,empyu
972196.png,https://derpicdn.net/img/view/2015/9/3/972196.png,0,0.9919167160987854,112,7,2572,2467,2460,2460,fluttershy|twilight sparkle,tarana10
973272.png,https://derpicdn.net/img/view/2015/9/5/973272.png,0,0.9802768230438232,950,256,1516,822,566,566,applejack|fluttershy|mane six|pinkie pie|rainbow dash|rarity|twilight sparkle,lifesharbinger
973272.png,https://derpicdn.net/img/view/2015/9/5/973272.png,1,0.926697850227356,1761,311,2359,909,598,598,applejack|fluttershy|mane six|pinkie pie|rainbow dash|rarity|twilight sparkle,lifesharbinger
973344.png,https://derpicdn.net/img/view/2015/9/5/973344.png,0,0.9851682782173156,316,213,850,747,534,534,princess celestia|twilight sparkle,phallen1
973344.png,https://derpicdn.net/img/view/2015/9/5/973344.png,1,0.9826700687408448,754,53,1232,531,478,478,princess celestia|twilight sparkle,phallen1
975977.png,https://derpicdn.net/img/view/2015/9/9/975977.png,0,0.909864902496338,0,11,703,717,703,706,fluttershy|twilight sparkle,
976496.png,https://derpicdn.net/img/view/2015/9/10/976496.png,3,0.9848851561546326,1684,1311,2682,2309,998,998,applejack|fluttershy|mane six|pinkie pie|rainbow dash|rarity|spike|twilight sparkle,sketchmcreations
981801.png,https://derpicdn.net/img/view/2015/9/17/981801.png,1,0.9732005000114441,885,82,1153,350,268,268,trixie|twilight sparkle,sugarwings-art
982300.jpg,https://derpicdn.net/img/view/2015/9/18/982300.jpg,1,0.9663468599319458,734,196,1074,536,340,340,applejack|fluttershy|rainbow dash|trixie|twilight sparkle,
982461.png,https://derpicdn.net/img/view/2015/9/18/982461.png,0,0.948756217956543,660,141,1062,543,402,402,applejack|fluttershy|mane six|pinkie pie|rainbow dash|rarity|twilight sparkle,
983434.png,https://derpicdn.net/img/view/2015/9/20/983434.png,1,0.9722324013710022,516,0,996,454,480,454,fluttershy|twilight sparkle,empyu
984674.png,https://derpicdn.net/img/view/2015/9/21/984674.png,0,0.9988130331039428,1105,115,2059,1153,954,1038,princess celestia|trixie|twilight sparkle,boyindahaus
984674.png,https://derpicdn.net/img/view/2015/9/21/984674.png,1,0.9490906000137328,0,0,1079,1067,1079,1067,princess celestia|trixie|twilight sparkle,boyindahaus
984715.png,https://derpicdn.net/img/view/2015/9/21/984715.png,0,0.9143466949462892,0,252,354,612,354,360,applejack|fluttershy|pinkie pie|rarity|spike|twilight sparkle,
985020.png,https://derpicdn.net/img/view/2015/9/22/985020.png,0,0.9891321063041688,873,362,1217,706,344,344,applejack|fluttershy|pinkie pie|rainbow dash|rarity|twilight sparkle,
986648.jpg,https://derpicdn.net/img/view/2015/9/24/986648.jpg,0,0.9962608218193054,513,98,871,456,358,358,applejack|pinkie pie|rainbow dash|rarity|spike|twilight sparkle,
987747.png,https://derpicdn.net/img/view/2015/9/25/987747.png,0,0.9374980330467224,89,281,315,507,226,226,applejack|fluttershy|mane six|pinkie pie|princess luna|rainbow dash|rarity|twilight sparkle,oliwia2514
990059.png,https://derpicdn.net/img/view/2015/9/28/990059.png,0,0.9848215579986572,1450,300,2270,1120,820,820,rainbow dash|trixie|twilight sparkle,optimus97|mrshlapa
990490.png,https://derpicdn.net/img/view/2015/9/29/990490.png,1,0.9763397574424744,2355,0,2979,596,624,596,applejack|fluttershy|mane six|pinkie pie|rainbow dash|rarity|twilight sparkle,miiv12
991800.png,https://derpicdn.net/img/view/2015/10/1/991800.png,0,0.9961081743240356,368,283,900,815,532,532,applejack|fluttershy|mane six|pinkie pie|rainbow dash|rarity|twilight sparkle,kera-moondust
991800.png,https://derpicdn.net/img/view/2015/10/1/991800.png,1,0.961668074131012,195,349,525,679,330,330,applejack|fluttershy|mane six|pinkie pie|rainbow dash|rarity|twilight sparkle,kera-moondust
991800.png,https://derpicdn.net/img/view/2015/10/1/991800.png,2,0.9548556208610536,1501,452,1821,772,320,320,applejack|fluttershy|mane six|pinkie pie|rainbow dash|rarity|twilight sparkle,kera-moondust
993544.png,https://derpicdn.net/img/view/2015/10/3/993544.png,0,0.9981489181518556,415,350,653,588,238,238,applejack|fluttershy|mane six|pinkie pie|rainbow dash|rarity|twilight sparkle,scatteredlove
993544.png,https://derpicdn.net/img/view/2015/10/3/993544.png,1,0.9945693016052246,549,9,837,297,288,288,applejack|fluttershy|mane six|pinkie pie|rainbow dash|rarity|twilight sparkle,scatteredlove
993544.png,https://derpicdn.net/img/view/2015/10/3/993544.png,2,0.975182831287384,0,537,287,835,287,298,applejack|fluttershy|mane six|pinkie pie|rainbow dash|rarity|twilight sparkle,scatteredlove
993544.png,https://derpicdn.net/img/view/2015/10/3/993544.png,3,0.942684292793274,772,513,972,713,200,200,applejack|fluttershy|mane six|pinkie pie|rainbow dash|rarity|twilight sparkle,scatteredlove
995155.png,https://derpicdn.net/img/view/2015/10/5/995155.png,0,0.9957262277603148,628,200,1954,1526,1326,1326,applejack|fluttershy|mane six|pinkie pie|rainbow dash|rarity|twilight sparkle,whazzam95
995155.png,https://derpicdn.net/img/view/2015/10/5/995155.png,1,0.9920833110809326,1178,1654,2018,2494,840,840,applejack|fluttershy|mane six|pinkie pie|rainbow dash|rarity|twilight sparkle,whazzam95
995155.png,https://derpicdn.net/img/view/2015/10/5/995155.png,4,0.9402261972427368,435,1505,1189,2259,754,754,applejack|fluttershy|mane six|pinkie pie|rainbow dash|rarity|twilight sparkle,whazzam95
99662.png,https://derpicdn.net/img/view/2012/9/16/99662.png,1,0.9059175252914428,779,246,957,424,178,178,applejack|discord|fluttershy|pinkie pie|princess cadance|princess celestia|princess luna|rainbow dash|rarity|shining armor|twilight sparkle,the_gneech
997275.png,https://derpicdn.net/img/view/2015/10/8/997275.png,0,0.9972826242446899,791,28,1197,434,406,406,applejack|rainbow dash|twilight sparkle,rwl
998443.png,https://derpicdn.net/img/view/2015/10/10/998443.png,0,0.9990409016609192,446,654,780,988,334,334,applejack|fluttershy|mane six|pinkie pie|rainbow dash|rarity|twilight sparkle,mkogwheel
998443.png,https://derpicdn.net/img/view/2015/10/10/998443.png,1,0.997069239616394,668,629,1032,993,364,364,applejack|fluttershy|mane six|pinkie pie|rainbow dash|rarity|twilight sparkle,mkogwheel
998443.png,https://derpicdn.net/img/view/2015/10/10/998443.png,2,0.9963423609733582,642,336,1018,712,376,376,applejack|fluttershy|mane six|pinkie pie|rainbow dash|rarity|twilight sparkle,mkogwheel
999552.png,https://derpicdn.net/img/view/2015/10/11/999552.png,0,0.9221364855766296,3099,6,3700,616,601,610,applejack|fluttershy|rainbow dash|spitfire|twilight sparkle,geraritydevillefort
1000697.jpeg,https://derpicdn.net/img/view/2015/10/12/1000697.jpeg,0,0.9567347764968872,0,792,430,1294,430,502,trixie|twilight sparkle,fox-moonglow
1002781.jpeg,https://derpicdn.net/img/view/2015/10/15/1002781.jpeg,0,0.9805272221565248,195,466,651,922,456,456,applejack|fluttershy|mane six|pinkie pie|rainbow dash|rarity|twilight sparkle,poecillia-gracilis19
1002807.jpeg,https://derpicdn.net/img/view/2015/10/15/1002807.jpeg,1,0.9956292510032654,1493,284,1981,772,488,488,applejack|fluttershy|pinkie pie|princess cadance|princess celestia|princess luna|queen chrysalis|rainbow dash|rarity|trixie|twilight sparkle,wilvarin-liadon
1002807.jpeg,https://derpicdn.net/img/view/2015/10/15/1002807.jpeg,2,0.9373003244400024,764,2056,1242,2534,478,478,applejack|fluttershy|pinkie pie|princess cadance|princess celestia|princess luna|queen chrysalis|rainbow dash|rarity|trixie|twilight sparkle,wilvarin-liadon
1002950.jpeg,https://derpicdn.net/img/view/2015/10/16/1002950.jpeg,0,0.9640946984291076,229,335,513,619,284,284,applejack|spike|twilight sparkle,maran-zelde
1003693.jpeg,https://derpicdn.net/img/view/2015/10/17/1003693.jpeg,0,0.9432541131973268,6701,1570,8357,3226,1656,1656,apple bloom|applejack|big macintosh|cutie mark crusaders|diamond tiara|discord|fluttershy|mane six|pinkie pie|princess cadance|princess celestia|princess luna|rainbow dash|rarity|scootaloo|shining armor|spike|sunset shimmer|sweetie belle|twilight sparkle,silfoe
1003693.jpeg,https://derpicdn.net/img/view/2015/10/17/1003693.jpeg,1,0.9095945954322816,3789,3373,4961,4545,1172,1172,apple bloom|applejack|big macintosh|cutie mark crusaders|diamond tiara|discord|fluttershy|mane six|pinkie pie|princess cadance|princess celestia|princess luna|rainbow dash|rarity|scootaloo|shining armor|spike|sunset shimmer|sweetie belle|twilight sparkle,silfoe
1005019.jpeg,https://derpicdn.net/img/view/2015/10/18/1005019.jpeg,0,0.980220913887024,1152,0,2607,1479,1455,1479,discord|twilight sparkle,mistydash
1005093.jpeg,https://derpicdn.net/img/view/2015/10/18/1005093.jpeg,1,0.9972521662712096,814,0,1222,382,408,382,applejack|fluttershy|mane six|pinkie pie|rainbow dash|rarity|twilight sparkle,abbystarling
1005093.jpeg,https://derpicdn.net/img/view/2015/10/18/1005093.jpeg,2,0.9919648170471193,413,330,845,762,432,432,applejack|fluttershy|mane six|pinkie pie|rainbow dash|rarity|twilight sparkle,abbystarling
1005093.jpeg,https://derpicdn.net/img/view/2015/10/18/1005093.jpeg,3,0.9873062968254088,820,355,1234,769,414,414,applejack|fluttershy|mane six|pinkie pie|rainbow dash|rarity|twilight sparkle,abbystarling
1007028.jpeg,https://derpicdn.net/img/view/2015/10/21/1007028.jpeg,0,0.998441994190216,302,33,790,521,488,488,apple bloom|cutie mark crusaders|rainbow dash|scootaloo|sweetie belle|twilight sparkle,imalou
1007028.jpeg,https://derpicdn.net/img/view/2015/10/21/1007028.jpeg,1,0.9909502863883972,596,75,1026,505,430,430,apple bloom|cutie mark crusaders|rainbow dash|scootaloo|sweetie belle|twilight sparkle,imalou
1007646.jpeg,https://derpicdn.net/img/view/2015/10/22/1007646.jpeg,0,0.9540414214134216,1839,765,2375,1301,536,536,applejack|discord|fluttershy|mane six|pinkie pie|rainbow dash|rarity|spike|twilight sparkle,ss2sonic
1007659.jpeg,https://derpicdn.net/img/view/2015/10/22/1007659.jpeg,0,0.9280183911323548,649,0,1197,513,548,513,princess celestia|princess luna|twilight sparkle,silfoe
1008035.jpeg,https://derpicdn.net/img/view/2015/10/23/1008035.jpeg,0,0.9214777946472168,49,213,551,715,502,502,trixie|twilight sparkle,imalou
1008846.jpeg,https://derpicdn.net/img/view/2015/10/24/1008846.jpeg,0,0.9977113008499146,1169,453,1859,1143,690,690,applejack|twilight sparkle,kikirdcz
1010554.jpeg,https://derpicdn.net/img/view/2015/10/28/1010554.jpeg,0,0.9859775900840759,2577,246,3483,1152,906,906,princess luna|spike|twilight sparkle,mistydash
1010554.jpeg,https://derpicdn.net/img/view/2015/10/28/1010554.jpeg,1,0.9476441740989684,508,152,1208,852,700,700,princess luna|spike|twilight sparkle,mistydash
1011840.jpeg,https://derpicdn.net/img/view/2015/10/29/1011840.jpeg,0,0.9904592037200928,335,118,679,462,344,344,spike|twilight sparkle,kongyi
1013162.jpeg,https://derpicdn.net/img/view/2015/10/31/1013162.jpeg,1,0.9796996116638184,1078,56,1452,430,374,374,applejack|rarity|twilight sparkle,yakovlev-vad|rublegun|princessofbeauxarts|mozgan
1013386.jpeg,https://derpicdn.net/img/view/2015/10/31/1013386.jpeg,0,0.994276523590088,0,1596,737,2392,737,796,applejack|fluttershy|mane six|pinkie pie|rainbow dash|rarity|twilight sparkle,blairchan231
1013386.jpeg,https://derpicdn.net/img/view/2015/10/31/1013386.jpeg,1,0.9864152073860168,2435,245,3265,1075,830,830,applejack|fluttershy|mane six|pinkie pie|rainbow dash|rarity|twilight sparkle,blairchan231
1013386.jpeg,https://derpicdn.net/img/view/2015/10/31/1013386.jpeg,2,0.9846829771995544,2764,1190,3378,1804,614,614,applejack|fluttershy|mane six|pinkie pie|rainbow dash|rarity|twilight sparkle,blairchan231
1013386.jpeg,https://derpicdn.net/img/view/2015/10/31/1013386.jpeg,3,0.9823183417320251,939,937,1851,1849,912,912,applejack|fluttershy|mane six|pinkie pie|rainbow dash|rarity|twilight sparkle,blairchan231
1013386.jpeg,https://derpicdn.net/img/view/2015/10/31/1013386.jpeg,4,0.9616758227348328,0,0,981,855,981,855,applejack|fluttershy|mane six|pinkie pie|rainbow dash|rarity|twilight sparkle,blairchan231
1014395.jpeg,https://derpicdn.net/img/view/2015/11/1/1014395.jpeg,0,0.9572041034698486,5448,3483,7340,5375,1892,1892,trixie|twilight sparkle,pikachumask
1015068.jpeg,https://derpicdn.net/img/view/2015/11/2/1015068.jpeg,1,0.953893542289734,1646,1227,2414,1995,768,768,princess cadance|shining armor|sunset shimmer|twilight sparkle,shira-hedgie
1015154.jpeg,https://derpicdn.net/img/view/2015/11/3/1015154.jpeg,0,0.998503029346466,819,0,1280,441,461,441,applejack|fluttershy|mane six|pinkie pie|rainbow dash|rarity|twilight sparkle,animestrife009
1015154.jpeg,https://derpicdn.net/img/view/2015/11/3/1015154.jpeg,2,0.9925224184989928,0,246,219,512,219,266,applejack|fluttershy|mane six|pinkie pie|rainbow dash|rarity|twilight sparkle,animestrife009
1015834.jpeg,https://derpicdn.net/img/view/2015/11/4/1015834.jpeg,0,0.9855718016624452,469,0,1453,948,984,948,princess luna|twilight sparkle,magnaluna
1016188.jpeg,https://derpicdn.net/img/view/2015/11/4/1016188.jpeg,0,0.9971917271614076,505,0,1285,700,780,700,princess celestia|twilight sparkle,magnaluna
1019356.jpeg,https://derpicdn.net/img/view/2015/11/9/1019356.jpeg,0,0.9437867999076844,464,6,958,500,494,494,pinkie pie|twilight sparkle,rockingscorpion
1020813.jpeg,https://derpicdn.net/img/view/2015/11/11/1020813.jpeg,0,0.968317985534668,952,0,1920,965,968,965,applejack|twilight sparkle,
1021863.jpeg,https://derpicdn.net/img/view/2015/11/13/1021863.jpeg,0,0.9759450554847716,474,0,918,391,444,391,applejack|fluttershy|rainbow dash|twilight sparkle,fruitilupis
1022668.jpeg,https://derpicdn.net/img/view/2015/11/14/1022668.jpeg,0,0.9359819889068604,5,0,359,336,354,336,fluttershy|twilight sparkle,
1022936.jpeg,https://derpicdn.net/img/view/2015/11/14/1022936.jpeg,0,0.9757104516029358,296,54,736,494,440,440,princess luna|twilight sparkle,silfoe
1023931.jpeg,https://derpicdn.net/img/view/2015/11/16/1023931.jpeg,0,0.9838700890541076,370,30,660,320,290,290,applejack|twilight sparkle,maran-zelde
1024723.jpeg,https://derpicdn.net/img/view/2015/11/17/1024723.jpeg,0,0.9394958019256592,316,5,862,551,546,546,fluttershy|twilight sparkle,rockingscorpion
1025303.jpeg,https://derpicdn.net/img/view/2015/11/18/1025303.jpeg,0,0.9963347315788268,354,377,830,853,476,476,applejack|fluttershy|mane six|pinkie pie|rainbow dash|rarity|twilight sparkle,bratzoid
1025303.jpeg,https://derpicdn.net/img/view/2015/11/18/1025303.jpeg,1,0.9874202013015748,879,1371,1311,1803,432,432,applejack|fluttershy|mane six|pinkie pie|rainbow dash|rarity|twilight sparkle,bratzoid
1025303.jpeg,https://derpicdn.net/img/view/2015/11/18/1025303.jpeg,2,0.971383273601532,267,1037,791,1561,524,524,applejack|fluttershy|mane six|pinkie pie|rainbow dash|rarity|twilight sparkle,bratzoid
1025303.jpeg,https://derpicdn.net/img/view/2015/11/18/1025303.jpeg,3,0.9653566479682922,1326,1015,1864,1553,538,538,applejack|fluttershy|mane six|pinkie pie|rainbow dash|rarity|twilight sparkle,bratzoid
1025303.jpeg,https://derpicdn.net/img/view/2015/11/18/1025303.jpeg,4,0.9653533101081848,1310,316,1850,856,540,540,applejack|fluttershy|mane six|pinkie pie|rainbow dash|rarity|twilight sparkle,bratzoid
1025639.jpeg,https://derpicdn.net/img/view/2015/11/19/1025639.jpeg,0,0.9972680807113647,1881,549,3089,1757,1208,1208,sunset shimmer|twilight sparkle,tankepic
1027943.jpeg,https://derpicdn.net/img/view/2015/11/22/1027943.jpeg,0,0.9989023804664612,519,0,1291,730,772,730,princess luna|twilight sparkle,redvaisandandre
1029620.jpeg,https://derpicdn.net/img/view/2015/11/24/1029620.jpeg,0,0.9931450486183168,2754,1894,3558,2698,804,804,sunset shimmer|twilight sparkle,overlordneon
1029620.jpeg,https://derpicdn.net/img/view/2015/11/24/1029620.jpeg,1,0.9023061990737916,964,2180,1648,2864,684,684,sunset shimmer|twilight sparkle,overlordneon
1031303.jpeg,https://derpicdn.net/img/view/2015/11/27/1031303.jpeg,0,0.9548014402389526,545,83,949,487,404,404,starlight glimmer|twilight sparkle,artistnjc
1033574.jpeg,https://derpicdn.net/img/view/2015/11/30/1033574.jpeg,0,0.9006034731864929,270,249,684,663,414,414,starlight glimmer|twilight sparkle,alloyrabbit
1033661.jpeg,https://derpicdn.net/img/view/2015/11/30/1033661.jpeg,0,0.9942172169685364,42,471,410,839,368,368,trixie|twilight sparkle,pixelkitties
1033661.jpeg,https://derpicdn.net/img/view/2015/11/30/1033661.jpeg,1,0.9891645908355712,360,604,652,896,292,292,trixie|twilight sparkle,pixelkitties
1033661.jpeg,https://derpicdn.net/img/view/2015/11/30/1033661.jpeg,2,0.9737783670425416,159,33,415,289,256,256,trixie|twilight sparkle,pixelkitties
1034633.jpeg,https://derpicdn.net/img/view/2015/12/1/1034633.jpeg,0,0.9953932166099548,1091,689,1280,887,189,198,applejack|fluttershy|mane six|pinkie pie|rainbow dash|rarity|twilight sparkle,leafbunny
1034633.jpeg,https://derpicdn.net/img/view/2015/12/1/1034633.jpeg,1,0.9944518208503724,204,665,398,859,194,194,applejack|fluttershy|mane six|pinkie pie|rainbow dash|rarity|twilight sparkle,leafbunny
1034633.jpeg,https://derpicdn.net/img/view/2015/12/1/1034633.jpeg,3,0.965696394443512,643,48,845,250,202,202,applejack|fluttershy|mane six|pinkie pie|rainbow dash|rarity|twilight sparkle,leafbunny
1036162.jpeg,https://derpicdn.net/img/view/2015/12/3/1036162.jpeg,0,0.9988899230957032,710,34,986,310,276,276,fluttershy|twilight sparkle,mad'n evil
1036774.jpeg,https://derpicdn.net/img/view/2015/12/4/1036774.jpeg,0,0.9856763482093812,5104,1291,5882,2069,778,778,applejack|discord|fluttershy|mane six|pinkie pie|queen chrysalis|rainbow dash|rarity|spike|starlight glimmer|twilight sparkle,lrusu
1036774.jpeg,https://derpicdn.net/img/view/2015/12/4/1036774.jpeg,1,0.984674870967865,4097,1361,4971,2235,874,874,applejack|discord|fluttershy|mane six|pinkie pie|queen chrysalis|rainbow dash|rarity|spike|starlight glimmer|twilight sparkle,lrusu
1038300.jpeg,https://derpicdn.net/img/view/2015/12/6/1038300.jpeg,0,0.97691148519516,651,251,813,413,162,162,applejack|fluttershy|mane six|pinkie pie|rainbow dash|rarity|twilight sparkle,
1038300.jpeg,https://derpicdn.net/img/view/2015/12/6/1038300.jpeg,1,0.9672698974609376,808,242,990,424,182,182,applejack|fluttershy|mane six|pinkie pie|rainbow dash|rarity|twilight sparkle,
1038300.jpeg,https://derpicdn.net/img/view/2015/12/6/1038300.jpeg,2,0.914186418056488,245,256,461,472,216,216,applejack|fluttershy|mane six|pinkie pie|rainbow dash|rarity|twilight sparkle,
1039210.jpeg,https://derpicdn.net/img/view/2015/12/7/1039210.jpeg,0,0.95650452375412,1616,0,2388,704,772,704,applejack|fluttershy|mane six|pinkie pie|rainbow dash|rarity|twilight sparkle,dilarus
1040024.jpeg,https://derpicdn.net/img/view/2015/12/8/1040024.jpeg,0,0.9953232407569884,288,127,1160,999,872,872,starlight glimmer|twilight sparkle,
1040024.jpeg,https://derpicdn.net/img/view/2015/12/8/1040024.jpeg,1,0.9951006770133972,1354,689,1910,1245,556,556,starlight glimmer|twilight sparkle,
1041194.jpeg,https://derpicdn.net/img/view/2015/12/10/1041194.jpeg,0,0.9994999170303344,1865,1140,2601,1876,736,736,queen chrysalis|twilight sparkle,dilarus
1041400.jpeg,https://derpicdn.net/img/view/2015/12/10/1041400.jpeg,1,0.9117584228515624,124,231,376,483,252,252,applejack|fluttershy|mane six|pinkie pie|rainbow dash|rarity|sunset shimmer|twilight sparkle,shimazun
1041403.jpeg,https://derpicdn.net/img/view/2015/12/10/1041403.jpeg,0,0.9838071465492249,590,770,1122,1302,532,532,starlight glimmer|sunset shimmer|trixie|twilight sparkle,ncmares
1041403.jpeg,https://derpicdn.net/img/view/2015/12/10/1041403.jpeg,1,0.9779964089393616,1130,645,1842,1357,712,712,starlight glimmer|sunset shimmer|trixie|twilight sparkle,ncmares
1043626.jpeg,https://derpicdn.net/img/view/2015/12/13/1043626.jpeg,0,0.9980350136756896,320,246,872,798,552,552,spike|twilight sparkle,lucky dragoness
1045512.jpeg,https://derpicdn.net/img/view/2015/12/16/1045512.jpeg,0,0.997186541557312,0,0,615,616,615,616,applejack|fluttershy|mane six|pinkie pie|rainbow dash|rarity|spike|twilight sparkle,abbystarling
1045512.jpeg,https://derpicdn.net/img/view/2015/12/16/1045512.jpeg,1,0.9110428094863892,794,859,1336,1320,542,461,applejack|fluttershy|mane six|pinkie pie|rainbow dash|rarity|spike|twilight sparkle,abbystarling
1045512.jpeg,https://derpicdn.net/img/view/2015/12/16/1045512.jpeg,2,0.905402898788452,1463,470,2040,1102,577,632,applejack|fluttershy|mane six|pinkie pie|rainbow dash|rarity|spike|twilight sparkle,abbystarling
1046689.jpeg,https://derpicdn.net/img/view/2015/12/18/1046689.jpeg,0,0.9790545701980592,174,0,544,338,370,338,trixie|twilight sparkle,longinius|princess-katie
1047603.jpeg,https://derpicdn.net/img/view/2015/12/19/1047603.jpeg,1,0.9854456186294556,229,0,573,337,344,337,pinkie pie|rainbow dash|rarity|twilight sparkle,ponygoddess
1047657.jpeg,https://derpicdn.net/img/view/2015/12/19/1047657.jpeg,0,0.9733975529670716,0,247,360,667,360,420,applejack|discord|fluttershy|mane six|pinkie pie|queen chrysalis|rainbow dash|rarity|twilight sparkle,aquaticsun
1047657.jpeg,https://derpicdn.net/img/view/2015/12/19/1047657.jpeg,2,0.9181025624275208,196,585,576,965,380,380,applejack|discord|fluttershy|mane six|pinkie pie|queen chrysalis|rainbow dash|rarity|twilight sparkle,aquaticsun
1051389.jpeg,https://derpicdn.net/img/view/2015/12/24/1051389.jpeg,1,0.9944825172424316,717,317,1089,689,372,372,starlight glimmer|twilight sparkle,cuddlehooves
1051389.jpeg,https://derpicdn.net/img/view/2015/12/24/1051389.jpeg,2,0.9766003489494324,382,27,788,433,406,406,starlight glimmer|twilight sparkle,cuddlehooves
1052400.jpeg,https://derpicdn.net/img/view/2015/12/25/1052400.jpeg,0,0.9980632066726683,205,16,527,338,322,322,apple bloom|applejack|cutie mark crusaders|fluttershy|mane six|pinkie pie|princess cadance|princess celestia|princess luna|rainbow dash|rarity|scootaloo|shining armor|starlight glimmer|sunset shimmer|sweetie belle|twilight sparkle,kongyi
1052400.jpeg,https://derpicdn.net/img/view/2015/12/25/1052400.jpeg,1,0.9672276377677916,281,804,577,1100,296,296,apple bloom|applejack|cutie mark crusaders|fluttershy|mane six|pinkie pie|princess cadance|princess celestia|princess luna|rainbow dash|rarity|scootaloo|shining armor|starlight glimmer|sunset shimmer|sweetie belle|twilight sparkle,kongyi
1052400.jpeg,https://derpicdn.net/img/view/2015/12/25/1052400.jpeg,3,0.9509464502334596,551,811,881,1141,330,330,apple bloom|applejack|cutie mark crusaders|fluttershy|mane six|pinkie pie|princess cadance|princess celestia|princess luna|rainbow dash|rarity|scootaloo|shining armor|starlight glimmer|sunset shimmer|sweetie belle|twilight sparkle,kongyi
1052744.jpeg,https://derpicdn.net/img/view/2015/12/26/1052744.jpeg,1,0.9990637898445128,509,551,861,903,352,352,pinkie pie|rainbow dash|rarity|soarin'|spitfire|sunset shimmer|twilight sparkle,shimazun
1052744.jpeg,https://derpicdn.net/img/view/2015/12/26/1052744.jpeg,4,0.9806121587753296,255,1222,587,1554,332,332,pinkie pie|rainbow dash|rarity|soarin'|spitfire|sunset shimmer|twilight sparkle,shimazun
1052744.jpeg,https://derpicdn.net/img/view/2015/12/26/1052744.jpeg,5,0.9742591381072998,956,0,1302,343,346,343,pinkie pie|rainbow dash|rarity|soarin'|spitfire|sunset shimmer|twilight sparkle,shimazun
1053393.jpeg,https://derpicdn.net/img/view/2015/12/27/1053393.jpeg,0,0.9898073673248292,537,29,935,427,398,398,trixie|twilight sparkle,asika-aida
1056280.jpeg,https://derpicdn.net/img/view/2015/12/31/1056280.jpeg,0,0.9841548800468444,242,315,486,559,244,244,applejack|fluttershy|mane six|pinkie pie|rainbow dash|rarity|spike|twilight sparkle,viddi32|thegamercolt
1056280.jpeg,https://derpicdn.net/img/view/2015/12/31/1056280.jpeg,1,0.9782510995864868,768,246,982,460,214,214,applejack|fluttershy|mane six|pinkie pie|rainbow dash|rarity|spike|twilight sparkle,viddi32|thegamercolt
1056280.jpeg,https://derpicdn.net/img/view/2015/12/31/1056280.jpeg,2,0.978069543838501,579,18,785,224,206,206,applejack|fluttershy|mane six|pinkie pie|rainbow dash|rarity|spike|twilight sparkle,viddi32|thegamercolt
1056280.jpeg,https://derpicdn.net/img/view/2015/12/31/1056280.jpeg,3,0.9456560611724854,44,398,298,652,254,254,applejack|fluttershy|mane six|pinkie pie|rainbow dash|rarity|spike|twilight sparkle,viddi32|thegamercolt
1057248.jpeg,https://derpicdn.net/img/view/2016/1/1/1057248.jpeg,0,0.9504392743110656,297,0,631,327,334,327,fluttershy|princess cadance|twilight sparkle,mirrorandimage
1057896.jpeg,https://derpicdn.net/img/view/2016/1/2/1057896.jpeg,0,0.9851825833320618,191,73,559,441,368,368,sunset shimmer|twilight sparkle,vago-xd
1058429.jpeg,https://derpicdn.net/img/view/2016/1/3/1058429.jpeg,0,0.9852936863899232,490,563,804,877,314,314,applejack|fluttershy|mane six|pinkie pie|rainbow dash|rarity|twilight sparkle,chris-artz
1058429.jpeg,https://derpicdn.net/img/view/2016/1/3/1058429.jpeg,1,0.9796552062034608,621,13,909,301,288,288,applejack|fluttershy|mane six|pinkie pie|rainbow dash|rarity|twilight sparkle,chris-artz
1058815.jpeg,https://derpicdn.net/img/view/2016/1/3/1058815.jpeg,0,0.9816685318946838,1386,2651,2094,3359,708,708,discord|fluttershy|princess celestia|rainbow dash|scootaloo|sunset shimmer|sweetie belle|twilight sparkle,overlordneon
1058815.jpeg,https://derpicdn.net/img/view/2016/1/3/1058815.jpeg,1,0.9800354838371276,1134,1617,1854,2337,720,720,discord|fluttershy|princess celestia|rainbow dash|scootaloo|sunset shimmer|sweetie belle|twilight sparkle,overlordneon
1060769.jpeg,https://derpicdn.net/img/view/2016/1/6/1060769.jpeg,0,0.9987342953681946,753,39,1359,645,606,606,applejack|fluttershy|mane six|pinkie pie|rainbow dash|rarity|twilight sparkle,periwinkietwinkie
1060769.jpeg,https://derpicdn.net/img/view/2016/1/6/1060769.jpeg,1,0.9975146651268004,741,713,1343,1315,602,602,applejack|fluttershy|mane six|pinkie pie|rainbow dash|rarity|twilight sparkle,periwinkietwinkie
1060769.jpeg,https://derpicdn.net/img/view/2016/1/6/1060769.jpeg,2,0.9937160611152648,1280,28,1896,644,616,616,applejack|fluttershy|mane six|pinkie pie|rainbow dash|rarity|twilight sparkle,periwinkietwinkie
1060769.jpeg,https://derpicdn.net/img/view/2016/1/6/1060769.jpeg,3,0.967485010623932,1290,726,1834,1270,544,544,applejack|fluttershy|mane six|pinkie pie|rainbow dash|rarity|twilight sparkle,periwinkietwinkie
1061554.jpeg,https://derpicdn.net/img/view/2016/1/7/1061554.jpeg,0,0.9390680193901062,119,102,480,480,361,378,starlight glimmer|twilight sparkle,
1062356.jpeg,https://derpicdn.net/img/view/2016/1/8/1062356.jpeg,0,0.9991456270217896,452,0,876,411,424,411,princess cadance|princess celestia|princess luna|twilight sparkle,girlsay
1062356.jpeg,https://derpicdn.net/img/view/2016/1/8/1062356.jpeg,1,0.9224305748939514,253,334,793,874,540,540,princess cadance|princess celestia|princess luna|twilight sparkle,girlsay
1066002.jpeg,https://derpicdn.net/img/view/2016/1/13/1066002.jpeg,0,0.9993748068809508,1266,306,1920,960,654,654,princess cadance|princess celestia|princess luna|twilight sparkle,ncmares
1067144.jpeg,https://derpicdn.net/img/view/2016/1/15/1067144.jpeg,0,0.9914640188217164,132,0,396,257,264,257,spike|twilight sparkle,xjkenny
1068126.jpeg,https://derpicdn.net/img/view/2016/1/17/1068126.jpeg,0,0.9915481805801392,998,486,1538,1026,540,540,princess celestia|twilight sparkle,ncmares
1068246.jpeg,https://derpicdn.net/img/view/2016/1/17/1068246.jpeg,0,0.9995378851890564,0,543,147,703,147,160,apple bloom|applejack|big macintosh|cutie mark crusaders|discord|fluttershy|mane six|pinkie pie|princess cadance|princess celestia|princess luna|queen chrysalis|rainbow dash|rarity|scootaloo|shining armor|spike|sweetie belle|trixie|twilight sparkle,christadoodles
1068246.jpeg,https://derpicdn.net/img/view/2016/1/17/1068246.jpeg,1,0.998726725578308,264,0,400,134,136,134,apple bloom|applejack|big macintosh|cutie mark crusaders|discord|fluttershy|mane six|pinkie pie|princess cadance|princess celestia|princess luna|queen chrysalis|rainbow dash|rarity|scootaloo|shining armor|spike|sweetie belle|trixie|twilight sparkle,christadoodles
1068246.jpeg,https://derpicdn.net/img/view/2016/1/17/1068246.jpeg,2,0.9974160194396972,382,747,518,883,136,136,apple bloom|applejack|big macintosh|cutie mark crusaders|discord|fluttershy|mane six|pinkie pie|princess cadance|princess celestia|princess luna|queen chrysalis|rainbow dash|rarity|scootaloo|shining armor|spike|sweetie belle|trixie|twilight sparkle,christadoodles
1068246.jpeg,https://derpicdn.net/img/view/2016/1/17/1068246.jpeg,3,0.9948590993881226,0,741,141,891,141,150,apple bloom|applejack|big macintosh|cutie mark crusaders|discord|fluttershy|mane six|pinkie pie|princess cadance|princess celestia|princess luna|queen chrysalis|rainbow dash|rarity|scootaloo|shining armor|spike|sweetie belle|trixie|twilight sparkle,christadoodles
1068246.jpeg,https://derpicdn.net/img/view/2016/1/17/1068246.jpeg,4,0.9891775846481324,656,565,800,719,144,154,apple bloom|applejack|big macintosh|cutie mark crusaders|discord|fluttershy|mane six|pinkie pie|princess cadance|princess celestia|princess luna|queen chrysalis|rainbow dash|rarity|scootaloo|shining armor|spike|sweetie belle|trixie|twilight sparkle,christadoodles
1068246.jpeg,https://derpicdn.net/img/view/2016/1/17/1068246.jpeg,5,0.9840840101242064,0,171,146,325,146,154,apple bloom|applejack|big macintosh|cutie mark crusaders|discord|fluttershy|mane six|pinkie pie|princess cadance|princess celestia|princess luna|queen chrysalis|rainbow dash|rarity|scootaloo|shining armor|spike|sweetie belle|trixie|twilight sparkle,christadoodles
1068246.jpeg,https://derpicdn.net/img/view/2016/1/17/1068246.jpeg,6,0.9825168251991272,129,748,269,888,140,140,apple bloom|applejack|big macintosh|cutie mark crusaders|discord|fluttershy|mane six|pinkie pie|princess cadance|princess celestia|princess luna|queen chrysalis|rainbow dash|rarity|scootaloo|shining armor|spike|sweetie belle|trixie|twilight sparkle,christadoodles
1068246.jpeg,https://derpicdn.net/img/view/2016/1/17/1068246.jpeg,7,0.9807452559471128,418,0,556,125,138,125,apple bloom|applejack|big macintosh|cutie mark crusaders|discord|fluttershy|mane six|pinkie pie|princess cadance|princess celestia|princess luna|queen chrysalis|rainbow dash|rarity|scootaloo|shining armor|spike|sweetie belle|trixie|twilight sparkle,christadoodles
1068246.jpeg,https://derpicdn.net/img/view/2016/1/17/1068246.jpeg,9,0.9533231258392334,524,162,700,338,176,176,apple bloom|applejack|big macintosh|cutie mark crusaders|discord|fluttershy|mane six|pinkie pie|princess cadance|princess celestia|princess luna|queen chrysalis|rainbow dash|rarity|scootaloo|shining armor|spike|sweetie belle|trixie|twilight sparkle,christadoodles
1068246.jpeg,https://derpicdn.net/img/view/2016/1/17/1068246.jpeg,10,0.914043128490448,628,168,800,374,172,206,apple bloom|applejack|big macintosh|cutie mark crusaders|discord|fluttershy|mane six|pinkie pie|princess cadance|princess celestia|princess luna|queen chrysalis|rainbow dash|rarity|scootaloo|shining armor|spike|sweetie belle|trixie|twilight sparkle,christadoodles
1069803.jpeg,https://derpicdn.net/img/view/2016/1/19/1069803.jpeg,0,0.9910795092582704,919,33,1173,287,254,254,applejack|fluttershy|mane six|pinkie pie|rainbow dash|rarity|twilight sparkle,runsammya
1070841.jpeg,https://derpicdn.net/img/view/2016/1/21/1070841.jpeg,0,0.9938345551490784,0,3960,954,5038,954,1078,applejack|fluttershy|mane six|pinkie pie|princess cadance|princess celestia|princess luna|rainbow dash|rarity|spike|twilight sparkle,shira-hedgie
1070841.jpeg,https://derpicdn.net/img/view/2016/1/21/1070841.jpeg,1,0.9932101368904114,2792,5697,3744,6649,952,952,applejack|fluttershy|mane six|pinkie pie|princess cadance|princess celestia|princess luna|rainbow dash|rarity|spike|twilight sparkle,shira-hedgie
1073539.jpeg,https://derpicdn.net/img/view/2016/1/25/1073539.jpeg,0,0.9949319958686828,519,539,853,873,334,334,applejack|fluttershy|pinkie pie|twilight sparkle,dan232323
1073759.jpeg,https://derpicdn.net/img/view/2016/1/25/1073759.jpeg,0,0.9790093302726746,0,77,371,495,371,418,princess cadance|princess celestia|princess luna|twilight sparkle,arta-the-pony
1073759.jpeg,https://derpicdn.net/img/view/2016/1/25/1073759.jpeg,1,0.9441712498664856,783,64,1280,600,497,536,princess cadance|princess celestia|princess luna|twilight sparkle,arta-the-pony
1076541.jpeg,https://derpicdn.net/img/view/2016/1/30/1076541.jpeg,0,0.9512994289398192,477,277,733,533,256,256,starlight glimmer|sunset shimmer|twilight sparkle,pinipy
1078875.jpeg,https://derpicdn.net/img/view/2016/2/2/1078875.jpeg,0,0.991308331489563,376,0,1130,720,754,720,princess luna|twilight sparkle,magnaluna
1078875.jpeg,https://derpicdn.net/img/view/2016/2/2/1078875.jpeg,1,0.9004738330841064,362,515,1066,1219,704,704,princess luna|twilight sparkle,magnaluna
1079170.jpeg,https://derpicdn.net/img/view/2016/2/3/1079170.jpeg,2,0.964811623096466,1564,1194,2074,1704,510,510,applejack|fluttershy|mane six|pinkie pie|rainbow dash|rarity|twilight sparkle,thundereddie
1079444.jpeg,https://derpicdn.net/img/view/2016/2/3/1079444.jpeg,0,0.9979185461997986,1909,369,2207,667,298,298,applejack|fluttershy|mane six|pinkie pie|rainbow dash|rarity|twilight sparkle,dun
1079444.jpeg,https://derpicdn.net/img/view/2016/2/3/1079444.jpeg,1,0.952383816242218,1546,341,1866,661,320,320,applejack|fluttershy|mane six|pinkie pie|rainbow dash|rarity|twilight sparkle,dun
1079444.jpeg,https://derpicdn.net/img/view/2016/2/3/1079444.jpeg,2,0.9435786604881288,441,249,773,581,332,332,applejack|fluttershy|mane six|pinkie pie|rainbow dash|rarity|twilight sparkle,dun
1079444.jpeg,https://derpicdn.net/img/view/2016/2/3/1079444.jpeg,3,0.9388630390167236,1191,346,1501,656,310,310,applejack|fluttershy|mane six|pinkie pie|rainbow dash|rarity|twilight sparkle,dun
1080585.jpeg,https://derpicdn.net/img/view/2016/2/5/1080585.jpeg,1,0.9929130673408508,99,566,657,1124,558,558,fluttershy|rarity|twilight sparkle,fairysearch
1081731.jpeg,https://derpicdn.net/img/view/2016/2/6/1081731.jpeg,0,0.9981779456138612,85,0,387,272,302,272,applejack|fluttershy|mane six|pinkie pie|rainbow dash|rarity|spike|twilight sparkle,shimazun
1081731.jpeg,https://derpicdn.net/img/view/2016/2/6/1081731.jpeg,1,0.9964340925216676,64,527,292,755,228,228,applejack|fluttershy|mane six|pinkie pie|rainbow dash|rarity|spike|twilight sparkle,shimazun
1081731.jpeg,https://derpicdn.net/img/view/2016/2/6/1081731.jpeg,2,0.9877488017082214,1160,0,1414,238,254,238,applejack|fluttershy|mane six|pinkie pie|rainbow dash|rarity|spike|twilight sparkle,shimazun
1081731.jpeg,https://derpicdn.net/img/view/2016/2/6/1081731.jpeg,3,0.9844825863838196,569,0,877,305,308,305,applejack|fluttershy|mane six|pinkie pie|rainbow dash|rarity|spike|twilight sparkle,shimazun
1081731.jpeg,https://derpicdn.net/img/view/2016/2/6/1081731.jpeg,4,0.9580374360084534,917,536,1161,780,244,244,applejack|fluttershy|mane six|pinkie pie|rainbow dash|rarity|spike|twilight sparkle,shimazun
1082106.jpeg,https://derpicdn.net/img/view/2016/2/7/1082106.jpeg,0,0.9915897250175476,699,199,1115,615,416,416,applejack|fluttershy|mane six|pinkie pie|rainbow dash|rarity|twilight sparkle,synthierose
1082795.jpeg,https://derpicdn.net/img/view/2016/2/7/1082795.jpeg,0,0.9455164074897766,381,83,911,613,530,530,pinkie pie|queen chrysalis|twilight sparkle,luna77899
1086105.jpeg,https://derpicdn.net/img/view/2016/2/12/1086105.jpeg,0,0.9386906027793884,103,0,505,308,402,308,princess celestia|twilight sparkle,miki 14
1086666.jpeg,https://derpicdn.net/img/view/2016/2/13/1086666.jpeg,2,0.9689197540283204,431,0,869,356,438,356,fluttershy|rarity|twilight sparkle,made-in-donuts
1087825.jpeg,https://derpicdn.net/img/view/2016/2/14/1087825.jpeg,0,0.9711689949035645,178,216,552,590,374,374,applejack|fluttershy|pinkie pie|rainbow dash|spike|twilight sparkle,kongyi
1088746.jpeg,https://derpicdn.net/img/view/2016/2/15/1088746.jpeg,0,0.9871195554733276,1863,254,2393,784,530,530,applejack|big macintosh|fluttershy|pinkie pie|rainbow dash|rarity|soarin'|twilight sparkle,whitefangkakashi300
1088746.jpeg,https://derpicdn.net/img/view/2016/2/15/1088746.jpeg,1,0.9606672525405884,1474,223,2052,801,578,578,applejack|big macintosh|fluttershy|pinkie pie|rainbow dash|rarity|soarin'|twilight sparkle,whitefangkakashi300
1089963.jpeg,https://derpicdn.net/img/view/2016/2/16/1089963.jpeg,0,0.9979509115219116,516,12,818,314,302,302,princess celestia|twilight sparkle,pettankochanv
1091288.jpeg,https://derpicdn.net/img/view/2016/2/18/1091288.jpeg,0,0.9981825947761536,35,3182,2609,5756,2574,2574,applejack|fluttershy|mane six|pinkie pie|rainbow dash|rarity|spike|twilight sparkle,tygerbug|wiseman288
1091288.jpeg,https://derpicdn.net/img/view/2016/2/18/1091288.jpeg,1,0.9895675778388976,2096,296,3986,2186,1890,1890,applejack|fluttershy|mane six|pinkie pie|rainbow dash|rarity|spike|twilight sparkle,tygerbug|wiseman288
1091288.jpeg,https://derpicdn.net/img/view/2016/2/18/1091288.jpeg,2,0.9579761624336244,6723,826,9209,3312,2486,2486,applejack|fluttershy|mane six|pinkie pie|rainbow dash|rarity|spike|twilight sparkle,tygerbug|wiseman288
1091288.jpeg,https://derpicdn.net/img/view/2016/2/18/1091288.jpeg,3,0.9566608667373656,5149,180,6485,1516,1336,1336,applejack|fluttershy|mane six|pinkie pie|rainbow dash|rarity|spike|twilight sparkle,tygerbug|wiseman288
1091295.jpeg,https://derpicdn.net/img/view/2016/2/18/1091295.jpeg,0,0.9810689091682434,409,547,811,949,402,402,applejack|fluttershy|mane six|pinkie pie|rainbow dash|rarity|twilight sparkle,madamemochete
1092636.jpeg,https://derpicdn.net/img/view/2016/2/20/1092636.jpeg,0,0.9419983625411988,296,297,554,555,258,258,rainbow dash|twilight sparkle,chaoskomori
1094841.jpeg,https://derpicdn.net/img/view/2016/2/23/1094841.jpeg,0,0.9900427460670472,612,39,942,369,330,330,applejack|fluttershy|twilight sparkle,nuka-kitty
1095562.jpeg,https://derpicdn.net/img/view/2016/2/24/1095562.jpeg,0,0.9932295680046082,293,629,573,909,280,280,princess celestia|rainbow dash|twilight sparkle,brendahickey
1095563.jpeg,https://derpicdn.net/img/view/2016/2/24/1095563.jpeg,0,0.9908300638198853,21,9,279,267,258,258,rainbow dash|shining armor|twilight sparkle,brendahickey
1095940.jpeg,https://derpicdn.net/img/view/2016/2/24/1095940.jpeg,0,0.9767997860908508,0,1,166,167,166,166,apple bloom|applejack|discord|fluttershy|granny smith|pinkie pie|princess cadance|rainbow dash|spike|sunset shimmer|sweetie belle|twilight sparkle,tonyfleecs
1100114.jpeg,https://derpicdn.net/img/view/2016/3/1/1100114.jpeg,0,0.9972827434539796,0,130,393,538,393,408,applejack|fluttershy|mane six|pinkie pie|rainbow dash|rarity|twilight sparkle,joe0316|laptop-pone
1100114.jpeg,https://derpicdn.net/img/view/2016/3/1/1100114.jpeg,3,0.9524828195571899,586,408,994,816,408,408,applejack|fluttershy|mane six|pinkie pie|rainbow dash|rarity|twilight sparkle,joe0316|laptop-pone
1100438.jpeg,https://derpicdn.net/img/view/2016/3/2/1100438.jpeg,0,0.9924611449241638,254,2882,1092,3720,838,838,discord|princess cadance|princess celestia|princess luna|queen chrysalis|shining armor|twilight sparkle,thegr8mc
1100976.jpeg,https://derpicdn.net/img/view/2016/3/3/1100976.jpeg,0,0.9427458643913268,419,0,779,298,360,298,sunset shimmer|twilight sparkle,angeltorchic
1101199.jpeg,https://derpicdn.net/img/view/2016/3/3/1101199.jpeg,0,0.9667255878448486,599,78,815,294,216,216,spike|twilight sparkle,merrypaws
1103900.jpeg,https://derpicdn.net/img/view/2016/3/7/1103900.jpeg,1,0.9756351113319396,320,311,586,577,266,266,pinkie pie|twilight sparkle,vanillaghosties
1103916.jpeg,https://derpicdn.net/img/view/2016/3/7/1103916.jpeg,1,0.997883677482605,47,639,461,1053,414,414,applejack|fluttershy|mane six|pinkie pie|rainbow dash|rarity|spike|twilight sparkle,archaspect
1103916.jpeg,https://derpicdn.net/img/view/2016/3/7/1103916.jpeg,2,0.9278416633605956,618,536,918,836,300,300,applejack|fluttershy|mane six|pinkie pie|rainbow dash|rarity|spike|twilight sparkle,archaspect
1106953.jpeg,https://derpicdn.net/img/view/2016/3/12/1106953.jpeg,0,0.9944158792495728,131,85,1269,1223,1138,1138,starlight glimmer|twilight sparkle,emcrasher
1107274.jpeg,https://derpicdn.net/img/view/2016/3/12/1107274.jpeg,0,0.9906960725784302,639,931,900,1225,261,294,princess celestia|trixie|twilight sparkle,brendahickey
1107274.jpeg,https://derpicdn.net/img/view/2016/3/12/1107274.jpeg,1,0.9373375177383424,83,344,501,762,418,418,princess celestia|trixie|twilight sparkle,brendahickey
1107603.jpeg,https://derpicdn.net/img/view/2016/3/12/1107603.jpeg,0,0.9468055963516236,402,11,1122,731,720,720,rainbow dash|twilight sparkle,elzzombie
1107603.jpeg,https://derpicdn.net/img/view/2016/3/12/1107603.jpeg,1,0.9389784336090088,0,0,701,708,701,708,rainbow dash|twilight sparkle,elzzombie
1108976.jpeg,https://derpicdn.net/img/view/2016/3/14/1108976.jpeg,0,0.9647895693778992,475,236,785,546,310,310,sunset shimmer|trixie|twilight sparkle,phoenixperegrine
1110894.jpeg,https://derpicdn.net/img/view/2016/3/17/1110894.jpeg,0,0.9945512413978576,286,438,602,754,316,316,applejack|fluttershy|mane six|pinkie pie|rainbow dash|rarity|twilight sparkle,alexstrazse
1110894.jpeg,https://derpicdn.net/img/view/2016/3/17/1110894.jpeg,1,0.9942691922187804,0,0,328,322,328,322,applejack|fluttershy|mane six|pinkie pie|rainbow dash|rarity|twilight sparkle,alexstrazse
1110894.jpeg,https://derpicdn.net/img/view/2016/3/17/1110894.jpeg,3,0.9713037014007568,302,0,616,313,314,313,applejack|fluttershy|mane six|pinkie pie|rainbow dash|rarity|twilight sparkle,alexstrazse
1110894.jpeg,https://derpicdn.net/img/view/2016/3/17/1110894.jpeg,4,0.964450478553772,635,13,900,291,265,278,applejack|fluttershy|mane six|pinkie pie|rainbow dash|rarity|twilight sparkle,alexstrazse
1110894.jpeg,https://derpicdn.net/img/view/2016/3/17/1110894.jpeg,5,0.9599037766456604,578,420,900,766,322,346,applejack|fluttershy|mane six|pinkie pie|rainbow dash|rarity|twilight sparkle,alexstrazse
1113103.jpeg,https://derpicdn.net/img/view/2016/3/20/1113103.jpeg,0,0.9089193344116212,96,0,812,614,716,614,starlight glimmer|twilight sparkle,tyuubatu
1113822.jpeg,https://derpicdn.net/img/view/2016/3/21/1113822.jpeg,0,0.9985107183456421,569,13,753,197,184,184,applejack|fluttershy|mane six|pinkie pie|rainbow dash|rarity|twilight sparkle,workshopjumpy
1113822.jpeg,https://derpicdn.net/img/view/2016/3/21/1113822.jpeg,1,0.9977671504020692,299,23,491,215,192,192,applejack|fluttershy|mane six|pinkie pie|rainbow dash|rarity|twilight sparkle,workshopjumpy
1113822.jpeg,https://derpicdn.net/img/view/2016/3/21/1113822.jpeg,2,0.9847561120986938,318,366,484,532,166,166,applejack|fluttershy|mane six|pinkie pie|rainbow dash|rarity|twilight sparkle,workshopjumpy
1113822.jpeg,https://derpicdn.net/img/view/2016/3/21/1113822.jpeg,3,0.9791004657745358,486,351,658,523,172,172,applejack|fluttershy|mane six|pinkie pie|rainbow dash|rarity|twilight sparkle,workshopjumpy
1113886.jpeg,https://derpicdn.net/img/view/2016/3/21/1113886.jpeg,0,0.9775059819221495,1077,60,1957,940,880,880,princess luna|twilight sparkle,magnaluna
1113886.jpeg,https://derpicdn.net/img/view/2016/3/21/1113886.jpeg,1,0.9126743078231812,440,36,1212,808,772,772,princess luna|twilight sparkle,magnaluna
1114820.jpeg,https://derpicdn.net/img/view/2016/3/23/1114820.jpeg,0,0.9781657457351683,364,644,716,996,352,352,applejack|fluttershy|mane six|pinkie pie|rainbow dash|rarity|spike|twilight sparkle,tonyfleecs
1114820.jpeg,https://derpicdn.net/img/view/2016/3/23/1114820.jpeg,1,0.939993381500244,229,299,511,581,282,282,applejack|fluttershy|mane six|pinkie pie|rainbow dash|rarity|spike|twilight sparkle,tonyfleecs
1114822.jpeg,https://derpicdn.net/img/view/2016/3/23/1114822.jpeg,0,0.9893438220024108,637,775,899,1037,262,262,applejack|discord|fluttershy|mane six|pinkie pie|rainbow dash|rarity|twilight sparkle,marybellamy
1115670.jpeg,https://derpicdn.net/img/view/2016/3/24/1115670.jpeg,0,0.9819604754447936,571,275,1200,917,629,642,princess celestia|twilight sparkle,jdan-s
1116278.jpeg,https://derpicdn.net/img/view/2016/3/25/1116278.jpeg,0,0.9978037476539612,2352,3677,3928,5253,1576,1576,applejack|fluttershy|mane six|pinkie pie|rainbow dash|rarity|spike|starlight glimmer|twilight sparkle,meganlovesangrybirds
1116278.jpeg,https://derpicdn.net/img/view/2016/3/25/1116278.jpeg,1,0.9950129389762878,1408,2518,3010,4120,1602,1602,applejack|fluttershy|mane six|pinkie pie|rainbow dash|rarity|spike|starlight glimmer|twilight sparkle,meganlovesangrybirds
1116278.jpeg,https://derpicdn.net/img/view/2016/3/25/1116278.jpeg,3,0.9085286259651184,3800,2734,5112,4046,1312,1312,applejack|fluttershy|mane six|pinkie pie|rainbow dash|rarity|spike|starlight glimmer|twilight sparkle,meganlovesangrybirds
1122158.jpeg,https://derpicdn.net/img/view/2016/4/2/1122158.jpeg,0,0.9978833794593812,468,334,1392,1258,924,924,applejack|fluttershy|mane six|pinkie pie|rainbow dash|rarity|twilight sparkle,whit3-dr4g0n
1122158.jpeg,https://derpicdn.net/img/view/2016/4/2/1122158.jpeg,1,0.9881458282470704,1003,744,2163,1904,1160,1160,applejack|fluttershy|mane six|pinkie pie|rainbow dash|rarity|twilight sparkle,whit3-dr4g0n
1122158.jpeg,https://derpicdn.net/img/view/2016/4/2/1122158.jpeg,2,0.9851316213607788,2462,370,3518,1426,1056,1056,applejack|fluttershy|mane six|pinkie pie|rainbow dash|rarity|twilight sparkle,whit3-dr4g0n
1122158.jpeg,https://derpicdn.net/img/view/2016/4/2/1122158.jpeg,4,0.9261482357978821,60,1144,948,2032,888,888,applejack|fluttershy|mane six|pinkie pie|rainbow dash|rarity|twilight sparkle,whit3-dr4g0n
1122564.jpeg,https://derpicdn.net/img/view/2016/4/2/1122564.jpeg,0,0.9923803210258484,839,255,1427,843,588,588,applejack|fluttershy|pinkie pie|rainbow dash|rarity|trixie|twilight sparkle,rayodragon
1130905.jpeg,https://derpicdn.net/img/view/2016/4/13/1130905.jpeg,0,0.9944919943809508,236,320,438,522,202,202,apple bloom|applejack|big macintosh|cutie mark crusaders|fluttershy|princess cadance|princess celestia|princess luna|rainbow dash|rarity|scootaloo|shining armor|spike|sweetie belle|twilight sparkle,andypriceart
1130905.jpeg,https://derpicdn.net/img/view/2016/4/13/1130905.jpeg,1,0.982816517353058,517,802,773,1058,256,256,apple bloom|applejack|big macintosh|cutie mark crusaders|fluttershy|princess cadance|princess celestia|princess luna|rainbow dash|rarity|scootaloo|shining armor|spike|sweetie belle|twilight sparkle,andypriceart
1130905.jpeg,https://derpicdn.net/img/view/2016/4/13/1130905.jpeg,2,0.9007068276405334,1149,280,1374,524,225,244,apple bloom|applejack|big macintosh|cutie mark crusaders|fluttershy|princess cadance|princess celestia|princess luna|rainbow dash|rarity|scootaloo|shining armor|spike|sweetie belle|twilight sparkle,andypriceart
1132713.jpeg,https://derpicdn.net/img/view/2016/4/15/1132713.jpeg,0,0.9991969466209412,197,99,967,869,770,770,princess celestia|princess luna|twilight sparkle,magnaluna
1132713.jpeg,https://derpicdn.net/img/view/2016/4/15/1132713.jpeg,2,0.9902057051658628,2228,331,2794,897,566,566,princess celestia|princess luna|twilight sparkle,magnaluna
1132716.jpeg,https://derpicdn.net/img/view/2016/4/15/1132716.jpeg,0,0.9961812496185304,0,0,1807,1698,1807,1698,princess luna|twilight sparkle,magnaluna
1133263.jpeg,https://derpicdn.net/img/view/2016/4/16/1133263.jpeg,0,0.9720933437347412,1042,412,1334,704,292,292,princess celestia|princess luna|rarity|spike|twilight sparkle,
1135270.jpeg,https://derpicdn.net/img/view/2016/4/18/1135270.jpeg,0,0.9922907948493958,290,794,576,1080,286,286,applejack|fluttershy|mane six|pinkie pie|rainbow dash|rarity|spike|twilight sparkle,andypriceart
1136346.jpeg,https://derpicdn.net/img/view/2016/4/20/1136346.jpeg,0,0.985695779323578,226,229,506,509,280,280,rainbow dash|twilight sparkle,mylittlelevi64
1136712.jpeg,https://derpicdn.net/img/view/2016/4/20/1136712.jpeg,1,0.985356867313385,76,291,1132,1347,1056,1056,applejack|rainbow dash|twilight sparkle,nauth
1138562.jpeg,https://derpicdn.net/img/view/2016/4/23/1138562.jpeg,0,0.9990902543067932,1291,59,1817,585,526,526,sunset shimmer|twilight sparkle,overlordneon
1138562.jpeg,https://derpicdn.net/img/view/2016/4/23/1138562.jpeg,1,0.998332977294922,984,268,1432,716,448,448,sunset shimmer|twilight sparkle,overlordneon
1139169.jpeg,https://derpicdn.net/img/view/2016/4/24/1139169.jpeg,0,0.9911391139030457,91,880,209,998,118,118,applejack|fluttershy|mane six|pinkie pie|rainbow dash|rarity|twilight sparkle,onat
1139169.jpeg,https://derpicdn.net/img/view/2016/4/24/1139169.jpeg,1,0.9907426834106444,375,70,489,184,114,114,applejack|fluttershy|mane six|pinkie pie|rainbow dash|rarity|twilight sparkle,onat
1139584.jpeg,https://derpicdn.net/img/view/2016/4/25/1139584.jpeg,1,0.9460058212280272,0,74,259,368,259,294,applejack|fluttershy|pinkie pie|rainbow dash|twilight sparkle,nuka-kitty
1139584.jpeg,https://derpicdn.net/img/view/2016/4/25/1139584.jpeg,2,0.9325379729270936,231,78,539,386,308,308,applejack|fluttershy|pinkie pie|rainbow dash|twilight sparkle,nuka-kitty
1140405.jpeg,https://derpicdn.net/img/view/2016/4/26/1140405.jpeg,0,0.9144873023033142,509,0,1479,762,970,762,princess flurry heart|twilight sparkle,7doran
1140667.jpeg,https://derpicdn.net/img/view/2016/4/26/1140667.jpeg,0,0.9791939854621888,437,266,719,548,282,282,apple bloom|cutie mark crusaders|scootaloo|sweetie belle|twilight sparkle,shimmycocopuffssx1
1141202.jpeg,https://derpicdn.net/img/view/2016/4/27/1141202.jpeg,0,0.9872830510139464,605,0,2003,1305,1398,1305,princess luna|twilight sparkle,magnaluna|silfoe
1145527.jpeg,https://derpicdn.net/img/view/2016/5/3/1145527.jpeg,0,0.985276997089386,376,509,826,959,450,450,starlight glimmer|twilight sparkle,brodogz
1146932.jpeg,https://derpicdn.net/img/view/2016/5/5/1146932.jpeg,0,0.9926493167877196,99,979,347,1227,248,248,applejack|fluttershy|pinkie pie|rainbow dash|rarity|spike|twilight sparkle,wadusher0
1149985.jpeg,https://derpicdn.net/img/view/2016/5/9/1149985.jpeg,0,0.9766950607299804,297,558,745,1006,448,448,starlight glimmer|trixie|twilight sparkle,ameliacostanza
1152179.jpeg,https://derpicdn.net/img/view/2016/5/12/1152179.jpeg,0,0.9876056909561156,510,116,952,558,442,442,rainbow dash|spike|starlight glimmer|trixie|twilight sparkle,artponymdp
1153323.jpeg,https://derpicdn.net/img/view/2016/5/13/1153323.jpeg,0,0.979236900806427,0,174,146,334,146,160,princess celestia|spike|sunset shimmer|twilight sparkle,shira-hedgie
1154888.jpeg,https://derpicdn.net/img/view/2016/5/15/1154888.jpeg,0,0.9247565865516664,62,72,504,514,442,442,princess luna|rarity|twilight sparkle,tsitra360
1155758.jpeg,https://derpicdn.net/img/view/2016/5/16/1155758.jpeg,0,0.9773795008659364,2792,851,3640,1699,848,848,starlight glimmer|twilight sparkle,dilarus
1158663.jpeg,https://derpicdn.net/img/view/2016/5/20/1158663.jpeg,0,0.9497751593589784,2024,1165,2688,1829,664,664,discord|princess cadance|princess celestia|princess luna|shining armor|spike|twilight sparkle,aspendragon
1158663.jpeg,https://derpicdn.net/img/view/2016/5/20/1158663.jpeg,1,0.919529139995575,1912,0,2610,639,698,639,discord|princess cadance|princess celestia|princess luna|shining armor|spike|twilight sparkle,aspendragon
1158663.jpeg,https://derpicdn.net/img/view/2016/5/20/1158663.jpeg,2,0.9151821732521056,2003,490,2635,1122,632,632,discord|princess cadance|princess celestia|princess luna|shining armor|spike|twilight sparkle,aspendragon
1158663.jpeg,https://derpicdn.net/img/view/2016/5/20/1158663.jpeg,3,0.9114621877670288,0,640,727,1378,727,738,discord|princess cadance|princess celestia|princess luna|shining armor|spike|twilight sparkle,aspendragon
1160440.jpeg,https://derpicdn.net/img/view/2016/5/22/1160440.jpeg,0,0.9901238679885864,65,159,605,699,540,540,princess luna|twilight sparkle,silfoe
1162898.jpeg,https://derpicdn.net/img/view/2016/5/25/1162898.jpeg,0,0.9153050184249878,8,194,214,400,206,206,applejack|spike|twilight sparkle,andypriceart
1162898.jpeg,https://derpicdn.net/img/view/2016/5/25/1162898.jpeg,1,0.903522789478302,188,197,390,399,202,202,applejack|spike|twilight sparkle,andypriceart
1164400.jpeg,https://derpicdn.net/img/view/2016/5/27/1164400.jpeg,0,0.9391948580741882,38,25,606,593,568,568,pinkie pie|twilight sparkle,rockingscorpion
1164831.jpeg,https://derpicdn.net/img/view/2016/5/28/1164831.jpeg,0,0.9986039400100708,1910,291,2490,871,580,580,spike|twilight sparkle,mysticalpha
1165373.jpeg,https://derpicdn.net/img/view/2016/5/29/1165373.jpeg,0,0.9937718510627748,0,0,590,572,590,572,rainbow dash|twilight sparkle,thefriendlyelephant
1169284.jpeg,https://derpicdn.net/img/view/2016/6/3/1169284.jpeg,1,0.9881373643875122,1466,773,2384,1691,918,918,princess celestia|twilight sparkle,magnaluna
1170584.jpeg,https://derpicdn.net/img/view/2016/6/5/1170584.jpeg,0,0.9628292322158812,1343,1036,1923,1616,580,580,princess luna|twilight sparkle,silfoe
1173650.jpeg,https://derpicdn.net/img/view/2016/6/8/1173650.jpeg,1,0.9716503024101256,1952,645,3600,2293,1648,1648,princess celestia|princess luna|twilight sparkle,magnaluna
1175315.jpeg,https://derpicdn.net/img/view/2016/6/10/1175315.jpeg,1,0.9980558753013612,284,740,708,1164,424,424,applejack|discord|fluttershy|pinkie pie|rainbow dash|rarity|scootaloo|sunset shimmer|twilight sparkle,rosegloom
1175315.jpeg,https://derpicdn.net/img/view/2016/6/10/1175315.jpeg,2,0.9948638677597046,266,6,646,386,380,380,applejack|discord|fluttershy|pinkie pie|rainbow dash|rarity|scootaloo|sunset shimmer|twilight sparkle,rosegloom
1175315.jpeg,https://derpicdn.net/img/view/2016/6/10/1175315.jpeg,3,0.9948393106460572,0,385,345,775,345,390,applejack|discord|fluttershy|pinkie pie|rainbow dash|rarity|scootaloo|sunset shimmer|twilight sparkle,rosegloom
1175315.jpeg,https://derpicdn.net/img/view/2016/6/10/1175315.jpeg,4,0.9942734837532043,697,927,1024,1277,327,350,applejack|discord|fluttershy|pinkie pie|rainbow dash|rarity|scootaloo|sunset shimmer|twilight sparkle,rosegloom
1175315.jpeg,https://derpicdn.net/img/view/2016/6/10/1175315.jpeg,5,0.9894436001777648,589,0,965,371,376,371,applejack|discord|fluttershy|pinkie pie|rainbow dash|rarity|scootaloo|sunset shimmer|twilight sparkle,rosegloom
1175648.jpeg,https://derpicdn.net/img/view/2016/6/11/1175648.jpeg,0,0.9950448274612428,411,1244,1027,1860,616,616,applejack|discord|fluttershy|mane six|pinkie pie|queen chrysalis|rainbow dash|rarity|spike|twilight sparkle,chibi-jen-hen
1175648.jpeg,https://derpicdn.net/img/view/2016/6/11/1175648.jpeg,2,0.9604775905609132,914,1422,1382,1890,468,468,applejack|discord|fluttershy|mane six|pinkie pie|queen chrysalis|rainbow dash|rarity|spike|twilight sparkle,chibi-jen-hen
1176239.jpeg,https://derpicdn.net/img/view/2016/6/11/1176239.jpeg,0,0.9751079678535458,657,630,933,906,276,276,applejack|fluttershy|mane six|pinkie pie|princess celestia|rainbow dash|rarity|twilight sparkle,mechagen
1176519.jpeg,https://derpicdn.net/img/view/2016/6/12/1176519.jpeg,0,0.9903901815414428,1104,2980,2310,4186,1206,1206,applejack|fluttershy|mane six|pinkie pie|rainbow dash|rarity|twilight sparkle,chibi-jen-hen
1176519.jpeg,https://derpicdn.net/img/view/2016/6/12/1176519.jpeg,1,0.9355047345161438,2060,40,3198,1178,1138,1138,applejack|fluttershy|mane six|pinkie pie|rainbow dash|rarity|twilight sparkle,chibi-jen-hen
1176519.jpeg,https://derpicdn.net/img/view/2016/6/12/1176519.jpeg,2,0.9130002856254578,2031,1580,3149,2698,1118,1118,applejack|fluttershy|mane six|pinkie pie|rainbow dash|rarity|twilight sparkle,chibi-jen-hen
1180306.jpeg,https://derpicdn.net/img/view/2016/6/17/1180306.jpeg,0,0.9994255304336548,448,76,1044,672,596,596,applejack|fluttershy|mane six|pinkie pie|rainbow dash|rarity|twilight sparkle,luthythekitty
1180306.jpeg,https://derpicdn.net/img/view/2016/6/17/1180306.jpeg,1,0.989673912525177,1925,68,2550,694,625,626,applejack|fluttershy|mane six|pinkie pie|rainbow dash|rarity|twilight sparkle,luthythekitty
1180306.jpeg,https://derpicdn.net/img/view/2016/6/17/1180306.jpeg,2,0.987642765045166,1185,26,1799,640,614,614,applejack|fluttershy|mane six|pinkie pie|rainbow dash|rarity|twilight sparkle,luthythekitty
1180306.jpeg,https://derpicdn.net/img/view/2016/6/17/1180306.jpeg,3,0.975882053375244,870,85,1446,661,576,576,applejack|fluttershy|mane six|pinkie pie|rainbow dash|rarity|twilight sparkle,luthythekitty
1181415.jpeg,https://derpicdn.net/img/view/2016/6/18/1181415.jpeg,0,0.9830209612846376,0,78,455,552,455,474,applejack|rarity|spike|twilight sparkle,yuwentaiji
1184727.jpeg,https://derpicdn.net/img/view/2016/6/23/1184727.jpeg,0,0.9962402582168579,2123,272,3065,1214,942,942,applejack|fluttershy|mane six|pinkie pie|rainbow dash|rarity|twilight sparkle,mama_monstrosity
1185319.jpeg,https://derpicdn.net/img/view/2016/6/23/1185319.jpeg,0,0.9489762187004088,21,0,365,337,344,337,starlight glimmer|twilight sparkle,invisibleone11
1186402.jpeg,https://derpicdn.net/img/view/2016/6/25/1186402.jpeg,0,0.9882032871246338,2201,0,3213,883,1012,883,applejack|fluttershy|mane six|pinkie pie|rainbow dash|rarity|twilight sparkle,zilvart
1187478.jpeg,https://derpicdn.net/img/view/2016/6/26/1187478.jpeg,0,0.9914206266403198,179,57,529,407,350,350,princess celestia|princess luna|twilight sparkle,silfoe|powercat
1187994.jpeg,https://derpicdn.net/img/view/2016/6/27/1187994.jpeg,0,0.9865817427635192,157,47,467,357,310,310,rainbow dash|twilight sparkle,jaytheartsypone
1188667.jpeg,https://derpicdn.net/img/view/2016/6/28/1188667.jpeg,0,0.9845359921455384,873,661,2201,1989,1328,1328,sunset shimmer|twilight sparkle,sol-r
1193501.jpeg,https://derpicdn.net/img/view/2016/7/4/1193501.jpeg,0,0.9889045357704164,92,962,304,1174,212,212,applejack|fluttershy|mane six|pinkie pie|rainbow dash|rarity|twilight sparkle,jay fosgitt
1196206.jpeg,https://derpicdn.net/img/view/2016/7/8/1196206.jpeg,0,0.9938288927078248,735,0,1305,542,570,542,trixie|twilight sparkle,wieczornykac
1196206.jpeg,https://derpicdn.net/img/view/2016/7/8/1196206.jpeg,1,0.988035261631012,251,0,937,647,686,647,trixie|twilight sparkle,wieczornykac
1196536.jpeg,https://derpicdn.net/img/view/2016/7/9/1196536.jpeg,0,0.9719251990318298,421,0,1500,870,1079,870,queen chrysalis|twilight sparkle,sahikari
1197185.jpeg,https://derpicdn.net/img/view/2016/7/10/1197185.jpeg,0,0.9932504296302797,440,703,726,989,286,286,fluttershy|pinkie pie|rainbow dash|spike|starlight glimmer|trixie|twilight sparkle,yaaaco
1197185.jpeg,https://derpicdn.net/img/view/2016/7/10/1197185.jpeg,2,0.9810132384300232,336,144,606,414,270,270,fluttershy|pinkie pie|rainbow dash|spike|starlight glimmer|trixie|twilight sparkle,yaaaco
1200983.jpeg,https://derpicdn.net/img/view/2016/7/14/1200983.jpeg,0,0.9852676391601562,1041,31,1333,323,292,292,fluttershy|twilight sparkle,carnifex
1203042.jpeg,https://derpicdn.net/img/view/2016/7/17/1203042.jpeg,0,0.9877469539642334,278,1146,426,1294,148,148,princess cadance|princess celestia|princess flurry heart|princess luna|twilight sparkle,hairyfood
1203042.jpeg,https://derpicdn.net/img/view/2016/7/17/1203042.jpeg,1,0.9254053235054016,242,653,432,843,190,190,princess cadance|princess celestia|princess flurry heart|princess luna|twilight sparkle,hairyfood
1203046.jpeg,https://derpicdn.net/img/view/2016/7/17/1203046.jpeg,0,0.985488772392273,9,305,277,573,268,268,spike|twilight sparkle,hairyfood
1203046.jpeg,https://derpicdn.net/img/view/2016/7/17/1203046.jpeg,1,0.9116432070732116,368,439,580,651,212,212,spike|twilight sparkle,hairyfood
1204334.jpeg,https://derpicdn.net/img/view/2016/7/19/1204334.jpeg,0,0.9797017574310304,242,75,1160,993,918,918,fluttershy|twilight sparkle,comet0ne|swagalicious-tony
1204334.jpeg,https://derpicdn.net/img/view/2016/7/19/1204334.jpeg,1,0.9479302763938904,1172,12,2144,984,972,972,fluttershy|twilight sparkle,comet0ne|swagalicious-tony
1204434.jpeg,https://derpicdn.net/img/view/2016/7/19/1204434.jpeg,0,0.99961119890213,1273,515,1599,841,326,326,applejack|fluttershy|mane six|pinkie pie|rainbow dash|rarity|twilight sparkle,vanillaghosties
1204434.jpeg,https://derpicdn.net/img/view/2016/7/19/1204434.jpeg,1,0.9961417913436892,614,469,984,839,370,370,applejack|fluttershy|mane six|pinkie pie|rainbow dash|rarity|twilight sparkle,vanillaghosties
1204434.jpeg,https://derpicdn.net/img/view/2016/7/19/1204434.jpeg,2,0.9931135177612304,276,482,658,864,382,382,applejack|fluttershy|mane six|pinkie pie|rainbow dash|rarity|twilight sparkle,vanillaghosties
1204434.jpeg,https://derpicdn.net/img/view/2016/7/19/1204434.jpeg,3,0.9768829941749572,888,426,1334,872,446,446,applejack|fluttershy|mane six|pinkie pie|rainbow dash|rarity|twilight sparkle,vanillaghosties
1204549.jpeg,https://derpicdn.net/img/view/2016/7/19/1204549.jpeg,0,0.9692279696464542,725,542,995,812,270,270,princess cadance|princess flurry heart|shining armor|starlight glimmer|twilight sparkle,misiekpl
1204549.jpeg,https://derpicdn.net/img/view/2016/7/19/1204549.jpeg,1,0.9524327516555786,1314,476,1704,866,390,390,princess cadance|princess flurry heart|shining armor|starlight glimmer|twilight sparkle,misiekpl
1205141.jpeg,https://derpicdn.net/img/view/2016/7/20/1205141.jpeg,0,0.9664342403411864,215,105,517,407,302,302,trixie|twilight sparkle,pixelkitties
1205481.jpeg,https://derpicdn.net/img/view/2016/7/20/1205481.jpeg,2,0.9940677881240844,204,791,636,1223,432,432,applejack|fluttershy|mane six|pinkie pie|rainbow dash|rarity|twilight sparkle,insanerobocat
1205481.jpeg,https://derpicdn.net/img/view/2016/7/20/1205481.jpeg,3,0.9813838601112366,1586,619,2278,1311,692,692,applejack|fluttershy|mane six|pinkie pie|rainbow dash|rarity|twilight sparkle,insanerobocat
1205481.jpeg,https://derpicdn.net/img/view/2016/7/20/1205481.jpeg,4,0.9361073970794678,77,12,645,580,568,568,applejack|fluttershy|mane six|pinkie pie|rainbow dash|rarity|twilight sparkle,insanerobocat
1207334.jpeg,https://derpicdn.net/img/view/2016/7/23/1207334.jpeg,0,0.9645071029663086,1007,1384,1673,2050,666,666,applejack|fluttershy|mane six|pinkie pie|rainbow dash|rarity|twilight sparkle,asprin white rabbit
1207642.jpeg,https://derpicdn.net/img/view/2016/7/23/1207642.jpeg,0,0.9358198642730712,1309,271,2021,983,712,712,trixie|twilight sparkle,gunslingerpen
1208325.jpeg,https://derpicdn.net/img/view/2016/7/24/1208325.jpeg,0,0.9961305856704712,614,469,984,839,370,370,applejack|fluttershy|mane six|pinkie pie|rainbow dash|rarity|twilight sparkle,vanillaghosties
1208325.jpeg,https://derpicdn.net/img/view/2016/7/24/1208325.jpeg,1,0.9931121468544006,276,482,658,864,382,382,applejack|fluttershy|mane six|pinkie pie|rainbow dash|rarity|twilight sparkle,vanillaghosties
1208325.jpeg,https://derpicdn.net/img/view/2016/7/24/1208325.jpeg,2,0.9918205738067628,1258,496,1606,844,348,348,applejack|fluttershy|mane six|pinkie pie|rainbow dash|rarity|twilight sparkle,vanillaghosties
1208325.jpeg,https://derpicdn.net/img/view/2016/7/24/1208325.jpeg,3,0.9773460626602172,869,412,1337,880,468,468,applejack|fluttershy|mane six|pinkie pie|rainbow dash|rarity|twilight sparkle,vanillaghosties
1209502.jpeg,https://derpicdn.net/img/view/2016/7/26/1209502.jpeg,1,0.9555132389068604,776,930,1840,1994,1064,1064,trixie|twilight sparkle,ciriliko
1210295.jpeg,https://derpicdn.net/img/view/2016/7/27/1210295.jpeg,0,0.9750587344169616,299,378,843,922,544,544,starlight glimmer|sunset shimmer|trixie|twilight sparkle,vanillaghosties
1210472.jpeg,https://derpicdn.net/img/view/2016/7/27/1210472.jpeg,0,0.9831485152244568,156,120,688,652,532,532,pinkie pie|twilight sparkle,spirit-woods
1211722.jpeg,https://derpicdn.net/img/view/2016/7/29/1211722.jpeg,0,0.9975326061248779,513,164,945,596,432,432,princess luna|twilight sparkle,twigpony
1212847.jpeg,https://derpicdn.net/img/view/2016/7/30/1212847.jpeg,1,0.9972150325775146,1284,19,1654,389,370,370,princess celestia|princess luna|rainbow dash|twilight sparkle,askbubblelee
1212847.jpeg,https://derpicdn.net/img/view/2016/7/30/1212847.jpeg,3,0.9451714158058168,406,232,690,516,284,284,princess celestia|princess luna|rainbow dash|twilight sparkle,askbubblelee
1214714.jpeg,https://derpicdn.net/img/view/2016/8/1/1214714.jpeg,0,0.9248420596122742,264,141,638,515,374,374,fluttershy|twilight sparkle,ara
1215678.jpeg,https://derpicdn.net/img/view/2016/8/2/1215678.jpeg,0,0.9659425616264344,50,0,502,433,452,433,pinkie pie|twilight sparkle,xxmissteaxx
1215815.jpeg,https://derpicdn.net/img/view/2016/8/3/1215815.jpeg,0,0.9783780574798584,265,814,783,1332,518,518,applejack|fluttershy|mane six|pinkie pie|rainbow dash|rarity|twilight sparkle,baraniruchu
1215815.jpeg,https://derpicdn.net/img/view/2016/8/3/1215815.jpeg,1,0.9497623443603516,1555,825,2048,1365,493,540,applejack|fluttershy|mane six|pinkie pie|rainbow dash|rarity|twilight sparkle,baraniruchu
1215815.jpeg,https://derpicdn.net/img/view/2016/8/3/1215815.jpeg,2,0.9323015809059144,188,390,676,878,488,488,applejack|fluttershy|mane six|pinkie pie|rainbow dash|rarity|twilight sparkle,baraniruchu
1217447.jpeg,https://derpicdn.net/img/view/2016/8/5/1217447.jpeg,0,0.9872487783432008,288,834,614,1160,326,326,princess cadance|shining armor|spike|twilight sparkle,wadusher0
1217447.jpeg,https://derpicdn.net/img/view/2016/8/5/1217447.jpeg,1,0.9093867540359496,743,1481,1021,1759,278,278,princess cadance|shining armor|spike|twilight sparkle,wadusher0
1217834.jpeg,https://derpicdn.net/img/view/2016/8/5/1217834.jpeg,1,0.9831445217132568,2106,558,3174,1626,1068,1068,applejack|fluttershy|mane six|pinkie pie|princess celestia|rainbow dash|rarity|spike|twilight sparkle,gsphere
1218654.jpeg,https://derpicdn.net/img/view/2016/8/6/1218654.jpeg,0,0.965008556842804,887,3684,1531,4328,644,644,spike|sunset shimmer|twilight sparkle,johnjoseco|marmerso
1219371.jpeg,https://derpicdn.net/img/view/2016/8/7/1219371.jpeg,1,0.9680912494659424,489,827,803,1141,314,314,princess cadance|princess celestia|princess luna|shining armor|twilight sparkle,evehly
1219371.jpeg,https://derpicdn.net/img/view/2016/8/7/1219371.jpeg,3,0.9238545298576356,0,111,527,669,527,558,princess cadance|princess celestia|princess luna|shining armor|twilight sparkle,evehly
1219842.jpeg,https://derpicdn.net/img/view/2016/8/8/1219842.jpeg,0,0.9998955726623536,746,594,1478,1326,732,732,princess cadance|princess celestia|princess luna|twilight sparkle,la-dafne
1219842.jpeg,https://derpicdn.net/img/view/2016/8/8/1219842.jpeg,1,0.9980858564376832,1715,923,2305,1513,590,590,princess cadance|princess celestia|princess luna|twilight sparkle,la-dafne
1220675.jpeg,https://derpicdn.net/img/view/2016/8/9/1220675.jpeg,0,0.997697412967682,1541,2182,2733,3374,1192,1192,applejack|fluttershy|mane six|pinkie pie|rainbow dash|rarity|twilight sparkle,luciferamon
1220994.jpeg,https://derpicdn.net/img/view/2016/8/9/1220994.jpeg,0,0.9126131534576416,128,393,1428,1693,1300,1300,sunset shimmer|twilight sparkle,drewmwhit
1221618.jpeg,https://derpicdn.net/img/view/2016/8/10/1221618.jpeg,0,0.9981002807617188,493,0,733,232,240,232,applejack|fluttershy|mane six|pinkie pie|rainbow dash|rarity|twilight sparkle,lindsay cibos
1221618.jpeg,https://derpicdn.net/img/view/2016/8/10/1221618.jpeg,1,0.9962444901466372,253,401,525,673,272,272,applejack|fluttershy|mane six|pinkie pie|rainbow dash|rarity|twilight sparkle,lindsay cibos
1221618.jpeg,https://derpicdn.net/img/view/2016/8/10/1221618.jpeg,3,0.9886528253555298,57,484,295,722,238,238,applejack|fluttershy|mane six|pinkie pie|rainbow dash|rarity|twilight sparkle,lindsay cibos
1221618.jpeg,https://derpicdn.net/img/view/2016/8/10/1221618.jpeg,5,0.9166340231895448,208,10,452,254,244,244,applejack|fluttershy|mane six|pinkie pie|rainbow dash|rarity|twilight sparkle,lindsay cibos
1222720.jpeg,https://derpicdn.net/img/view/2016/8/11/1222720.jpeg,0,0.9981713891029358,268,320,488,540,220,220,trixie|twilight sparkle,scorpion-89
1222720.jpeg,https://derpicdn.net/img/view/2016/8/11/1222720.jpeg,1,0.9981133937835692,490,0,1024,547,534,547,trixie|twilight sparkle,scorpion-89
1225054.jpeg,https://derpicdn.net/img/view/2016/8/14/1225054.jpeg,0,0.9003691077232361,488,184,1096,792,608,608,sunset shimmer|twilight sparkle,theorderofalisikus
1225130.jpeg,https://derpicdn.net/img/view/2016/8/14/1225130.jpeg,0,0.9896842837333679,260,298,638,676,378,378,rainbow dash|twilight sparkle,phoenixb159|phenya
1229858.jpeg,https://derpicdn.net/img/view/2016/8/20/1229858.jpeg,0,0.982720911502838,10,5,440,435,430,430,starlight glimmer|twilight sparkle,
1230589.jpeg,https://derpicdn.net/img/view/2016/8/21/1230589.jpeg,0,0.9993698000907898,260,419,1052,1211,792,792,rarity|spike|starlight glimmer|twilight sparkle,styroponyworks
1232386.jpeg,https://derpicdn.net/img/view/2016/8/23/1232386.jpeg,0,0.9864259958267212,541,0,1181,599,640,599,princess luna|twilight sparkle,silfoe
1234912.jpeg,https://derpicdn.net/img/view/2016/8/27/1234912.jpeg,0,0.9589245319366456,325,0,1280,930,955,930,rainbow dash|twilight sparkle,flutterluv
1235069.jpeg,https://derpicdn.net/img/view/2016/8/27/1235069.jpeg,0,0.9648266434669496,460,16,966,522,506,506,shining armor|twilight sparkle,zodiarkfox
1235265.jpeg,https://derpicdn.net/img/view/2016/8/27/1235265.jpeg,0,0.992463767528534,272,247,648,623,376,376,starlight glimmer|sunset shimmer|trixie|twilight sparkle,magister39|hourglass-vectors|the smiling pony|slb94|sketchmedia|cezaryy
1235986.jpeg,https://derpicdn.net/img/view/2016/8/28/1235986.jpeg,0,0.9714961051940918,686,938,1216,1468,530,530,applejack|fluttershy|mane six|pinkie pie|rainbow dash|rarity|twilight sparkle,kura
1235986.jpeg,https://derpicdn.net/img/view/2016/8/28/1235986.jpeg,1,0.9620237946510316,1050,434,1546,930,496,496,applejack|fluttershy|mane six|pinkie pie|rainbow dash|rarity|twilight sparkle,kura
1235986.jpeg,https://derpicdn.net/img/view/2016/8/28/1235986.jpeg,2,0.9552192091941832,281,919,733,1371,452,452,applejack|fluttershy|mane six|pinkie pie|rainbow dash|rarity|twilight sparkle,kura
1236223.jpeg,https://derpicdn.net/img/view/2016/8/28/1236223.jpeg,1,0.9455406665802002,213,11,539,337,326,326,princess celestia|twilight sparkle,skywalkergirl666
1237091.jpeg,https://derpicdn.net/img/view/2016/8/29/1237091.jpeg,1,0.9578083753585817,467,1197,819,1549,352,352,applejack|fluttershy|mane six|pinkie pie|rainbow dash|rarity|soarin'|spike|twilight sparkle,kikirdcz
1240018.jpeg,https://derpicdn.net/img/view/2016/9/2/1240018.jpeg,0,0.9873000383377076,0,50,387,462,387,412,spike|twilight sparkle,foudubulbe
1240063.jpeg,https://derpicdn.net/img/view/2016/9/2/1240063.jpeg,0,0.9851767420768738,340,241,558,459,218,218,fluttershy|pinkie pie|twilight sparkle,dearmary
1240404.jpeg,https://derpicdn.net/img/view/2016/9/3/1240404.jpeg,0,0.9953733682632446,204,206,462,464,258,258,starlight glimmer|sunset shimmer|trixie|twilight sparkle,mayozilla
1240581.jpeg,https://derpicdn.net/img/view/2016/9/3/1240581.jpeg,0,0.9958796501159668,557,237,813,493,256,256,fluttershy|pinkie pie|rainbow dash|rarity|twilight sparkle,hobilo
1240653.jpeg,https://derpicdn.net/img/view/2016/9/3/1240653.jpeg,0,0.9961603283882141,951,922,1397,1368,446,446,applejack|fluttershy|mane six|pinkie pie|rainbow dash|rarity|twilight sparkle,caibaoreturn
1240653.jpeg,https://derpicdn.net/img/view/2016/9/3/1240653.jpeg,1,0.9850366711616516,91,432,745,1086,654,654,applejack|fluttershy|mane six|pinkie pie|rainbow dash|rarity|twilight sparkle,caibaoreturn
1240653.jpeg,https://derpicdn.net/img/view/2016/9/3/1240653.jpeg,2,0.9839819669723512,644,73,1050,479,406,406,applejack|fluttershy|mane six|pinkie pie|rainbow dash|rarity|twilight sparkle,caibaoreturn
1240653.jpeg,https://derpicdn.net/img/view/2016/9/3/1240653.jpeg,4,0.9581764340400696,42,1134,664,1756,622,622,applejack|fluttershy|mane six|pinkie pie|rainbow dash|rarity|twilight sparkle,caibaoreturn
1240653.jpeg,https://derpicdn.net/img/view/2016/9/3/1240653.jpeg,5,0.9153996109962464,796,1325,1320,1849,524,524,applejack|fluttershy|mane six|pinkie pie|rainbow dash|rarity|twilight sparkle,caibaoreturn
1240700.jpeg,https://derpicdn.net/img/view/2016/9/3/1240700.jpeg,0,0.9671183228492736,3459,368,3769,678,310,310,pinkie pie|princess cadance|rainbow dash|starlight glimmer|twilight sparkle,
1240700.jpeg,https://derpicdn.net/img/view/2016/9/3/1240700.jpeg,1,0.9434802532196044,1050,0,1414,357,364,357,pinkie pie|princess cadance|rainbow dash|starlight glimmer|twilight sparkle,
1242176.jpeg,https://derpicdn.net/img/view/2016/9/5/1242176.jpeg,1,0.9687394499778748,844,49,1176,381,332,332,princess celestia|princess luna|twilight sparkle,magnaluna
1243495.jpeg,https://derpicdn.net/img/view/2016/9/6/1243495.jpeg,0,0.9993896484375,718,0,1280,493,562,493,princess celestia|twilight sparkle,magnaluna
1244562.jpeg,https://derpicdn.net/img/view/2016/9/8/1244562.jpeg,0,0.9873071312904358,777,333,1110,719,333,386,applejack|fluttershy|mane six|pinkie pie|rainbow dash|rarity|twilight sparkle,yoona
1244562.jpeg,https://derpicdn.net/img/view/2016/9/8/1244562.jpeg,1,0.9663418531417848,299,53,573,327,274,274,applejack|fluttershy|mane six|pinkie pie|rainbow dash|rarity|twilight sparkle,yoona
1244562.jpeg,https://derpicdn.net/img/view/2016/9/8/1244562.jpeg,2,0.9322170615196228,543,23,925,405,382,382,applejack|fluttershy|mane six|pinkie pie|rainbow dash|rarity|twilight sparkle,yoona
1248390.jpeg,https://derpicdn.net/img/view/2016/9/13/1248390.jpeg,0,0.9948592782020568,1732,0,3202,1409,1470,1409,sunset shimmer|twilight sparkle,bakumaru01
1248723.jpeg,https://derpicdn.net/img/view/2016/9/13/1248723.jpeg,0,0.9993063807487488,1407,355,1739,687,332,332,apple bloom|applejack|diamond tiara|fluttershy|granny smith|mane six|pinkie pie|rainbow dash|rarity|starlight glimmer|sunset shimmer|sweetie belle|trixie|twilight sparkle,陳芫茹‎
1248723.jpeg,https://derpicdn.net/img/view/2016/9/13/1248723.jpeg,1,0.9979678392410278,1129,1545,1441,1857,312,312,apple bloom|applejack|diamond tiara|fluttershy|granny smith|mane six|pinkie pie|rainbow dash|rarity|starlight glimmer|sunset shimmer|sweetie belle|trixie|twilight sparkle,陳芫茹‎
1248723.jpeg,https://derpicdn.net/img/view/2016/9/13/1248723.jpeg,2,0.997181236743927,343,718,697,1072,354,354,apple bloom|applejack|diamond tiara|fluttershy|granny smith|mane six|pinkie pie|rainbow dash|rarity|starlight glimmer|sunset shimmer|sweetie belle|trixie|twilight sparkle,陳芫茹‎
1248723.jpeg,https://derpicdn.net/img/view/2016/9/13/1248723.jpeg,4,0.9946088194847108,0,730,342,1076,342,346,apple bloom|applejack|diamond tiara|fluttershy|granny smith|mane six|pinkie pie|rainbow dash|rarity|starlight glimmer|sunset shimmer|sweetie belle|trixie|twilight sparkle,陳芫茹‎
1248723.jpeg,https://derpicdn.net/img/view/2016/9/13/1248723.jpeg,7,0.9849840402603148,340,1147,662,1469,322,322,apple bloom|applejack|diamond tiara|fluttershy|granny smith|mane six|pinkie pie|rainbow dash|rarity|starlight glimmer|sunset shimmer|sweetie belle|trixie|twilight sparkle,陳芫茹‎
1248723.jpeg,https://derpicdn.net/img/view/2016/9/13/1248723.jpeg,8,0.9813014268875122,0,375,288,675,288,300,apple bloom|applejack|diamond tiara|fluttershy|granny smith|mane six|pinkie pie|rainbow dash|rarity|starlight glimmer|sunset shimmer|sweetie belle|trixie|twilight sparkle,陳芫茹‎
1248723.jpeg,https://derpicdn.net/img/view/2016/9/13/1248723.jpeg,9,0.9778842329978944,1443,1126,1805,1488,362,362,apple bloom|applejack|diamond tiara|fluttershy|granny smith|mane six|pinkie pie|rainbow dash|rarity|starlight glimmer|sunset shimmer|sweetie belle|trixie|twilight sparkle,陳芫茹‎
1248723.jpeg,https://derpicdn.net/img/view/2016/9/13/1248723.jpeg,10,0.9661453366279602,363,0,685,302,322,302,apple bloom|applejack|diamond tiara|fluttershy|granny smith|mane six|pinkie pie|rainbow dash|rarity|starlight glimmer|sunset shimmer|sweetie belle|trixie|twilight sparkle,陳芫茹‎
1248737.jpeg,https://derpicdn.net/img/view/2016/9/13/1248737.jpeg,0,0.9890201687812804,3054,1148,3574,1668,520,520,princess celestia|twilight sparkle,raikoh
1249549.jpeg,https://derpicdn.net/img/view/2016/9/15/1249549.jpeg,0,0.9922482967376708,228,358,582,712,354,354,princess luna|twilight sparkle,silfoe
1250211.jpeg,https://derpicdn.net/img/view/2016/9/16/1250211.jpeg,0,0.9271723628044128,120,64,354,298,234,234,sunset shimmer|twilight sparkle,aka-ryuga
1251676.jpeg,https://derpicdn.net/img/view/2016/9/17/1251676.jpeg,0,0.9920058250427246,91,260,383,552,292,292,princess cadance|princess flurry heart|spike|twilight sparkle,silfoe
1254151.jpeg,https://derpicdn.net/img/view/2016/9/20/1254151.jpeg,0,0.9917421340942384,295,157,445,307,150,150,applejack|fluttershy|mane six|pinkie pie|rainbow dash|rarity|twilight sparkle,caibaoreturn|saturnspace|begasus
1254151.jpeg,https://derpicdn.net/img/view/2016/9/20/1254151.jpeg,1,0.9608227610588074,527,157,695,325,168,168,applejack|fluttershy|mane six|pinkie pie|rainbow dash|rarity|twilight sparkle,caibaoreturn|saturnspace|begasus
1254596.jpeg,https://derpicdn.net/img/view/2016/9/21/1254596.jpeg,0,0.9498138427734376,33,285,261,513,228,228,applejack|fluttershy|mane six|pinkie pie|princess celestia|rainbow dash|rarity|spike|twilight sparkle,yoshimarsart
1254596.jpeg,https://derpicdn.net/img/view/2016/9/21/1254596.jpeg,1,0.946144700050354,787,258,1024,502,237,244,applejack|fluttershy|mane six|pinkie pie|princess celestia|rainbow dash|rarity|spike|twilight sparkle,yoshimarsart
1255438.jpeg,https://derpicdn.net/img/view/2016/9/22/1255438.jpeg,1,0.9604966640472412,0,0,999,854,999,854,starlight glimmer|sunset shimmer|trixie|twilight sparkle,mosamosa_n
1255729.jpeg,https://derpicdn.net/img/view/2016/9/22/1255729.jpeg,0,0.9958418011665344,346,91,626,371,280,280,sunset shimmer|twilight sparkle,texasuberalles
1255854.jpeg,https://derpicdn.net/img/view/2016/9/23/1255854.jpeg,0,0.9960170984268188,390,0,874,474,484,474,sunset shimmer|twilight sparkle,pastel-pony-pictures
1258859.jpeg,https://derpicdn.net/img/view/2016/9/26/1258859.jpeg,0,0.9976815581321716,509,274,771,536,262,262,pinkie pie|princess celestia|queen chrysalis|rainbow dash|shining armor|spike|spitfire|twilight sparkle,andypriceart
1258859.jpeg,https://derpicdn.net/img/view/2016/9/26/1258859.jpeg,2,0.9839420914649964,170,750,420,1000,250,250,pinkie pie|princess celestia|queen chrysalis|rainbow dash|shining armor|spike|spitfire|twilight sparkle,andypriceart
1259465.jpeg,https://derpicdn.net/img/view/2016/9/27/1259465.jpeg,0,0.9940071105957032,177,3,469,295,292,292,pinkie pie|twilight sparkle,telltale-sheriff
1259474.jpeg,https://derpicdn.net/img/view/2016/9/27/1259474.jpeg,0,0.9989781975746156,386,533,1234,1381,848,848,trixie|twilight sparkle,americananomaly
1259484.jpeg,https://derpicdn.net/img/view/2016/9/27/1259484.jpeg,0,0.9806388020515442,555,1559,1175,2179,620,620,apple bloom|applejack|big macintosh|braeburn|cutie mark crusaders|fluttershy|granny smith|mane six|pinkie pie|rainbow dash|rarity|scootaloo|spike|sweetie belle|twilight sparkle,mohawkrex
1259484.jpeg,https://derpicdn.net/img/view/2016/9/27/1259484.jpeg,1,0.9187944531440736,289,2885,775,3371,486,486,apple bloom|applejack|big macintosh|braeburn|cutie mark crusaders|fluttershy|granny smith|mane six|pinkie pie|rainbow dash|rarity|scootaloo|spike|sweetie belle|twilight sparkle,mohawkrex
1259696.jpeg,https://derpicdn.net/img/view/2016/9/27/1259696.jpeg,0,0.9418709278106692,2715,0,3045,301,330,301,applejack|fluttershy|mane six|pinkie pie|rainbow dash|rarity|twilight sparkle,rainbowhitter
1260736.jpeg,https://derpicdn.net/img/view/2016/9/29/1260736.jpeg,0,0.9820233583450316,533,778,729,974,196,196,applejack|fluttershy|mane six|pinkie pie|rainbow dash|rarity|sunset shimmer|twilight sparkle,stoneyashes
1260736.jpeg,https://derpicdn.net/img/view/2016/9/29/1260736.jpeg,2,0.9666191339492798,148,769,316,937,168,168,applejack|fluttershy|mane six|pinkie pie|rainbow dash|rarity|sunset shimmer|twilight sparkle,stoneyashes
1260736.jpeg,https://derpicdn.net/img/view/2016/9/29/1260736.jpeg,3,0.9272422790527344,243,710,469,936,226,226,applejack|fluttershy|mane six|pinkie pie|rainbow dash|rarity|sunset shimmer|twilight sparkle,stoneyashes
1260736.jpeg,https://derpicdn.net/img/view/2016/9/29/1260736.jpeg,4,0.9149764180183412,588,638,760,810,172,172,applejack|fluttershy|mane six|pinkie pie|rainbow dash|rarity|sunset shimmer|twilight sparkle,stoneyashes
1261398.jpeg,https://derpicdn.net/img/view/2016/9/30/1261398.jpeg,0,0.9923959374427797,868,348,1296,776,428,428,rarity|spike|starlight glimmer|twilight sparkle,
1261398.jpeg,https://derpicdn.net/img/view/2016/9/30/1261398.jpeg,1,0.9840665459632874,990,1143,1396,1549,406,406,rarity|spike|starlight glimmer|twilight sparkle,
1261398.jpeg,https://derpicdn.net/img/view/2016/9/30/1261398.jpeg,2,0.9496104121208192,353,17,875,539,522,522,rarity|spike|starlight glimmer|twilight sparkle,
1261482.jpeg,https://derpicdn.net/img/view/2016/9/30/1261482.jpeg,0,0.9081538915634156,163,99,753,689,590,590,princess celestia|twilight sparkle,magnaluna
1263217.jpeg,https://derpicdn.net/img/view/2016/10/2/1263217.jpeg,0,0.998129665851593,760,578,1018,836,258,258,applejack|fluttershy|mane six|pinkie pie|rainbow dash|rarity|twilight sparkle,slawomiro
1263217.jpeg,https://derpicdn.net/img/view/2016/10/2/1263217.jpeg,2,0.9029375314712524,566,579,810,823,244,244,applejack|fluttershy|mane six|pinkie pie|rainbow dash|rarity|twilight sparkle,slawomiro
1264190.jpeg,https://derpicdn.net/img/view/2016/10/3/1264190.jpeg,0,0.9699002504348756,738,31,1150,443,412,412,princess celestia|twilight sparkle,traupa
1264321.jpeg,https://derpicdn.net/img/view/2016/10/3/1264321.jpeg,0,0.9918013215065002,126,415,748,1037,622,622,spike|twilight sparkle,exelzior
1264642.jpeg,https://derpicdn.net/img/view/2016/10/4/1264642.jpeg,0,0.998655080795288,476,22,828,374,352,352,applejack|fluttershy|mane six|pinkie pie|rainbow dash|rarity|twilight sparkle,manifest harmony
1266245.jpeg,https://derpicdn.net/img/view/2016/10/6/1266245.jpeg,0,0.9617438912391664,6070,279,7852,2061,1782,1782,princess cadance|princess celestia|princess luna|twilight sparkle,coconuthound
1267152.jpeg,https://derpicdn.net/img/view/2016/10/7/1267152.jpeg,0,0.9880570769309998,948,485,1526,1063,578,578,pinkie pie|rainbow dash|soarin'|starlight glimmer|twilight sparkle,kikirdcz
1267194.jpeg,https://derpicdn.net/img/view/2016/10/7/1267194.jpeg,0,0.9732460379600524,426,19,720,313,294,294,rainbow dash|twilight sparkle,xjkenny
1267249.jpeg,https://derpicdn.net/img/view/2016/10/7/1267249.jpeg,0,0.9606751799583436,1533,1931,1921,2319,388,388,applejack|fluttershy|mane six|pinkie pie|princess cadance|princess flurry heart|queen chrysalis|rainbow dash|rarity|shining armor|spike|starlight glimmer|twilight sparkle,
1269383.jpeg,https://derpicdn.net/img/view/2016/10/10/1269383.jpeg,0,0.9827036261558532,49,63,529,543,480,480,spike|twilight sparkle,silfoe
1269722.jpeg,https://derpicdn.net/img/view/2016/10/10/1269722.jpeg,0,0.9978914260864258,1198,257,1704,763,506,506,applejack|fluttershy|mane six|pinkie pie|rainbow dash|rarity|twilight sparkle,mannybcadavera
1269722.jpeg,https://derpicdn.net/img/view/2016/10/10/1269722.jpeg,2,0.9891163110733032,1607,309,2039,741,432,432,applejack|fluttershy|mane six|pinkie pie|rainbow dash|rarity|twilight sparkle,mannybcadavera
1270890.jpeg,https://derpicdn.net/img/view/2016/10/11/1270890.jpeg,1,0.939622163772583,56,30,218,192,162,162,starlight glimmer|twilight sparkle,agnesgarbowska
1272622.jpeg,https://derpicdn.net/img/view/2016/10/14/1272622.jpeg,0,0.9956901073455808,1068,375,1780,1087,712,712,starlight glimmer|twilight sparkle,avchonline
1272622.jpeg,https://derpicdn.net/img/view/2016/10/14/1272622.jpeg,1,0.9167667031288148,328,438,1060,1170,732,732,starlight glimmer|twilight sparkle,avchonline
1274692.jpeg,https://derpicdn.net/img/view/2016/10/16/1274692.jpeg,0,0.9967946410179138,0,169,322,529,322,360,rainbow dash|twilight sparkle,chub-wub
1275823.jpeg,https://derpicdn.net/img/view/2016/10/18/1275823.jpeg,0,0.9978556036949158,1821,346,2495,1020,674,674,applejack|pinkie pie|princess celestia|rainbow dash|rarity|scootaloo|sweetie belle|twilight sparkle,pembroke
1277603.jpeg,https://derpicdn.net/img/view/2016/10/20/1277603.jpeg,0,0.9337787628173828,295,106,669,480,374,374,princess luna|twilight sparkle,silfoe
1278508.jpeg,https://derpicdn.net/img/view/2016/10/22/1278508.jpeg,0,0.9208234548568726,113,57,529,473,416,416,trixie|twilight sparkle,2074
1279345.jpeg,https://derpicdn.net/img/view/2016/10/23/1279345.jpeg,0,0.9977821111679076,786,451,1146,811,360,360,applejack|fluttershy|mane six|pinkie pie|rainbow dash|rarity|starlight glimmer|twilight sparkle,tyuubatu
1279345.jpeg,https://derpicdn.net/img/view/2016/10/23/1279345.jpeg,2,0.9868684411048888,25,215,311,501,286,286,applejack|fluttershy|mane six|pinkie pie|rainbow dash|rarity|starlight glimmer|twilight sparkle,tyuubatu
1279345.jpeg,https://derpicdn.net/img/view/2016/10/23/1279345.jpeg,3,0.9673312902450562,486,462,808,784,322,322,applejack|fluttershy|mane six|pinkie pie|rainbow dash|rarity|starlight glimmer|twilight sparkle,tyuubatu
1279345.jpeg,https://derpicdn.net/img/view/2016/10/23/1279345.jpeg,4,0.9653881788253784,38,480,394,836,356,356,applejack|fluttershy|mane six|pinkie pie|rainbow dash|rarity|starlight glimmer|twilight sparkle,tyuubatu
1279345.jpeg,https://derpicdn.net/img/view/2016/10/23/1279345.jpeg,5,0.9457364082336426,296,491,554,749,258,258,applejack|fluttershy|mane six|pinkie pie|rainbow dash|rarity|starlight glimmer|twilight sparkle,tyuubatu
1280918.jpeg,https://derpicdn.net/img/view/2016/10/25/1280918.jpeg,0,0.98638653755188,420,0,874,382,454,382,starlight glimmer|sunset shimmer|twilight sparkle,angeltorchic
1282194.jpeg,https://derpicdn.net/img/view/2016/10/26/1282194.jpeg,0,0.9975630044937134,589,140,997,548,408,408,princess celestia|twilight sparkle,magnaluna
1282194.jpeg,https://derpicdn.net/img/view/2016/10/26/1282194.jpeg,1,0.956244707107544,70,0,572,431,502,431,princess celestia|twilight sparkle,magnaluna
1283321.jpeg,https://derpicdn.net/img/view/2016/10/28/1283321.jpeg,1,0.9670862555503844,522,52,952,482,430,430,fluttershy|twilight sparkle,frostynightsandfairylights
1284387.jpeg,https://derpicdn.net/img/view/2016/10/29/1284387.jpeg,0,0.9957196116447448,787,303,1555,1071,768,768,spike|twilight sparkle,exelzior
1284387.jpeg,https://derpicdn.net/img/view/2016/10/29/1284387.jpeg,1,0.9908915162086488,428,671,890,1133,462,462,spike|twilight sparkle,exelzior
1286028.jpeg,https://derpicdn.net/img/view/2016/11/1/1286028.jpeg,0,0.9946853518486024,45,0,587,517,542,517,princess celestia|twilight sparkle,magnaluna
1286028.jpeg,https://derpicdn.net/img/view/2016/11/1/1286028.jpeg,1,0.9928541779518129,375,0,829,429,454,429,princess celestia|twilight sparkle,magnaluna
1286570.jpeg,https://derpicdn.net/img/view/2016/11/1/1286570.jpeg,0,0.9940502643585204,754,656,1838,1740,1084,1084,shining armor|twilight sparkle,roshichen
1286570.jpeg,https://derpicdn.net/img/view/2016/11/1/1286570.jpeg,1,0.9741332530975342,1765,0,2927,1113,1162,1113,shining armor|twilight sparkle,roshichen
1287941.jpeg,https://derpicdn.net/img/view/2016/11/3/1287941.jpeg,0,0.9895463585853576,190,78,618,506,428,428,pinkie pie|twilight sparkle,louderpony
1288087.jpeg,https://derpicdn.net/img/view/2016/11/3/1288087.jpeg,0,0.9756830334663392,163,0,1073,872,910,872,princess luna|twilight sparkle,silfoe
1288610.jpeg,https://derpicdn.net/img/view/2016/11/4/1288610.jpeg,0,0.99637371301651,142,0,1246,1016,1104,1016,applejack|fluttershy|mane six|pinkie pie|rainbow dash|rarity|starlight glimmer|twilight sparkle,bakumaru01
1288610.jpeg,https://derpicdn.net/img/view/2016/11/4/1288610.jpeg,1,0.9916428923606871,2287,891,3291,1895,1004,1004,applejack|fluttershy|mane six|pinkie pie|rainbow dash|rarity|starlight glimmer|twilight sparkle,bakumaru01
1288610.jpeg,https://derpicdn.net/img/view/2016/11/4/1288610.jpeg,3,0.9797986745834352,11,830,1133,1952,1122,1122,applejack|fluttershy|mane six|pinkie pie|rainbow dash|rarity|starlight glimmer|twilight sparkle,bakumaru01
1288610.jpeg,https://derpicdn.net/img/view/2016/11/4/1288610.jpeg,4,0.9628438353538512,1483,856,2551,1924,1068,1068,applejack|fluttershy|mane six|pinkie pie|rainbow dash|rarity|starlight glimmer|twilight sparkle,bakumaru01
1288610.jpeg,https://derpicdn.net/img/view/2016/11/4/1288610.jpeg,5,0.9268774390220642,2194,0,3254,1017,1060,1017,applejack|fluttershy|mane six|pinkie pie|rainbow dash|rarity|starlight glimmer|twilight sparkle,bakumaru01
1289921.jpeg,https://derpicdn.net/img/view/2016/11/6/1289921.jpeg,1,0.9176734685897828,2343,605,3653,1915,1310,1310,spike|twilight sparkle,lamar_bone
1290642.jpeg,https://derpicdn.net/img/view/2016/11/7/1290642.jpeg,1,0.9692130088806152,821,1198,2597,2974,1776,1776,rarity|twilight sparkle,handmantoot
1290659.jpeg,https://derpicdn.net/img/view/2016/11/7/1290659.jpeg,0,0.9821702837944032,99,99,353,353,254,254,big macintosh|discord|spike|twilight sparkle,kimberlycolors
1290878.jpeg,https://derpicdn.net/img/view/2016/11/7/1290878.jpeg,0,0.9876635670661926,47,1198,835,1986,788,788,princess luna|spike|starlight glimmer|twilight sparkle,silfoe
1290977.jpeg,https://derpicdn.net/img/view/2016/11/7/1290977.jpeg,1,0.9693443775177002,2876,1456,3660,2240,784,784,discord|princess cadance|princess celestia|princess flurry heart|princess luna|queen chrysalis|spike|starlight glimmer|trixie|twilight sparkle,xeviousgreenii
1292128.jpeg,https://derpicdn.net/img/view/2016/11/9/1292128.jpeg,0,0.903375208377838,63,641,563,1080,500,439,sunset shimmer|twilight sparkle,aka-ryuga
1292259.jpeg,https://derpicdn.net/img/view/2016/11/9/1292259.jpeg,0,0.957461953163147,755,6,1280,542,525,536,discord|twilight sparkle,mad'n evil
1292265.jpeg,https://derpicdn.net/img/view/2016/11/9/1292265.jpeg,0,0.9994202256202698,360,0,626,247,266,247,applejack|fluttershy|mane six|pinkie pie|rainbow dash|rarity|twilight sparkle,pandaamanda11
1292265.jpeg,https://derpicdn.net/img/view/2016/11/9/1292265.jpeg,1,0.9859393835067748,78,24,312,258,234,234,applejack|fluttershy|mane six|pinkie pie|rainbow dash|rarity|twilight sparkle,pandaamanda11
1292265.jpeg,https://derpicdn.net/img/view/2016/11/9/1292265.jpeg,2,0.9841424226760864,511,382,733,604,222,222,applejack|fluttershy|mane six|pinkie pie|rainbow dash|rarity|twilight sparkle,pandaamanda11
1292265.jpeg,https://derpicdn.net/img/view/2016/11/9/1292265.jpeg,3,0.9211529493331908,329,270,567,508,238,238,applejack|fluttershy|mane six|pinkie pie|rainbow dash|rarity|twilight sparkle,pandaamanda11
1293504.jpeg,https://derpicdn.net/img/view/2016/11/11/1293504.jpeg,0,0.9797722101211548,726,784,984,1042,258,258,princess cadance|shining armor|twilight sparkle,stupjam
1294237.jpeg,https://derpicdn.net/img/view/2016/11/12/1294237.jpeg,0,0.9928458929061892,793,973,1139,1319,346,346,princess cadance|princess celestia|princess flurry heart|princess luna|twilight sparkle,clefficia
1294237.jpeg,https://derpicdn.net/img/view/2016/11/12/1294237.jpeg,1,0.9807431101799012,346,843,704,1201,358,358,princess cadance|princess celestia|princess flurry heart|princess luna|twilight sparkle,clefficia
1297035.jpeg,https://derpicdn.net/img/view/2016/11/16/1297035.jpeg,1,0.9451940655708312,788,26,970,208,182,182,applejack|fluttershy|mane six|pinkie pie|rainbow dash|rarity|twilight sparkle,dun
1297242.jpeg,https://derpicdn.net/img/view/2016/11/16/1297242.jpeg,0,0.971466064453125,1541,0,3300,1414,1759,1414,princess celestia|princess luna|twilight sparkle,magnaluna
1297321.jpeg,https://derpicdn.net/img/view/2016/11/16/1297321.jpeg,0,0.9701146483421326,201,1762,429,1990,228,228,applejack|fluttershy|mane six|pinkie pie|rainbow dash|rarity|soarin'|starlight glimmer|twilight sparkle,vindhov
1297946.jpeg,https://derpicdn.net/img/view/2016/11/17/1297946.jpeg,0,0.997571051120758,503,31,927,455,424,424,sunset shimmer|twilight sparkle,windymils
1297957.jpeg,https://derpicdn.net/img/view/2016/11/17/1297957.jpeg,0,0.9382694959640504,87,288,1689,1734,1602,1446,sunset shimmer|twilight sparkle,cutepencilcase
1298396.jpeg,https://derpicdn.net/img/view/2016/11/18/1298396.jpeg,0,0.9835805296897888,0,119,386,509,386,390,pinkie pie|twilight sparkle,xjkenny
1299757.jpeg,https://derpicdn.net/img/view/2016/11/20/1299757.jpeg,0,0.9821745753288268,57,0,441,311,384,311,sunset shimmer|twilight sparkle,angeltorchic
1300191.jpeg,https://derpicdn.net/img/view/2016/11/21/1300191.jpeg,1,0.9541930556297302,2707,937,3309,1539,602,602,applejack|fluttershy|mane six|pinkie pie|princess celestia|princess luna|rainbow dash|rarity|spike|twilight sparkle,valcron
1301645.jpeg,https://derpicdn.net/img/view/2016/11/23/1301645.jpeg,0,0.99505352973938,810,674,1042,906,232,232,applejack|fluttershy|mane six|pinkie pie|princess celestia|rainbow dash|rarity|spike|twilight sparkle,tonyfleecs
1303393.jpeg,https://derpicdn.net/img/view/2016/11/25/1303393.jpeg,0,0.9988375902175904,48,0,558,477,510,477,applejack|fluttershy|mane six|pinkie pie|rainbow dash|rarity|sunset shimmer|twilight sparkle,uotapo
1303393.jpeg,https://derpicdn.net/img/view/2016/11/25/1303393.jpeg,1,0.9959363341331482,671,0,1200,527,529,527,applejack|fluttershy|mane six|pinkie pie|rainbow dash|rarity|sunset shimmer|twilight sparkle,uotapo
1303793.jpeg,https://derpicdn.net/img/view/2016/11/26/1303793.jpeg,0,0.9287623167037964,401,493,773,865,372,372,applejack|fluttershy|mane six|pinkie pie|rainbow dash|rarity|twilight sparkle,silverscarf
1304637.jpeg,https://derpicdn.net/img/view/2016/11/27/1304637.jpeg,0,0.9956586956977844,308,79,1284,1055,976,976,pinkie pie|twilight sparkle,akainu_pony
1304637.jpeg,https://derpicdn.net/img/view/2016/11/27/1304637.jpeg,1,0.9805375933647156,1669,0,2969,1215,1300,1215,pinkie pie|twilight sparkle,akainu_pony
1306885.jpeg,https://derpicdn.net/img/view/2016/11/30/1306885.jpeg,0,0.99178808927536,393,0,749,314,356,314,shining armor|twilight sparkle,
1311191.jpeg,https://derpicdn.net/img/view/2016/12/6/1311191.jpeg,0,0.9916768074035645,13,0,659,503,646,503,applejack|fluttershy|mane six|pinkie pie|rainbow dash|rarity|twilight sparkle,colorbrush
1311191.jpeg,https://derpicdn.net/img/view/2016/12/6/1311191.jpeg,3,0.9136868119239808,800,68,1144,412,344,344,applejack|fluttershy|mane six|pinkie pie|rainbow dash|rarity|twilight sparkle,colorbrush
1312136.jpeg,https://derpicdn.net/img/view/2016/12/7/1312136.jpeg,0,0.9718542695045472,1400,184,1654,438,254,254,apple bloom|applejack|babs seed|cutie mark crusaders|fluttershy|rarity|scootaloo|spitfire|sweetie belle|twilight sparkle,stuflox
1313533.jpeg,https://derpicdn.net/img/view/2016/12/9/1313533.jpeg,1,0.9294760227203368,2290,620,3474,1804,1184,1184,applejack|discord|fluttershy|mane six|pinkie pie|rainbow dash|rarity|spike|twilight sparkle,dawn22eagle
1315023.jpeg,https://derpicdn.net/img/view/2016/12/11/1315023.jpeg,1,0.9841906428337096,565,106,957,498,392,392,applejack|fluttershy|mane six|pinkie pie|rainbow dash|rarity|twilight sparkle,jgu112
1318911.jpeg,https://derpicdn.net/img/view/2016/12/16/1318911.jpeg,0,0.9889010787010192,158,731,714,1287,556,556,princess cadance|princess celestia|twilight sparkle,rariedash
1320242.jpeg,https://derpicdn.net/img/view/2016/12/18/1320242.jpeg,0,0.988201379776001,1169,159,2639,1629,1470,1470,starlight glimmer|sunset shimmer|twilight sparkle,bbqninja501st
1321532.jpeg,https://derpicdn.net/img/view/2016/12/20/1321532.jpeg,0,0.9593266248703004,0,0,462,447,462,447,applejack|fluttershy|mane six|pinkie pie|rainbow dash|rarity|spike|twilight sparkle,asianpony
1321532.jpeg,https://derpicdn.net/img/view/2016/12/20/1321532.jpeg,1,0.9201735258102416,641,83,1040,501,399,418,applejack|fluttershy|mane six|pinkie pie|rainbow dash|rarity|spike|twilight sparkle,asianpony
1322898.jpeg,https://derpicdn.net/img/view/2016/12/22/1322898.jpeg,0,0.9989773631095886,4980,3206,5852,4078,872,872,applejack|fluttershy|mane six|pinkie pie|rainbow dash|rarity|twilight sparkle,avchonline
1322898.jpeg,https://derpicdn.net/img/view/2016/12/22/1322898.jpeg,1,0.9987432360649108,2884,3346,3700,4162,816,816,applejack|fluttershy|mane six|pinkie pie|rainbow dash|rarity|twilight sparkle,avchonline
1323045.jpeg,https://derpicdn.net/img/view/2016/12/22/1323045.jpeg,0,0.9923503994941713,1009,155,1493,639,484,484,big macintosh|fluttershy|princess celestia|princess luna|rainbow dash|soarin'|spitfire|twilight sparkle,sinaherib
1323054.jpeg,https://derpicdn.net/img/view/2016/12/22/1323054.jpeg,0,0.9832335114479064,1590,61,1838,309,248,248,princess cadance|sunset shimmer|twilight sparkle,imdrunkontea
1323054.jpeg,https://derpicdn.net/img/view/2016/12/22/1323054.jpeg,1,0.9233287572860718,1235,46,1505,316,270,270,princess cadance|sunset shimmer|twilight sparkle,imdrunkontea
1323501.jpeg,https://derpicdn.net/img/view/2016/12/23/1323501.jpeg,0,0.9235239028930664,0,611,321,945,321,334,princess cadance|princess celestia|princess flurry heart|princess luna|shining armor|spike|twilight sparkle,silfoe
1324092.jpeg,https://derpicdn.net/img/view/2016/12/24/1324092.jpeg,0,0.9741640686988832,201,101,957,857,756,756,apple bloom|cutie mark crusaders|scootaloo|spike|sweetie belle|twilight sparkle,kongyi
1324110.jpeg,https://derpicdn.net/img/view/2016/12/24/1324110.jpeg,1,0.9740901589393616,625,107,1163,645,538,538,applejack|fluttershy|mane six|pinkie pie|rainbow dash|rarity|twilight sparkle,dangerblaze
1325393.jpeg,https://derpicdn.net/img/view/2016/12/26/1325393.jpeg,0,0.9582103490829468,122,16,520,414,398,398,apple bloom|applejack|big macintosh|cutie mark crusaders|fluttershy|mane six|pinkie pie|princess celestia|princess luna|queen chrysalis|rainbow dash|rarity|scootaloo|spike|sweetie belle|trixie|twilight sparkle,pokehidden
1326893.jpeg,https://derpicdn.net/img/view/2016/12/28/1326893.jpeg,0,0.9765650033950806,1326,323,1713,723,387,400,applejack|fluttershy|mane six|pinkie pie|rainbow dash|rarity|sunset shimmer|twilight sparkle,aka-ryuga
1328737.jpeg,https://derpicdn.net/img/view/2016/12/31/1328737.jpeg,0,0.993606686592102,1369,76,2207,914,838,838,applejack|fluttershy|rainbow dash|rarity|twilight sparkle,sumin6301
1328737.jpeg,https://derpicdn.net/img/view/2016/12/31/1328737.jpeg,1,0.9817139506340028,2127,506,2913,1292,786,786,applejack|fluttershy|rainbow dash|rarity|twilight sparkle,sumin6301
1328737.jpeg,https://derpicdn.net/img/view/2016/12/31/1328737.jpeg,2,0.9792580008506776,645,132,1397,884,752,752,applejack|fluttershy|rainbow dash|rarity|twilight sparkle,sumin6301
1328737.jpeg,https://derpicdn.net/img/view/2016/12/31/1328737.jpeg,3,0.9580970406532288,55,535,765,1245,710,710,applejack|fluttershy|rainbow dash|rarity|twilight sparkle,sumin6301
1329273.jpeg,https://derpicdn.net/img/view/2016/12/31/1329273.jpeg,0,0.9582103490829468,122,16,520,414,398,398,apple bloom|applejack|big macintosh|cutie mark crusaders|fluttershy|mane six|pinkie pie|princess celestia|princess luna|queen chrysalis|rainbow dash|rarity|scootaloo|spike|sweetie belle|trixie|twilight sparkle,pokehidden
1329309.jpeg,https://derpicdn.net/img/view/2016/12/31/1329309.jpeg,0,0.9991740584373474,357,575,1427,1645,1070,1070,rarity|spike|starlight glimmer|twilight sparkle,styroponyworks
1329336.jpeg,https://derpicdn.net/img/view/2016/12/31/1329336.jpeg,0,0.9987949132919312,162,397,496,731,334,334,princess celestia|twilight sparkle,magnaluna
1329336.jpeg,https://derpicdn.net/img/view/2016/12/31/1329336.jpeg,1,0.9616471529006958,394,209,728,543,334,334,princess celestia|twilight sparkle,magnaluna
1329395.jpeg,https://derpicdn.net/img/view/2017/1/1/1329395.jpeg,0,0.9754958152770996,1734,436,3288,1990,1554,1554,princess cadance|princess celestia|princess flurry heart|princess luna|shining armor|spike|twilight sparkle,silfoe
1332369.jpeg,https://derpicdn.net/img/view/2017/1/5/1332369.jpeg,0,0.9875040054321288,127,206,669,748,542,542,applejack|pinkie pie|rarity|twilight sparkle,raptor007
1333324.jpeg,https://derpicdn.net/img/view/2017/1/6/1333324.jpeg,0,0.9855540990829468,2008,467,2814,1273,806,806,spike|twilight sparkle,yunnecora
1333414.jpeg,https://derpicdn.net/img/view/2017/1/6/1333414.jpeg,1,0.9543922543525696,842,161,1274,593,432,432,applejack|fluttershy|mane six|pinkie pie|rainbow dash|rarity|twilight sparkle,mysticalpha
1333414.jpeg,https://derpicdn.net/img/view/2017/1/6/1333414.jpeg,2,0.94690603017807,482,166,908,592,426,426,applejack|fluttershy|mane six|pinkie pie|rainbow dash|rarity|twilight sparkle,mysticalpha
1335928.jpeg,https://derpicdn.net/img/view/2017/1/9/1335928.jpeg,2,0.947018027305603,0,668,852,1542,852,874,princess luna|trixie|twilight sparkle,magnaluna
1337306.jpeg,https://derpicdn.net/img/view/2017/1/11/1337306.jpeg,0,0.949144959449768,4686,1285,6162,2761,1476,1476,applejack|fluttershy|mane six|pinkie pie|rainbow dash|rarity|spike|twilight sparkle,
1337306.jpeg,https://derpicdn.net/img/view/2017/1/11/1337306.jpeg,1,0.9436898231506348,1373,1663,2479,2769,1106,1106,applejack|fluttershy|mane six|pinkie pie|rainbow dash|rarity|spike|twilight sparkle,
1337306.jpeg,https://derpicdn.net/img/view/2017/1/11/1337306.jpeg,2,0.9260748028755188,937,3294,2111,4468,1174,1174,applejack|fluttershy|mane six|pinkie pie|rainbow dash|rarity|spike|twilight sparkle,
1337306.jpeg,https://derpicdn.net/img/view/2017/1/11/1337306.jpeg,3,0.9252517223358154,3216,424,4178,1386,962,962,applejack|fluttershy|mane six|pinkie pie|rainbow dash|rarity|spike|twilight sparkle,
1338296.jpeg,https://derpicdn.net/img/view/2017/1/13/1338296.jpeg,0,0.9970068335533142,80,448,350,718,270,270,applejack|fluttershy|mane six|pinkie pie|rainbow dash|rarity|twilight sparkle,mosamosa_n
1338296.jpeg,https://derpicdn.net/img/view/2017/1/13/1338296.jpeg,1,0.996094822883606,624,453,908,737,284,284,applejack|fluttershy|mane six|pinkie pie|rainbow dash|rarity|twilight sparkle,mosamosa_n
1338296.jpeg,https://derpicdn.net/img/view/2017/1/13/1338296.jpeg,3,0.9792350530624392,928,436,1228,736,300,300,applejack|fluttershy|mane six|pinkie pie|rainbow dash|rarity|twilight sparkle,mosamosa_n
1338296.jpeg,https://derpicdn.net/img/view/2017/1/13/1338296.jpeg,4,0.9071182608604432,941,42,1213,314,272,272,applejack|fluttershy|mane six|pinkie pie|rainbow dash|rarity|twilight sparkle,mosamosa_n
1338694.jpeg,https://derpicdn.net/img/view/2017/1/13/1338694.jpeg,0,0.9992777109146118,204,57,354,207,150,150,princess celestia|princess luna|queen chrysalis|sunset shimmer|twilight sparkle,bakki
1338694.jpeg,https://derpicdn.net/img/view/2017/1/13/1338694.jpeg,1,0.9939316511154176,70,119,204,253,134,134,princess celestia|princess luna|queen chrysalis|sunset shimmer|twilight sparkle,bakki
1338694.jpeg,https://derpicdn.net/img/view/2017/1/13/1338694.jpeg,2,0.9555680751800536,293,251,417,375,124,124,princess celestia|princess luna|queen chrysalis|sunset shimmer|twilight sparkle,bakki
1342234.jpeg,https://derpicdn.net/img/view/2017/1/18/1342234.jpeg,0,0.9914667010307312,200,0,536,310,336,310,princess cadance|twilight sparkle,grokostimpy
1342234.jpeg,https://derpicdn.net/img/view/2017/1/18/1342234.jpeg,1,0.9677414894104004,399,114,713,428,314,314,princess cadance|twilight sparkle,grokostimpy
1342373.jpeg,https://derpicdn.net/img/view/2017/1/18/1342373.jpeg,1,0.9893312454223632,439,974,1609,2144,1170,1170,sunset shimmer|twilight sparkle,scarletskitty12
1342511.jpeg,https://derpicdn.net/img/view/2017/1/19/1342511.jpeg,0,0.921679139137268,520,281,886,647,366,366,rainbow dash|twilight sparkle,helmie-d|modecom1
1343925.jpeg,https://derpicdn.net/img/view/2017/1/21/1343925.jpeg,1,0.9723045229911804,8,240,688,920,680,680,princess celestia|princess luna|twilight sparkle,magnaluna
1344054.jpeg,https://derpicdn.net/img/view/2017/1/21/1344054.jpeg,0,0.9930890798568726,0,0,644,657,644,657,princess celestia|princess luna|twilight sparkle,kawaiipony2
1344714.jpeg,https://derpicdn.net/img/view/2017/1/21/1344714.jpeg,0,0.9988248944282532,182,306,762,886,580,580,starlight glimmer|twilight sparkle,phantim
1344973.jpeg,https://derpicdn.net/img/view/2017/1/22/1344973.jpeg,0,0.9790472984313964,0,52,259,338,259,286,applejack|fluttershy|mane six|pinkie pie|rainbow dash|rarity|twilight sparkle,moyamoya kuroi
1345798.jpeg,https://derpicdn.net/img/view/2017/1/23/1345798.jpeg,0,0.9399598836898804,2775,1022,3507,1900,732,878,starlight glimmer|sunset shimmer|trixie|twilight sparkle,luciferamon
1347269.jpeg,https://derpicdn.net/img/view/2017/1/25/1347269.jpeg,0,0.9971045851707458,1499,668,2107,1276,608,608,starlight glimmer|twilight sparkle,
1347269.jpeg,https://derpicdn.net/img/view/2017/1/25/1347269.jpeg,3,0.9848393797874452,1260,1157,2376,2273,1116,1116,starlight glimmer|twilight sparkle,
1347269.jpeg,https://derpicdn.net/img/view/2017/1/25/1347269.jpeg,4,0.9824536442756652,2895,0,3671,737,776,737,starlight glimmer|twilight sparkle,
1348139.jpeg,https://derpicdn.net/img/view/2017/1/26/1348139.jpeg,0,0.9952207207679749,17,0,321,291,304,291,queen chrysalis|twilight sparkle,bloodredpegasus
1351477.jpeg,https://derpicdn.net/img/view/2017/1/30/1351477.jpeg,0,0.9752703309059144,5,3,433,431,428,428,rainbow dash|twilight sparkle,sprinkledashyt
1351616.jpeg,https://derpicdn.net/img/view/2017/1/31/1351616.jpeg,0,0.9622276425361632,353,83,987,747,634,664,rainbow dash|twilight sparkle,simby-pika
1351616.jpeg,https://derpicdn.net/img/view/2017/1/31/1351616.jpeg,1,0.917253315448761,0,109,650,789,650,680,rainbow dash|twilight sparkle,simby-pika
1351706.jpeg,https://derpicdn.net/img/view/2017/1/31/1351706.jpeg,1,0.9428456425666808,1189,9,1543,363,354,354,princess cadance|princess celestia|princess flurry heart|princess luna|queen chrysalis|rarity|twilight sparkle,rose-beuty
1351706.jpeg,https://derpicdn.net/img/view/2017/1/31/1351706.jpeg,2,0.919380247592926,284,0,804,451,520,451,princess cadance|princess celestia|princess flurry heart|princess luna|queen chrysalis|rarity|twilight sparkle,rose-beuty
1352695.jpeg,https://derpicdn.net/img/view/2017/2/1/1352695.jpeg,0,0.9124950766563416,481,250,699,468,218,218,princess celestia|princess luna|trixie|twilight sparkle,pixelkitties
1353155.jpeg,https://derpicdn.net/img/view/2017/2/2/1353155.jpeg,0,0.9720469117164612,350,415,688,753,338,338,rainbow dash|twilight sparkle,ecmonkey
1355217.jpeg,https://derpicdn.net/img/view/2017/2/4/1355217.jpeg,0,0.9457032680511476,718,652,1324,1258,606,606,princess celestia|princess luna|twilight sparkle,magnaluna
1356575.jpeg,https://derpicdn.net/img/view/2017/2/6/1356575.jpeg,0,0.9270208477973938,907,15,1441,549,534,534,princess flurry heart|twilight sparkle,newportmuse
1358601.jpeg,https://derpicdn.net/img/view/2017/2/9/1358601.jpeg,0,0.9720640778541564,283,84,1341,1142,1058,1058,rainbow dash|spike|twilight sparkle,rainbowyoshi305
1358601.jpeg,https://derpicdn.net/img/view/2017/2/9/1358601.jpeg,1,0.9589560031890868,1277,61,2377,1161,1100,1100,rainbow dash|spike|twilight sparkle,rainbowyoshi305
1358601.jpeg,https://derpicdn.net/img/view/2017/2/9/1358601.jpeg,2,0.9123902320861816,711,1536,1577,2402,866,866,rainbow dash|spike|twilight sparkle,rainbowyoshi305
1359941.jpeg,https://derpicdn.net/img/view/2017/2/11/1359941.jpeg,0,0.9994798898696899,98,0,316,196,218,196,fluttershy|pinkie pie|twilight sparkle,raikoh
1359941.jpeg,https://derpicdn.net/img/view/2017/2/11/1359941.jpeg,1,0.9953778982162476,454,0,682,217,228,217,fluttershy|pinkie pie|twilight sparkle,raikoh
1359941.jpeg,https://derpicdn.net/img/view/2017/2/11/1359941.jpeg,2,0.9056005477905272,160,400,384,624,224,224,fluttershy|pinkie pie|twilight sparkle,raikoh
1361943.jpeg,https://derpicdn.net/img/view/2017/2/13/1361943.jpeg,0,0.970428466796875,440,85,770,415,330,330,trixie|twilight sparkle,athlete-grizzle
1362826.jpeg,https://derpicdn.net/img/view/2017/2/14/1362826.jpeg,0,0.9988121390342712,131,2047,1119,3035,988,988,applejack|fluttershy|mane six|pinkie pie|rainbow dash|rarity|starlight glimmer|sunset shimmer|twilight sparkle,da3rd|tallyburd|phathusa|thecreamyowl|skoon|frist44|evilymasterful|bantha
1362826.jpeg,https://derpicdn.net/img/view/2017/2/14/1362826.jpeg,1,0.9941686987876892,296,0,1012,644,716,644,applejack|fluttershy|mane six|pinkie pie|rainbow dash|rarity|starlight glimmer|sunset shimmer|twilight sparkle,da3rd|tallyburd|phathusa|thecreamyowl|skoon|frist44|evilymasterful|bantha
1362826.jpeg,https://derpicdn.net/img/view/2017/2/14/1362826.jpeg,2,0.9893418550491332,299,1264,1251,2216,952,952,applejack|fluttershy|mane six|pinkie pie|rainbow dash|rarity|starlight glimmer|sunset shimmer|twilight sparkle,da3rd|tallyburd|phathusa|thecreamyowl|skoon|frist44|evilymasterful|bantha
1363310.jpeg,https://derpicdn.net/img/view/2017/2/15/1363310.jpeg,0,0.9538124203681946,207,59,565,417,358,358,sunset shimmer|twilight sparkle,imdrunkontea
1363586.jpeg,https://derpicdn.net/img/view/2017/2/15/1363586.jpeg,0,0.9705222249031068,2814,543,4900,2635,2086,2092,discord|trixie|twilight sparkle,poecillia-gracilis19
1364574.jpeg,https://derpicdn.net/img/view/2017/2/16/1364574.jpeg,1,0.976904034614563,1254,556,2316,1618,1062,1062,princess luna|twilight sparkle,magnaluna
1365056.jpeg,https://derpicdn.net/img/view/2017/2/17/1365056.jpeg,0,0.9850161075592041,579,0,969,298,390,298,rainbow dash|twilight sparkle,cosmonaut
1365058.jpeg,https://derpicdn.net/img/view/2017/2/17/1365058.jpeg,0,0.9957507848739624,755,0,1280,432,525,432,rainbow dash|twilight sparkle,cosmonaut
1365062.jpeg,https://derpicdn.net/img/view/2017/2/17/1365062.jpeg,0,0.9707671403884888,866,0,1276,341,410,341,discord|rainbow dash|twilight sparkle,cosmonaut
1365365.jpeg,https://derpicdn.net/img/view/2017/2/17/1365365.jpeg,0,0.998605489730835,551,221,893,563,342,342,applejack|fluttershy|mane six|pinkie pie|rainbow dash|rarity|twilight sparkle,
1365365.jpeg,https://derpicdn.net/img/view/2017/2/17/1365365.jpeg,1,0.9979340434074402,1061,308,1373,620,312,312,applejack|fluttershy|mane six|pinkie pie|rainbow dash|rarity|twilight sparkle,
1365365.jpeg,https://derpicdn.net/img/view/2017/2/17/1365365.jpeg,3,0.96052086353302,17,340,369,692,352,352,applejack|fluttershy|mane six|pinkie pie|rainbow dash|rarity|twilight sparkle,
1365365.jpeg,https://derpicdn.net/img/view/2017/2/17/1365365.jpeg,4,0.9340495467185974,1547,343,1919,715,372,372,applejack|fluttershy|mane six|pinkie pie|rainbow dash|rarity|twilight sparkle,
1365451.jpeg,https://derpicdn.net/img/view/2017/2/17/1365451.jpeg,0,0.9964253306388856,1105,893,2261,2049,1156,1156,princess cadance|princess celestia|princess luna|twilight sparkle,x-bond-of-flame-x
1365574.jpeg,https://derpicdn.net/img/view/2017/2/17/1365574.jpeg,0,0.9910036325454712,893,109,1719,935,826,826,princess luna|twilight sparkle,magnaluna
1366292.jpeg,https://derpicdn.net/img/view/2017/2/18/1366292.jpeg,0,0.9956699013710022,212,47,718,553,506,506,discord|twilight sparkle,lunaritass
1366502.jpeg,https://derpicdn.net/img/view/2017/2/18/1366502.jpeg,0,0.939329981803894,515,317,1455,1257,940,940,princess celestia|twilight sparkle,magnaluna
1366954.jpeg,https://derpicdn.net/img/view/2017/2/19/1366954.jpeg,0,0.9583012461662292,54,26,352,324,298,298,rainbow dash|twilight sparkle,thecreativerey
1367000.jpeg,https://derpicdn.net/img/view/2017/2/19/1367000.jpeg,0,0.993071973323822,1797,116,2419,738,622,622,fluttershy|twilight sparkle,kyotox33jdi
1367000.jpeg,https://derpicdn.net/img/view/2017/2/19/1367000.jpeg,1,0.9604810476303101,775,211,1433,869,658,658,fluttershy|twilight sparkle,kyotox33jdi
1367897.jpeg,https://derpicdn.net/img/view/2017/2/19/1367897.jpeg,1,0.9981383085250854,1009,714,1181,886,172,172,applejack|fluttershy|mane six|pinkie pie|rainbow dash|rarity|twilight sparkle,vladiverse
1367897.jpeg,https://derpicdn.net/img/view/2017/2/19/1367897.jpeg,2,0.996602475643158,278,13,436,171,158,158,applejack|fluttershy|mane six|pinkie pie|rainbow dash|rarity|twilight sparkle,vladiverse
1367897.jpeg,https://derpicdn.net/img/view/2017/2/19/1367897.jpeg,4,0.9442248940467834,862,1357,1030,1525,168,168,applejack|fluttershy|mane six|pinkie pie|rainbow dash|rarity|twilight sparkle,vladiverse
1367897.jpeg,https://derpicdn.net/img/view/2017/2/19/1367897.jpeg,5,0.9411848783493042,825,693,965,833,140,140,applejack|fluttershy|mane six|pinkie pie|rainbow dash|rarity|twilight sparkle,vladiverse
1367897.jpeg,https://derpicdn.net/img/view/2017/2/19/1367897.jpeg,6,0.9221483469009399,194,1337,372,1515,178,178,applejack|fluttershy|mane six|pinkie pie|rainbow dash|rarity|twilight sparkle,vladiverse
1368203.jpeg,https://derpicdn.net/img/view/2017/2/20/1368203.jpeg,0,0.9965108036994934,285,260,623,598,338,338,apple bloom|applejack|cutie mark crusaders|fluttershy|pinkie pie|rarity|scootaloo|sweetie belle|twilight sparkle,pinkymynery2212
1368530.jpeg,https://derpicdn.net/img/view/2017/2/20/1368530.jpeg,0,0.9816110134124756,959,0,1651,590,692,590,sunset shimmer|twilight sparkle,aka-ryuga
1369083.jpeg,https://derpicdn.net/img/view/2017/2/21/1369083.jpeg,0,0.9693611264228821,94,103,606,615,512,512,spike|twilight sparkle,jojobibou
1369131.jpeg,https://derpicdn.net/img/view/2017/2/21/1369131.jpeg,0,0.9754319190979004,710,142,894,326,184,184,applejack|fluttershy|mane six|pinkie pie|rainbow dash|rarity|twilight sparkle,andypriceart
1369522.jpeg,https://derpicdn.net/img/view/2017/2/21/1369522.jpeg,0,0.9512465596199036,1387,0,2317,919,930,919,princess celestia|twilight sparkle,magnaluna
1370160.jpeg,https://derpicdn.net/img/view/2017/2/22/1370160.jpeg,0,0.9878849983215332,33,255,979,1201,946,946,apple bloom|cutie mark crusaders|rainbow dash|scootaloo|sweetie belle|twilight sparkle,rainbowyoshi305
1370867.jpeg,https://derpicdn.net/img/view/2017/2/23/1370867.jpeg,0,0.9647234082221984,841,400,1787,1346,946,946,rainbow dash|twilight sparkle,rainbowyoshi305
1370867.jpeg,https://derpicdn.net/img/view/2017/2/23/1370867.jpeg,1,0.9592349529266356,1294,27,2562,1493,1268,1466,rainbow dash|twilight sparkle,rainbowyoshi305
1370867.jpeg,https://derpicdn.net/img/view/2017/2/23/1370867.jpeg,2,0.9398334622383118,855,1917,1973,3035,1118,1118,rainbow dash|twilight sparkle,rainbowyoshi305
1370881.jpeg,https://derpicdn.net/img/view/2017/2/23/1370881.jpeg,0,0.9117488861083984,961,965,2513,2517,1552,1552,rainbow dash|spike|twilight sparkle,rainbowyoshi305
1372484.jpeg,https://derpicdn.net/img/view/2017/2/25/1372484.jpeg,0,0.9820184111595154,0,667,667,1345,667,678,princess luna|twilight sparkle,silfoe
1373881.jpeg,https://derpicdn.net/img/view/2017/2/26/1373881.jpeg,0,0.9470622539520264,39,5,697,663,658,658,rainbow dash|twilight sparkle,melodysweettunes
1373966.jpeg,https://derpicdn.net/img/view/2017/2/26/1373966.jpeg,0,0.9984414577484132,698,1051,916,1269,218,218,apple bloom|applejack|cutie mark crusaders|fluttershy|mane six|pinkie pie|princess celestia|princess luna|rainbow dash|rarity|scootaloo|spike|sweetie belle|twilight sparkle,silfoe
1373966.jpeg,https://derpicdn.net/img/view/2017/2/26/1373966.jpeg,1,0.9971892237663268,998,113,1242,357,244,244,apple bloom|applejack|cutie mark crusaders|fluttershy|mane six|pinkie pie|princess celestia|princess luna|rainbow dash|rarity|scootaloo|spike|sweetie belle|twilight sparkle,silfoe
1373966.jpeg,https://derpicdn.net/img/view/2017/2/26/1373966.jpeg,2,0.995097279548645,1031,991,1280,1241,249,250,apple bloom|applejack|cutie mark crusaders|fluttershy|mane six|pinkie pie|princess celestia|princess luna|rainbow dash|rarity|scootaloo|spike|sweetie belle|twilight sparkle,silfoe
1373966.jpeg,https://derpicdn.net/img/view/2017/2/26/1373966.jpeg,3,0.9877327084541321,258,1128,456,1326,198,198,apple bloom|applejack|cutie mark crusaders|fluttershy|mane six|pinkie pie|princess celestia|princess luna|rainbow dash|rarity|scootaloo|spike|sweetie belle|twilight sparkle,silfoe
1373966.jpeg,https://derpicdn.net/img/view/2017/2/26/1373966.jpeg,4,0.9872186183929444,554,969,754,1169,200,200,apple bloom|applejack|cutie mark crusaders|fluttershy|mane six|pinkie pie|princess celestia|princess luna|rainbow dash|rarity|scootaloo|spike|sweetie belle|twilight sparkle,silfoe
1373966.jpeg,https://derpicdn.net/img/view/2017/2/26/1373966.jpeg,5,0.9863595962524414,500,631,698,829,198,198,apple bloom|applejack|cutie mark crusaders|fluttershy|mane six|pinkie pie|princess celestia|princess luna|rainbow dash|rarity|scootaloo|spike|sweetie belle|twilight sparkle,silfoe
1373966.jpeg,https://derpicdn.net/img/view/2017/2/26/1373966.jpeg,8,0.9568694233894348,1075,511,1279,715,204,204,apple bloom|applejack|cutie mark crusaders|fluttershy|mane six|pinkie pie|princess celestia|princess luna|rainbow dash|rarity|scootaloo|spike|sweetie belle|twilight sparkle,silfoe
1373966.jpeg,https://derpicdn.net/img/view/2017/2/26/1373966.jpeg,9,0.9517216682434082,123,1006,335,1218,212,212,apple bloom|applejack|cutie mark crusaders|fluttershy|mane six|pinkie pie|princess celestia|princess luna|rainbow dash|rarity|scootaloo|spike|sweetie belle|twilight sparkle,silfoe
1373966.jpeg,https://derpicdn.net/img/view/2017/2/26/1373966.jpeg,10,0.9294151663780212,352,467,556,671,204,204,apple bloom|applejack|cutie mark crusaders|fluttershy|mane six|pinkie pie|princess celestia|princess luna|rainbow dash|rarity|scootaloo|spike|sweetie belle|twilight sparkle,silfoe
1376109.jpeg,https://derpicdn.net/img/view/2017/2/28/1376109.jpeg,0,0.9030373692512512,592,0,1920,1080,1328,1080,trixie|twilight sparkle,lynchristina
1376214.jpeg,https://derpicdn.net/img/view/2017/3/1/1376214.jpeg,0,0.9995285868644714,750,24,1500,776,750,752,rarity|spike|twilight sparkle,vavacung
1376621.jpeg,https://derpicdn.net/img/view/2017/3/1/1376621.jpeg,0,0.9951154589653016,587,226,1567,1206,980,980,pinkie pie|twilight sparkle,passigcamel
1377007.jpeg,https://derpicdn.net/img/view/2017/3/2/1377007.jpeg,0,0.9945539236068726,25,532,377,884,352,352,applejack|fluttershy|pinkie pie|rainbow dash|twilight sparkle,jay fosgitt
1377293.jpeg,https://derpicdn.net/img/view/2017/3/2/1377293.jpeg,0,0.9034030437469482,561,87,1073,599,512,512,sunset shimmer|twilight sparkle,sibashen
1380827.jpeg,https://derpicdn.net/img/view/2017/3/6/1380827.jpeg,0,0.9798886179924012,826,0,1060,206,234,206,applejack|fluttershy|mane six|pinkie pie|rainbow dash|rarity|twilight sparkle,kutty-sark
1380827.jpeg,https://derpicdn.net/img/view/2017/3/6/1380827.jpeg,1,0.973238170146942,416,22,580,186,164,164,applejack|fluttershy|mane six|pinkie pie|rainbow dash|rarity|twilight sparkle,kutty-sark
1381709.jpeg,https://derpicdn.net/img/view/2017/3/7/1381709.jpeg,1,0.976707637310028,2366,787,3226,1647,860,860,princess cadance|rarity|twilight sparkle,traupa
1381709.jpeg,https://derpicdn.net/img/view/2017/3/7/1381709.jpeg,2,0.9670523405075072,3575,1083,4565,2073,990,990,princess cadance|rarity|twilight sparkle,traupa
1382127.jpeg,https://derpicdn.net/img/view/2017/3/8/1382127.jpeg,0,0.9993359446525574,380,348,584,552,204,204,princess cadance|princess celestia|princess luna|twilight sparkle,lilllyeevee
1382127.jpeg,https://derpicdn.net/img/view/2017/3/8/1382127.jpeg,1,0.9858639240264891,14,362,194,542,180,180,princess cadance|princess celestia|princess luna|twilight sparkle,lilllyeevee
1384770.jpeg,https://derpicdn.net/img/view/2017/3/11/1384770.jpeg,0,0.9942416548728944,1299,40,1773,514,474,474,applejack|fluttershy|mane six|pinkie pie|rainbow dash|rarity|twilight sparkle,tcffandoms
1384770.jpeg,https://derpicdn.net/img/view/2017/3/11/1384770.jpeg,1,0.9878138303756714,142,0,806,539,664,539,applejack|fluttershy|mane six|pinkie pie|rainbow dash|rarity|twilight sparkle,tcffandoms
1386722.jpeg,https://derpicdn.net/img/view/2017/3/14/1386722.jpeg,0,0.9802672863006592,62,19,218,175,156,156,applejack|fluttershy|pinkie pie|rainbow dash|sunset shimmer|trixie|twilight sparkle,
1388950.jpeg,https://derpicdn.net/img/view/2017/3/16/1388950.jpeg,0,0.9112415313720704,602,44,1298,740,696,696,rainbow dash|twilight sparkle,popcornhorns
1389473.jpeg,https://derpicdn.net/img/view/2017/3/17/1389473.jpeg,0,0.9967211484909058,0,0,780,714,780,714,princess cadance|princess celestia|princess luna|twilight sparkle,maniacpaint
1389473.jpeg,https://derpicdn.net/img/view/2017/3/17/1389473.jpeg,1,0.9962835311889648,763,0,1165,385,402,385,princess cadance|princess celestia|princess luna|twilight sparkle,maniacpaint
1391075.jpeg,https://derpicdn.net/img/view/2017/3/19/1391075.jpeg,0,0.9939661622047424,876,299,1310,733,434,434,princess cadance|princess celestia|shining armor|spike|twilight sparkle,harwick
1391075.jpeg,https://derpicdn.net/img/view/2017/3/19/1391075.jpeg,1,0.9887902140617372,389,42,925,578,536,536,princess cadance|princess celestia|shining armor|spike|twilight sparkle,harwick
1391707.jpeg,https://derpicdn.net/img/view/2017/3/19/1391707.jpeg,0,0.997610569000244,861,710,1129,978,268,268,applejack|fluttershy|mane six|pinkie pie|rainbow dash|rarity|spike|twilight sparkle,
1391707.jpeg,https://derpicdn.net/img/view/2017/3/19/1391707.jpeg,1,0.9543206691741944,806,390,1106,690,300,300,applejack|fluttershy|mane six|pinkie pie|rainbow dash|rarity|spike|twilight sparkle,
1391709.jpeg,https://derpicdn.net/img/view/2017/3/19/1391709.jpeg,1,0.9489923715591432,1219,0,1455,192,236,192,applejack|fluttershy|mane six|pinkie pie|princess cadance|rainbow dash|rarity|spike|twilight sparkle,
1391709.jpeg,https://derpicdn.net/img/view/2017/3/19/1391709.jpeg,6,0.9109114408493042,291,591,525,825,234,234,applejack|fluttershy|mane six|pinkie pie|princess cadance|rainbow dash|rarity|spike|twilight sparkle,
1391712.jpeg,https://derpicdn.net/img/view/2017/3/19/1391712.jpeg,2,0.9321849346160888,659,0,865,186,206,186,applejack|fluttershy|mane six|pinkie pie|rainbow dash|rarity|spike|twilight sparkle,
1393528.jpeg,https://derpicdn.net/img/view/2017/3/22/1393528.jpeg,1,0.9940327405929564,513,443,887,817,374,374,applejack|big macintosh|fluttershy|mane six|pinkie pie|princess celestia|princess luna|rainbow dash|rarity|spike|starlight glimmer|twilight sparkle,andypriceart
1397086.jpeg,https://derpicdn.net/img/view/2017/3/26/1397086.jpeg,0,0.9958390593528748,461,430,809,778,348,348,applejack|fluttershy|mane six|pinkie pie|rainbow dash|rarity|spike|twilight sparkle,billwalko
1397086.jpeg,https://derpicdn.net/img/view/2017/3/26/1397086.jpeg,1,0.9798918962478638,0,514,356,932,356,418,applejack|fluttershy|mane six|pinkie pie|rainbow dash|rarity|spike|twilight sparkle,billwalko
1397086.jpeg,https://derpicdn.net/img/view/2017/3/26/1397086.jpeg,2,0.9505484700202942,206,1005,470,1269,264,264,applejack|fluttershy|mane six|pinkie pie|rainbow dash|rarity|spike|twilight sparkle,billwalko
1397086.jpeg,https://derpicdn.net/img/view/2017/3/26/1397086.jpeg,3,0.9441371560096741,315,201,707,593,392,392,applejack|fluttershy|mane six|pinkie pie|rainbow dash|rarity|spike|twilight sparkle,billwalko
1397086.jpeg,https://derpicdn.net/img/view/2017/3/26/1397086.jpeg,4,0.9149667024612428,0,865,350,1235,350,370,applejack|fluttershy|mane six|pinkie pie|rainbow dash|rarity|spike|twilight sparkle,billwalko
1401404.jpeg,https://derpicdn.net/img/view/2017/4/1/1401404.jpeg,1,0.9888753294944764,2596,888,3286,1720,690,832,applejack|fluttershy|pinkie pie|rainbow dash|rarity|twilight sparkle,togeticisa
1401404.jpeg,https://derpicdn.net/img/view/2017/4/1/1401404.jpeg,2,0.9656085968017578,62,1005,774,1717,712,712,applejack|fluttershy|pinkie pie|rainbow dash|rarity|twilight sparkle,togeticisa
1401404.jpeg,https://derpicdn.net/img/view/2017/4/1/1401404.jpeg,3,0.9373290538787842,729,1033,1471,1775,742,742,applejack|fluttershy|pinkie pie|rainbow dash|rarity|twilight sparkle,togeticisa
1406164.jpeg,https://derpicdn.net/img/view/2017/4/7/1406164.jpeg,2,0.9911556243896484,95,926,767,1598,672,672,applejack|fluttershy|mane six|pinkie pie|rainbow dash|rarity|starlight glimmer|sunset shimmer|twilight sparkle,kumikoponylk
1406164.jpeg,https://derpicdn.net/img/view/2017/4/7/1406164.jpeg,3,0.9904250502586364,607,1007,1231,1631,624,624,applejack|fluttershy|mane six|pinkie pie|rainbow dash|rarity|starlight glimmer|sunset shimmer|twilight sparkle,kumikoponylk
1406164.jpeg,https://derpicdn.net/img/view/2017/4/7/1406164.jpeg,4,0.9821555614471436,1038,0,1370,319,332,319,applejack|fluttershy|mane six|pinkie pie|rainbow dash|rarity|starlight glimmer|sunset shimmer|twilight sparkle,kumikoponylk
1406164.jpeg,https://derpicdn.net/img/view/2017/4/7/1406164.jpeg,5,0.9764084815979004,1111,808,1748,1450,637,642,applejack|fluttershy|mane six|pinkie pie|rainbow dash|rarity|starlight glimmer|sunset shimmer|twilight sparkle,kumikoponylk
1406164.jpeg,https://derpicdn.net/img/view/2017/4/7/1406164.jpeg,6,0.9615290760993958,959,1601,1555,2197,596,596,applejack|fluttershy|mane six|pinkie pie|rainbow dash|rarity|starlight glimmer|sunset shimmer|twilight sparkle,kumikoponylk
1406326.jpeg,https://derpicdn.net/img/view/2017/4/7/1406326.jpeg,1,0.9917203187942504,1318,739,2178,1599,860,860,rainbow dash|twilight sparkle,traupa
1410369.jpeg,https://derpicdn.net/img/view/2017/4/13/1410369.jpeg,0,0.95765882730484,335,149,599,413,264,264,spike|twilight sparkle,yoshimarsart
1410811.jpeg,https://derpicdn.net/img/view/2017/4/13/1410811.jpeg,0,0.9882400035858154,289,344,449,504,160,160,applejack|fluttershy|pinkie pie|rainbow dash|rarity|twilight sparkle,moronsonofboron
1411293.jpeg,https://derpicdn.net/img/view/2017/4/14/1411293.jpeg,0,0.9980676770210266,407,0,1045,623,638,623,applejack|fluttershy|pinkie pie|rainbow dash|rarity|starlight glimmer|trixie|twilight sparkle,hiccupsdoesart
1411293.jpeg,https://derpicdn.net/img/view/2017/4/14/1411293.jpeg,2,0.9850977659225464,408,975,922,1489,514,514,applejack|fluttershy|pinkie pie|rainbow dash|rarity|starlight glimmer|trixie|twilight sparkle,hiccupsdoesart
1411293.jpeg,https://derpicdn.net/img/view/2017/4/14/1411293.jpeg,3,0.9763763546943665,0,430,294,730,294,300,applejack|fluttershy|pinkie pie|rainbow dash|rarity|starlight glimmer|trixie|twilight sparkle,hiccupsdoesart
1411473.jpeg,https://derpicdn.net/img/view/2017/4/14/1411473.jpeg,0,0.9991238713264464,1815,205,2823,1257,1008,1052,princess luna|twilight sparkle,magnaluna
1412077.jpeg,https://derpicdn.net/img/view/2017/4/15/1412077.jpeg,0,0.938666045665741,940,116,1308,484,368,368,applejack|fluttershy|mane six|pinkie pie|rainbow dash|rarity|twilight sparkle,
1412308.jpeg,https://derpicdn.net/img/view/2017/4/15/1412308.jpeg,0,0.99821537733078,256,0,648,378,392,378,princess luna|twilight sparkle,silfoe
1412699.jpeg,https://derpicdn.net/img/view/2017/4/16/1412699.jpeg,0,0.9994278550148008,973,103,1289,419,316,316,princess celestia|twilight sparkle,xbi
1412700.jpeg,https://derpicdn.net/img/view/2017/4/16/1412700.jpeg,0,0.9967015981674194,530,358,1064,892,534,534,applejack|discord|fluttershy|mane six|pinkie pie|princess celestia|princess luna|rainbow dash|rarity|soarin'|spike|spitfire|twilight sparkle,andypriceart
1412700.jpeg,https://derpicdn.net/img/view/2017/4/16/1412700.jpeg,1,0.9759218096733092,360,775,644,1059,284,284,applejack|discord|fluttershy|mane six|pinkie pie|princess celestia|princess luna|rainbow dash|rarity|soarin'|spike|spitfire|twilight sparkle,andypriceart
1413041.jpeg,https://derpicdn.net/img/view/2017/4/16/1413041.jpeg,3,0.9004995822906494,159,7,431,279,272,272,applejack|fluttershy|mane six|pinkie pie|princess cadance|princess celestia|princess flurry heart|princess luna|rainbow dash|rarity|shining armor|starlight glimmer|twilight sparkle,starlightv
1413179.jpeg,https://derpicdn.net/img/view/2017/4/16/1413179.jpeg,0,0.9475236535072328,1503,658,1920,1138,417,480,apple bloom|fluttershy|princess cadance|rainbow dash|twilight sparkle,tiffanymarsou
1413579.jpeg,https://derpicdn.net/img/view/2017/4/17/1413579.jpeg,0,0.9997373223304749,841,100,1185,444,344,344,princess cadance|twilight sparkle,spazzykoneko
1413579.jpeg,https://derpicdn.net/img/view/2017/4/17/1413579.jpeg,1,0.9996082186698914,198,17,538,357,340,340,princess cadance|twilight sparkle,spazzykoneko
1415017.jpeg,https://derpicdn.net/img/view/2017/4/18/1415017.jpeg,0,0.9417229890823364,612,433,956,777,344,344,applejack|fluttershy|mane six|pinkie pie|rainbow dash|rarity|twilight sparkle,
1415017.jpeg,https://derpicdn.net/img/view/2017/4/18/1415017.jpeg,3,0.9093729257583618,3235,1540,3651,1956,416,416,applejack|fluttershy|mane six|pinkie pie|rainbow dash|rarity|twilight sparkle,
1415017.jpeg,https://derpicdn.net/img/view/2017/4/18/1415017.jpeg,4,0.9090314507484436,2832,427,3122,717,290,290,applejack|fluttershy|mane six|pinkie pie|rainbow dash|rarity|twilight sparkle,
1415659.jpeg,https://derpicdn.net/img/view/2017/4/19/1415659.jpeg,0,0.9969168305397034,1214,1875,2400,3191,1186,1316,sunset shimmer|twilight sparkle,overlordneon
1415659.jpeg,https://derpicdn.net/img/view/2017/4/19/1415659.jpeg,2,0.9884450435638428,96,37,1262,1203,1166,1166,sunset shimmer|twilight sparkle,overlordneon
1415690.jpeg,https://derpicdn.net/img/view/2017/4/19/1415690.jpeg,0,0.94005024433136,140,134,294,288,154,154,applejack|discord|fluttershy|mane six|pinkie pie|princess celestia|princess luna|rainbow dash|rarity|soarin'|spike|spitfire|twilight sparkle,andypriceart
1415769.jpeg,https://derpicdn.net/img/view/2017/4/19/1415769.jpeg,2,0.9895514845848083,424,1030,654,1260,230,230,applejack|fluttershy|mane six|pinkie pie|rainbow dash|rarity|twilight sparkle,jay fosgitt
1416374.jpeg,https://derpicdn.net/img/view/2017/4/19/1416374.jpeg,0,0.99224054813385,65,78,317,330,252,252,applejack|fluttershy|mane six|pinkie pie|rainbow dash|rarity|starlight glimmer|twilight sparkle,soulsliver249
1416374.jpeg,https://derpicdn.net/img/view/2017/4/19/1416374.jpeg,1,0.9442103505134584,193,94,443,344,250,250,applejack|fluttershy|mane six|pinkie pie|rainbow dash|rarity|starlight glimmer|twilight sparkle,soulsliver249
1416539.jpeg,https://derpicdn.net/img/view/2017/4/20/1416539.jpeg,0,0.9055218696594238,265,6,599,340,334,334,rainbow dash|twilight sparkle,tsitra360
1418513.jpeg,https://derpicdn.net/img/view/2017/4/22/1418513.jpeg,0,0.9741391539573668,82,0,1402,923,1320,923,princess flurry heart|twilight sparkle,
1418553.jpeg,https://derpicdn.net/img/view/2017/4/22/1418553.jpeg,0,0.9961130023002625,738,92,1246,600,508,508,applejack|fluttershy|mane six|pinkie pie|rainbow dash|rarity|spike|twilight sparkle,joy-ang
1418553.jpeg,https://derpicdn.net/img/view/2017/4/22/1418553.jpeg,1,0.9139907360076904,151,646,549,1044,398,398,applejack|fluttershy|mane six|pinkie pie|rainbow dash|rarity|spike|twilight sparkle,joy-ang
1419269.jpeg,https://derpicdn.net/img/view/2017/4/23/1419269.jpeg,0,0.996681034564972,481,561,837,917,356,356,princess flurry heart|spike|twilight sparkle,saturdaymorningproj
1419507.jpeg,https://derpicdn.net/img/view/2017/4/23/1419507.jpeg,0,0.9994136095046996,309,0,1007,694,698,694,princess flurry heart|twilight sparkle,tyuubatu
1419758.jpeg,https://derpicdn.net/img/view/2017/4/23/1419758.jpeg,0,0.9346947669982908,43,0,1250,1182,1207,1182,princess flurry heart|twilight sparkle,zigrock
1421243.jpeg,https://derpicdn.net/img/view/2017/4/25/1421243.jpeg,0,0.9957223534584044,80,420,666,1006,586,586,rarity|sweetie belle|twilight sparkle,wan
1422315.jpeg,https://derpicdn.net/img/view/2017/4/26/1422315.jpeg,1,0.9362292885780334,951,570,1493,1112,542,542,princess celestia|twilight sparkle,magnaluna
1422358.jpeg,https://derpicdn.net/img/view/2017/4/26/1422358.jpeg,0,0.9964781403541564,1275,1272,1743,1740,468,468,applejack|fluttershy|mane six|pinkie pie|rainbow dash|rarity|twilight sparkle,violetashes
1422358.jpeg,https://derpicdn.net/img/view/2017/4/26/1422358.jpeg,1,0.9714443683624268,621,1295,1061,1735,440,440,applejack|fluttershy|mane six|pinkie pie|rainbow dash|rarity|twilight sparkle,violetashes
1422358.jpeg,https://derpicdn.net/img/view/2017/4/26/1422358.jpeg,2,0.957998752593994,889,645,1383,1139,494,494,applejack|fluttershy|mane six|pinkie pie|rainbow dash|rarity|twilight sparkle,violetashes
1422572.jpeg,https://derpicdn.net/img/view/2017/4/26/1422572.jpeg,1,0.9521427750587464,184,292,632,740,448,448,princess flurry heart|twilight sparkle,calena
1422771.jpeg,https://derpicdn.net/img/view/2017/4/27/1422771.jpeg,0,0.9921455979347228,471,65,937,531,466,466,applejack|fluttershy|mane six|pinkie pie|rainbow dash|rarity|twilight sparkle,edcom02|krynos79
1422809.jpeg,https://derpicdn.net/img/view/2017/4/27/1422809.jpeg,0,0.9966405630111694,887,0,1223,329,336,329,princess flurry heart|twilight sparkle,flushthebatsanta
1422938.jpeg,https://derpicdn.net/img/view/2017/4/27/1422938.jpeg,1,0.9796210527420044,192,544,710,1062,518,518,apple bloom|applejack|big macintosh|granny smith|shining armor|spike|twilight sparkle,tejedora
1424315.jpeg,https://derpicdn.net/img/view/2017/4/29/1424315.jpeg,0,0.9917005300521852,315,31,529,245,214,214,applejack|fluttershy|mane six|pinkie pie|rainbow dash|rarity|twilight sparkle,passigcamel
1424315.jpeg,https://derpicdn.net/img/view/2017/4/29/1424315.jpeg,1,0.946440577507019,22,63,204,245,182,182,applejack|fluttershy|mane six|pinkie pie|rainbow dash|rarity|twilight sparkle,passigcamel
1425099.jpeg,https://derpicdn.net/img/view/2017/4/30/1425099.jpeg,1,0.9341167211532592,292,132,754,594,462,462,starlight glimmer|trixie|twilight sparkle,gunpowdergreentea
1427831.jpeg,https://derpicdn.net/img/view/2017/5/3/1427831.jpeg,0,0.9989333152770996,0,140,680,828,680,688,rainbow dash|twilight sparkle,soshyqqq
1427971.jpeg,https://derpicdn.net/img/view/2017/5/3/1427971.jpeg,0,0.9253749847412108,0,0,2355,2146,2355,2146,apple bloom|cutie mark crusaders|scootaloo|sweetie belle|twilight sparkle,skribbler84
1428000.jpeg,https://derpicdn.net/img/view/2017/5/3/1428000.jpeg,0,0.9859387874603271,346,463,636,753,290,290,applejack|fluttershy|mane six|pinkie pie|rainbow dash|rarity|twilight sparkle,
1428000.jpeg,https://derpicdn.net/img/view/2017/5/3/1428000.jpeg,1,0.9684922695159912,221,735,583,1097,362,362,applejack|fluttershy|mane six|pinkie pie|rainbow dash|rarity|twilight sparkle,
1428000.jpeg,https://derpicdn.net/img/view/2017/5/3/1428000.jpeg,2,0.9454107284545898,544,629,846,931,302,302,applejack|fluttershy|mane six|pinkie pie|rainbow dash|rarity|twilight sparkle,
1430987.jpeg,https://derpicdn.net/img/view/2017/5/7/1430987.jpeg,0,0.9992807507514954,2820,148,3392,720,572,572,princess luna|twilight sparkle,magnaluna
1432339.jpeg,https://derpicdn.net/img/view/2017/5/9/1432339.jpeg,1,0.9920186400413512,892,305,1568,981,676,676,spike|twilight sparkle,kabukihomewood
1433028.jpeg,https://derpicdn.net/img/view/2017/5/10/1433028.jpeg,0,0.9940161705017092,271,0,1543,1079,1272,1079,princess celestia|princess luna|twilight sparkle,magnaluna
1433028.jpeg,https://derpicdn.net/img/view/2017/5/10/1433028.jpeg,1,0.9670953750610352,1497,235,2653,1391,1156,1156,princess celestia|princess luna|twilight sparkle,magnaluna
1433317.jpeg,https://derpicdn.net/img/view/2017/5/10/1433317.jpeg,0,0.966177463531494,804,239,1578,1013,774,774,rainbow dash|twilight sparkle,littlehybridshila
1433569.jpeg,https://derpicdn.net/img/view/2017/5/10/1433569.jpeg,0,0.9705619215965272,1703,733,2411,1441,708,708,rainbow dash|twilight sparkle,a8f12
1433656.jpeg,https://derpicdn.net/img/view/2017/5/10/1433656.jpeg,1,0.98441481590271,245,375,491,621,246,246,applejack|fluttershy|mane six|pinkie pie|rainbow dash|rarity|twilight sparkle,antych
1433656.jpeg,https://derpicdn.net/img/view/2017/5/10/1433656.jpeg,3,0.9390997290611268,215,0,513,276,298,276,applejack|fluttershy|mane six|pinkie pie|rainbow dash|rarity|twilight sparkle,antych
1435083.jpeg,https://derpicdn.net/img/view/2017/5/13/1435083.jpeg,0,0.9950608015060424,1217,286,1621,690,404,404,applejack|fluttershy|mane six|pinkie pie|rainbow dash|rarity|twilight sparkle,densosard
1435083.jpeg,https://derpicdn.net/img/view/2017/5/13/1435083.jpeg,1,0.9919496178627014,0,231,496,745,496,514,applejack|fluttershy|mane six|pinkie pie|rainbow dash|rarity|twilight sparkle,densosard
1435146.jpeg,https://derpicdn.net/img/view/2017/5/13/1435146.jpeg,0,0.9241126179695128,324,428,496,600,172,172,spike|twilight sparkle,mirroredsea
1435341.jpeg,https://derpicdn.net/img/view/2017/5/13/1435341.jpeg,1,0.9110260605812072,1231,1536,1654,2014,423,478,applejack|discord|fluttershy|mane six|pinkie pie|princess celestia|princess luna|rainbow dash|rarity|twilight sparkle,plainoasis
1436619.jpeg,https://derpicdn.net/img/view/2017/5/14/1436619.jpeg,0,0.9933944344520568,367,41,993,667,626,626,princess luna|twilight sparkle,silfoe
1437561.jpeg,https://derpicdn.net/img/view/2017/5/15/1437561.jpeg,0,0.9978790879249572,0,552,366,988,366,436,applejack|fluttershy|mane six|pinkie pie|rainbow dash|rarity|twilight sparkle,
1437561.jpeg,https://derpicdn.net/img/view/2017/5/15/1437561.jpeg,1,0.9976571798324584,52,279,388,615,336,336,applejack|fluttershy|mane six|pinkie pie|rainbow dash|rarity|twilight sparkle,
1437561.jpeg,https://derpicdn.net/img/view/2017/5/15/1437561.jpeg,2,0.9715962409973145,322,434,632,744,310,310,applejack|fluttershy|mane six|pinkie pie|rainbow dash|rarity|twilight sparkle,
1440748.jpeg,https://derpicdn.net/img/view/2017/5/20/1440748.jpeg,0,0.9193398952484132,424,0,716,286,292,286,pinkie pie|rainbow dash|spike|twilight sparkle,
1441670.jpeg,https://derpicdn.net/img/view/2017/5/20/1441670.jpeg,0,0.9980897307395936,6,204,936,1134,930,930,princess cadance|princess luna|twilight sparkle,silfoe
1442532.jpeg,https://derpicdn.net/img/view/2017/5/21/1442532.jpeg,0,0.993503212928772,459,0,991,504,532,504,princess celestia|princess luna|twilight sparkle,magnaluna
1442532.jpeg,https://derpicdn.net/img/view/2017/5/21/1442532.jpeg,1,0.9888865351676941,1039,58,1551,570,512,512,princess celestia|princess luna|twilight sparkle,magnaluna
1442532.jpeg,https://derpicdn.net/img/view/2017/5/21/1442532.jpeg,2,0.9872632622718812,2290,1250,2862,1822,572,572,princess celestia|princess luna|twilight sparkle,magnaluna
1442532.jpeg,https://derpicdn.net/img/view/2017/5/21/1442532.jpeg,4,0.914772629737854,373,1247,913,1787,540,540,princess celestia|princess luna|twilight sparkle,magnaluna
1443184.jpeg,https://derpicdn.net/img/view/2017/5/22/1443184.jpeg,1,0.9828396439552308,714,3,1070,359,356,356,pinkie pie|twilight sparkle,hazurasinner
1443259.jpeg,https://derpicdn.net/img/view/2017/5/22/1443259.jpeg,0,0.9983406066894532,829,0,1459,507,630,507,princess luna|twilight sparkle,magnaluna
1443259.jpeg,https://derpicdn.net/img/view/2017/5/22/1443259.jpeg,1,0.99567312002182,192,0,792,494,600,494,princess luna|twilight sparkle,magnaluna
1444253.jpeg,https://derpicdn.net/img/view/2017/5/23/1444253.jpeg,0,0.9406692385673524,683,0,971,270,288,270,applejack|fluttershy|pinkie pie|rainbow dash|rarity|twilight sparkle,pandaamanda11
1444541.jpeg,https://derpicdn.net/img/view/2017/5/24/1444541.jpeg,0,0.9823316335678101,2105,1310,3271,2476,1166,1166,starlight glimmer|twilight sparkle,avchonline
1444541.jpeg,https://derpicdn.net/img/view/2017/5/24/1444541.jpeg,1,0.91128271818161,1048,1960,2364,3276,1316,1316,starlight glimmer|twilight sparkle,avchonline
1445773.jpeg,https://derpicdn.net/img/view/2017/5/25/1445773.jpeg,0,0.9970433115959167,618,135,926,443,308,308,princess luna|spike|sunset shimmer|twilight sparkle,silfoe
1445773.jpeg,https://derpicdn.net/img/view/2017/5/25/1445773.jpeg,1,0.9815650582313538,812,92,1142,422,330,330,princess luna|spike|sunset shimmer|twilight sparkle,silfoe
1445773.jpeg,https://derpicdn.net/img/view/2017/5/25/1445773.jpeg,2,0.9799264669418336,61,86,441,466,380,380,princess luna|spike|sunset shimmer|twilight sparkle,silfoe
1445773.jpeg,https://derpicdn.net/img/view/2017/5/25/1445773.jpeg,3,0.9699914455413818,353,184,663,494,310,310,princess luna|spike|sunset shimmer|twilight sparkle,silfoe
1446520.jpeg,https://derpicdn.net/img/view/2017/5/26/1446520.jpeg,0,0.9963133931159972,1253,2559,1927,3233,674,674,applejack|fluttershy|mane six|pinkie pie|rainbow dash|rarity|spike|twilight sparkle,
1446520.jpeg,https://derpicdn.net/img/view/2017/5/26/1446520.jpeg,1,0.9822304248809814,1952,1408,2670,2126,718,718,applejack|fluttershy|mane six|pinkie pie|rainbow dash|rarity|spike|twilight sparkle,
1446520.jpeg,https://derpicdn.net/img/view/2017/5/26/1446520.jpeg,2,0.967718780040741,1858,2325,2446,2913,588,588,applejack|fluttershy|mane six|pinkie pie|rainbow dash|rarity|spike|twilight sparkle,
1446520.jpeg,https://derpicdn.net/img/view/2017/5/26/1446520.jpeg,3,0.9632009863853456,1703,427,2265,989,562,562,applejack|fluttershy|mane six|pinkie pie|rainbow dash|rarity|spike|twilight sparkle,
1446527.jpeg,https://derpicdn.net/img/view/2017/5/26/1446527.jpeg,0,0.9421277046203612,699,1085,1247,1633,548,548,princess cadance|princess celestia|princess luna|twilight sparkle,amy mebberson
1446527.jpeg,https://derpicdn.net/img/view/2017/5/26/1446527.jpeg,1,0.928768277168274,1642,1470,2198,2026,556,556,princess cadance|princess celestia|princess luna|twilight sparkle,amy mebberson
1446789.jpeg,https://derpicdn.net/img/view/2017/5/27/1446789.jpeg,0,0.995354413986206,304,7,978,681,674,674,princess luna|twilight sparkle,magnaluna
1447238.jpeg,https://derpicdn.net/img/view/2017/5/27/1447238.jpeg,0,0.9931994080543518,362,521,884,1043,522,522,applejack|fluttershy|mane six|pinkie pie|rainbow dash|rarity|twilight sparkle,kaori matsuo|s-bis
1449720.jpeg,https://derpicdn.net/img/view/2017/5/30/1449720.jpeg,0,0.9779615998268129,2512,322,2876,686,364,364,princess cadance|princess celestia|princess luna|twilight sparkle,twigpony
1449805.jpeg,https://derpicdn.net/img/view/2017/5/30/1449805.jpeg,2,0.9476839900016784,2845,425,3131,711,286,286,applejack|fluttershy|mane six|pinkie pie|rainbow dash|rarity|twilight sparkle,
1449805.jpeg,https://derpicdn.net/img/view/2017/5/30/1449805.jpeg,3,0.9280769228935242,2828,1481,3144,1797,316,316,applejack|fluttershy|mane six|pinkie pie|rainbow dash|rarity|twilight sparkle,
1450018.jpeg,https://derpicdn.net/img/view/2017/5/30/1450018.jpeg,0,0.9808026552200316,284,509,608,833,324,324,rainbow dash|twilight sparkle,
1450937.jpeg,https://derpicdn.net/img/view/2017/5/31/1450937.jpeg,0,0.9935036897659302,1215,230,1805,820,590,590,princess luna|twilight sparkle,magnaluna
1452403.jpeg,https://derpicdn.net/img/view/2017/6/2/1452403.jpeg,0,0.9977342486381532,792,912,1476,1596,684,684,starlight glimmer|twilight sparkle,cloud-drawings
1454165.jpeg,https://derpicdn.net/img/view/2017/6/4/1454165.jpeg,0,0.9986374378204346,201,740,1173,1712,972,972,rainbow dash|twilight sparkle,rublegun
1454165.jpeg,https://derpicdn.net/img/view/2017/6/4/1454165.jpeg,1,0.9724277257919312,1006,1128,1664,1786,658,658,rainbow dash|twilight sparkle,rublegun
1454348.jpeg,https://derpicdn.net/img/view/2017/6/5/1454348.jpeg,0,0.9984381794929504,550,114,1040,604,490,490,spitfire|twilight sparkle,lordstormcaller
1454467.jpeg,https://derpicdn.net/img/view/2017/6/5/1454467.jpeg,0,0.957139492034912,6,168,124,286,118,118,starlight glimmer|sunset shimmer|trixie|twilight sparkle,nekokevin
1454882.jpeg,https://derpicdn.net/img/view/2017/6/5/1454882.jpeg,1,0.9993287920951844,142,45,474,377,332,332,princess celestia|princess luna|twilight sparkle,magnaluna
1454882.jpeg,https://derpicdn.net/img/view/2017/6/5/1454882.jpeg,4,0.9950018525123596,180,2115,876,2811,696,696,princess celestia|princess luna|twilight sparkle,magnaluna
1455421.jpeg,https://derpicdn.net/img/view/2017/6/6/1455421.jpeg,0,0.9957612752914428,3188,195,3860,899,672,704,princess celestia|princess luna|twilight sparkle,magnaluna
1455421.jpeg,https://derpicdn.net/img/view/2017/6/6/1455421.jpeg,1,0.9854022264480592,1158,250,2330,1422,1172,1172,princess celestia|princess luna|twilight sparkle,magnaluna
1455421.jpeg,https://derpicdn.net/img/view/2017/6/6/1455421.jpeg,2,0.9032576084136964,435,241,1113,919,678,678,princess celestia|princess luna|twilight sparkle,magnaluna
1455505.jpeg,https://derpicdn.net/img/view/2017/6/6/1455505.jpeg,0,0.9941784739494324,172,621,1508,1957,1336,1336,sunset shimmer|twilight sparkle,scarletskitty12
1456264.jpeg,https://derpicdn.net/img/view/2017/6/7/1456264.jpeg,0,0.9881364107131958,24,0,1116,859,1092,859,princess cadance|twilight sparkle,pearlyiridescence
1457700.jpeg,https://derpicdn.net/img/view/2017/6/9/1457700.jpeg,0,0.9663185477256776,1422,220,2328,1126,906,906,princess cadance|twilight sparkle,spunkubus
1458345.jpeg,https://derpicdn.net/img/view/2017/6/10/1458345.jpeg,0,0.9756777286529541,1163,57,1483,377,320,320,applejack|princess celestia|rainbow dash|starlight glimmer|trixie|twilight sparkle,zidanemina
1458345.jpeg,https://derpicdn.net/img/view/2017/6/10/1458345.jpeg,2,0.9028134942054749,1171,505,1457,791,286,286,applejack|princess celestia|rainbow dash|starlight glimmer|trixie|twilight sparkle,zidanemina
1458345.jpeg,https://derpicdn.net/img/view/2017/6/10/1458345.jpeg,3,0.9002989530563354,79,0,521,420,442,420,applejack|princess celestia|rainbow dash|starlight glimmer|trixie|twilight sparkle,zidanemina
1458767.jpeg,https://derpicdn.net/img/view/2017/6/11/1458767.jpeg,0,0.9902099370956421,308,1,534,227,226,226,applejack|rarity|twilight sparkle,calena
1458831.jpeg,https://derpicdn.net/img/view/2017/6/11/1458831.jpeg,0,0.995415985584259,273,50,511,288,238,238,applejack|fluttershy|pinkie pie|rainbow dash|rarity|spike|twilight sparkle,joy-ang
1458831.jpeg,https://derpicdn.net/img/view/2017/6/11/1458831.jpeg,1,0.98353910446167,521,334,687,500,166,166,applejack|fluttershy|pinkie pie|rainbow dash|rarity|spike|twilight sparkle,joy-ang
1458831.jpeg,https://derpicdn.net/img/view/2017/6/11/1458831.jpeg,2,0.946285367012024,28,332,178,482,150,150,applejack|fluttershy|pinkie pie|rainbow dash|rarity|spike|twilight sparkle,joy-ang
1458853.jpeg,https://derpicdn.net/img/view/2017/6/11/1458853.jpeg,0,0.982298731803894,4087,1035,4461,1409,374,374,applejack|fluttershy|mane six|pinkie pie|rainbow dash|rarity|twilight sparkle,earthsong9405
1459109.jpeg,https://derpicdn.net/img/view/2017/6/11/1459109.jpeg,0,0.9319459795951844,282,0,598,275,316,275,starlight glimmer|twilight sparkle,
1461340.jpeg,https://derpicdn.net/img/view/2017/6/14/1461340.jpeg,0,0.9810526371002196,131,47,521,437,390,390,applejack|fluttershy|mane six|pinkie pie|rainbow dash|rarity|twilight sparkle,angel_bee
1461340.jpeg,https://derpicdn.net/img/view/2017/6/14/1461340.jpeg,1,0.9117273688316344,706,111,1184,589,478,478,applejack|fluttershy|mane six|pinkie pie|rainbow dash|rarity|twilight sparkle,angel_bee
1461516.jpeg,https://derpicdn.net/img/view/2017/6/14/1461516.jpeg,0,0.9983419179916382,1195,831,2149,1785,954,954,applejack|fluttershy|pinkie pie|rainbow dash|starlight glimmer|sunset shimmer|trixie|twilight sparkle,yuck
1461516.jpeg,https://derpicdn.net/img/view/2017/6/14/1461516.jpeg,2,0.979484796524048,1631,2955,2111,3435,480,480,applejack|fluttershy|pinkie pie|rainbow dash|starlight glimmer|sunset shimmer|trixie|twilight sparkle,yuck
1462934.jpeg,https://derpicdn.net/img/view/2017/6/16/1462934.jpeg,0,0.9978132247924804,118,0,858,660,740,660,rainbow dash|twilight sparkle,rebeliousprice
1462934.jpeg,https://derpicdn.net/img/view/2017/6/16/1462934.jpeg,1,0.9937027096748352,55,459,327,731,272,272,rainbow dash|twilight sparkle,rebeliousprice
1463654.jpeg,https://derpicdn.net/img/view/2017/6/17/1463654.jpeg,0,0.949410080909729,179,317,397,535,218,218,applejack|fluttershy|mane six|pinkie pie|rainbow dash|rarity|starlight glimmer|twilight sparkle,slifertheskydragon
1464087.jpeg,https://derpicdn.net/img/view/2017/6/17/1464087.jpeg,0,0.9994199275970459,384,4,600,220,216,216,applejack|discord|fluttershy|mane six|pinkie pie|princess cadance|princess celestia|princess flurry heart|princess luna|rainbow dash|rarity|shining armor|spike|starlight glimmer|trixie|twilight sparkle,alts-art
1464087.jpeg,https://derpicdn.net/img/view/2017/6/17/1464087.jpeg,1,0.9307220578193665,191,23,363,195,172,172,applejack|discord|fluttershy|mane six|pinkie pie|princess cadance|princess celestia|princess flurry heart|princess luna|rainbow dash|rarity|shining armor|spike|starlight glimmer|trixie|twilight sparkle,alts-art
1466829.jpeg,https://derpicdn.net/img/view/2017/6/20/1466829.jpeg,0,0.999384880065918,1410,497,2234,1321,824,824,spike|twilight sparkle,silfoe
1467136.jpeg,https://derpicdn.net/img/view/2017/6/20/1467136.jpeg,0,0.999666690826416,470,329,686,545,216,216,princess celestia|twilight sparkle,johnjoseco
1467136.jpeg,https://derpicdn.net/img/view/2017/6/20/1467136.jpeg,1,0.9929450750350952,153,89,383,319,230,230,princess celestia|twilight sparkle,johnjoseco
1467364.jpeg,https://derpicdn.net/img/view/2017/6/21/1467364.jpeg,0,0.9829107522964478,794,932,1120,1258,326,326,applejack|fluttershy|mane six|pinkie pie|rainbow dash|rarity|spike|twilight sparkle,
1467364.jpeg,https://derpicdn.net/img/view/2017/6/21/1467364.jpeg,1,0.9704889059066772,412,766,692,1046,280,280,applejack|fluttershy|mane six|pinkie pie|rainbow dash|rarity|spike|twilight sparkle,
1467375.jpeg,https://derpicdn.net/img/view/2017/6/21/1467375.jpeg,1,0.9763404726982116,23,317,245,539,222,222,applejack|fluttershy|pinkie pie|rainbow dash|rarity|twilight sparkle,abbystarling
1467375.jpeg,https://derpicdn.net/img/view/2017/6/21/1467375.jpeg,2,0.9612736105918884,572,522,1028,978,456,456,applejack|fluttershy|pinkie pie|rainbow dash|rarity|twilight sparkle,abbystarling
1467404.jpeg,https://derpicdn.net/img/view/2017/6/21/1467404.jpeg,0,0.97184956073761,370,525,944,1099,574,574,spike|twilight sparkle,pencils
1470193.jpeg,https://derpicdn.net/img/view/2017/6/24/1470193.jpeg,0,0.9144824743270874,430,4515,1604,5689,1174,1174,applejack|discord|fluttershy|mane six|pinkie pie|princess cadance|princess celestia|princess flurry heart|princess luna|rainbow dash|rarity|shining armor|spike|starlight glimmer|trixie|twilight sparkle,alts-art
1470193.jpeg,https://derpicdn.net/img/view/2017/6/24/1470193.jpeg,1,0.9052517414093018,4588,3678,5644,4734,1056,1056,applejack|discord|fluttershy|mane six|pinkie pie|princess cadance|princess celestia|princess flurry heart|princess luna|rainbow dash|rarity|shining armor|spike|starlight glimmer|trixie|twilight sparkle,alts-art
1473370.jpeg,https://derpicdn.net/img/view/2017/6/28/1473370.jpeg,0,0.9975298643112184,82,0,502,413,420,413,starlight glimmer|twilight sparkle,kawaiicreationss
1473787.jpeg,https://derpicdn.net/img/view/2017/6/28/1473787.jpeg,0,0.987776517868042,739,124,1851,1236,1112,1112,rainbow dash|twilight sparkle,yuck
1473899.jpeg,https://derpicdn.net/img/view/2017/6/29/1473899.jpeg,0,0.9804731607437134,473,77,847,451,374,374,applejack|fluttershy|mane six|pinkie pie|rainbow dash|rarity|spike|twilight sparkle,
1474558.jpeg,https://derpicdn.net/img/view/2017/6/29/1474558.jpeg,1,0.9384151697158812,106,0,400,282,294,282,rainbow dash|twilight sparkle,eternalsubscriber
1474594.jpeg,https://derpicdn.net/img/view/2017/6/29/1474594.jpeg,0,0.9959823489189148,581,0,1091,440,510,440,applejack|fluttershy|mane six|pinkie pie|rainbow dash|rarity|spike|starlight glimmer|trixie|twilight sparkle,
1474594.jpeg,https://derpicdn.net/img/view/2017/6/29/1474594.jpeg,1,0.9803597927093506,916,0,1468,462,552,462,applejack|fluttershy|mane six|pinkie pie|rainbow dash|rarity|spike|starlight glimmer|trixie|twilight sparkle,
1474594.jpeg,https://derpicdn.net/img/view/2017/6/29/1474594.jpeg,2,0.979481041431427,1336,327,1770,761,434,434,applejack|fluttershy|mane six|pinkie pie|rainbow dash|rarity|spike|starlight glimmer|trixie|twilight sparkle,
1474594.jpeg,https://derpicdn.net/img/view/2017/6/29/1474594.jpeg,3,0.956679344177246,269,0,727,432,458,432,applejack|fluttershy|mane six|pinkie pie|rainbow dash|rarity|spike|starlight glimmer|trixie|twilight sparkle,
1474594.jpeg,https://derpicdn.net/img/view/2017/6/29/1474594.jpeg,5,0.9247186183929444,1022,626,1434,1038,412,412,applejack|fluttershy|mane six|pinkie pie|rainbow dash|rarity|spike|starlight glimmer|trixie|twilight sparkle,
1474594.jpeg,https://derpicdn.net/img/view/2017/6/29/1474594.jpeg,6,0.9156657457351683,1257,966,1523,1232,266,266,applejack|fluttershy|mane six|pinkie pie|rainbow dash|rarity|spike|starlight glimmer|trixie|twilight sparkle,
1475136.jpeg,https://derpicdn.net/img/view/2017/6/30/1475136.jpeg,0,0.9559075236320496,169,40,1000,1070,831,1030,spike|twilight sparkle,emositecc
1475599.jpeg,https://derpicdn.net/img/view/2017/6/30/1475599.jpeg,0,0.996090829372406,737,17,1145,425,408,408,princess celestia|princess luna|twilight sparkle,magnaluna
1475599.jpeg,https://derpicdn.net/img/view/2017/6/30/1475599.jpeg,1,0.9876378178596495,351,77,657,383,306,306,princess celestia|princess luna|twilight sparkle,magnaluna
1475599.jpeg,https://derpicdn.net/img/view/2017/6/30/1475599.jpeg,2,0.9746071696281432,131,0,545,384,414,384,princess celestia|princess luna|twilight sparkle,magnaluna
1476036.jpeg,https://derpicdn.net/img/view/2017/7/1/1476036.jpeg,0,0.9707210659980774,1141,87,2767,1713,1626,1626,fluttershy|pinkie pie|twilight sparkle,flicker-show
1476200.jpeg,https://derpicdn.net/img/view/2017/7/1/1476200.jpeg,1,0.9786809682846068,168,313,620,765,452,452,rarity|twilight sparkle,
1477091.jpeg,https://derpicdn.net/img/view/2017/7/2/1477091.jpeg,1,0.9696893692016602,0,0,1851,1550,1851,1550,spike|starlight glimmer|twilight sparkle,mistydash
1477111.jpeg,https://derpicdn.net/img/view/2017/7/2/1477111.jpeg,0,0.964270293712616,619,1084,1443,1908,824,824,applejack|fluttershy|pinkie pie|rainbow dash|rarity|spike|twilight sparkle,mistydash
1478158.jpeg,https://derpicdn.net/img/view/2017/7/4/1478158.jpeg,0,0.9983523488044742,524,589,1198,1263,674,674,shining armor|twilight sparkle,justsomepainter11
1478158.jpeg,https://derpicdn.net/img/view/2017/7/4/1478158.jpeg,1,0.9977266788482666,1559,597,2161,1199,602,602,shining armor|twilight sparkle,justsomepainter11
1478435.jpeg,https://derpicdn.net/img/view/2017/7/4/1478435.jpeg,0,0.9734820127487184,2581,2006,3749,3174,1168,1168,discord|rainbow dash|twilight sparkle,mistydash
1480508.jpeg,https://derpicdn.net/img/view/2017/7/7/1480508.jpeg,0,0.994419276714325,125,994,421,1290,296,296,rainbow dash|twilight sparkle,aceeternal
1480508.jpeg,https://derpicdn.net/img/view/2017/7/7/1480508.jpeg,1,0.9939910769462584,535,29,781,275,246,246,rainbow dash|twilight sparkle,aceeternal
1480508.jpeg,https://derpicdn.net/img/view/2017/7/7/1480508.jpeg,3,0.9399980306625366,350,652,662,964,312,312,rainbow dash|twilight sparkle,aceeternal
1480956.jpeg,https://derpicdn.net/img/view/2017/7/7/1480956.jpeg,0,0.9423614144325256,341,180,621,460,280,280,princess celestia|starlight glimmer|sunset shimmer|trixie|twilight sparkle,sparkponies|itsfortoo
1481432.jpeg,https://derpicdn.net/img/view/2017/7/8/1481432.jpeg,0,0.9216824173927308,60,9,432,401,372,392,fluttershy|rarity|starlight glimmer|twilight sparkle,
1482115.jpeg,https://derpicdn.net/img/view/2017/7/9/1482115.jpeg,0,0.9928523898124696,191,0,465,262,274,262,spike|starlight glimmer|trixie|twilight sparkle,uotapo
1482115.jpeg,https://derpicdn.net/img/view/2017/7/9/1482115.jpeg,1,0.9904952049255372,0,0,239,235,239,235,spike|starlight glimmer|trixie|twilight sparkle,uotapo
1482115.jpeg,https://derpicdn.net/img/view/2017/7/9/1482115.jpeg,2,0.9671921133995056,219,281,403,465,184,184,spike|starlight glimmer|trixie|twilight sparkle,uotapo
1482115.jpeg,https://derpicdn.net/img/view/2017/7/9/1482115.jpeg,3,0.9049386978149414,222,605,466,849,244,244,spike|starlight glimmer|trixie|twilight sparkle,uotapo
1482273.jpeg,https://derpicdn.net/img/view/2017/7/9/1482273.jpeg,0,0.9943054914474488,61,0,291,219,230,219,applejack|fluttershy|mane six|pinkie pie|rainbow dash|rarity|spike|twilight sparkle,kaemantis
1482273.jpeg,https://derpicdn.net/img/view/2017/7/9/1482273.jpeg,1,0.9610052108764648,517,10,731,224,214,214,applejack|fluttershy|mane six|pinkie pie|rainbow dash|rarity|spike|twilight sparkle,kaemantis
1482273.jpeg,https://derpicdn.net/img/view/2017/7/9/1482273.jpeg,2,0.9364547729492188,841,47,1021,227,180,180,applejack|fluttershy|mane six|pinkie pie|rainbow dash|rarity|spike|twilight sparkle,kaemantis
1482273.jpeg,https://derpicdn.net/img/view/2017/7/9/1482273.jpeg,3,0.9085952639579772,358,97,530,269,172,172,applejack|fluttershy|mane six|pinkie pie|rainbow dash|rarity|spike|twilight sparkle,kaemantis
1483233.jpeg,https://derpicdn.net/img/view/2017/7/10/1483233.jpeg,0,0.9886611700057985,416,35,796,415,380,380,sunset shimmer|twilight sparkle,fj23pk
1484087.jpeg,https://derpicdn.net/img/view/2017/7/11/1484087.jpeg,0,0.9980475902557372,704,506,1280,1138,576,632,applejack|fluttershy|pinkie pie|rarity|twilight sparkle,nekubi
1484087.jpeg,https://derpicdn.net/img/view/2017/7/11/1484087.jpeg,1,0.9939596056938172,6,1240,556,1790,550,550,applejack|fluttershy|pinkie pie|rarity|twilight sparkle,nekubi
1484087.jpeg,https://derpicdn.net/img/view/2017/7/11/1484087.jpeg,2,0.9917873740196228,0,621,434,1133,434,512,applejack|fluttershy|pinkie pie|rarity|twilight sparkle,nekubi
1484087.jpeg,https://derpicdn.net/img/view/2017/7/11/1484087.jpeg,3,0.9824642539024352,780,1191,1280,1781,500,590,applejack|fluttershy|pinkie pie|rarity|twilight sparkle,nekubi
1484087.jpeg,https://derpicdn.net/img/view/2017/7/11/1484087.jpeg,4,0.9678358435630798,322,602,722,1002,400,400,applejack|fluttershy|pinkie pie|rarity|twilight sparkle,nekubi
1484260.jpeg,https://derpicdn.net/img/view/2017/7/12/1484260.jpeg,0,0.9479787945747375,1837,1448,2361,1972,524,524,applejack|fluttershy|mane six|pinkie pie|rainbow dash|rarity|spike|twilight sparkle,
1486477.jpeg,https://derpicdn.net/img/view/2017/7/15/1486477.jpeg,0,0.9777626991271972,1425,122,1781,478,356,356,applejack|fluttershy|mane six|pinkie pie|rainbow dash|rarity|spike|twilight sparkle,
1486510.jpeg,https://derpicdn.net/img/view/2017/7/15/1486510.jpeg,0,0.9665012359619141,1458,35,1926,503,468,468,pinkie pie|princess celestia|rainbow dash|rarity|soarin'|sunset shimmer|twilight sparkle,
1486650.jpeg,https://derpicdn.net/img/view/2017/7/15/1486650.jpeg,0,0.95945006608963,192,92,434,334,242,242,pinkie pie|twilight sparkle,uotapo
1486650.jpeg,https://derpicdn.net/img/view/2017/7/15/1486650.jpeg,1,0.9158467650413512,460,75,948,563,488,488,pinkie pie|twilight sparkle,uotapo
1487865.jpeg,https://derpicdn.net/img/view/2017/7/16/1487865.jpeg,0,0.9759588241577148,1183,916,1565,1298,382,382,princess celestia|twilight sparkle,malimarthemage|earthsong9405
1489455.jpeg,https://derpicdn.net/img/view/2017/7/19/1489455.jpeg,0,0.9906479120254515,327,591,791,1055,464,464,applejack|fluttershy|mane six|pinkie pie|rainbow dash|rarity|twilight sparkle,sararichard
1490165.jpeg,https://derpicdn.net/img/view/2017/7/19/1490165.jpeg,0,0.9967747330665588,334,0,878,475,544,475,princess celestia|twilight sparkle,skypony14
1491884.jpeg,https://derpicdn.net/img/view/2017/7/21/1491884.jpeg,0,0.9968436360359192,2,600,1238,1836,1236,1236,princess cadance|princess celestia|twilight sparkle,
1496100.jpeg,https://derpicdn.net/img/view/2017/7/27/1496100.jpeg,0,0.9967955350875854,1279,561,1771,1053,492,492,applejack|fluttershy|mane six|pinkie pie|rainbow dash|rarity|twilight sparkle,imalou
1496100.jpeg,https://derpicdn.net/img/view/2017/7/27/1496100.jpeg,1,0.9931656718254088,2112,663,2710,1261,598,598,applejack|fluttershy|mane six|pinkie pie|rainbow dash|rarity|twilight sparkle,imalou
1496100.jpeg,https://derpicdn.net/img/view/2017/7/27/1496100.jpeg,2,0.9473038911819458,876,611,1282,1017,406,406,applejack|fluttershy|mane six|pinkie pie|rainbow dash|rarity|twilight sparkle,imalou
1496138.jpeg,https://derpicdn.net/img/view/2017/7/27/1496138.jpeg,0,0.9788074493408204,266,99,612,445,346,346,princess celestia|twilight sparkle,kumikoponylk
1496324.jpeg,https://derpicdn.net/img/view/2017/7/27/1496324.jpeg,2,0.9903316497802734,150,62,438,350,288,288,applejack|fluttershy|mane six|pinkie pie|rainbow dash|rarity|twilight sparkle,tiadrawsz
1496324.jpeg,https://derpicdn.net/img/view/2017/7/27/1496324.jpeg,3,0.9844103455543518,510,304,770,564,260,260,applejack|fluttershy|mane six|pinkie pie|rainbow dash|rarity|twilight sparkle,tiadrawsz
1496324.jpeg,https://derpicdn.net/img/view/2017/7/27/1496324.jpeg,4,0.978346824645996,344,495,568,719,224,224,applejack|fluttershy|mane six|pinkie pie|rainbow dash|rarity|twilight sparkle,tiadrawsz
1498538.jpeg,https://derpicdn.net/img/view/2017/7/30/1498538.jpeg,0,0.973506510257721,579,260,989,670,410,410,applejack|fluttershy|pinkie pie|rarity|twilight sparkle,quakehoof
1498538.jpeg,https://derpicdn.net/img/view/2017/7/30/1498538.jpeg,1,0.9099063873291016,1145,339,1517,711,372,372,applejack|fluttershy|pinkie pie|rarity|twilight sparkle,quakehoof
1500088.jpeg,https://derpicdn.net/img/view/2017/8/1/1500088.jpeg,1,0.9899673461914062,921,195,1361,635,440,440,applejack|fluttershy|mane six|pinkie pie|rainbow dash|rarity|twilight sparkle,traupa
1500088.jpeg,https://derpicdn.net/img/view/2017/8/1/1500088.jpeg,3,0.9425694346427916,1231,154,1697,620,466,466,applejack|fluttershy|mane six|pinkie pie|rainbow dash|rarity|twilight sparkle,traupa
1501762.jpeg,https://derpicdn.net/img/view/2017/8/3/1501762.jpeg,0,0.995712399482727,2563,121,3027,585,464,464,applejack|fluttershy|mane six|pinkie pie|rainbow dash|rarity|spike|starlight glimmer|trixie|twilight sparkle,koviry
1501762.jpeg,https://derpicdn.net/img/view/2017/8/3/1501762.jpeg,2,0.9483522176742554,3040,201,3330,491,290,290,applejack|fluttershy|mane six|pinkie pie|rainbow dash|rarity|spike|starlight glimmer|trixie|twilight sparkle,koviry
1501887.jpeg,https://derpicdn.net/img/view/2017/8/3/1501887.jpeg,0,0.9796919226646424,51,222,375,546,324,324,applejack|fluttershy|mane six|pinkie pie|rainbow dash|rarity|twilight sparkle,caibaoreturn
1501887.jpeg,https://derpicdn.net/img/view/2017/8/3/1501887.jpeg,1,0.9704977869987488,487,468,707,688,220,220,applejack|fluttershy|mane six|pinkie pie|rainbow dash|rarity|twilight sparkle,caibaoreturn
1501887.jpeg,https://derpicdn.net/img/view/2017/8/3/1501887.jpeg,2,0.9689204096794128,37,52,257,272,220,220,applejack|fluttershy|mane six|pinkie pie|rainbow dash|rarity|twilight sparkle,caibaoreturn
1501887.jpeg,https://derpicdn.net/img/view/2017/8/3/1501887.jpeg,3,0.9434146881103516,304,10,562,268,258,258,applejack|fluttershy|mane six|pinkie pie|rainbow dash|rarity|twilight sparkle,caibaoreturn
1502694.jpeg,https://derpicdn.net/img/view/2017/8/4/1502694.jpeg,0,0.99894118309021,488,0,842,339,354,339,sunset shimmer|twilight sparkle,xjkenny
1505292.jpeg,https://derpicdn.net/img/view/2017/8/7/1505292.jpeg,0,0.9572371840476992,1137,39,1427,329,290,290,applejack|fluttershy|mane six|pinkie pie|rainbow dash|rarity|spike|twilight sparkle,
1505292.jpeg,https://derpicdn.net/img/view/2017/8/7/1505292.jpeg,1,0.9548108577728271,1545,191,1893,539,348,348,applejack|fluttershy|mane six|pinkie pie|rainbow dash|rarity|spike|twilight sparkle,
1505307.jpeg,https://derpicdn.net/img/view/2017/8/7/1505307.jpeg,0,0.975416660308838,113,28,404,303,291,275,pinkie pie|twilight sparkle,
1505309.jpeg,https://derpicdn.net/img/view/2017/8/7/1505309.jpeg,0,0.9941155910491944,520,24,788,292,268,268,applejack|pinkie pie|twilight sparkle,
1505309.jpeg,https://derpicdn.net/img/view/2017/8/7/1505309.jpeg,1,0.9657466411590576,939,31,1272,449,333,418,applejack|pinkie pie|twilight sparkle,
1505309.jpeg,https://derpicdn.net/img/view/2017/8/7/1505309.jpeg,3,0.9080033302307128,722,0,972,244,250,244,applejack|pinkie pie|twilight sparkle,
1505478.jpeg,https://derpicdn.net/img/view/2017/8/8/1505478.jpeg,0,0.996082067489624,438,0,678,224,240,224,applejack|fluttershy|mane six|pinkie pie|rainbow dash|rarity|twilight sparkle,nekocrispy
1505478.jpeg,https://derpicdn.net/img/view/2017/8/8/1505478.jpeg,1,0.986148476600647,0,0,230,199,230,199,applejack|fluttershy|mane six|pinkie pie|rainbow dash|rarity|twilight sparkle,nekocrispy
1505478.jpeg,https://derpicdn.net/img/view/2017/8/8/1505478.jpeg,2,0.9176097512245178,74,273,308,507,234,234,applejack|fluttershy|mane six|pinkie pie|rainbow dash|rarity|twilight sparkle,nekocrispy
1506525.jpeg,https://derpicdn.net/img/view/2017/8/9/1506525.jpeg,0,0.9993274211883544,751,0,1247,428,496,428,rainbow dash|twilight sparkle,zetamad
1507119.jpeg,https://derpicdn.net/img/view/2017/8/10/1507119.jpeg,1,0.98865807056427,223,0,461,216,238,216,sunset shimmer|twilight sparkle,dementra369
1508174.jpeg,https://derpicdn.net/img/view/2017/8/11/1508174.jpeg,1,0.9724041819572448,0,2140,1058,3198,1058,1058,applejack|fluttershy|mane six|pinkie pie|rainbow dash|rarity|spike|twilight sparkle,
1509765.jpeg,https://derpicdn.net/img/view/2017/8/13/1509765.jpeg,0,0.9865631461143494,950,396,1426,872,476,476,pinkie pie|twilight sparkle,flutterluv
1510106.jpeg,https://derpicdn.net/img/view/2017/8/13/1510106.jpeg,0,0.9635778665542604,570,62,1034,526,464,464,sunset shimmer|twilight sparkle,artomicmuffin
1510641.jpeg,https://derpicdn.net/img/view/2017/8/14/1510641.jpeg,0,0.9755997061729432,939,318,1461,840,522,522,pinkie pie|twilight sparkle,flutterluv
1510641.jpeg,https://derpicdn.net/img/view/2017/8/14/1510641.jpeg,1,0.9731491208076476,1469,488,1800,846,331,358,pinkie pie|twilight sparkle,flutterluv
1511680.jpeg,https://derpicdn.net/img/view/2017/8/15/1511680.jpeg,0,0.9401021003723145,0,75,178,299,178,224,apple bloom|applejack|fluttershy|mane six|pinkie pie|rainbow dash|rarity|spike|starlight glimmer|twilight sparkle,emositecc
1512632.jpeg,https://derpicdn.net/img/view/2017/8/17/1512632.jpeg,0,0.9603629112243652,1991,930,2549,1488,558,558,princess celestia|twilight sparkle,foughtdragon01
1513299.jpeg,https://derpicdn.net/img/view/2017/8/18/1513299.jpeg,0,0.9807747602462769,1522,377,1876,731,354,354,applejack|fluttershy|mane six|pinkie pie|rainbow dash|rarity|starlight glimmer|twilight sparkle,yummiestseven65
1513299.jpeg,https://derpicdn.net/img/view/2017/8/18/1513299.jpeg,1,0.9327476024627686,620,432,996,808,376,376,applejack|fluttershy|mane six|pinkie pie|rainbow dash|rarity|starlight glimmer|twilight sparkle,yummiestseven65
1513299.jpeg,https://derpicdn.net/img/view/2017/8/18/1513299.jpeg,2,0.9073462486267092,1867,369,2257,759,390,390,applejack|fluttershy|mane six|pinkie pie|rainbow dash|rarity|starlight glimmer|twilight sparkle,yummiestseven65
1513464.jpeg,https://derpicdn.net/img/view/2017/8/18/1513464.jpeg,0,0.9798508286476136,376,32,1382,1038,1006,1006,sunset shimmer|twilight sparkle,redvais
1513781.jpeg,https://derpicdn.net/img/view/2017/8/18/1513781.jpeg,1,0.9935494661331176,1455,517,2237,1299,782,782,sunset shimmer|twilight sparkle,sensko
1513825.jpeg,https://derpicdn.net/img/view/2017/8/18/1513825.jpeg,0,0.9180338978767396,0,13,272,313,272,300,applejack|fluttershy|pinkie pie|rainbow dash|rarity|twilight sparkle,navitaserussirus
1514648.jpeg,https://derpicdn.net/img/view/2017/8/19/1514648.jpeg,0,0.9895132780075072,578,236,1020,678,442,442,spike|starlight glimmer|twilight sparkle,
1517228.jpeg,https://derpicdn.net/img/view/2017/8/22/1517228.jpeg,0,0.935123085975647,469,0,1691,1218,1222,1218,princess celestia|twilight sparkle,rubyflank
1518176.jpeg,https://derpicdn.net/img/view/2017/8/23/1518176.jpeg,0,0.9735487699508668,1419,146,2281,1008,862,862,fluttershy|spike|twilight sparkle,beetrue
1519083.jpeg,https://derpicdn.net/img/view/2017/8/25/1519083.jpeg,0,0.9688717126846312,1161,93,1473,405,312,312,applejack|fluttershy|mane six|pinkie pie|rainbow dash|rarity|spike|twilight sparkle,
1519228.jpeg,https://derpicdn.net/img/view/2017/8/25/1519228.jpeg,0,0.940433144569397,121,0,589,251,468,251,applejack|fluttershy|mane six|pinkie pie|rainbow dash|rarity|twilight sparkle,
1522488.jpeg,https://derpicdn.net/img/view/2017/8/29/1522488.jpeg,0,0.9983136653900146,647,153,915,421,268,268,spike|starlight glimmer|twilight sparkle,art-2u
1522700.jpeg,https://derpicdn.net/img/view/2017/8/29/1522700.jpeg,0,0.909063458442688,125,0,391,251,266,251,applejack|fluttershy|mane six|pinkie pie|rainbow dash|rarity|spike|twilight sparkle,
1522711.jpeg,https://derpicdn.net/img/view/2017/8/29/1522711.jpeg,1,0.9949081540107728,1397,0,2505,1073,1108,1073,princess cadance|princess celestia|princess luna|twilight sparkle,silfoe
1523175.jpeg,https://derpicdn.net/img/view/2017/8/30/1523175.jpeg,0,0.996871292591095,170,194,350,374,180,180,applejack|fluttershy|mane six|pinkie pie|rainbow dash|rarity|twilight sparkle,
1523581.jpeg,https://derpicdn.net/img/view/2017/8/30/1523581.jpeg,0,0.999472975730896,0,304,942,1342,942,1038,rainbow dash|scootaloo|twilight sparkle,blazeblitz
1523581.jpeg,https://derpicdn.net/img/view/2017/8/30/1523581.jpeg,1,0.9963887929916382,1334,0,2376,1000,1042,1000,rainbow dash|scootaloo|twilight sparkle,blazeblitz
1525068.jpeg,https://derpicdn.net/img/view/2017/9/1/1525068.jpeg,0,0.9546188116073608,547,335,913,701,366,366,spike|twilight sparkle,joy-ang
1525099.jpeg,https://derpicdn.net/img/view/2017/9/1/1525099.jpeg,0,0.9490796327590942,1693,1156,2067,1530,374,374,applejack|fluttershy|mane six|pinkie pie|rainbow dash|rarity|twilight sparkle,kelly grupczynski
1525099.jpeg,https://derpicdn.net/img/view/2017/9/1/1525099.jpeg,1,0.9357180595397948,240,1035,740,1535,500,500,applejack|fluttershy|mane six|pinkie pie|rainbow dash|rarity|twilight sparkle,kelly grupczynski
1527096.jpeg,https://derpicdn.net/img/view/2017/9/3/1527096.jpeg,0,0.9831835031509399,642,187,1024,575,382,388,rainbow dash|twilight sparkle,
1528164.jpeg,https://derpicdn.net/img/view/2017/9/5/1528164.jpeg,0,0.9859322905540466,1763,998,2151,1386,388,388,applejack|fluttershy|mane six|pinkie pie|rainbow dash|rarity|twilight sparkle,
1528181.jpeg,https://derpicdn.net/img/view/2017/9/5/1528181.jpeg,0,0.9807353019714355,304,96,708,500,404,404,princess cadance|princess celestia|princess luna|starlight glimmer|trixie|twilight sparkle,imalou
1528183.jpeg,https://derpicdn.net/img/view/2017/9/5/1528183.jpeg,0,0.9785943627357484,1477,128,1920,592,443,464,applejack|fluttershy|mane six|pinkie pie|rainbow dash|rarity|twilight sparkle,
1528183.jpeg,https://derpicdn.net/img/view/2017/9/5/1528183.jpeg,1,0.9757500886917114,41,162,361,482,320,320,applejack|fluttershy|mane six|pinkie pie|rainbow dash|rarity|twilight sparkle,
1528183.jpeg,https://derpicdn.net/img/view/2017/9/5/1528183.jpeg,2,0.9650092124938964,188,943,624,1379,436,436,applejack|fluttershy|mane six|pinkie pie|rainbow dash|rarity|twilight sparkle,
1528183.jpeg,https://derpicdn.net/img/view/2017/9/5/1528183.jpeg,3,0.9412802457809448,1291,981,1649,1339,358,358,applejack|fluttershy|mane six|pinkie pie|rainbow dash|rarity|twilight sparkle,
1528286.jpeg,https://derpicdn.net/img/view/2017/9/5/1528286.jpeg,0,0.9930756092071532,831,305,1011,485,180,180,applejack|fluttershy|pinkie pie|rainbow dash|rarity|sunset shimmer|twilight sparkle,nano23823
1528286.jpeg,https://derpicdn.net/img/view/2017/9/5/1528286.jpeg,1,0.989010751247406,23,19,253,249,230,230,applejack|fluttershy|pinkie pie|rainbow dash|rarity|sunset shimmer|twilight sparkle,nano23823
1528286.jpeg,https://derpicdn.net/img/view/2017/9/5/1528286.jpeg,2,0.9878631234169006,542,281,736,475,194,194,applejack|fluttershy|pinkie pie|rainbow dash|rarity|sunset shimmer|twilight sparkle,nano23823
1528286.jpeg,https://derpicdn.net/img/view/2017/9/5/1528286.jpeg,3,0.9863308072090148,586,9,800,223,214,214,applejack|fluttershy|pinkie pie|rainbow dash|rarity|sunset shimmer|twilight sparkle,nano23823
1528286.jpeg,https://derpicdn.net/img/view/2017/9/5/1528286.jpeg,4,0.9663096070289612,287,278,449,440,162,162,applejack|fluttershy|pinkie pie|rainbow dash|rarity|sunset shimmer|twilight sparkle,nano23823
1528286.jpeg,https://derpicdn.net/img/view/2017/9/5/1528286.jpeg,5,0.9150338172912598,844,812,992,960,148,148,applejack|fluttershy|pinkie pie|rainbow dash|rarity|sunset shimmer|twilight sparkle,nano23823
1531299.jpeg,https://derpicdn.net/img/view/2017/9/9/1531299.jpeg,0,0.9486804604530334,1111,21,1435,345,324,324,applejack|fluttershy|mane six|pinkie pie|rainbow dash|rarity|twilight sparkle,mysticalpha
1531299.jpeg,https://derpicdn.net/img/view/2017/9/9/1531299.jpeg,1,0.9280836582183838,597,188,913,504,316,316,applejack|fluttershy|mane six|pinkie pie|rainbow dash|rarity|twilight sparkle,mysticalpha
1531898.jpeg,https://derpicdn.net/img/view/2017/9/10/1531898.jpeg,0,0.9936932325363159,1408,694,2016,1302,608,608,applejack|fluttershy|mane six|pinkie pie|princess celestia|princess luna|rainbow dash|rarity|spike|twilight sparkle,silfoe
1531898.jpeg,https://derpicdn.net/img/view/2017/9/10/1531898.jpeg,2,0.99192613363266,527,1055,1059,1587,532,532,applejack|fluttershy|mane six|pinkie pie|princess celestia|princess luna|rainbow dash|rarity|spike|twilight sparkle,silfoe
1531939.jpeg,https://derpicdn.net/img/view/2017/9/10/1531939.jpeg,0,0.9987234473228456,2044,20,3300,1306,1256,1286,applejack|fluttershy|mane six|pinkie pie|rainbow dash|rarity|twilight sparkle,inspectornills
1531939.jpeg,https://derpicdn.net/img/view/2017/9/10/1531939.jpeg,1,0.9759836196899414,77,1201,1111,2235,1034,1034,applejack|fluttershy|mane six|pinkie pie|rainbow dash|rarity|twilight sparkle,inspectornills
1532118.jpeg,https://derpicdn.net/img/view/2017/9/10/1532118.jpeg,0,0.9365673661231996,0,0,610,631,610,631,applejack|twilight sparkle,tangankittentail
1532573.jpeg,https://derpicdn.net/img/view/2017/9/10/1532573.jpeg,0,0.9979050755500792,218,0,1066,812,848,812,fluttershy|twilight sparkle,
1533017.jpeg,https://derpicdn.net/img/view/2017/9/11/1533017.jpeg,0,0.97292298078537,720,2,1076,358,356,356,applejack|fluttershy|mane six|pinkie pie|rainbow dash|rarity|twilight sparkle,
1534354.jpeg,https://derpicdn.net/img/view/2017/9/13/1534354.jpeg,0,0.9105581641197203,466,0,1456,905,990,905,rainbow dash|twilight sparkle,incendiaryboobs|snobbleweb
1538643.jpeg,https://derpicdn.net/img/view/2017/9/18/1538643.jpeg,0,0.9301405549049376,242,799,704,1261,462,462,applejack|fluttershy|mane six|pinkie pie|rainbow dash|rarity|twilight sparkle,kaori matsuo|s-bis
1538643.jpeg,https://derpicdn.net/img/view/2017/9/18/1538643.jpeg,1,0.9224393963813782,548,846,1000,1324,452,478,applejack|fluttershy|mane six|pinkie pie|rainbow dash|rarity|twilight sparkle,kaori matsuo|s-bis
1539344.jpeg,https://derpicdn.net/img/view/2017/9/19/1539344.jpeg,0,0.9988816976547241,661,128,2021,1488,1360,1360,pinkie pie|rainbow dash|twilight sparkle,tacomytaco
1540829.jpeg,https://derpicdn.net/img/view/2017/9/21/1540829.jpeg,0,0.9959797263145448,395,11,707,323,312,312,princess celestia|princess luna|twilight sparkle,twilite-sparkleplz
1541768.jpeg,https://derpicdn.net/img/view/2017/9/22/1541768.jpeg,0,0.9919815659523008,156,0,574,399,418,399,sunset shimmer|twilight sparkle,xjkenny
1547148.jpeg,https://derpicdn.net/img/view/2017/9/28/1547148.jpeg,0,0.9740902185440063,2679,1028,4447,2796,1768,1768,rarity|twilight sparkle,earthsong9405
1548615.jpeg,https://derpicdn.net/img/view/2017/9/30/1548615.jpeg,1,0.9924509525299072,770,145,1108,483,338,338,applejack|fluttershy|mane six|pinkie pie|princess celestia|princess luna|rainbow dash|rarity|spike|twilight sparkle,silfoe
1548615.jpeg,https://derpicdn.net/img/view/2017/9/30/1548615.jpeg,2,0.989798665046692,270,555,542,827,272,272,applejack|fluttershy|mane six|pinkie pie|princess celestia|princess luna|rainbow dash|rarity|spike|twilight sparkle,silfoe
1548615.jpeg,https://derpicdn.net/img/view/2017/9/30/1548615.jpeg,3,0.9880645871162416,472,0,870,342,398,342,applejack|fluttershy|mane six|pinkie pie|princess celestia|princess luna|rainbow dash|rarity|spike|twilight sparkle,silfoe
1548615.jpeg,https://derpicdn.net/img/view/2017/9/30/1548615.jpeg,5,0.9328519701957704,472,586,762,876,290,290,applejack|fluttershy|mane six|pinkie pie|princess celestia|princess luna|rainbow dash|rarity|spike|twilight sparkle,silfoe
1549349.jpeg,https://derpicdn.net/img/view/2017/10/1/1549349.jpeg,0,0.9834068417549132,0,1144,560,1726,560,582,applejack|fluttershy|mane six|pinkie pie|rainbow dash|rarity|spike|twilight sparkle,
1549349.jpeg,https://derpicdn.net/img/view/2017/10/1/1549349.jpeg,3,0.9213022589683532,477,525,955,1003,478,478,applejack|fluttershy|mane six|pinkie pie|rainbow dash|rarity|spike|twilight sparkle,
1550711.jpeg,https://derpicdn.net/img/view/2017/10/2/1550711.jpeg,0,0.986619472503662,6,0,172,159,166,159,applejack|big macintosh|fluttershy|pinkie pie|rainbow dash|rarity|soarin'|starlight glimmer|sunset shimmer|trixie|twilight sparkle,andromedasparkz
1551016.jpeg,https://derpicdn.net/img/view/2017/10/3/1551016.jpeg,0,0.9762329459190368,244,233,636,625,392,392,sunset shimmer|twilight sparkle,passigcamel
1551016.jpeg,https://derpicdn.net/img/view/2017/10/3/1551016.jpeg,1,0.9302561283111572,478,254,832,608,354,354,sunset shimmer|twilight sparkle,passigcamel
1551936.jpeg,https://derpicdn.net/img/view/2017/10/4/1551936.jpeg,0,0.9993391633033752,172,437,674,939,502,502,sunset shimmer|twilight sparkle,eeviart
1553005.jpeg,https://derpicdn.net/img/view/2017/10/5/1553005.jpeg,0,0.985129714012146,963,504,1536,1082,573,578,applejack|fluttershy|mane six|pinkie pie|rainbow dash|rarity|twilight sparkle,andypriceart
1553282.jpeg,https://derpicdn.net/img/view/2017/10/6/1553282.jpeg,0,0.9180963635444641,358,117,980,739,622,622,applejack|fluttershy|mane six|pinkie pie|rainbow dash|rarity|twilight sparkle,yam
1553549.jpeg,https://derpicdn.net/img/view/2017/10/6/1553549.jpeg,0,0.9860253930091858,220,369,496,645,276,276,rainbow dash|twilight sparkle,inowiseei
1553549.jpeg,https://derpicdn.net/img/view/2017/10/6/1553549.jpeg,1,0.9642079472541808,499,249,807,557,308,308,rainbow dash|twilight sparkle,inowiseei
1554431.jpeg,https://derpicdn.net/img/view/2017/10/7/1554431.jpeg,0,0.9919254183769226,122,558,278,714,156,156,applejack|fluttershy|mane six|pinkie pie|rainbow dash|rarity|spike|twilight sparkle,xkappax
1554431.jpeg,https://derpicdn.net/img/view/2017/10/7/1554431.jpeg,1,0.9869853854179382,134,3,310,179,176,176,applejack|fluttershy|mane six|pinkie pie|rainbow dash|rarity|spike|twilight sparkle,xkappax
1555157.jpeg,https://derpicdn.net/img/view/2017/10/8/1555157.jpeg,0,0.9605457186698914,78,73,434,429,356,356,applejack|fluttershy|mane six|pinkie pie|rainbow dash|rarity|spike|twilight sparkle,
1555157.jpeg,https://derpicdn.net/img/view/2017/10/8/1555157.jpeg,1,0.9447698593139648,1026,126,1358,458,332,332,applejack|fluttershy|mane six|pinkie pie|rainbow dash|rarity|spike|twilight sparkle,
1555157.jpeg,https://derpicdn.net/img/view/2017/10/8/1555157.jpeg,2,0.9381906390190125,540,148,838,446,298,298,applejack|fluttershy|mane six|pinkie pie|rainbow dash|rarity|spike|twilight sparkle,
1556371.jpeg,https://derpicdn.net/img/view/2017/10/9/1556371.jpeg,0,0.9046040177345276,238,0,604,361,366,361,starlight glimmer|trixie|twilight sparkle,
1557797.jpeg,https://derpicdn.net/img/view/2017/10/10/1557797.jpeg,0,0.9989403486251832,518,0,1186,590,668,590,princess cadance|twilight sparkle,joakaha
1558845.jpeg,https://derpicdn.net/img/view/2017/10/12/1558845.jpeg,0,0.9862880706787108,1250,373,1604,727,354,354,applejack|fluttershy|mane six|pinkie pie|rainbow dash|rarity|spike|twilight sparkle,
1559288.jpeg,https://derpicdn.net/img/view/2017/10/12/1559288.jpeg,1,0.9490309357643129,0,242,810,1024,810,782,fluttershy|twilight sparkle,
1560106.jpeg,https://derpicdn.net/img/view/2017/10/13/1560106.jpeg,0,0.9988828897476196,40,16,394,370,354,354,starlight glimmer|trixie|twilight sparkle,xjkenny
1560106.jpeg,https://derpicdn.net/img/view/2017/10/13/1560106.jpeg,1,0.9751721620559692,364,536,668,840,304,304,starlight glimmer|trixie|twilight sparkle,xjkenny
1560108.jpeg,https://derpicdn.net/img/view/2017/10/13/1560108.jpeg,1,0.9908522367477416,426,1406,808,1788,382,382,applejack|fluttershy|mane six|pinkie pie|princess celestia|rainbow dash|rarity|spike|twilight sparkle,joy-ang
1560108.jpeg,https://derpicdn.net/img/view/2017/10/13/1560108.jpeg,2,0.9823715686798096,141,1129,575,1563,434,434,applejack|fluttershy|mane six|pinkie pie|princess celestia|rainbow dash|rarity|spike|twilight sparkle,joy-ang
1560360.jpeg,https://derpicdn.net/img/view/2017/10/13/1560360.jpeg,0,0.9909084439277648,2398,416,3148,1166,750,750,princess celestia|princess luna|twilight sparkle,magnaluna
1561863.jpeg,https://derpicdn.net/img/view/2017/10/15/1561863.jpeg,0,0.9195318818092346,151,0,771,555,620,555,sunset shimmer|twilight sparkle,little-tweenframes
1563866.jpeg,https://derpicdn.net/img/view/2017/10/17/1563866.jpeg,0,0.9998132586479188,227,1037,609,1419,382,382,apple bloom|applejack|big macintosh|diamond tiara|discord|fluttershy|granny smith|pinkie pie|princess cadance|princess celestia|princess flurry heart|princess luna|rainbow dash|rarity|scootaloo|shining armor|spike|starlight glimmer|sunset shimmer|sweetie belle|trixie|twilight sparkle,justsomepainter11|blueberry cannon
1563866.jpeg,https://derpicdn.net/img/view/2017/10/17/1563866.jpeg,1,0.9984919428825378,521,981,975,1435,454,454,apple bloom|applejack|big macintosh|diamond tiara|discord|fluttershy|granny smith|pinkie pie|princess cadance|princess celestia|princess flurry heart|princess luna|rainbow dash|rarity|scootaloo|shining armor|spike|starlight glimmer|sunset shimmer|sweetie belle|trixie|twilight sparkle,justsomepainter11|blueberry cannon
1563866.jpeg,https://derpicdn.net/img/view/2017/10/17/1563866.jpeg,2,0.9974539875984192,283,5,755,477,472,472,apple bloom|applejack|big macintosh|diamond tiara|discord|fluttershy|granny smith|pinkie pie|princess cadance|princess celestia|princess flurry heart|princess luna|rainbow dash|rarity|scootaloo|shining armor|spike|starlight glimmer|sunset shimmer|sweetie belle|trixie|twilight sparkle,justsomepainter11|blueberry cannon
1563866.jpeg,https://derpicdn.net/img/view/2017/10/17/1563866.jpeg,4,0.9949312806129456,561,1881,877,2197,316,316,apple bloom|applejack|big macintosh|diamond tiara|discord|fluttershy|granny smith|pinkie pie|princess cadance|princess celestia|princess flurry heart|princess luna|rainbow dash|rarity|scootaloo|shining armor|spike|starlight glimmer|sunset shimmer|sweetie belle|trixie|twilight sparkle,justsomepainter11|blueberry cannon
1563866.jpeg,https://derpicdn.net/img/view/2017/10/17/1563866.jpeg,5,0.994860291481018,852,1713,1248,2109,396,396,apple bloom|applejack|big macintosh|diamond tiara|discord|fluttershy|granny smith|pinkie pie|princess cadance|princess celestia|princess flurry heart|princess luna|rainbow dash|rarity|scootaloo|shining armor|spike|starlight glimmer|sunset shimmer|sweetie belle|trixie|twilight sparkle,justsomepainter11|blueberry cannon
1563866.jpeg,https://derpicdn.net/img/view/2017/10/17/1563866.jpeg,6,0.9934536218643188,1444,1030,1772,1358,328,328,apple bloom|applejack|big macintosh|diamond tiara|discord|fluttershy|granny smith|pinkie pie|princess cadance|princess celestia|princess flurry heart|princess luna|rainbow dash|rarity|scootaloo|shining armor|spike|starlight glimmer|sunset shimmer|sweetie belle|trixie|twilight sparkle,justsomepainter11|blueberry cannon
1563866.jpeg,https://derpicdn.net/img/view/2017/10/17/1563866.jpeg,7,0.9925884008407592,959,688,1335,1064,376,376,apple bloom|applejack|big macintosh|diamond tiara|discord|fluttershy|granny smith|pinkie pie|princess cadance|princess celestia|princess flurry heart|princess luna|rainbow dash|rarity|scootaloo|shining armor|spike|starlight glimmer|sunset shimmer|sweetie belle|trixie|twilight sparkle,justsomepainter11|blueberry cannon
1563866.jpeg,https://derpicdn.net/img/view/2017/10/17/1563866.jpeg,10,0.9902045130729676,881,1017,1207,1343,326,326,apple bloom|applejack|big macintosh|diamond tiara|discord|fluttershy|granny smith|pinkie pie|princess cadance|princess celestia|princess flurry heart|princess luna|rainbow dash|rarity|scootaloo|shining armor|spike|starlight glimmer|sunset shimmer|sweetie belle|trixie|twilight sparkle,justsomepainter11|blueberry cannon
1563866.jpeg,https://derpicdn.net/img/view/2017/10/17/1563866.jpeg,11,0.989765465259552,1716,1789,2048,2167,332,378,apple bloom|applejack|big macintosh|diamond tiara|discord|fluttershy|granny smith|pinkie pie|princess cadance|princess celestia|princess flurry heart|princess luna|rainbow dash|rarity|scootaloo|shining armor|spike|starlight glimmer|sunset shimmer|sweetie belle|trixie|twilight sparkle,justsomepainter11|blueberry cannon
1563866.jpeg,https://derpicdn.net/img/view/2017/10/17/1563866.jpeg,12,0.9876883029937744,1740,1285,2048,1623,308,338,apple bloom|applejack|big macintosh|diamond tiara|discord|fluttershy|granny smith|pinkie pie|princess cadance|princess celestia|princess flurry heart|princess luna|rainbow dash|rarity|scootaloo|shining armor|spike|starlight glimmer|sunset shimmer|sweetie belle|trixie|twilight sparkle,justsomepainter11|blueberry cannon
1563866.jpeg,https://derpicdn.net/img/view/2017/10/17/1563866.jpeg,13,0.9857745170593262,1738,151,2048,515,310,364,apple bloom|applejack|big macintosh|diamond tiara|discord|fluttershy|granny smith|pinkie pie|princess cadance|princess celestia|princess flurry heart|princess luna|rainbow dash|rarity|scootaloo|shining armor|spike|starlight glimmer|sunset shimmer|sweetie belle|trixie|twilight sparkle,justsomepainter11|blueberry cannon
1563866.jpeg,https://derpicdn.net/img/view/2017/10/17/1563866.jpeg,15,0.9811596870422364,1420,1772,1754,2106,334,334,apple bloom|applejack|big macintosh|diamond tiara|discord|fluttershy|granny smith|pinkie pie|princess cadance|princess celestia|princess flurry heart|princess luna|rainbow dash|rarity|scootaloo|shining armor|spike|starlight glimmer|sunset shimmer|sweetie belle|trixie|twilight sparkle,justsomepainter11|blueberry cannon
1563866.jpeg,https://derpicdn.net/img/view/2017/10/17/1563866.jpeg,18,0.9582405090332032,0,66,361,434,361,368,apple bloom|applejack|big macintosh|diamond tiara|discord|fluttershy|granny smith|pinkie pie|princess cadance|princess celestia|princess flurry heart|princess luna|rainbow dash|rarity|scootaloo|shining armor|spike|starlight glimmer|sunset shimmer|sweetie belle|trixie|twilight sparkle,justsomepainter11|blueberry cannon
1563866.jpeg,https://derpicdn.net/img/view/2017/10/17/1563866.jpeg,19,0.9479156136512756,1402,59,1842,499,440,440,apple bloom|applejack|big macintosh|diamond tiara|discord|fluttershy|granny smith|pinkie pie|princess cadance|princess celestia|princess flurry heart|princess luna|rainbow dash|rarity|scootaloo|shining armor|spike|starlight glimmer|sunset shimmer|sweetie belle|trixie|twilight sparkle,justsomepainter11|blueberry cannon
1564185.jpeg,https://derpicdn.net/img/view/2017/10/18/1564185.jpeg,0,0.9843800663948059,598,341,898,641,300,300,applejack|rainbow dash|twilight sparkle,pixelkitties
1564185.jpeg,https://derpicdn.net/img/view/2017/10/18/1564185.jpeg,1,0.9836869835853576,239,322,549,632,310,310,applejack|rainbow dash|twilight sparkle,pixelkitties
1564385.jpeg,https://derpicdn.net/img/view/2017/10/18/1564385.jpeg,0,0.997562050819397,514,1394,868,1748,354,354,applejack|big macintosh|fluttershy|mane six|pinkie pie|princess cadance|princess celestia|princess luna|rainbow dash|rarity|shining armor|spike|twilight sparkle,andypriceart
1564385.jpeg,https://derpicdn.net/img/view/2017/10/18/1564385.jpeg,1,0.9829391837120056,365,466,651,752,286,286,applejack|big macintosh|fluttershy|mane six|pinkie pie|princess cadance|princess celestia|princess luna|rainbow dash|rarity|shining armor|spike|twilight sparkle,andypriceart
1564385.jpeg,https://derpicdn.net/img/view/2017/10/18/1564385.jpeg,2,0.9825539588928224,507,691,845,1029,338,338,applejack|big macintosh|fluttershy|mane six|pinkie pie|princess cadance|princess celestia|princess luna|rainbow dash|rarity|shining armor|spike|twilight sparkle,andypriceart
1564385.jpeg,https://derpicdn.net/img/view/2017/10/18/1564385.jpeg,3,0.9823033213615416,158,964,410,1216,252,252,applejack|big macintosh|fluttershy|mane six|pinkie pie|princess cadance|princess celestia|princess luna|rainbow dash|rarity|shining armor|spike|twilight sparkle,andypriceart
1564385.jpeg,https://derpicdn.net/img/view/2017/10/18/1564385.jpeg,4,0.9545942544937134,353,935,631,1213,278,278,applejack|big macintosh|fluttershy|mane six|pinkie pie|princess cadance|princess celestia|princess luna|rainbow dash|rarity|shining armor|spike|twilight sparkle,andypriceart
1564385.jpeg,https://derpicdn.net/img/view/2017/10/18/1564385.jpeg,5,0.9498353004455566,172,1192,478,1498,306,306,applejack|big macintosh|fluttershy|mane six|pinkie pie|princess cadance|princess celestia|princess luna|rainbow dash|rarity|shining armor|spike|twilight sparkle,andypriceart
1565477.jpeg,https://derpicdn.net/img/view/2017/10/19/1565477.jpeg,0,0.9494369626045228,157,82,373,298,216,216,spike|twilight sparkle,jenkiwi
1566037.jpeg,https://derpicdn.net/img/view/2017/10/20/1566037.jpeg,0,0.99819678068161,662,126,1582,1046,920,920,princess celestia|twilight sparkle,magnaluna
1566190.jpeg,https://derpicdn.net/img/view/2017/10/20/1566190.jpeg,1,0.9985486268997192,607,100,1163,656,556,556,applejack|fluttershy|mane six|pinkie pie|rainbow dash|rarity|twilight sparkle,fidzfox
1566341.jpeg,https://derpicdn.net/img/view/2017/10/21/1566341.jpeg,0,0.9922529458999634,365,51,1301,987,936,936,princess luna|twilight sparkle,sinceus
1566692.jpeg,https://derpicdn.net/img/view/2017/10/21/1566692.jpeg,0,0.9700189232826232,500,227,926,653,426,426,starlight glimmer|twilight sparkle,mysticalpha
1566692.jpeg,https://derpicdn.net/img/view/2017/10/21/1566692.jpeg,1,0.9303970336914062,878,144,1318,584,440,440,starlight glimmer|twilight sparkle,mysticalpha
1568536.jpeg,https://derpicdn.net/img/view/2017/10/23/1568536.jpeg,1,0.9965940117836,0,177,247,433,247,256,applejack|fluttershy|mane six|pinkie pie|rainbow dash|rarity|twilight sparkle,jannel300
1568806.jpeg,https://derpicdn.net/img/view/2017/10/24/1568806.jpeg,0,0.9745080471038818,315,1101,759,1545,444,444,applejack|fluttershy|mane six|pinkie pie|rainbow dash|rarity|sunset shimmer|trixie|twilight sparkle,the-butch-x
1568806.jpeg,https://derpicdn.net/img/view/2017/10/24/1568806.jpeg,1,0.9698188900947572,1760,1105,2162,1507,402,402,applejack|fluttershy|mane six|pinkie pie|rainbow dash|rarity|sunset shimmer|trixie|twilight sparkle,the-butch-x
1568806.jpeg,https://derpicdn.net/img/view/2017/10/24/1568806.jpeg,2,0.960389256477356,3962,30,4448,516,486,486,applejack|fluttershy|mane six|pinkie pie|rainbow dash|rarity|sunset shimmer|trixie|twilight sparkle,the-butch-x
1568806.jpeg,https://derpicdn.net/img/view/2017/10/24/1568806.jpeg,3,0.91542249917984,3233,1099,3649,1515,416,416,applejack|fluttershy|mane six|pinkie pie|rainbow dash|rarity|sunset shimmer|trixie|twilight sparkle,the-butch-x
1568806.jpeg,https://derpicdn.net/img/view/2017/10/24/1568806.jpeg,4,0.9143704175949096,997,1090,1433,1526,436,436,applejack|fluttershy|mane six|pinkie pie|rainbow dash|rarity|sunset shimmer|trixie|twilight sparkle,the-butch-x
1568806.jpeg,https://derpicdn.net/img/view/2017/10/24/1568806.jpeg,5,0.9035952687263488,3205,1,3669,465,464,464,applejack|fluttershy|mane six|pinkie pie|rainbow dash|rarity|sunset shimmer|trixie|twilight sparkle,the-butch-x
1569154.jpeg,https://derpicdn.net/img/view/2017/10/24/1569154.jpeg,1,0.9983410835266112,806,0,1280,476,474,476,applejack|fluttershy|mane six|pinkie pie|rainbow dash|rarity|twilight sparkle,blackfrost
1569154.jpeg,https://derpicdn.net/img/view/2017/10/24/1569154.jpeg,2,0.9978100061416626,0,0,415,435,415,435,applejack|fluttershy|mane six|pinkie pie|rainbow dash|rarity|twilight sparkle,blackfrost
1569154.jpeg,https://derpicdn.net/img/view/2017/10/24/1569154.jpeg,3,0.9966070055961608,424,23,824,423,400,400,applejack|fluttershy|mane six|pinkie pie|rainbow dash|rarity|twilight sparkle,blackfrost
1569154.jpeg,https://derpicdn.net/img/view/2017/10/24/1569154.jpeg,4,0.9837017059326172,0,664,368,1056,368,392,applejack|fluttershy|mane six|pinkie pie|rainbow dash|rarity|twilight sparkle,blackfrost
1570958.jpeg,https://derpicdn.net/img/view/2017/10/27/1570958.jpeg,1,0.9873796105384828,1460,461,2370,1371,910,910,applejack|fluttershy|mane six|pinkie pie|rainbow dash|rarity|twilight sparkle,earthsong9405
1570958.jpeg,https://derpicdn.net/img/view/2017/10/27/1570958.jpeg,2,0.9628391265869141,4263,885,4875,1497,612,612,applejack|fluttershy|mane six|pinkie pie|rainbow dash|rarity|twilight sparkle,earthsong9405
1570958.jpeg,https://derpicdn.net/img/view/2017/10/27/1570958.jpeg,3,0.9368844628334044,819,620,1583,1384,764,764,applejack|fluttershy|mane six|pinkie pie|rainbow dash|rarity|twilight sparkle,earthsong9405
1571084.jpeg,https://derpicdn.net/img/view/2017/10/27/1571084.jpeg,0,0.9997491240501404,910,275,1358,723,448,448,pinkie pie|twilight sparkle,jucamovi1992
1571084.jpeg,https://derpicdn.net/img/view/2017/10/27/1571084.jpeg,1,0.9772385358810424,573,188,1047,662,474,474,pinkie pie|twilight sparkle,jucamovi1992
1571848.jpeg,https://derpicdn.net/img/view/2017/10/28/1571848.jpeg,0,0.9439356327056884,328,30,742,444,414,414,spike|twilight sparkle,yam
1572021.jpeg,https://derpicdn.net/img/view/2017/10/28/1572021.jpeg,0,0.9941772818565368,425,964,667,1206,242,242,starlight glimmer|twilight sparkle,mysticalpha
1572021.jpeg,https://derpicdn.net/img/view/2017/10/28/1572021.jpeg,1,0.9904065132141112,257,974,511,1228,254,254,starlight glimmer|twilight sparkle,mysticalpha
1572997.jpeg,https://derpicdn.net/img/view/2017/10/29/1572997.jpeg,0,0.9946299195289612,537,0,871,279,334,279,sunset shimmer|twilight sparkle,hobilo
1572997.jpeg,https://derpicdn.net/img/view/2017/10/29/1572997.jpeg,1,0.9775452613830566,136,0,602,419,466,419,sunset shimmer|twilight sparkle,hobilo
1574930.jpeg,https://derpicdn.net/img/view/2017/10/31/1574930.jpeg,0,0.9936550259590148,1050,17,1348,351,298,334,applejack|fluttershy|mane six|pinkie pie|rainbow dash|rarity|twilight sparkle,liniitadash23
1574930.jpeg,https://derpicdn.net/img/view/2017/10/31/1574930.jpeg,1,0.950231432914734,462,48,738,324,276,276,applejack|fluttershy|mane six|pinkie pie|rainbow dash|rarity|twilight sparkle,liniitadash23
1574930.jpeg,https://derpicdn.net/img/view/2017/10/31/1574930.jpeg,2,0.9413523674011228,623,527,921,825,298,298,applejack|fluttershy|mane six|pinkie pie|rainbow dash|rarity|twilight sparkle,liniitadash23
1576709.jpeg,https://derpicdn.net/img/view/2017/11/3/1576709.jpeg,0,0.9777041673660278,762,2664,2314,4216,1552,1552,princess celestia|starlight glimmer|twilight sparkle,poecillia-gracilis19
1576709.jpeg,https://derpicdn.net/img/view/2017/11/3/1576709.jpeg,1,0.9287427663803101,1815,4010,3215,5410,1400,1400,princess celestia|starlight glimmer|twilight sparkle,poecillia-gracilis19
1577506.jpeg,https://derpicdn.net/img/view/2017/11/4/1577506.jpeg,0,0.9900751709938048,143,0,743,534,600,534,spike|twilight sparkle,emositecc|riukime
1577506.jpeg,https://derpicdn.net/img/view/2017/11/4/1577506.jpeg,1,0.9827768206596376,614,7,1114,507,500,500,spike|twilight sparkle,emositecc|riukime
1577506.jpeg,https://derpicdn.net/img/view/2017/11/4/1577506.jpeg,2,0.943198561668396,800,393,1214,815,414,422,spike|twilight sparkle,emositecc|riukime
1580191.jpeg,https://derpicdn.net/img/view/2017/11/7/1580191.jpeg,0,0.977294385433197,387,263,575,451,188,188,princess cadance|princess celestia|princess flurry heart|princess luna|twilight sparkle,lytlethelemur
1580550.jpeg,https://derpicdn.net/img/view/2017/11/7/1580550.jpeg,0,0.9324521422386168,171,0,839,624,668,624,rainbow dash|twilight sparkle,dumddeer
1580678.jpeg,https://derpicdn.net/img/view/2017/11/7/1580678.jpeg,0,0.9550346732139589,64,121,616,673,552,552,sunset shimmer|twilight sparkle,aka-ryuga
1581199.jpeg,https://derpicdn.net/img/view/2017/11/8/1581199.jpeg,0,0.9732750058174132,603,399,1221,1017,618,618,rainbow dash|twilight sparkle,vest|caboni32
1581199.jpeg,https://derpicdn.net/img/view/2017/11/8/1581199.jpeg,1,0.958884596824646,126,139,726,739,600,600,rainbow dash|twilight sparkle,vest|caboni32
1582892.jpeg,https://derpicdn.net/img/view/2017/11/10/1582892.jpeg,1,0.9896267652511596,1390,1042,2214,1866,824,824,spike|starlight glimmer|sunset shimmer|trixie|twilight sparkle,stevetwisp
1582892.jpeg,https://derpicdn.net/img/view/2017/11/10/1582892.jpeg,2,0.9879837036132812,2266,467,3060,1261,794,794,spike|starlight glimmer|sunset shimmer|trixie|twilight sparkle,stevetwisp
1582892.jpeg,https://derpicdn.net/img/view/2017/11/10/1582892.jpeg,3,0.9750779271125792,524,1120,1158,1754,634,634,spike|starlight glimmer|sunset shimmer|trixie|twilight sparkle,stevetwisp
1583520.jpeg,https://derpicdn.net/img/view/2017/11/11/1583520.jpeg,0,0.9516015052795408,0,0,1328,1652,1328,1652,pinkie pie|rainbow dash|twilight sparkle,smallhorses|bighorsesarethebest
1585477.jpeg,https://derpicdn.net/img/view/2017/11/13/1585477.jpeg,0,0.9872936606407166,1153,370,1777,994,624,624,sunset shimmer|twilight sparkle,overlordneon
1586710.jpeg,https://derpicdn.net/img/view/2017/11/15/1586710.jpeg,0,0.9471683502197266,391,475,701,785,310,310,fluttershy|rarity|twilight sparkle,agnesgarbowska
1587079.jpeg,https://derpicdn.net/img/view/2017/11/15/1587079.jpeg,1,0.9780991673469543,717,1005,1007,1295,290,290,applejack|fluttershy|mane six|pinkie pie|rainbow dash|rarity|spike|twilight sparkle,chibi-jen-hen
1588357.jpeg,https://derpicdn.net/img/view/2017/11/17/1588357.jpeg,0,0.9964869618415833,0,10,375,432,375,422,starlight glimmer|trixie|twilight sparkle,xjkenny
1588357.jpeg,https://derpicdn.net/img/view/2017/11/17/1588357.jpeg,1,0.9950851202011108,455,9,800,355,345,346,starlight glimmer|trixie|twilight sparkle,xjkenny
1589188.jpeg,https://derpicdn.net/img/view/2017/11/18/1589188.jpeg,0,0.9967781901359558,1598,409,2368,1179,770,770,rainbow dash|twilight sparkle,a8f12
1589188.jpeg,https://derpicdn.net/img/view/2017/11/18/1589188.jpeg,1,0.9864667057991028,0,0,1155,1147,1155,1147,rainbow dash|twilight sparkle,a8f12
1589602.jpeg,https://derpicdn.net/img/view/2017/11/19/1589602.jpeg,0,0.916869044303894,1942,0,3862,1910,1920,1910,rarity|twilight sparkle,earthsong9405
1591049.jpeg,https://derpicdn.net/img/view/2017/11/21/1591049.jpeg,0,0.9823721051216124,353,385,559,591,206,206,starlight glimmer|twilight sparkle,
1591171.jpeg,https://derpicdn.net/img/view/2017/11/21/1591171.jpeg,0,0.9972150921821594,755,2846,1673,3764,918,918,rarity|twilight sparkle,earthsong9405
1591772.jpeg,https://derpicdn.net/img/view/2017/11/22/1591772.jpeg,0,0.996602475643158,0,801,366,1245,366,444,applejack|diamond tiara|fluttershy|mane six|pinkie pie|rainbow dash|rarity|spike|twilight sparkle,brendahickey
1591899.jpeg,https://derpicdn.net/img/view/2017/11/22/1591899.jpeg,0,0.9994946718215942,326,216,542,432,216,216,trixie|twilight sparkle,linedraweer
1592608.jpeg,https://derpicdn.net/img/view/2017/11/23/1592608.jpeg,0,0.9973430633544922,1113,137,1353,377,240,240,applejack|fluttershy|pinkie pie|rainbow dash|rarity|sunset shimmer|twilight sparkle,
1592608.jpeg,https://derpicdn.net/img/view/2017/11/23/1592608.jpeg,1,0.985927939414978,1004,1071,1718,1785,714,714,applejack|fluttershy|pinkie pie|rainbow dash|rarity|sunset shimmer|twilight sparkle,
1592608.jpeg,https://derpicdn.net/img/view/2017/11/23/1592608.jpeg,2,0.9453033804893494,227,264,459,496,232,232,applejack|fluttershy|pinkie pie|rainbow dash|rarity|sunset shimmer|twilight sparkle,
1592608.jpeg,https://derpicdn.net/img/view/2017/11/23/1592608.jpeg,3,0.9196110367774964,873,181,1137,445,264,264,applejack|fluttershy|pinkie pie|rainbow dash|rarity|sunset shimmer|twilight sparkle,
1594596.jpeg,https://derpicdn.net/img/view/2017/11/26/1594596.jpeg,0,0.9597494602203368,34,35,442,443,408,408,starlight glimmer|twilight sparkle,hosikawa
1595074.jpeg,https://derpicdn.net/img/view/2017/11/26/1595074.jpeg,0,0.9947960376739502,565,375,1349,1159,784,784,princess luna|twilight sparkle,magnaluna
1595211.jpeg,https://derpicdn.net/img/view/2017/11/27/1595211.jpeg,0,0.9974508881568908,316,340,580,604,264,264,applejack|fluttershy|mane six|pinkie pie|rainbow dash|rarity|starlight glimmer|twilight sparkle,calena
1595211.jpeg,https://derpicdn.net/img/view/2017/11/27/1595211.jpeg,1,0.9961864948272704,652,0,994,300,342,300,applejack|fluttershy|mane six|pinkie pie|rainbow dash|rarity|starlight glimmer|twilight sparkle,calena
1596102.jpeg,https://derpicdn.net/img/view/2017/11/28/1596102.jpeg,0,0.984894633293152,299,203,507,411,208,208,starlight glimmer|twilight sparkle,lollipony
1596504.jpeg,https://derpicdn.net/img/view/2017/11/28/1596504.jpeg,0,0.9433270692825316,142,579,682,1119,540,540,rainbow dash|twilight sparkle,brendahickey
1596592.jpeg,https://derpicdn.net/img/view/2017/11/29/1596592.jpeg,0,0.993556797504425,1267,635,1931,1299,664,664,princess cadance|princess flurry heart|shining armor|spike|twilight sparkle,justsomepainter11
1596592.jpeg,https://derpicdn.net/img/view/2017/11/29/1596592.jpeg,3,0.9568157792091372,535,540,1291,1296,756,756,princess cadance|princess flurry heart|shining armor|spike|twilight sparkle,justsomepainter11
1598686.jpeg,https://derpicdn.net/img/view/2017/12/2/1598686.jpeg,0,0.992559850215912,496,114,972,590,476,476,spike|twilight sparkle,rossignolet
1599815.jpeg,https://derpicdn.net/img/view/2017/12/3/1599815.jpeg,1,0.9732125997543336,1044,0,1568,472,524,472,applejack|fluttershy|mane six|pinkie pie|rainbow dash|rarity|twilight sparkle,shiinadrawmiku
1599815.jpeg,https://derpicdn.net/img/view/2017/12/3/1599815.jpeg,2,0.962264358997345,1086,394,1572,880,486,486,applejack|fluttershy|mane six|pinkie pie|rainbow dash|rarity|twilight sparkle,shiinadrawmiku
1599856.jpeg,https://derpicdn.net/img/view/2017/12/3/1599856.jpeg,0,0.9992383718490601,0,54,205,268,205,214,applejack|fluttershy|mane six|pinkie pie|rainbow dash|rarity|twilight sparkle,graphic-lee
1599856.jpeg,https://derpicdn.net/img/view/2017/12/3/1599856.jpeg,1,0.9731984734535216,331,62,597,328,266,266,applejack|fluttershy|mane six|pinkie pie|rainbow dash|rarity|twilight sparkle,graphic-lee
1600126.jpeg,https://derpicdn.net/img/view/2017/12/4/1600126.jpeg,0,0.998831868171692,1259,1288,1509,1538,250,250,applejack|fluttershy|mane six|pinkie pie|rainbow dash|rarity|twilight sparkle,
1600126.jpeg,https://derpicdn.net/img/view/2017/12/4/1600126.jpeg,1,0.9976730942726136,991,1165,1293,1467,302,302,applejack|fluttershy|mane six|pinkie pie|rainbow dash|rarity|twilight sparkle,
1600126.jpeg,https://derpicdn.net/img/view/2017/12/4/1600126.jpeg,2,0.9894919991493224,271,1185,561,1475,290,290,applejack|fluttershy|mane six|pinkie pie|rainbow dash|rarity|twilight sparkle,
1600126.jpeg,https://derpicdn.net/img/view/2017/12/4/1600126.jpeg,3,0.9789918065071106,568,995,944,1371,376,376,applejack|fluttershy|mane six|pinkie pie|rainbow dash|rarity|twilight sparkle,
1600294.jpeg,https://derpicdn.net/img/view/2017/12/4/1600294.jpeg,0,0.9362695217132568,3305,5274,4367,6336,1062,1062,applejack|fluttershy|mane six|pinkie pie|rainbow dash|rarity|twilight sparkle,edcom02|krynos79
1600352.jpeg,https://derpicdn.net/img/view/2017/12/4/1600352.jpeg,0,0.9682729840278624,1629,353,2139,863,510,510,princess luna|twilight sparkle,chapaevv
1600352.jpeg,https://derpicdn.net/img/view/2017/12/4/1600352.jpeg,1,0.9560258388519288,355,589,1195,1429,840,840,princess luna|twilight sparkle,chapaevv
1600352.jpeg,https://derpicdn.net/img/view/2017/12/4/1600352.jpeg,2,0.911454975605011,2148,246,2892,990,744,744,princess luna|twilight sparkle,chapaevv
1600544.jpeg,https://derpicdn.net/img/view/2017/12/4/1600544.jpeg,0,0.9830833077430724,249,0,1549,1098,1300,1098,princess celestia|twilight sparkle,justsomepainter11
1600544.jpeg,https://derpicdn.net/img/view/2017/12/4/1600544.jpeg,1,0.9097529649734496,1579,640,2463,1524,884,884,princess celestia|twilight sparkle,justsomepainter11
1600881.jpeg,https://derpicdn.net/img/view/2017/12/5/1600881.jpeg,0,0.9469087719917296,103,0,609,505,506,505,rarity|twilight sparkle,
1600948.jpeg,https://derpicdn.net/img/view/2017/12/5/1600948.jpeg,1,0.9901018142700196,0,229,401,645,401,416,applejack|fluttershy|mane six|pinkie pie|princess luna|rainbow dash|rarity|twilight sparkle,shiinadrawmiku
1600948.jpeg,https://derpicdn.net/img/view/2017/12/5/1600948.jpeg,3,0.9204345941543579,281,260,677,656,396,396,applejack|fluttershy|mane six|pinkie pie|princess luna|rainbow dash|rarity|twilight sparkle,shiinadrawmiku
1603840.jpeg,https://derpicdn.net/img/view/2017/12/9/1603840.jpeg,0,0.9833849668502808,28,644,320,936,292,292,applejack|fluttershy|mane six|pinkie pie|rainbow dash|rarity|spike|twilight sparkle,joy-ang
1604265.jpeg,https://derpicdn.net/img/view/2017/12/10/1604265.jpeg,0,0.9999620914459229,15,215,977,1177,962,962,rainbow dash|twilight sparkle,fizzy-dog
1604359.jpeg,https://derpicdn.net/img/view/2017/12/10/1604359.jpeg,0,0.989007294178009,0,502,325,862,325,360,applejack|fluttershy|mane six|pinkie pie|princess celestia|princess luna|rainbow dash|rarity|twilight sparkle,andypriceart
1604495.jpeg,https://derpicdn.net/img/view/2017/12/10/1604495.jpeg,0,0.9520962238311768,2184,334,3018,1168,834,834,applejack|fluttershy|mane six|pinkie pie|rainbow dash|rarity|twilight sparkle,satv12
1605033.jpeg,https://derpicdn.net/img/view/2017/12/11/1605033.jpeg,0,0.9986774325370787,801,137,1385,721,584,584,sunset shimmer|twilight sparkle,overlordneon
1605033.jpeg,https://derpicdn.net/img/view/2017/12/11/1605033.jpeg,1,0.97010338306427,124,341,604,821,480,480,sunset shimmer|twilight sparkle,overlordneon
1605710.jpeg,https://derpicdn.net/img/view/2017/12/12/1605710.jpeg,0,0.9964099526405334,906,307,1172,573,266,266,applejack|fluttershy|mane six|pinkie pie|rainbow dash|rarity|spike|twilight sparkle,
1605710.jpeg,https://derpicdn.net/img/view/2017/12/12/1605710.jpeg,1,0.9773090481758118,136,0,490,315,354,315,applejack|fluttershy|mane six|pinkie pie|rainbow dash|rarity|spike|twilight sparkle,
1606548.jpeg,https://derpicdn.net/img/view/2017/12/13/1606548.jpeg,0,0.9961600303649902,1306,1037,2028,1759,722,722,princess celestia|princess luna|twilight sparkle,magnaluna
1606548.jpeg,https://derpicdn.net/img/view/2017/12/13/1606548.jpeg,2,0.9904847145080566,71,91,869,889,798,798,princess celestia|princess luna|twilight sparkle,magnaluna
1607808.jpeg,https://derpicdn.net/img/view/2017/12/14/1607808.jpeg,0,0.999339759349823,316,21,620,325,304,304,applejack|fluttershy|mane six|pinkie pie|rainbow dash|rarity|spike|starlight glimmer|twilight sparkle,jowybean
1607808.jpeg,https://derpicdn.net/img/view/2017/12/14/1607808.jpeg,1,0.9803919792175292,340,511,604,775,264,264,applejack|fluttershy|mane six|pinkie pie|rainbow dash|rarity|spike|starlight glimmer|twilight sparkle,jowybean
1607808.jpeg,https://derpicdn.net/img/view/2017/12/14/1607808.jpeg,3,0.9182538390159608,46,19,384,357,338,338,applejack|fluttershy|mane six|pinkie pie|rainbow dash|rarity|spike|starlight glimmer|twilight sparkle,jowybean
1607808.jpeg,https://derpicdn.net/img/view/2017/12/14/1607808.jpeg,4,0.9066957235336304,519,19,900,407,381,388,applejack|fluttershy|mane six|pinkie pie|rainbow dash|rarity|spike|starlight glimmer|twilight sparkle,jowybean
1610594.jpeg,https://derpicdn.net/img/view/2017/12/18/1610594.jpeg,0,0.9957337379455566,279,589,631,941,352,352,sunset shimmer|twilight sparkle,jonfawkes|little-tweenframes
1610594.jpeg,https://derpicdn.net/img/view/2017/12/18/1610594.jpeg,2,0.9906947612762452,128,856,474,1202,346,346,sunset shimmer|twilight sparkle,jonfawkes|little-tweenframes
1610638.jpeg,https://derpicdn.net/img/view/2017/12/18/1610638.jpeg,0,0.9975941777229308,779,123,1093,437,314,314,rainbow dash|twilight sparkle,dreadlime
1610638.jpeg,https://derpicdn.net/img/view/2017/12/18/1610638.jpeg,1,0.971144199371338,1052,912,1352,1212,300,300,rainbow dash|twilight sparkle,dreadlime
1610638.jpeg,https://derpicdn.net/img/view/2017/12/18/1610638.jpeg,2,0.9434541463851928,791,686,1087,982,296,296,rainbow dash|twilight sparkle,dreadlime
1611721.jpeg,https://derpicdn.net/img/view/2017/12/20/1611721.jpeg,0,0.9875949621200562,333,491,735,893,402,402,applejack|fluttershy|mane six|pinkie pie|rainbow dash|rarity|spike|twilight sparkle,andypriceart
1611721.jpeg,https://derpicdn.net/img/view/2017/12/20/1611721.jpeg,1,0.9579235315322876,548,303,886,641,338,338,applejack|fluttershy|mane six|pinkie pie|rainbow dash|rarity|spike|twilight sparkle,andypriceart
1613338.jpeg,https://derpicdn.net/img/view/2017/12/22/1613338.jpeg,0,0.9120829105377196,193,233,693,733,500,500,discord|starlight glimmer|trixie|twilight sparkle,yam
1614907.jpeg,https://derpicdn.net/img/view/2017/12/24/1614907.jpeg,0,0.9969451427459716,284,25,748,489,464,464,applejack|fluttershy|mane six|pinkie pie|rainbow dash|rarity|twilight sparkle,passigcamel
1614907.jpeg,https://derpicdn.net/img/view/2017/12/24/1614907.jpeg,1,0.9964773654937744,1380,1577,1790,1987,410,410,applejack|fluttershy|mane six|pinkie pie|rainbow dash|rarity|twilight sparkle,passigcamel
1614907.jpeg,https://derpicdn.net/img/view/2017/12/24/1614907.jpeg,2,0.9958332180976868,1068,325,1596,853,528,528,applejack|fluttershy|mane six|pinkie pie|rainbow dash|rarity|twilight sparkle,passigcamel
1614907.jpeg,https://derpicdn.net/img/view/2017/12/24/1614907.jpeg,3,0.9198803305625916,1127,1836,1529,2238,402,402,applejack|fluttershy|mane six|pinkie pie|rainbow dash|rarity|twilight sparkle,passigcamel
1615024.jpeg,https://derpicdn.net/img/view/2017/12/24/1615024.jpeg,1,0.9683783054351808,1426,228,1640,442,214,214,princess celestia|princess luna|spike|sunset shimmer|twilight sparkle,silfoe
1615097.jpeg,https://derpicdn.net/img/view/2017/12/24/1615097.jpeg,0,0.9088154435157776,619,2252,1089,2722,470,470,applejack|big macintosh|starlight glimmer|trixie|twilight sparkle,1jaz
1616202.jpeg,https://derpicdn.net/img/view/2017/12/25/1616202.jpeg,0,0.9863459467887878,137,305,517,685,380,380,applejack|fluttershy|pinkie pie|rainbow dash|rarity|twilight sparkle,aiyanmanno
1617298.jpeg,https://derpicdn.net/img/view/2017/12/27/1617298.jpeg,0,0.9336504340171814,0,160,835,1036,835,876,starlight glimmer|sunset shimmer|trixie|twilight sparkle,tyantyai_mokka
1617355.jpeg,https://derpicdn.net/img/view/2017/12/27/1617355.jpeg,0,0.9883484840393066,121,0,1195,1072,1074,1072,spike|twilight sparkle,osawari64
1618044.jpeg,https://derpicdn.net/img/view/2017/12/28/1618044.jpeg,0,0.9851686358451844,909,0,1499,584,590,584,spike|twilight sparkle,celestial-rainstorm
1618301.jpeg,https://derpicdn.net/img/view/2017/12/28/1618301.jpeg,0,0.9973323345184326,589,293,1593,1297,1004,1004,princess celestia|twilight sparkle,magnaluna
1618665.jpeg,https://derpicdn.net/img/view/2017/12/29/1618665.jpeg,0,0.9472556114196776,960,1056,1570,1666,610,610,rainbow dash|scootaloo|twilight sparkle,liaaqila
1618665.jpeg,https://derpicdn.net/img/view/2017/12/29/1618665.jpeg,1,0.9214146137237548,1772,443,2552,1223,780,780,rainbow dash|scootaloo|twilight sparkle,liaaqila
1618817.jpeg,https://derpicdn.net/img/view/2017/12/29/1618817.jpeg,0,0.9840890765190125,1110,1117,1576,1583,466,466,princess cadance|princess celestia|princess flurry heart|princess luna|twilight sparkle,sl0ne
1621604.jpeg,https://derpicdn.net/img/view/2018/1/1/1621604.jpeg,0,0.9342240691184998,1871,72,3875,2076,2004,2004,sunset shimmer|twilight sparkle,imafutureguitarhero
1621604.jpeg,https://derpicdn.net/img/view/2018/1/1/1621604.jpeg,1,0.9251455068588256,3011,2016,5307,4312,2296,2296,sunset shimmer|twilight sparkle,imafutureguitarhero
1622308.jpeg,https://derpicdn.net/img/view/2018/1/2/1622308.jpeg,0,0.986680269241333,1255,717,2217,1679,962,962,princess celestia|princess luna|twilight sparkle,foughtdragon01
1623131.jpeg,https://derpicdn.net/img/view/2018/1/3/1623131.jpeg,0,0.9734122157096864,729,0,1607,819,878,819,applejack|fluttershy|rainbow dash|rarity|twilight sparkle,shiinadrawmiku
1623131.jpeg,https://derpicdn.net/img/view/2018/1/3/1623131.jpeg,1,0.9177406430244446,0,0,668,728,668,728,applejack|fluttershy|rainbow dash|rarity|twilight sparkle,shiinadrawmiku
1623565.jpeg,https://derpicdn.net/img/view/2018/1/4/1623565.jpeg,0,0.9745554924011228,172,617,282,727,110,110,apple bloom|applejack|big macintosh|braeburn|cutie mark crusaders|discord|fluttershy|pinkie pie|princess celestia|princess luna|rainbow dash|rarity|scootaloo|soarin'|spike|spitfire|sweetie belle|trixie|twilight sparkle,johnjoseco
1625536.jpeg,https://derpicdn.net/img/view/2018/1/6/1625536.jpeg,0,0.975564420223236,813,16,1583,786,770,770,rarity|twilight sparkle,earthsong9405
1625914.jpeg,https://derpicdn.net/img/view/2018/1/7/1625914.jpeg,0,0.9971005320549012,0,46,473,520,473,474,discord|pinkie pie|princess celestia|princess luna|queen chrysalis|rainbow dash|shining armor|spike|twilight sparkle,earthsong9405
1625914.jpeg,https://derpicdn.net/img/view/2018/1/7/1625914.jpeg,3,0.9943712949752808,557,50,1091,584,534,534,discord|pinkie pie|princess celestia|princess luna|queen chrysalis|rainbow dash|shining armor|spike|twilight sparkle,earthsong9405
1625914.jpeg,https://derpicdn.net/img/view/2018/1/7/1625914.jpeg,4,0.983224630355835,0,653,570,1253,570,600,discord|pinkie pie|princess celestia|princess luna|queen chrysalis|rainbow dash|shining armor|spike|twilight sparkle,earthsong9405
1625914.jpeg,https://derpicdn.net/img/view/2018/1/7/1625914.jpeg,5,0.9829572439193726,975,1397,1600,2057,625,660,discord|pinkie pie|princess celestia|princess luna|queen chrysalis|rainbow dash|shining armor|spike|twilight sparkle,earthsong9405
1625914.jpeg,https://derpicdn.net/img/view/2018/1/7/1625914.jpeg,10,0.943051278591156,557,1410,1079,1932,522,522,discord|pinkie pie|princess celestia|princess luna|queen chrysalis|rainbow dash|shining armor|spike|twilight sparkle,earthsong9405
1626369.jpeg,https://derpicdn.net/img/view/2018/1/7/1626369.jpeg,1,0.9696133732795716,9796,486,10684,1374,888,888,applejack|fluttershy|mane six|pinkie pie|rainbow dash|rarity|spike|twilight sparkle,earthsong9405
1626369.jpeg,https://derpicdn.net/img/view/2018/1/7/1626369.jpeg,2,0.9667000770568848,4498,154,5512,1168,1014,1014,applejack|fluttershy|mane six|pinkie pie|rainbow dash|rarity|spike|twilight sparkle,earthsong9405
1626369.jpeg,https://derpicdn.net/img/view/2018/1/7/1626369.jpeg,4,0.9372104406356812,3376,940,4282,1846,906,906,applejack|fluttershy|mane six|pinkie pie|rainbow dash|rarity|spike|twilight sparkle,earthsong9405
1626369.jpeg,https://derpicdn.net/img/view/2018/1/7/1626369.jpeg,5,0.9194915294647216,5579,810,6609,1840,1030,1030,applejack|fluttershy|mane six|pinkie pie|rainbow dash|rarity|spike|twilight sparkle,earthsong9405
1626548.jpeg,https://derpicdn.net/img/view/2018/1/7/1626548.jpeg,2,0.984097957611084,915,475,1207,767,292,292,applejack|fluttershy|mane six|pinkie pie|rainbow dash|rarity|twilight sparkle,zoxriver503
1626548.jpeg,https://derpicdn.net/img/view/2018/1/7/1626548.jpeg,3,0.9737374782562256,911,798,1201,1088,290,290,applejack|fluttershy|mane six|pinkie pie|rainbow dash|rarity|twilight sparkle,zoxriver503
1626548.jpeg,https://derpicdn.net/img/view/2018/1/7/1626548.jpeg,4,0.9668991565704346,661,779,967,1085,306,306,applejack|fluttershy|mane six|pinkie pie|rainbow dash|rarity|twilight sparkle,zoxriver503
1627303.jpeg,https://derpicdn.net/img/view/2018/1/8/1627303.jpeg,0,0.9725708365440368,1382,427,2350,1395,968,968,spike|twilight sparkle,darcelleart
1627416.jpeg,https://derpicdn.net/img/view/2018/1/8/1627416.jpeg,0,0.9887746572494508,440,172,682,414,242,242,applejack|fluttershy|mane six|pinkie pie|rainbow dash|rarity|twilight sparkle,celestial-rainstorm
1627416.jpeg,https://derpicdn.net/img/view/2018/1/8/1627416.jpeg,1,0.9726555347442628,163,47,411,295,248,248,applejack|fluttershy|mane six|pinkie pie|rainbow dash|rarity|twilight sparkle,celestial-rainstorm
1627416.jpeg,https://derpicdn.net/img/view/2018/1/8/1627416.jpeg,2,0.9523857235908508,176,2414,464,2702,288,288,applejack|fluttershy|mane six|pinkie pie|rainbow dash|rarity|twilight sparkle,celestial-rainstorm
1628279.jpeg,https://derpicdn.net/img/view/2018/1/9/1628279.jpeg,0,0.9897007942199708,4217,0,5431,1034,1214,1034,applejack|fluttershy|mane six|pinkie pie|rainbow dash|rarity|twilight sparkle,hiccupsdoesart
1628279.jpeg,https://derpicdn.net/img/view/2018/1/9/1628279.jpeg,1,0.9886656403541564,621,0,1715,1039,1094,1039,applejack|fluttershy|mane six|pinkie pie|rainbow dash|rarity|twilight sparkle,hiccupsdoesart
1628279.jpeg,https://derpicdn.net/img/view/2018/1/9/1628279.jpeg,2,0.9612034559249878,3960,1943,4898,2881,938,938,applejack|fluttershy|mane six|pinkie pie|rainbow dash|rarity|twilight sparkle,hiccupsdoesart
1628279.jpeg,https://derpicdn.net/img/view/2018/1/9/1628279.jpeg,3,0.9453093409538268,2674,1739,3746,2811,1072,1072,applejack|fluttershy|mane six|pinkie pie|rainbow dash|rarity|twilight sparkle,hiccupsdoesart
1633891.jpeg,https://derpicdn.net/img/view/2018/1/16/1633891.jpeg,0,0.9964297413825988,1409,15,2443,1049,1034,1034,princess luna|twilight sparkle,magnaluna
1633891.jpeg,https://derpicdn.net/img/view/2018/1/16/1633891.jpeg,1,0.9942469596862792,436,105,1516,1185,1080,1080,princess luna|twilight sparkle,magnaluna
1634081.jpeg,https://derpicdn.net/img/view/2018/1/17/1634081.jpeg,0,0.9781357049942015,2027,442,2343,758,316,316,apple bloom|applejack|fluttershy|mane six|pinkie pie|rainbow dash|rarity|spike|twilight sparkle,shimazun
1634081.jpeg,https://derpicdn.net/img/view/2018/1/17/1634081.jpeg,1,0.9607061743736268,86,229,512,655,426,426,apple bloom|applejack|fluttershy|mane six|pinkie pie|rainbow dash|rarity|spike|twilight sparkle,shimazun
1634940.jpeg,https://derpicdn.net/img/view/2018/1/18/1634940.jpeg,0,0.9842742681503296,156,1195,526,1565,370,370,pinkie pie|starlight glimmer|sunset shimmer|trixie|twilight sparkle,
1636737.jpeg,https://derpicdn.net/img/view/2018/1/20/1636737.jpeg,0,0.9791433811187744,770,0,4950,4012,4180,4012,sunset shimmer|twilight sparkle,dressella
1638823.jpeg,https://derpicdn.net/img/view/2018/1/23/1638823.jpeg,1,0.9319564700126648,644,1664,1574,2594,930,930,rainbow dash|twilight sparkle,sharpieboss
1641452.jpeg,https://derpicdn.net/img/view/2018/1/26/1641452.jpeg,0,0.9832661747932434,250,0,530,268,280,268,trixie|twilight sparkle,xjkenny
1642367.jpeg,https://derpicdn.net/img/view/2018/1/27/1642367.jpeg,0,0.9700419902801514,923,275,1299,651,376,376,princess luna|sunset shimmer|twilight sparkle,tejedora
1642367.jpeg,https://derpicdn.net/img/view/2018/1/27/1642367.jpeg,1,0.9585670232772828,648,303,960,615,312,312,princess luna|sunset shimmer|twilight sparkle,tejedora
1642367.jpeg,https://derpicdn.net/img/view/2018/1/27/1642367.jpeg,2,0.9488936066627502,1337,88,1769,520,432,432,princess luna|sunset shimmer|twilight sparkle,tejedora
1642423.jpeg,https://derpicdn.net/img/view/2018/1/27/1642423.jpeg,0,0.9968698024749756,923,45,1320,465,397,420,shining armor|twilight sparkle,silfoe
1644313.jpeg,https://derpicdn.net/img/view/2018/1/30/1644313.jpeg,0,0.9983650445938108,3745,5607,5907,7769,2162,2162,applejack|fluttershy|mane six|pinkie pie|rainbow dash|rarity|twilight sparkle,zaballama
1644313.jpeg,https://derpicdn.net/img/view/2018/1/30/1644313.jpeg,1,0.9881259202957152,4239,0,6413,2116,2174,2116,applejack|fluttershy|mane six|pinkie pie|rainbow dash|rarity|twilight sparkle,zaballama
1644313.jpeg,https://derpicdn.net/img/view/2018/1/30/1644313.jpeg,2,0.9785739779472352,3647,2727,6201,5281,2554,2554,applejack|fluttershy|mane six|pinkie pie|rainbow dash|rarity|twilight sparkle,zaballama
1644313.jpeg,https://derpicdn.net/img/view/2018/1/30/1644313.jpeg,3,0.9485509991645812,408,51,2190,1833,1782,1782,applejack|fluttershy|mane six|pinkie pie|rainbow dash|rarity|twilight sparkle,zaballama
1645529.jpeg,https://derpicdn.net/img/view/2018/1/31/1645529.jpeg,0,0.9043004512786864,177,7,1553,1383,1376,1376,princess celestia|princess luna|twilight sparkle,darkest-lunar-flower
1645644.jpeg,https://derpicdn.net/img/view/2018/2/1/1645644.jpeg,0,0.9993621706962584,656,348,1388,1080,732,732,princess celestia|princess luna|twilight sparkle,magnaluna
1645644.jpeg,https://derpicdn.net/img/view/2018/2/1/1645644.jpeg,1,0.9831852316856384,98,162,622,686,524,524,princess celestia|princess luna|twilight sparkle,magnaluna
1645700.jpeg,https://derpicdn.net/img/view/2018/2/1/1645700.jpeg,0,0.9840182662010192,6854,2042,7646,2834,792,792,apple bloom|applejack|big macintosh|cutie mark crusaders|diamond tiara|discord|fluttershy|granny smith|mane six|pinkie pie|princess cadance|princess celestia|princess luna|rainbow dash|rarity|scootaloo|shining armor|silver spoon|spike|starlight glimmer|sunset shimmer|sweetie belle|trixie|twilight sparkle,conthauberger
1645700.jpeg,https://derpicdn.net/img/view/2018/2/1/1645700.jpeg,1,0.9576594829559326,394,3484,1318,4408,924,924,apple bloom|applejack|big macintosh|cutie mark crusaders|diamond tiara|discord|fluttershy|granny smith|mane six|pinkie pie|princess cadance|princess celestia|princess luna|rainbow dash|rarity|scootaloo|shining armor|silver spoon|spike|starlight glimmer|sunset shimmer|sweetie belle|trixie|twilight sparkle,conthauberger
1649479.jpeg,https://derpicdn.net/img/view/2018/2/6/1649479.jpeg,1,0.9224942922592164,682,1337,1246,1901,564,564,sunset shimmer|twilight sparkle,overlordneon
1650714.jpeg,https://derpicdn.net/img/view/2018/2/7/1650714.jpeg,0,0.9532945156097412,449,8,875,434,426,426,spike|twilight sparkle,tsitra360
1651253.jpeg,https://derpicdn.net/img/view/2018/2/8/1651253.jpeg,0,0.9848235249519348,208,134,576,502,368,368,starlight glimmer|twilight sparkle,
1651834.jpeg,https://derpicdn.net/img/view/2018/2/9/1651834.jpeg,0,0.9065648317337036,1799,460,2229,890,430,430,princess cadance|princess celestia|rainbow dash|scootaloo|spike|twilight sparkle,liaaqila
1657103.jpeg,https://derpicdn.net/img/view/2018/2/15/1657103.jpeg,0,0.9963027834892272,1257,333,1555,631,298,298,applejack|fluttershy|pinkie pie|rainbow dash|rarity|sunset shimmer|twilight sparkle,aberdeen
1657577.jpeg,https://derpicdn.net/img/view/2018/2/16/1657577.jpeg,0,0.9937127828598022,491,175,901,585,410,410,sunset shimmer|twilight sparkle,naginiko
1657577.jpeg,https://derpicdn.net/img/view/2018/2/16/1657577.jpeg,1,0.9805919528007508,7,0,443,426,436,426,sunset shimmer|twilight sparkle,naginiko
1657593.jpeg,https://derpicdn.net/img/view/2018/2/16/1657593.jpeg,0,0.9543583393096924,815,0,1295,465,480,465,applejack|fluttershy|mane six|pinkie pie|rainbow dash|rarity|spike|twilight sparkle,phoenixperegrine
1660457.jpeg,https://derpicdn.net/img/view/2018/2/19/1660457.jpeg,1,0.9411941170692444,503,0,958,471,455,471,sunset shimmer|twilight sparkle,
1661929.jpeg,https://derpicdn.net/img/view/2018/2/21/1661929.jpeg,0,0.9951939582824708,730,578,1038,886,308,308,applejack|fluttershy|pinkie pie|rainbow dash|twilight sparkle,xjenn9
1661929.jpeg,https://derpicdn.net/img/view/2018/2/21/1661929.jpeg,1,0.9886979460716248,507,633,845,971,338,338,applejack|fluttershy|pinkie pie|rainbow dash|twilight sparkle,xjenn9
1662109.jpeg,https://derpicdn.net/img/view/2018/2/21/1662109.jpeg,0,0.9947553277015686,1179,2189,1905,2915,726,726,sunset shimmer|twilight sparkle,
1662109.jpeg,https://derpicdn.net/img/view/2018/2/21/1662109.jpeg,4,0.9383874535560608,0,1585,480,2205,480,620,sunset shimmer|twilight sparkle,
1662138.jpeg,https://derpicdn.net/img/view/2018/2/21/1662138.jpeg,0,0.9691886901855468,657,428,965,736,308,308,sunset shimmer|twilight sparkle,liaaqila
1662210.jpeg,https://derpicdn.net/img/view/2018/2/21/1662210.jpeg,0,0.9522252678871156,483,80,719,316,236,236,trixie|twilight sparkle,racoonsan
1662816.jpeg,https://derpicdn.net/img/view/2018/2/22/1662816.jpeg,0,0.9909681677818298,197,58,583,444,386,386,princess celestia|twilight sparkle,scheadar
1663065.jpeg,https://derpicdn.net/img/view/2018/2/22/1663065.jpeg,0,0.9840366840362548,725,523,1691,1489,966,966,fluttershy|twilight sparkle,overlordneon
1663513.jpeg,https://derpicdn.net/img/view/2018/2/23/1663513.jpeg,0,0.9988287091255188,0,290,584,904,584,614,sunset shimmer|twilight sparkle,
1663513.jpeg,https://derpicdn.net/img/view/2018/2/23/1663513.jpeg,1,0.9935809373855592,613,317,1043,747,430,430,sunset shimmer|twilight sparkle,
1663513.jpeg,https://derpicdn.net/img/view/2018/2/23/1663513.jpeg,2,0.9785842895507812,1536,1095,2048,1703,512,608,sunset shimmer|twilight sparkle,
1663513.jpeg,https://derpicdn.net/img/view/2018/2/23/1663513.jpeg,3,0.9755522012710572,681,1165,1081,1565,400,400,sunset shimmer|twilight sparkle,
1664309.jpeg,https://derpicdn.net/img/view/2018/2/24/1664309.jpeg,0,0.9974543452262878,250,0,676,380,426,380,spike|twilight sparkle,kagitsuki
1664309.jpeg,https://derpicdn.net/img/view/2018/2/24/1664309.jpeg,1,0.9899553060531616,576,326,890,640,314,314,spike|twilight sparkle,kagitsuki
1665164.jpeg,https://derpicdn.net/img/view/2018/2/25/1665164.jpeg,0,0.9173914790153505,1063,517,1255,709,192,192,applejack|fluttershy|mane six|pinkie pie|rainbow dash|rarity|spike|twilight sparkle,seamaggie
1665452.jpeg,https://derpicdn.net/img/view/2018/2/25/1665452.jpeg,0,0.9897196888923644,12,197,416,601,404,404,applejack|fluttershy|pinkie pie|rainbow dash|rarity|twilight sparkle,nanook123
1665495.jpeg,https://derpicdn.net/img/view/2018/2/25/1665495.jpeg,0,0.9864277243614196,31,16,365,350,334,334,applejack|fluttershy|mane six|pinkie pie|rainbow dash|rarity|twilight sparkle,nanook123
1665495.jpeg,https://derpicdn.net/img/view/2018/2/25/1665495.jpeg,1,0.9605343341827391,581,0,891,307,310,307,applejack|fluttershy|mane six|pinkie pie|rainbow dash|rarity|twilight sparkle,nanook123
1666175.jpeg,https://derpicdn.net/img/view/2018/2/26/1666175.jpeg,2,0.9724592566490172,22,328,270,576,248,248,applejack|fluttershy|mane six|pinkie pie|rainbow dash|rarity|twilight sparkle,hosikawa
1666175.jpeg,https://derpicdn.net/img/view/2018/2/26/1666175.jpeg,3,0.9552383422851562,614,71,812,269,198,198,applejack|fluttershy|mane six|pinkie pie|rainbow dash|rarity|twilight sparkle,hosikawa
1666909.jpeg,https://derpicdn.net/img/view/2018/2/27/1666909.jpeg,0,0.9632218480110168,5590,337,8636,3397,3046,3060,starlight glimmer|sunset shimmer|twilight sparkle,ardail
1667284.jpeg,https://derpicdn.net/img/view/2018/2/27/1667284.jpeg,0,0.999197781085968,515,45,747,277,232,232,applejack|fluttershy|mane six|pinkie pie|rainbow dash|rarity|twilight sparkle,sibashen
1667284.jpeg,https://derpicdn.net/img/view/2018/2/27/1667284.jpeg,1,0.9920809268951416,30,31,248,249,218,218,applejack|fluttershy|mane six|pinkie pie|rainbow dash|rarity|twilight sparkle,sibashen
1667284.jpeg,https://derpicdn.net/img/view/2018/2/27/1667284.jpeg,2,0.9717032313346864,225,18,413,206,188,188,applejack|fluttershy|mane six|pinkie pie|rainbow dash|rarity|twilight sparkle,sibashen
1667284.jpeg,https://derpicdn.net/img/view/2018/2/27/1667284.jpeg,3,0.9652672410011292,156,182,368,394,212,212,applejack|fluttershy|mane six|pinkie pie|rainbow dash|rarity|twilight sparkle,sibashen
1667788.jpeg,https://derpicdn.net/img/view/2018/2/28/1667788.jpeg,0,0.9981371164321899,1388,2732,2048,3496,660,764,applejack|fluttershy|mane six|pinkie pie|rainbow dash|rarity|twilight sparkle,tonyfleecs
1667788.jpeg,https://derpicdn.net/img/view/2018/2/28/1667788.jpeg,1,0.9950859546661376,1138,0,1652,504,514,504,applejack|fluttershy|mane six|pinkie pie|rainbow dash|rarity|twilight sparkle,tonyfleecs
1667788.jpeg,https://derpicdn.net/img/view/2018/2/28/1667788.jpeg,3,0.9157365560531616,960,2857,1460,3357,500,500,applejack|fluttershy|mane six|pinkie pie|rainbow dash|rarity|twilight sparkle,tonyfleecs
1667788.jpeg,https://derpicdn.net/img/view/2018/2/28/1667788.jpeg,4,0.9051650762557985,6,822,804,1620,798,798,applejack|fluttershy|mane six|pinkie pie|rainbow dash|rarity|twilight sparkle,tonyfleecs
1668073.jpeg,https://derpicdn.net/img/view/2018/2/28/1668073.jpeg,1,0.9502273797988892,1277,262,1681,666,404,404,rainbow dash|twilight sparkle,hosikawa
1669483.jpeg,https://derpicdn.net/img/view/2018/3/2/1669483.jpeg,1,0.9844577312469482,743,274,1011,542,268,268,applejack|fluttershy|mane six|pinkie pie|rainbow dash|rarity|twilight sparkle,miamaha
1671183.jpeg,https://derpicdn.net/img/view/2018/3/4/1671183.jpeg,0,0.9958853721618652,430,1133,2168,2871,1738,1738,rarity|twilight sparkle,earthsong9405
1671914.jpeg,https://derpicdn.net/img/view/2018/3/5/1671914.jpeg,0,0.99706369638443,34,0,496,448,462,448,scootaloo|twilight sparkle,dilarus
1672449.jpeg,https://derpicdn.net/img/view/2018/3/5/1672449.jpeg,0,0.9454869627952576,0,382,143,552,143,170,applejack|fluttershy|mane six|pinkie pie|rainbow dash|rarity|twilight sparkle,orin331
1672808.jpeg,https://derpicdn.net/img/view/2018/3/6/1672808.jpeg,0,0.9854523539543152,275,0,737,416,462,416,starlight glimmer|twilight sparkle,up_p_ab
1672808.jpeg,https://derpicdn.net/img/view/2018/3/6/1672808.jpeg,1,0.9187381267547609,640,0,1096,450,456,450,starlight glimmer|twilight sparkle,up_p_ab
1673626.jpeg,https://derpicdn.net/img/view/2018/3/7/1673626.jpeg,0,0.9271708726882936,215,221,449,455,234,234,applejack|fluttershy|mane six|pinkie pie|rainbow dash|rarity|spike|twilight sparkle,tony cliff|joy-ang
1673878.jpeg,https://derpicdn.net/img/view/2018/3/7/1673878.jpeg,0,0.9837899804115297,1742,201,2218,677,476,476,applejack|fluttershy|mane six|pinkie pie|rainbow dash|rarity|twilight sparkle,littlehybridshila
1674198.jpeg,https://derpicdn.net/img/view/2018/3/8/1674198.jpeg,0,0.9798376560211182,304,0,926,600,622,600,pinkie pie|twilight sparkle,
1674412.jpeg,https://derpicdn.net/img/view/2018/3/8/1674412.jpeg,0,0.9672914743423462,148,407,558,817,410,410,rarity|twilight sparkle,pastel-pony-pictures
1674590.jpeg,https://derpicdn.net/img/view/2018/3/8/1674590.jpeg,0,0.9692493081092834,1915,1218,2803,2106,888,888,applejack|fluttershy|mane six|pinkie pie|rainbow dash|rarity|spike|twilight sparkle,bronybehindthedoor
1674590.jpeg,https://derpicdn.net/img/view/2018/3/8/1674590.jpeg,1,0.962533473968506,1190,748,2052,1610,862,862,applejack|fluttershy|mane six|pinkie pie|rainbow dash|rarity|spike|twilight sparkle,bronybehindthedoor
1675363.jpeg,https://derpicdn.net/img/view/2018/3/9/1675363.jpeg,0,0.9876965880393982,2735,4153,3651,5069,916,916,applejack|fluttershy|mane six|pinkie pie|princess celestia|rainbow dash|rarity|twilight sparkle,claudiaqh
1675363.jpeg,https://derpicdn.net/img/view/2018/3/9/1675363.jpeg,1,0.9848357439041138,3101,537,3995,1431,894,894,applejack|fluttershy|mane six|pinkie pie|princess celestia|rainbow dash|rarity|twilight sparkle,claudiaqh
1675378.jpeg,https://derpicdn.net/img/view/2018/3/9/1675378.jpeg,0,0.9966480731964112,312,590,528,806,216,216,applejack|fluttershy|mane six|pinkie pie|rainbow dash|rarity|spike|twilight sparkle,brendahickey
1675378.jpeg,https://derpicdn.net/img/view/2018/3/9/1675378.jpeg,1,0.9942775368690492,216,103,430,317,214,214,applejack|fluttershy|mane six|pinkie pie|rainbow dash|rarity|spike|twilight sparkle,brendahickey
1675384.jpeg,https://derpicdn.net/img/view/2018/3/9/1675384.jpeg,0,0.9842201471328736,0,587,280,923,280,336,applejack|diamond tiara|fluttershy|mane six|pinkie pie|rainbow dash|rarity|spike|twilight sparkle,brendahickey
1675384.jpeg,https://derpicdn.net/img/view/2018/3/9/1675384.jpeg,2,0.9272291660308838,309,968,545,1194,236,226,applejack|diamond tiara|fluttershy|mane six|pinkie pie|rainbow dash|rarity|spike|twilight sparkle,brendahickey
1675404.jpeg,https://derpicdn.net/img/view/2018/3/9/1675404.jpeg,0,0.9400479793548584,77,221,605,749,528,528,rarity|starlight glimmer|twilight sparkle,
1676300.jpeg,https://derpicdn.net/img/view/2018/3/10/1676300.jpeg,0,0.9705421328544616,103,44,357,298,254,254,rarity|twilight sparkle,murai shinobu
1676334.jpeg,https://derpicdn.net/img/view/2018/3/10/1676334.jpeg,0,0.9988051652908324,171,292,695,816,524,524,applejack|fluttershy|mane six|pinkie pie|rainbow dash|rarity|twilight sparkle,tincantim
1676334.jpeg,https://derpicdn.net/img/view/2018/3/10/1676334.jpeg,1,0.9255185723304749,1673,628,2139,1094,466,466,applejack|fluttershy|mane six|pinkie pie|rainbow dash|rarity|twilight sparkle,tincantim
1677941.jpeg,https://derpicdn.net/img/view/2018/3/12/1677941.jpeg,0,0.9911832809448242,6,360,522,876,516,516,pinkie pie|starlight glimmer|twilight sparkle,oberon826
1680474.jpeg,https://derpicdn.net/img/view/2018/3/14/1680474.jpeg,0,0.9967046976089478,0,443,308,753,308,310,applejack|rainbow dash|sunset shimmer|twilight sparkle,serge-stiles
1680474.jpeg,https://derpicdn.net/img/view/2018/3/14/1680474.jpeg,1,0.9746385216712952,1332,377,1600,653,268,276,applejack|rainbow dash|sunset shimmer|twilight sparkle,serge-stiles
1680507.jpeg,https://derpicdn.net/img/view/2018/3/14/1680507.jpeg,0,0.9790927171707152,209,43,909,743,700,700,spike|twilight sparkle,franschesco
1681457.jpeg,https://derpicdn.net/img/view/2018/3/15/1681457.jpeg,0,0.9969915747642516,599,0,911,286,312,286,starlight glimmer|twilight sparkle,
1681457.jpeg,https://derpicdn.net/img/view/2018/3/15/1681457.jpeg,1,0.9649605751037598,487,449,939,901,452,452,starlight glimmer|twilight sparkle,
1683453.jpeg,https://derpicdn.net/img/view/2018/3/17/1683453.jpeg,0,0.997335970401764,821,171,1017,367,196,196,princess cadance|shining armor|twilight sparkle,inuhoshi-to-darkpen
1683453.jpeg,https://derpicdn.net/img/view/2018/3/17/1683453.jpeg,1,0.9922980070114136,41,160,285,404,244,244,princess cadance|shining armor|twilight sparkle,inuhoshi-to-darkpen
1684590.jpeg,https://derpicdn.net/img/view/2018/3/19/1684590.jpeg,0,0.9689610600471495,348,335,612,599,264,264,pinkie pie|twilight sparkle,dan232323
1684629.jpeg,https://derpicdn.net/img/view/2018/3/19/1684629.jpeg,0,0.9955109357833862,473,0,865,383,392,383,princess cadance|princess flurry heart|shining armor|spike|twilight sparkle,dan232323
1686742.jpeg,https://derpicdn.net/img/view/2018/3/21/1686742.jpeg,0,0.9974815249443054,108,84,422,398,314,314,fluttershy|twilight sparkle,aurorafang
1687510.jpeg,https://derpicdn.net/img/view/2018/3/22/1687510.jpeg,0,0.9962894916534424,575,20,969,414,394,394,sweetie belle|twilight sparkle,fur-what-loo
1687751.jpeg,https://derpicdn.net/img/view/2018/3/22/1687751.jpeg,0,0.961189329624176,0,9,312,329,312,320,sunset shimmer|twilight sparkle,jannel300
1687751.jpeg,https://derpicdn.net/img/view/2018/3/22/1687751.jpeg,1,0.948427140712738,268,421,546,699,278,278,sunset shimmer|twilight sparkle,jannel300
1687753.jpeg,https://derpicdn.net/img/view/2018/3/22/1687753.jpeg,0,0.9983785152435304,266,260,482,476,216,216,applejack|fluttershy|mane six|pinkie pie|rainbow dash|rarity|twilight sparkle,jannel300
1687753.jpeg,https://derpicdn.net/img/view/2018/3/22/1687753.jpeg,1,0.9959506392478944,340,14,518,192,178,178,applejack|fluttershy|mane six|pinkie pie|rainbow dash|rarity|twilight sparkle,jannel300
1688366.jpeg,https://derpicdn.net/img/view/2018/3/23/1688366.jpeg,0,0.9934960007667542,0,0,300,292,300,292,applejack|pinkie pie|rainbow dash|twilight sparkle,xjkenny
1688366.jpeg,https://derpicdn.net/img/view/2018/3/23/1688366.jpeg,1,0.9841827750205994,540,28,788,276,248,248,applejack|pinkie pie|rainbow dash|twilight sparkle,xjkenny
1689813.jpeg,https://derpicdn.net/img/view/2018/3/25/1689813.jpeg,1,0.9849291443824768,568,407,1286,1080,718,673,applejack|fluttershy|mane six|pinkie pie|rainbow dash|rarity|twilight sparkle,nolycs
1689813.jpeg,https://derpicdn.net/img/view/2018/3/25/1689813.jpeg,2,0.980472207069397,548,0,1334,621,786,621,applejack|fluttershy|mane six|pinkie pie|rainbow dash|rarity|twilight sparkle,nolycs
1689813.jpeg,https://derpicdn.net/img/view/2018/3/25/1689813.jpeg,3,0.9116225838661194,98,10,530,442,432,432,applejack|fluttershy|mane six|pinkie pie|rainbow dash|rarity|twilight sparkle,nolycs
1690084.jpeg,https://derpicdn.net/img/view/2018/3/25/1690084.jpeg,0,0.9967277050018308,500,92,922,542,422,450,starlight glimmer|twilight sparkle,
1690084.jpeg,https://derpicdn.net/img/view/2018/3/25/1690084.jpeg,1,0.9781186580657959,114,171,540,597,426,426,starlight glimmer|twilight sparkle,
1690232.jpeg,https://derpicdn.net/img/view/2018/3/25/1690232.jpeg,0,0.9991621971130372,694,527,980,813,286,286,applejack|fluttershy|mane six|pinkie pie|rainbow dash|rarity|spike|twilight sparkle,tastypeach
1690232.jpeg,https://derpicdn.net/img/view/2018/3/25/1690232.jpeg,2,0.9967817068099976,339,62,625,348,286,286,applejack|fluttershy|mane six|pinkie pie|rainbow dash|rarity|spike|twilight sparkle,tastypeach
1690232.jpeg,https://derpicdn.net/img/view/2018/3/25/1690232.jpeg,3,0.9922620058059692,17,9,259,251,242,242,applejack|fluttershy|mane six|pinkie pie|rainbow dash|rarity|spike|twilight sparkle,tastypeach
1690232.jpeg,https://derpicdn.net/img/view/2018/3/25/1690232.jpeg,4,0.985289990901947,354,492,612,750,258,258,applejack|fluttershy|mane six|pinkie pie|rainbow dash|rarity|spike|twilight sparkle,tastypeach
1690239.jpeg,https://derpicdn.net/img/view/2018/3/25/1690239.jpeg,0,0.9983599781990052,365,676,521,832,156,156,applejack|fluttershy|mane six|pinkie pie|princess luna|rainbow dash|rarity|trixie|twilight sparkle,tastypeach
1690239.jpeg,https://derpicdn.net/img/view/2018/3/25/1690239.jpeg,1,0.9742850065231324,97,659,301,863,204,204,applejack|fluttershy|mane six|pinkie pie|princess luna|rainbow dash|rarity|trixie|twilight sparkle,tastypeach
1690239.jpeg,https://derpicdn.net/img/view/2018/3/25/1690239.jpeg,2,0.9631118178367616,297,446,437,586,140,140,applejack|fluttershy|mane six|pinkie pie|princess luna|rainbow dash|rarity|trixie|twilight sparkle,tastypeach
1691826.jpeg,https://derpicdn.net/img/view/2018/3/27/1691826.jpeg,2,0.934775173664093,292,305,590,603,298,298,applejack|fluttershy|mane six|pinkie pie|rainbow dash|rarity|spike|twilight sparkle,
1693030.jpeg,https://derpicdn.net/img/view/2018/3/28/1693030.jpeg,0,0.9934084415435792,375,268,499,412,124,144,applejack|fluttershy|mane six|pinkie pie|rainbow dash|rarity|spike|twilight sparkle,tonyfleecs
1693030.jpeg,https://derpicdn.net/img/view/2018/3/28/1693030.jpeg,2,0.9482211470603944,196,351,336,491,140,140,applejack|fluttershy|mane six|pinkie pie|rainbow dash|rarity|spike|twilight sparkle,tonyfleecs
1695122.jpeg,https://derpicdn.net/img/view/2018/3/31/1695122.jpeg,0,0.999448835849762,357,92,763,498,406,406,rainbow dash|twilight sparkle,dumddeer
1695122.jpeg,https://derpicdn.net/img/view/2018/3/31/1695122.jpeg,1,0.9975535273551941,142,186,506,550,364,364,rainbow dash|twilight sparkle,dumddeer
1696000.jpeg,https://derpicdn.net/img/view/2018/4/1/1696000.jpeg,0,0.9883378744125366,4,670,116,782,112,112,princess cadance|princess celestia|princess luna|queen chrysalis|rarity|trixie|twilight sparkle,cyborg-steve|doomcap|art-2u|jj-psychotic|bronypanda|facelesssoles|dashie116
1696263.jpeg,https://derpicdn.net/img/view/2018/4/1/1696263.jpeg,0,0.9979506731033324,325,2412,1655,3742,1330,1330,big macintosh|fluttershy|trixie|twilight sparkle,earthsong9405
1696263.jpeg,https://derpicdn.net/img/view/2018/4/1/1696263.jpeg,1,0.975031852722168,2778,2501,3890,3613,1112,1112,big macintosh|fluttershy|trixie|twilight sparkle,earthsong9405
1696263.jpeg,https://derpicdn.net/img/view/2018/4/1/1696263.jpeg,2,0.9688453674316406,636,866,1684,1914,1048,1048,big macintosh|fluttershy|trixie|twilight sparkle,earthsong9405
1696263.jpeg,https://derpicdn.net/img/view/2018/4/1/1696263.jpeg,3,0.9287709593772888,2265,409,4073,2217,1808,1808,big macintosh|fluttershy|trixie|twilight sparkle,earthsong9405
1697700.jpeg,https://derpicdn.net/img/view/2018/4/3/1697700.jpeg,0,0.99095356464386,2944,841,3578,1475,634,634,applejack|fluttershy|mane six|pinkie pie|rainbow dash|rarity|spike|starlight glimmer|twilight sparkle,
1697700.jpeg,https://derpicdn.net/img/view/2018/4/3/1697700.jpeg,2,0.9340009093284608,935,880,1669,1614,734,734,applejack|fluttershy|mane six|pinkie pie|rainbow dash|rarity|spike|starlight glimmer|twilight sparkle,
1698136.jpeg,https://derpicdn.net/img/view/2018/4/3/1698136.jpeg,0,0.9972095489501952,426,965,662,1201,236,236,starlight glimmer|twilight sparkle,mysticalpha
1698136.jpeg,https://derpicdn.net/img/view/2018/4/3/1698136.jpeg,1,0.9865604639053344,256,971,512,1227,256,256,starlight glimmer|twilight sparkle,mysticalpha
1698136.jpeg,https://derpicdn.net/img/view/2018/4/3/1698136.jpeg,2,0.9830751419067384,609,930,867,1188,258,258,starlight glimmer|twilight sparkle,mysticalpha
1698142.jpeg,https://derpicdn.net/img/view/2018/4/3/1698142.jpeg,1,0.9326170682907104,883,148,1313,578,430,430,starlight glimmer|twilight sparkle,mysticalpha
1702684.jpeg,https://derpicdn.net/img/view/2018/4/8/1702684.jpeg,0,0.9975609779357908,881,227,2205,1551,1324,1324,princess flurry heart|twilight sparkle,bronybehindthedoor
1702684.jpeg,https://derpicdn.net/img/view/2018/4/8/1702684.jpeg,1,0.9733017683029176,1934,1917,2302,2285,368,368,princess flurry heart|twilight sparkle,bronybehindthedoor
1704004.jpeg,https://derpicdn.net/img/view/2018/4/10/1704004.jpeg,0,0.9723250865936279,569,384,2477,2292,1908,1908,rarity|twilight sparkle,earthsong9405
1707297.jpeg,https://derpicdn.net/img/view/2018/4/14/1707297.jpeg,0,0.911786675453186,1580,184,1954,558,374,374,fluttershy|rainbow dash|twilight sparkle,bluespaceling
1707429.jpeg,https://derpicdn.net/img/view/2018/4/14/1707429.jpeg,1,0.9802243113517758,1055,0,1827,764,772,764,sunset shimmer|twilight sparkle,oberon826
1709449.jpeg,https://derpicdn.net/img/view/2018/4/16/1709449.jpeg,0,0.9944263696670532,834,591,1090,847,256,256,fluttershy|pinkie pie|rainbow dash|rarity|spike|twilight sparkle,
1709449.jpeg,https://derpicdn.net/img/view/2018/4/16/1709449.jpeg,2,0.9490341544151306,92,247,316,471,224,224,fluttershy|pinkie pie|rainbow dash|rarity|spike|twilight sparkle,
1710848.jpeg,https://derpicdn.net/img/view/2018/4/18/1710848.jpeg,1,0.9958683848381042,1645,952,2480,1804,835,852,applejack|fluttershy|mane six|pinkie pie|rainbow dash|rarity|starlight glimmer|twilight sparkle,0ndshok
1710848.jpeg,https://derpicdn.net/img/view/2018/4/18/1710848.jpeg,2,0.9918866157531738,396,1670,1216,2490,820,820,applejack|fluttershy|mane six|pinkie pie|rainbow dash|rarity|starlight glimmer|twilight sparkle,0ndshok
1710848.jpeg,https://derpicdn.net/img/view/2018/4/18/1710848.jpeg,3,0.9904592037200928,1259,1121,1921,1783,662,662,applejack|fluttershy|mane six|pinkie pie|rainbow dash|rarity|starlight glimmer|twilight sparkle,0ndshok
1710848.jpeg,https://derpicdn.net/img/view/2018/4/18/1710848.jpeg,4,0.979317545890808,4,903,920,1819,916,916,applejack|fluttershy|mane six|pinkie pie|rainbow dash|rarity|starlight glimmer|twilight sparkle,0ndshok
1712957.jpeg,https://derpicdn.net/img/view/2018/4/20/1712957.jpeg,1,0.9636799693107604,409,724,721,1036,312,312,applejack|fluttershy|pinkie pie|rainbow dash|rarity|spike|sunset shimmer|twilight sparkle,
1712957.jpeg,https://derpicdn.net/img/view/2018/4/20/1712957.jpeg,2,0.9617723822593688,0,1012,348,1360,348,348,applejack|fluttershy|pinkie pie|rainbow dash|rarity|spike|sunset shimmer|twilight sparkle,
1712957.jpeg,https://derpicdn.net/img/view/2018/4/20/1712957.jpeg,3,0.9539785981178284,213,629,495,911,282,282,applejack|fluttershy|pinkie pie|rainbow dash|rarity|spike|sunset shimmer|twilight sparkle,
1713291.jpeg,https://derpicdn.net/img/view/2018/4/21/1713291.jpeg,0,0.9689448475837708,935,0,1941,992,1006,992,fluttershy|rainbow dash|twilight sparkle,gsphere
1715047.jpeg,https://derpicdn.net/img/view/2018/4/23/1715047.jpeg,0,0.9902982115745544,1032,0,3706,2373,2674,2373,rarity|twilight sparkle,earthsong9405
1715426.jpeg,https://derpicdn.net/img/view/2018/4/23/1715426.jpeg,0,0.9548137784004213,754,503,1280,1029,526,526,applejack|discord|fluttershy|mane six|pinkie pie|princess luna|rainbow dash|rarity|spike|sunset shimmer|twilight sparkle,tejedora
1716012.jpeg,https://derpicdn.net/img/view/2018/4/24/1716012.jpeg,0,0.9405718445777892,3617,2150,4339,2872,722,722,applejack|fluttershy|mane six|pinkie pie|rainbow dash|rarity|spike|twilight sparkle,chepelitaxd
1716064.jpeg,https://derpicdn.net/img/view/2018/4/24/1716064.jpeg,1,0.9369414448738098,2119,3453,3065,4399,946,946,applejack|fluttershy|mane six|pinkie pie|rainbow dash|rarity|twilight sparkle,chepelitaxd
1717711.jpeg,https://derpicdn.net/img/view/2018/4/26/1717711.jpeg,0,0.9362344741821288,616,354,1576,1224,960,870,princess celestia|princess luna|twilight sparkle,magnaluna
1717975.jpeg,https://derpicdn.net/img/view/2018/4/27/1717975.jpeg,0,0.9973544478416444,0,406,97,522,97,116,apple bloom|applejack|big macintosh|cutie mark crusaders|discord|fluttershy|mane six|pinkie pie|princess cadance|princess celestia|princess luna|queen chrysalis|rainbow dash|rarity|scootaloo|shining armor|spike|sweetie belle|trixie|twilight sparkle,christadoodles
1717975.jpeg,https://derpicdn.net/img/view/2018/4/27/1717975.jpeg,1,0.9971973896026612,58,179,172,293,114,114,apple bloom|applejack|big macintosh|cutie mark crusaders|discord|fluttershy|mane six|pinkie pie|princess cadance|princess celestia|princess luna|queen chrysalis|rainbow dash|rarity|scootaloo|shining armor|spike|sweetie belle|trixie|twilight sparkle,christadoodles
1717975.jpeg,https://derpicdn.net/img/view/2018/4/27/1717975.jpeg,4,0.9916995763778688,353,63,465,201,112,138,apple bloom|applejack|big macintosh|cutie mark crusaders|discord|fluttershy|mane six|pinkie pie|princess cadance|princess celestia|princess luna|queen chrysalis|rainbow dash|rarity|scootaloo|shining armor|spike|sweetie belle|trixie|twilight sparkle,christadoodles
1717975.jpeg,https://derpicdn.net/img/view/2018/4/27/1717975.jpeg,5,0.9883015155792236,54,77,170,193,116,116,apple bloom|applejack|big macintosh|cutie mark crusaders|discord|fluttershy|mane six|pinkie pie|princess cadance|princess celestia|princess luna|queen chrysalis|rainbow dash|rarity|scootaloo|shining armor|spike|sweetie belle|trixie|twilight sparkle,christadoodles
1718665.jpeg,https://derpicdn.net/img/view/2018/4/28/1718665.jpeg,0,0.9811829328536988,3024,501,3714,1191,690,690,starlight glimmer|twilight sparkle,richard-skip
1718956.jpeg,https://derpicdn.net/img/view/2018/4/28/1718956.jpeg,0,0.9964953660964966,1108,3795,1534,4221,426,426,applejack|fluttershy|mane six|pinkie pie|queen chrysalis|rainbow dash|rarity|spike|twilight sparkle,franschesco
1718956.jpeg,https://derpicdn.net/img/view/2018/4/28/1718956.jpeg,1,0.979592740535736,73,3704,519,4150,446,446,applejack|fluttershy|mane six|pinkie pie|queen chrysalis|rainbow dash|rarity|spike|twilight sparkle,franschesco
1719102.jpeg,https://derpicdn.net/img/view/2018/4/28/1719102.jpeg,0,0.9840970635414124,1565,245,1871,551,306,306,applejack|fluttershy|mane six|pinkie pie|rainbow dash|rarity|starlight glimmer|twilight sparkle,
1719590.jpeg,https://derpicdn.net/img/view/2018/4/29/1719590.jpeg,0,0.9968401789665222,751,29,1147,425,396,396,spike|twilight sparkle,
1719590.jpeg,https://derpicdn.net/img/view/2018/4/29/1719590.jpeg,1,0.9767944812774658,66,139,520,593,454,454,spike|twilight sparkle,
1719930.jpeg,https://derpicdn.net/img/view/2018/4/29/1719930.jpeg,1,0.9592213630676272,861,0,1133,263,272,263,apple bloom|applejack|big macintosh|cutie mark crusaders|fluttershy|granny smith|pinkie pie|princess luna|rainbow dash|scootaloo|spike|starlight glimmer|sunset shimmer|sweetie belle|twilight sparkle,
1720694.jpeg,https://derpicdn.net/img/view/2018/4/30/1720694.jpeg,0,0.9986595511436462,58,0,590,506,532,506,applejack|rainbow dash|rarity|twilight sparkle,zidanemina
1720694.jpeg,https://derpicdn.net/img/view/2018/4/30/1720694.jpeg,1,0.9980263710021972,61,668,563,1170,502,502,applejack|rainbow dash|rarity|twilight sparkle,zidanemina
1720694.jpeg,https://derpicdn.net/img/view/2018/4/30/1720694.jpeg,2,0.9954012036323548,723,641,1199,1117,476,476,applejack|rainbow dash|rarity|twilight sparkle,zidanemina
1720694.jpeg,https://derpicdn.net/img/view/2018/4/30/1720694.jpeg,3,0.9920076727867126,676,0,1256,576,580,576,applejack|rainbow dash|rarity|twilight sparkle,zidanemina
1721198.jpeg,https://derpicdn.net/img/view/2018/4/30/1721198.jpeg,0,0.9909789562225342,136,110,538,512,402,402,rainbow dash|twilight sparkle,lw9510|twidasher
1723689.jpeg,https://derpicdn.net/img/view/2018/5/4/1723689.jpeg,0,0.9345301389694214,1954,3723,4244,6013,2290,2290,spike|twilight sparkle,colourstrike
1723689.jpeg,https://derpicdn.net/img/view/2018/5/4/1723689.jpeg,1,0.9180235266685486,1741,70,4017,2346,2276,2276,spike|twilight sparkle,colourstrike
1724625.jpeg,https://derpicdn.net/img/view/2018/5/5/1724625.jpeg,1,0.9601212143898008,195,249,531,585,336,336,starlight glimmer|twilight sparkle,lummh
1725407.jpeg,https://derpicdn.net/img/view/2018/5/5/1725407.jpeg,0,0.9979426860809326,370,15,848,493,478,478,spike|twilight sparkle,kaemantis
1725407.jpeg,https://derpicdn.net/img/view/2018/5/5/1725407.jpeg,1,0.9848286509513856,1750,129,1942,321,192,192,spike|twilight sparkle,kaemantis
1725407.jpeg,https://derpicdn.net/img/view/2018/5/5/1725407.jpeg,3,0.9320346117019652,45,0,505,453,460,453,spike|twilight sparkle,kaemantis
1726467.jpeg,https://derpicdn.net/img/view/2018/5/7/1726467.jpeg,0,0.9749804139137268,1211,318,1987,1094,776,776,sunset shimmer|twilight sparkle,lollipony|vanillaghosties
1726717.jpeg,https://derpicdn.net/img/view/2018/5/7/1726717.jpeg,0,0.9942371845245358,1261,145,2615,1499,1354,1354,princess celestia|princess luna|twilight sparkle,magnaluna
1726717.jpeg,https://derpicdn.net/img/view/2018/5/7/1726717.jpeg,1,0.9941645860671996,2889,377,3631,1119,742,742,princess celestia|princess luna|twilight sparkle,magnaluna
1729100.jpeg,https://derpicdn.net/img/view/2018/5/10/1729100.jpeg,0,0.9269325137138368,1095,582,2137,1624,1042,1042,sunset shimmer|twilight sparkle,liu ting
1729101.jpeg,https://derpicdn.net/img/view/2018/5/10/1729101.jpeg,0,0.9702237844467164,1095,581,2137,1623,1042,1042,sunset shimmer|twilight sparkle,liu ting
1729226.jpeg,https://derpicdn.net/img/view/2018/5/10/1729226.jpeg,0,0.9570091366767884,271,309,557,595,286,286,princess celestia|twilight sparkle,z-y-c
1729952.jpeg,https://derpicdn.net/img/view/2018/5/11/1729952.jpeg,0,0.9542356133461,4,12,914,922,910,910,starlight glimmer|twilight sparkle,akainu_pony
1730483.jpeg,https://derpicdn.net/img/view/2018/5/12/1730483.jpeg,0,0.9954816102981568,319,314,899,894,580,580,fluttershy|rainbow dash|twilight sparkle,ukulelepineapplecat
1731070.jpeg,https://derpicdn.net/img/view/2018/5/12/1731070.jpeg,0,0.9990253448486328,570,525,1464,1419,894,894,spike|twilight sparkle,lara
1731445.jpeg,https://derpicdn.net/img/view/2018/5/13/1731445.jpeg,0,0.94029438495636,712,0,1000,215,288,215,applejack|fluttershy|mane six|pinkie pie|rainbow dash|rarity|starlight glimmer|sunset shimmer|trixie|twilight sparkle,dawnfire
1732045.jpeg,https://derpicdn.net/img/view/2018/5/13/1732045.jpeg,0,0.983675479888916,584,205,834,455,250,250,fluttershy|rainbow dash|spike|sunset shimmer|twilight sparkle,
1732045.jpeg,https://derpicdn.net/img/view/2018/5/13/1732045.jpeg,1,0.9279425144195556,9,505,287,783,278,278,fluttershy|rainbow dash|spike|sunset shimmer|twilight sparkle,
1733234.jpeg,https://derpicdn.net/img/view/2018/5/15/1733234.jpeg,0,0.9847011566162108,945,0,1465,485,520,485,applejack|fluttershy|mane six|pinkie pie|rainbow dash|rarity|twilight sparkle,liaaqila
1733234.jpeg,https://derpicdn.net/img/view/2018/5/15/1733234.jpeg,1,0.982905387878418,284,534,692,942,408,408,applejack|fluttershy|mane six|pinkie pie|rainbow dash|rarity|twilight sparkle,liaaqila
1733234.jpeg,https://derpicdn.net/img/view/2018/5/15/1733234.jpeg,2,0.9622052907943726,632,775,1134,1277,502,502,applejack|fluttershy|mane six|pinkie pie|rainbow dash|rarity|twilight sparkle,liaaqila
1733234.jpeg,https://derpicdn.net/img/view/2018/5/15/1733234.jpeg,3,0.9612330794334412,365,28,855,518,490,490,applejack|fluttershy|mane six|pinkie pie|rainbow dash|rarity|twilight sparkle,liaaqila
1736078.jpeg,https://derpicdn.net/img/view/2018/5/19/1736078.jpeg,0,0.9922548532485962,676,244,1010,576,334,332,applejack|fluttershy|mane six|pinkie pie|rainbow dash|rarity|starlight glimmer|twilight sparkle,lynchristina
1736078.jpeg,https://derpicdn.net/img/view/2018/5/19/1736078.jpeg,1,0.917596697807312,187,0,613,330,426,330,applejack|fluttershy|mane six|pinkie pie|rainbow dash|rarity|starlight glimmer|twilight sparkle,lynchristina
1737361.jpeg,https://derpicdn.net/img/view/2018/5/20/1737361.jpeg,0,0.9904228448867798,585,470,981,866,396,396,princess celestia|princess luna|queen chrysalis|twilight sparkle,bakki
1739042.jpeg,https://derpicdn.net/img/view/2018/5/22/1739042.jpeg,0,0.994441032409668,3176,1143,3788,1755,612,612,applejack|fluttershy|mane six|pinkie pie|rainbow dash|rarity|starlight glimmer|trixie|twilight sparkle,zidanemina
1739042.jpeg,https://derpicdn.net/img/view/2018/5/22/1739042.jpeg,1,0.9867935776710508,0,0,382,360,382,360,applejack|fluttershy|mane six|pinkie pie|rainbow dash|rarity|starlight glimmer|trixie|twilight sparkle,zidanemina
1739042.jpeg,https://derpicdn.net/img/view/2018/5/22/1739042.jpeg,2,0.9675578474998474,1849,0,2517,527,668,527,applejack|fluttershy|mane six|pinkie pie|rainbow dash|rarity|starlight glimmer|trixie|twilight sparkle,zidanemina
1739190.jpeg,https://derpicdn.net/img/view/2018/5/22/1739190.jpeg,1,0.9305222034454346,668,0,916,195,248,195,applejack|fluttershy|mane six|pinkie pie|rainbow dash|rarity|twilight sparkle,whitewingedanwe
1739507.jpeg,https://derpicdn.net/img/view/2018/5/23/1739507.jpeg,1,0.9731074571609496,1427,99,2597,1269,1170,1170,starlight glimmer|sunset shimmer|trixie|twilight sparkle,
1741177.jpeg,https://derpicdn.net/img/view/2018/5/25/1741177.jpeg,0,0.9270166754722596,384,902,900,1418,516,516,rarity|twilight sparkle,harwick
1742680.jpeg,https://derpicdn.net/img/view/2018/5/27/1742680.jpeg,0,0.9989241957664492,503,655,699,851,196,196,princess cadance|princess celestia|princess luna|sunset shimmer|twilight sparkle,lmkyouki
1744692.jpeg,https://derpicdn.net/img/view/2018/5/29/1744692.jpeg,2,0.9900060296058656,315,0,1751,1308,1436,1308,applejack|fluttershy|mane six|pinkie pie|rainbow dash|rarity|twilight sparkle,yanamosuda
1745301.jpeg,https://derpicdn.net/img/view/2018/5/30/1745301.jpeg,0,0.9625851511955258,0,173,414,601,414,428,rainbow dash|twilight sparkle,mcsadat
1745898.jpeg,https://derpicdn.net/img/view/2018/5/31/1745898.jpeg,0,0.9998271465301514,126,0,934,680,808,680,applejack|fluttershy|mane six|pinkie pie|rainbow dash|rarity|twilight sparkle,raiokai
1745898.jpeg,https://derpicdn.net/img/view/2018/5/31/1745898.jpeg,1,0.9991849064826964,1666,881,2296,1511,630,630,applejack|fluttershy|mane six|pinkie pie|rainbow dash|rarity|twilight sparkle,raiokai
1745898.jpeg,https://derpicdn.net/img/view/2018/5/31/1745898.jpeg,2,0.9953769445419312,2517,878,2999,1360,482,482,applejack|fluttershy|mane six|pinkie pie|rainbow dash|rarity|twilight sparkle,raiokai
1745898.jpeg,https://derpicdn.net/img/view/2018/5/31/1745898.jpeg,3,0.9932487607002258,1856,0,2438,537,582,537,applejack|fluttershy|mane six|pinkie pie|rainbow dash|rarity|twilight sparkle,raiokai
1745898.jpeg,https://derpicdn.net/img/view/2018/5/31/1745898.jpeg,5,0.98683100938797,727,0,1469,661,742,661,applejack|fluttershy|mane six|pinkie pie|rainbow dash|rarity|twilight sparkle,raiokai
1749672.jpeg,https://derpicdn.net/img/view/2018/6/4/1749672.jpeg,0,0.9352386593818665,296,0,1920,1343,1624,1343,princess luna|twilight sparkle,amarynceus
1750035.jpeg,https://derpicdn.net/img/view/2018/6/4/1750035.jpeg,0,0.9822958111763,931,148,1339,556,408,408,applejack|fluttershy|mane six|pinkie pie|rainbow dash|rarity|twilight sparkle,mysticalpha
1750035.jpeg,https://derpicdn.net/img/view/2018/6/4/1750035.jpeg,1,0.9327464699745178,1512,185,1914,587,402,402,applejack|fluttershy|mane six|pinkie pie|rainbow dash|rarity|twilight sparkle,mysticalpha
1751078.jpeg,https://derpicdn.net/img/view/2018/6/6/1751078.jpeg,0,0.9982912540435792,145,429,379,663,234,234,applejack|big macintosh|fluttershy|mane six|pinkie pie|princess cadance|princess celestia|princess luna|rainbow dash|rarity|shining armor|spike|twilight sparkle,andypriceart
1751078.jpeg,https://derpicdn.net/img/view/2018/6/6/1751078.jpeg,1,0.989284098148346,419,1228,805,1614,386,386,applejack|big macintosh|fluttershy|mane six|pinkie pie|princess cadance|princess celestia|princess luna|rainbow dash|rarity|shining armor|spike|twilight sparkle,andypriceart
1751078.jpeg,https://derpicdn.net/img/view/2018/6/6/1751078.jpeg,2,0.9818351864814758,119,1064,429,1374,310,310,applejack|big macintosh|fluttershy|mane six|pinkie pie|princess cadance|princess celestia|princess luna|rainbow dash|rarity|shining armor|spike|twilight sparkle,andypriceart
1751078.jpeg,https://derpicdn.net/img/view/2018/6/6/1751078.jpeg,3,0.967586636543274,482,1070,742,1330,260,260,applejack|big macintosh|fluttershy|mane six|pinkie pie|princess cadance|princess celestia|princess luna|rainbow dash|rarity|shining armor|spike|twilight sparkle,andypriceart
1751078.jpeg,https://derpicdn.net/img/view/2018/6/6/1751078.jpeg,4,0.95150226354599,0,420,229,670,229,250,applejack|big macintosh|fluttershy|mane six|pinkie pie|princess cadance|princess celestia|princess luna|rainbow dash|rarity|shining armor|spike|twilight sparkle,andypriceart
1752020.jpeg,https://derpicdn.net/img/view/2018/6/7/1752020.jpeg,0,0.998521089553833,239,0,719,480,480,480,applejack|pinkie pie|rainbow dash|twilight sparkle,flutterluv
1752020.jpeg,https://derpicdn.net/img/view/2018/6/7/1752020.jpeg,1,0.9908733963966372,266,414,736,884,470,470,applejack|pinkie pie|rainbow dash|twilight sparkle,flutterluv
1756894.jpeg,https://derpicdn.net/img/view/2018/6/13/1756894.jpeg,2,0.9681561589241028,57,486,483,912,426,426,applejack|fluttershy|mane six|pinkie pie|rainbow dash|rarity|twilight sparkle,loupgarou
1758929.jpeg,https://derpicdn.net/img/view/2018/6/16/1758929.jpeg,0,0.996497631072998,797,369,1023,595,226,226,applejack|fluttershy|mane six|pinkie pie|rainbow dash|rarity|twilight sparkle,crystalleye
1758929.jpeg,https://derpicdn.net/img/view/2018/6/16/1758929.jpeg,1,0.9912100434303284,997,398,1217,618,220,220,applejack|fluttershy|mane six|pinkie pie|rainbow dash|rarity|twilight sparkle,crystalleye
1758929.jpeg,https://derpicdn.net/img/view/2018/6/16/1758929.jpeg,2,0.9676470756530762,384,321,638,575,254,254,applejack|fluttershy|mane six|pinkie pie|rainbow dash|rarity|twilight sparkle,crystalleye
1759438.jpeg,https://derpicdn.net/img/view/2018/6/17/1759438.jpeg,0,0.9976933598518372,371,681,619,929,248,248,applejack|fluttershy|mane six|pinkie pie|rainbow dash|rarity|spike|twilight sparkle,uotapo
1759438.jpeg,https://derpicdn.net/img/view/2018/6/17/1759438.jpeg,1,0.9950259923934937,1683,23,1973,313,290,290,applejack|fluttershy|mane six|pinkie pie|rainbow dash|rarity|spike|twilight sparkle,uotapo
1759438.jpeg,https://derpicdn.net/img/view/2018/6/17/1759438.jpeg,2,0.9677016139030457,966,1363,1258,1655,292,292,applejack|fluttershy|mane six|pinkie pie|rainbow dash|rarity|spike|twilight sparkle,uotapo
1759438.jpeg,https://derpicdn.net/img/view/2018/6/17/1759438.jpeg,3,0.9640690088272096,1434,1336,1770,1672,336,336,applejack|fluttershy|mane six|pinkie pie|rainbow dash|rarity|spike|twilight sparkle,uotapo
1761684.jpeg,https://derpicdn.net/img/view/2018/6/20/1761684.jpeg,0,0.9820671081542968,783,261,1143,621,360,360,rarity|twilight sparkle,vyazinrei
1762022.jpeg,https://derpicdn.net/img/view/2018/6/20/1762022.jpeg,0,0.999512255191803,332,296,692,656,360,360,applejack|fluttershy|mane six|pinkie pie|rainbow dash|rarity|twilight sparkle,chenxi
1762022.jpeg,https://derpicdn.net/img/view/2018/6/20/1762022.jpeg,1,0.9992535710334778,0,0,384,347,384,347,applejack|fluttershy|mane six|pinkie pie|rainbow dash|rarity|twilight sparkle,chenxi
1762022.jpeg,https://derpicdn.net/img/view/2018/6/20/1762022.jpeg,2,0.9955288171768188,672,329,1000,661,328,332,applejack|fluttershy|mane six|pinkie pie|rainbow dash|rarity|twilight sparkle,chenxi
1762022.jpeg,https://derpicdn.net/img/view/2018/6/20/1762022.jpeg,3,0.9645060896873474,25,345,293,613,268,268,applejack|fluttershy|mane six|pinkie pie|rainbow dash|rarity|twilight sparkle,chenxi
1762022.jpeg,https://derpicdn.net/img/view/2018/6/20/1762022.jpeg,4,0.9636023640632628,698,0,978,275,280,275,applejack|fluttershy|mane six|pinkie pie|rainbow dash|rarity|twilight sparkle,chenxi
1762022.jpeg,https://derpicdn.net/img/view/2018/6/20/1762022.jpeg,5,0.9222029447555542,324,0,718,344,394,344,applejack|fluttershy|mane six|pinkie pie|rainbow dash|rarity|twilight sparkle,chenxi
1762352.jpeg,https://derpicdn.net/img/view/2018/6/20/1762352.jpeg,0,0.9491406679153442,206,70,768,632,562,562,pinkie pie|twilight sparkle,baron engel
1762481.jpeg,https://derpicdn.net/img/view/2018/6/21/1762481.jpeg,0,0.992235004901886,79,88,263,272,184,184,princess luna|twilight sparkle,gor1ck
1762481.jpeg,https://derpicdn.net/img/view/2018/6/21/1762481.jpeg,1,0.9790960550308228,281,127,471,317,190,190,princess luna|twilight sparkle,gor1ck
1762824.jpeg,https://derpicdn.net/img/view/2018/6/21/1762824.jpeg,1,0.92190819978714,2439,1042,3049,1652,610,610,applejack|fluttershy|mane six|pinkie pie|rainbow dash|rarity|spike|starlight glimmer|sunset shimmer|twilight sparkle,ikirunosindo
1763491.jpeg,https://derpicdn.net/img/view/2018/6/22/1763491.jpeg,0,0.9952014684677124,0,5,121,127,121,122,applejack|fluttershy|mane six|pinkie pie|rainbow dash|rarity|twilight sparkle,marybellamy
1763491.jpeg,https://derpicdn.net/img/view/2018/6/22/1763491.jpeg,1,0.9600899815559388,110,0,246,129,136,129,applejack|fluttershy|mane six|pinkie pie|rainbow dash|rarity|twilight sparkle,marybellamy
1764086.jpeg,https://derpicdn.net/img/view/2018/6/23/1764086.jpeg,0,0.9990793466567992,291,6,643,358,352,352,applejack|fluttershy|mane six|pinkie pie|rainbow dash|rarity|twilight sparkle,guiltyp
1764086.jpeg,https://derpicdn.net/img/view/2018/6/23/1764086.jpeg,1,0.9979754686355592,518,1097,892,1471,374,374,applejack|fluttershy|mane six|pinkie pie|rainbow dash|rarity|twilight sparkle,guiltyp
1764086.jpeg,https://derpicdn.net/img/view/2018/6/23/1764086.jpeg,2,0.9965686202049256,633,22,913,302,280,280,applejack|fluttershy|mane six|pinkie pie|rainbow dash|rarity|twilight sparkle,guiltyp
1764086.jpeg,https://derpicdn.net/img/view/2018/6/23/1764086.jpeg,4,0.9442492127418518,0,1184,394,1582,394,398,applejack|fluttershy|mane six|pinkie pie|rainbow dash|rarity|twilight sparkle,guiltyp
1764113.jpeg,https://derpicdn.net/img/view/2018/6/23/1764113.jpeg,0,0.9894715547561646,1048,0,1644,456,596,456,applejack|pinkie pie|rainbow dash|rarity|spitfire|starlight glimmer|trixie|twilight sparkle,artfestation
1765892.jpeg,https://derpicdn.net/img/view/2018/6/25/1765892.jpeg,0,0.920574188232422,195,14,707,526,512,512,applejack|fluttershy|mane six|pinkie pie|rainbow dash|rarity|spike|twilight sparkle,fuf
1766103.jpeg,https://derpicdn.net/img/view/2018/6/26/1766103.jpeg,0,0.9981073141098022,706,395,1294,983,588,588,pinkie pie|twilight sparkle,pastel-pony-pictures
1766431.jpeg,https://derpicdn.net/img/view/2018/6/26/1766431.jpeg,0,0.9874970316886902,148,101,802,755,654,654,starlight glimmer|trixie|twilight sparkle,jeremywithlove
1767813.jpeg,https://derpicdn.net/img/view/2018/6/28/1767813.jpeg,0,0.9604249000549316,880,0,2080,919,1200,919,applejack|mane six|pinkie pie|princess luna|queen chrysalis|rainbow dash|rarity|twilight sparkle,tsitra360
1769212.jpeg,https://derpicdn.net/img/view/2018/6/30/1769212.jpeg,0,0.9947251081466676,65,1015,337,1287,272,272,applejack|fluttershy|mane six|pinkie pie|rainbow dash|rarity|twilight sparkle,php77|orin331
1769212.jpeg,https://derpicdn.net/img/view/2018/6/30/1769212.jpeg,1,0.9898617267608644,342,1060,574,1292,232,232,applejack|fluttershy|mane six|pinkie pie|rainbow dash|rarity|twilight sparkle,php77|orin331
1769212.jpeg,https://derpicdn.net/img/view/2018/6/30/1769212.jpeg,2,0.9626358151435852,875,1003,1143,1271,268,268,applejack|fluttershy|mane six|pinkie pie|rainbow dash|rarity|twilight sparkle,php77|orin331
1770203.jpeg,https://derpicdn.net/img/view/2018/7/1/1770203.jpeg,0,0.9950796961784364,731,276,957,502,226,226,applejack|fluttershy|mane six|pinkie pie|rainbow dash|rarity|twilight sparkle,
1770203.jpeg,https://derpicdn.net/img/view/2018/7/1/1770203.jpeg,1,0.9942695498466492,562,309,746,493,184,184,applejack|fluttershy|mane six|pinkie pie|rainbow dash|rarity|twilight sparkle,
1770442.jpeg,https://derpicdn.net/img/view/2018/7/1/1770442.jpeg,1,0.9824542999267578,3,262,377,636,374,374,applejack|fluttershy|mane six|pinkie pie|rainbow dash|rarity|spike|twilight sparkle,peichenphilip
1770442.jpeg,https://derpicdn.net/img/view/2018/7/1/1770442.jpeg,2,0.9759225249290466,0,1017,397,1425,397,408,applejack|fluttershy|mane six|pinkie pie|rainbow dash|rarity|spike|twilight sparkle,peichenphilip
1771245.jpeg,https://derpicdn.net/img/view/2018/7/2/1771245.jpeg,0,0.9969158768653872,1854,1129,2448,1723,594,594,apple bloom|applejack|fluttershy|pinkie pie|rainbow dash|rarity|scootaloo|sweetie belle|twilight sparkle,pesty_skillengton
1771245.jpeg,https://derpicdn.net/img/view/2018/7/2/1771245.jpeg,1,0.9774509072303772,1842,0,2342,458,500,458,apple bloom|applejack|fluttershy|pinkie pie|rainbow dash|rarity|scootaloo|sweetie belle|twilight sparkle,pesty_skillengton
1771839.jpeg,https://derpicdn.net/img/view/2018/7/3/1771839.jpeg,0,0.9873440861701964,363,602,559,798,196,196,applejack|fluttershy|mane six|pinkie pie|rainbow dash|rarity|twilight sparkle,sophillia
1771839.jpeg,https://derpicdn.net/img/view/2018/7/3/1771839.jpeg,2,0.9005243182182312,696,64,1000,368,304,304,applejack|fluttershy|mane six|pinkie pie|rainbow dash|rarity|twilight sparkle,sophillia
1772760.jpeg,https://derpicdn.net/img/view/2018/7/4/1772760.jpeg,0,0.998643398284912,42,0,528,476,486,476,rainbow dash|twilight sparkle,ponythroat
1773089.jpeg,https://derpicdn.net/img/view/2018/7/4/1773089.jpeg,2,0.959178388118744,379,474,925,1020,546,546,princess celestia|sunset shimmer|twilight sparkle,cascayd
1773604.jpeg,https://derpicdn.net/img/view/2018/7/5/1773604.jpeg,0,0.961909830570221,51,72,421,442,370,370,applejack|fluttershy|mane six|pinkie pie|rainbow dash|rarity|twilight sparkle,lummh|light262
1774586.jpeg,https://derpicdn.net/img/view/2018/7/6/1774586.jpeg,0,0.9776750206947328,30,723,1036,1729,1006,1006,applejack|fluttershy|pinkie pie|rainbow dash|rarity|starlight glimmer|sunset shimmer|twilight sparkle,dieart77
1774586.jpeg,https://derpicdn.net/img/view/2018/7/6/1774586.jpeg,1,0.9388138055801392,2465,396,3209,1140,744,744,applejack|fluttershy|pinkie pie|rainbow dash|rarity|starlight glimmer|sunset shimmer|twilight sparkle,dieart77
1774972.jpeg,https://derpicdn.net/img/view/2018/7/7/1774972.jpeg,0,0.9166204333305359,279,0,997,680,718,680,princess celestia|twilight sparkle,bojack_mlplove
1776630.jpeg,https://derpicdn.net/img/view/2018/7/9/1776630.jpeg,0,0.9355228543281556,550,323,720,493,170,170,fluttershy|pinkie pie|rarity|twilight sparkle,pegushi
1776891.jpeg,https://derpicdn.net/img/view/2018/7/9/1776891.jpeg,0,0.9980092644691468,143,0,521,370,378,370,starlight glimmer|sunset shimmer|twilight sparkle,katya
1776891.jpeg,https://derpicdn.net/img/view/2018/7/9/1776891.jpeg,1,0.9972723722457886,591,0,997,388,406,388,starlight glimmer|sunset shimmer|twilight sparkle,katya
1777940.jpeg,https://derpicdn.net/img/view/2018/7/10/1777940.jpeg,0,0.9925302863121032,621,190,1125,694,504,504,princess luna|twilight sparkle,latecustomer
1778778.jpeg,https://derpicdn.net/img/view/2018/7/11/1778778.jpeg,0,0.9856390953063964,16,12,402,398,386,386,princess celestia|princess luna|twilight sparkle,kateww
1780401.jpeg,https://derpicdn.net/img/view/2018/7/13/1780401.jpeg,0,0.9386606812477112,300,340,524,564,224,224,applejack|fluttershy|mane six|pinkie pie|rainbow dash|rarity|spike|twilight sparkle,andypriceart
1780425.jpeg,https://derpicdn.net/img/view/2018/7/14/1780425.jpeg,0,0.9948852658271792,83,163,441,521,358,358,applejack|fluttershy|mane six|pinkie pie|rainbow dash|rarity|twilight sparkle,sararichard|tonyfleecs|jay fosgitt
1780425.jpeg,https://derpicdn.net/img/view/2018/7/14/1780425.jpeg,2,0.9576333165168762,557,42,969,454,412,412,applejack|fluttershy|mane six|pinkie pie|rainbow dash|rarity|twilight sparkle,sararichard|tonyfleecs|jay fosgitt
1781565.jpeg,https://derpicdn.net/img/view/2018/7/15/1781565.jpeg,1,0.9990103244781494,431,17,1055,641,624,624,applejack|fluttershy|mane six|pinkie pie|rainbow dash|rarity|spike|starlight glimmer|twilight sparkle,setharu
1781565.jpeg,https://derpicdn.net/img/view/2018/7/15/1781565.jpeg,2,0.9951522946357728,1310,10,1872,572,562,562,applejack|fluttershy|mane six|pinkie pie|rainbow dash|rarity|spike|starlight glimmer|twilight sparkle,setharu
1782005.jpeg,https://derpicdn.net/img/view/2018/7/16/1782005.jpeg,0,0.9290740489959716,2667,371,4223,1927,1556,1556,starlight glimmer|sunset shimmer|twilight sparkle,zaid val'roa
1782781.jpeg,https://derpicdn.net/img/view/2018/7/17/1782781.jpeg,0,0.9822642803192142,4,0,1518,1394,1514,1394,fluttershy|rarity|twilight sparkle,ponythroat
1783022.jpeg,https://derpicdn.net/img/view/2018/7/17/1783022.jpeg,0,0.9888538122177124,80,0,966,727,886,727,applejack|fluttershy|mane six|pinkie pie|rainbow dash|rarity|starlight glimmer|twilight sparkle,threewontoo
1783022.jpeg,https://derpicdn.net/img/view/2018/7/17/1783022.jpeg,1,0.9853057861328124,2377,223,3200,1149,823,926,applejack|fluttershy|mane six|pinkie pie|rainbow dash|rarity|starlight glimmer|twilight sparkle,threewontoo
1783857.jpeg,https://derpicdn.net/img/view/2018/7/18/1783857.jpeg,0,0.9901554584503174,48,0,654,510,606,510,sunset shimmer|twilight sparkle,dez
1784100.jpeg,https://derpicdn.net/img/view/2018/7/18/1784100.jpeg,0,0.9995853304862976,568,544,800,800,232,256,applejack|fluttershy|mane six|pinkie pie|rainbow dash|rarity|twilight sparkle,maytee
1784100.jpeg,https://derpicdn.net/img/view/2018/7/18/1784100.jpeg,1,0.9989907145500184,337,582,631,876,294,294,applejack|fluttershy|mane six|pinkie pie|rainbow dash|rarity|twilight sparkle,maytee
1784100.jpeg,https://derpicdn.net/img/view/2018/7/18/1784100.jpeg,4,0.9966185688972472,214,0,446,224,232,224,applejack|fluttershy|mane six|pinkie pie|rainbow dash|rarity|twilight sparkle,maytee
1784100.jpeg,https://derpicdn.net/img/view/2018/7/18/1784100.jpeg,5,0.9810129404067992,560,150,782,372,222,222,applejack|fluttershy|mane six|pinkie pie|rainbow dash|rarity|twilight sparkle,maytee
1784100.jpeg,https://derpicdn.net/img/view/2018/7/18/1784100.jpeg,6,0.9782041907310486,95,342,311,558,216,216,applejack|fluttershy|mane six|pinkie pie|rainbow dash|rarity|twilight sparkle,maytee
1784593.jpeg,https://derpicdn.net/img/view/2018/7/19/1784593.jpeg,0,0.998085916042328,1296,2046,2092,2842,796,796,applejack|fluttershy|mane six|pinkie pie|princess celestia|princess luna|rainbow dash|rarity|starlight glimmer|sunset shimmer|twilight sparkle,hungrysohma
1784593.jpeg,https://derpicdn.net/img/view/2018/7/19/1784593.jpeg,1,0.9951977729797364,2317,1072,3107,1862,790,790,applejack|fluttershy|mane six|pinkie pie|princess celestia|princess luna|rainbow dash|rarity|starlight glimmer|sunset shimmer|twilight sparkle,hungrysohma
1784593.jpeg,https://derpicdn.net/img/view/2018/7/19/1784593.jpeg,2,0.9799731373786926,216,1151,902,1837,686,686,applejack|fluttershy|mane six|pinkie pie|princess celestia|princess luna|rainbow dash|rarity|starlight glimmer|sunset shimmer|twilight sparkle,hungrysohma
1785343.jpeg,https://derpicdn.net/img/view/2018/7/20/1785343.jpeg,0,0.9946035146713256,1191,529,1591,929,400,400,fluttershy|twilight sparkle,shunya yamashita
1785343.jpeg,https://derpicdn.net/img/view/2018/7/20/1785343.jpeg,1,0.969905436038971,373,551,719,897,346,346,fluttershy|twilight sparkle,shunya yamashita
1785343.jpeg,https://derpicdn.net/img/view/2018/7/20/1785343.jpeg,3,0.9066548943519592,1055,17,1303,265,248,248,fluttershy|twilight sparkle,shunya yamashita
1785496.jpeg,https://derpicdn.net/img/view/2018/7/20/1785496.jpeg,0,0.9936822652816772,464,0,838,331,374,331,pinkie pie|twilight sparkle,erufi
1785506.jpeg,https://derpicdn.net/img/view/2018/7/20/1785506.jpeg,0,0.9399373531341552,6,97,406,497,400,400,rainbow dash|twilight sparkle,erufi
1786101.jpeg,https://derpicdn.net/img/view/2018/7/21/1786101.jpeg,0,0.9315706491470336,14,2,614,602,600,600,pinkie pie|twilight sparkle,tohupo
1786351.jpeg,https://derpicdn.net/img/view/2018/7/21/1786351.jpeg,0,0.9892048835754396,53,115,221,283,168,168,princess celestia|twilight sparkle,pembroke
1788107.jpeg,https://derpicdn.net/img/view/2018/7/23/1788107.jpeg,0,0.9964175820350648,782,593,1896,1707,1114,1114,applejack|discord|fluttershy|mane six|pinkie pie|princess celestia|princess luna|rainbow dash|rarity|soarin'|spike|spitfire|twilight sparkle,andypriceart
1788107.jpeg,https://derpicdn.net/img/view/2018/7/23/1788107.jpeg,1,0.9839608073234558,490,1492,1032,2034,542,542,applejack|discord|fluttershy|mane six|pinkie pie|princess celestia|princess luna|rainbow dash|rarity|soarin'|spike|spitfire|twilight sparkle,andypriceart
1788659.jpeg,https://derpicdn.net/img/view/2018/7/24/1788659.jpeg,1,0.999086618423462,68,709,700,1341,632,632,applejack|fluttershy|mane six|pinkie pie|rainbow dash|rarity|starlight glimmer|sunset shimmer|twilight sparkle,zidanemina
1788659.jpeg,https://derpicdn.net/img/view/2018/7/24/1788659.jpeg,2,0.9989522695541382,77,1469,659,2051,582,582,applejack|fluttershy|mane six|pinkie pie|rainbow dash|rarity|starlight glimmer|sunset shimmer|twilight sparkle,zidanemina
1788659.jpeg,https://derpicdn.net/img/view/2018/7/24/1788659.jpeg,3,0.9989489316940308,1454,0,2082,615,628,615,applejack|fluttershy|mane six|pinkie pie|rainbow dash|rarity|starlight glimmer|sunset shimmer|twilight sparkle,zidanemina
1788659.jpeg,https://derpicdn.net/img/view/2018/7/24/1788659.jpeg,5,0.994906723499298,1487,715,2063,1291,576,576,applejack|fluttershy|mane six|pinkie pie|rainbow dash|rarity|starlight glimmer|sunset shimmer|twilight sparkle,zidanemina
1788659.jpeg,https://derpicdn.net/img/view/2018/7/24/1788659.jpeg,6,0.9798710942268372,1533,1484,2075,2026,542,542,applejack|fluttershy|mane six|pinkie pie|rainbow dash|rarity|starlight glimmer|sunset shimmer|twilight sparkle,zidanemina
1788659.jpeg,https://derpicdn.net/img/view/2018/7/24/1788659.jpeg,7,0.9767044186592102,727,1460,1447,2160,720,700,applejack|fluttershy|mane six|pinkie pie|rainbow dash|rarity|starlight glimmer|sunset shimmer|twilight sparkle,zidanemina
1788935.jpeg,https://derpicdn.net/img/view/2018/7/24/1788935.jpeg,0,0.966060221195221,422,72,660,310,238,238,spike|twilight sparkle,yoshimarsart
1788935.jpeg,https://derpicdn.net/img/view/2018/7/24/1788935.jpeg,1,0.9500173330307008,370,326,634,590,264,264,spike|twilight sparkle,yoshimarsart
1789854.jpeg,https://derpicdn.net/img/view/2018/7/26/1789854.jpeg,0,0.9428958296775818,742,0,1508,583,766,583,princess cadance|princess luna|twilight sparkle,2snacks
1790884.jpeg,https://derpicdn.net/img/view/2018/7/27/1790884.jpeg,0,0.9995323419570924,1548,363,2306,1121,758,758,princess cadance|princess flurry heart|shining armor|spike|twilight sparkle,justsomepainter11
1790884.jpeg,https://derpicdn.net/img/view/2018/7/27/1790884.jpeg,2,0.9975187182426452,485,418,1153,1086,668,668,princess cadance|princess flurry heart|shining armor|spike|twilight sparkle,justsomepainter11
1791998.jpeg,https://derpicdn.net/img/view/2018/7/28/1791998.jpeg,0,0.9319486618041992,280,183,1224,1127,944,944,sunset shimmer|twilight sparkle,aka-ryuga
1792083.jpeg,https://derpicdn.net/img/view/2018/7/28/1792083.jpeg,0,0.9888234138488772,1202,277,1832,907,630,630,starlight glimmer|sunset shimmer|twilight sparkle,theshadowstone|xebck|illumnious
1792083.jpeg,https://derpicdn.net/img/view/2018/7/28/1792083.jpeg,1,0.9835386276245116,46,277,734,965,688,688,starlight glimmer|sunset shimmer|twilight sparkle,theshadowstone|xebck|illumnious
1792190.jpeg,https://derpicdn.net/img/view/2018/7/28/1792190.jpeg,0,0.9214790463447572,9,50,1249,1080,1240,1030,spike|twilight sparkle,
1793843.jpeg,https://derpicdn.net/img/view/2018/7/31/1793843.jpeg,0,0.9008308649063108,715,354,973,612,258,258,pinkie pie|twilight sparkle,silfoe
1794726.jpeg,https://derpicdn.net/img/view/2018/8/1/1794726.jpeg,0,0.9957581162452698,143,35,1293,1185,1150,1150,princess celestia|twilight sparkle,lockheart|greyscaleart
1795868.jpeg,https://derpicdn.net/img/view/2018/8/2/1795868.jpeg,0,0.9847147464752196,769,2460,1585,3276,816,816,apple bloom|applejack|cutie mark crusaders|scootaloo|starlight glimmer|sweetie belle|trixie|twilight sparkle,theravencriss
1797688.jpeg,https://derpicdn.net/img/view/2018/8/4/1797688.jpeg,0,0.990662157535553,19,84,517,545,498,461,fluttershy|pinkie pie|rarity|twilight sparkle,
1797894.jpeg,https://derpicdn.net/img/view/2018/8/4/1797894.jpeg,0,0.9885979294776917,655,470,1343,1158,688,688,princess luna|twilight sparkle,jowybean
1798345.jpeg,https://derpicdn.net/img/view/2018/8/5/1798345.jpeg,0,0.9836010336875916,1170,43,1450,323,280,280,apple bloom|applejack|cutie mark crusaders|diamond tiara|fluttershy|pinkie pie|princess cadance|rainbow dash|rarity|scootaloo|starlight glimmer|sunset shimmer|sweetie belle|trixie|twilight sparkle,patricksiegler
1799547.jpeg,https://derpicdn.net/img/view/2018/8/6/1799547.jpeg,0,0.9605648517608644,494,238,1130,874,636,636,rarity|twilight sparkle,vilkadvanoli
1799552.jpeg,https://derpicdn.net/img/view/2018/8/6/1799552.jpeg,0,0.9984994530677797,1486,1030,2180,1724,694,694,applejack|fluttershy|mane six|pinkie pie|rainbow dash|rarity|twilight sparkle,nitrogenowo
1799552.jpeg,https://derpicdn.net/img/view/2018/8/6/1799552.jpeg,2,0.9745449423789978,523,119,1105,701,582,582,applejack|fluttershy|mane six|pinkie pie|rainbow dash|rarity|twilight sparkle,nitrogenowo
1799552.jpeg,https://derpicdn.net/img/view/2018/8/6/1799552.jpeg,3,0.9707215428352356,985,1042,1625,1682,640,640,applejack|fluttershy|mane six|pinkie pie|rainbow dash|rarity|twilight sparkle,nitrogenowo
1799908.jpeg,https://derpicdn.net/img/view/2018/8/6/1799908.jpeg,0,0.969071328639984,1555,144,1877,466,322,322,rainbow dash|spike|twilight sparkle,
1803946.jpeg,https://derpicdn.net/img/view/2018/8/11/1803946.jpeg,0,0.9641821980476379,106,194,432,520,326,326,applejack|fluttershy|pinkie pie|rainbow dash|rarity|starlight glimmer|twilight sparkle,zakro
1803946.jpeg,https://derpicdn.net/img/view/2018/8/11/1803946.jpeg,1,0.9265806078910828,530,0,810,234,280,234,applejack|fluttershy|pinkie pie|rainbow dash|rarity|starlight glimmer|twilight sparkle,zakro
1804129.jpeg,https://derpicdn.net/img/view/2018/8/11/1804129.jpeg,1,0.9984158277511596,897,44,1229,376,332,332,applejack|fluttershy|mane six|pinkie pie|rainbow dash|rarity|twilight sparkle,kityenmatoi
1804136.jpeg,https://derpicdn.net/img/view/2018/8/11/1804136.jpeg,0,0.9983462691307068,654,171,942,459,288,288,applejack|fluttershy|mane six|pinkie pie|rainbow dash|rarity|twilight sparkle,flutterluv
1804252.jpeg,https://derpicdn.net/img/view/2018/8/11/1804252.jpeg,1,0.9943792819976808,834,459,1110,735,276,276,applejack|fluttershy|mane six|pinkie pie|rainbow dash|rarity|spike|twilight sparkle,earthsong9405
1804252.jpeg,https://derpicdn.net/img/view/2018/8/11/1804252.jpeg,4,0.9744388461112976,596,30,994,428,398,398,applejack|fluttershy|mane six|pinkie pie|rainbow dash|rarity|spike|twilight sparkle,earthsong9405
1806279.jpeg,https://derpicdn.net/img/view/2018/8/14/1806279.jpeg,0,0.9827480316162108,1039,101,1509,571,470,470,fluttershy|twilight sparkle,lollipony
1807619.jpeg,https://derpicdn.net/img/view/2018/8/15/1807619.jpeg,0,0.9709506034851074,696,727,1678,1801,982,1074,pinkie pie|twilight sparkle,lummh|light262
1807633.jpeg,https://derpicdn.net/img/view/2018/8/15/1807633.jpeg,0,0.9943661093711852,1353,0,1595,238,242,238,applejack|fluttershy|mane six|pinkie pie|rainbow dash|rarity|twilight sparkle,light262
1808013.jpeg,https://derpicdn.net/img/view/2018/8/16/1808013.jpeg,0,0.9435862302780152,2440,1227,3014,1770,574,543,applejack|fluttershy|rainbow dash|rarity|twilight sparkle,light262|lummh
1808013.jpeg,https://derpicdn.net/img/view/2018/8/16/1808013.jpeg,1,0.9231821298599244,2115,1255,2651,1770,536,515,applejack|fluttershy|rainbow dash|rarity|twilight sparkle,light262|lummh
1809048.jpeg,https://derpicdn.net/img/view/2018/8/17/1809048.jpeg,1,0.9885507225990297,1471,776,2379,1684,908,908,princess celestia|twilight sparkle,magnaluna
1809049.jpeg,https://derpicdn.net/img/view/2018/8/17/1809049.jpeg,0,0.9065094590187072,172,0,1496,1311,1324,1311,princess celestia|twilight sparkle,magnaluna
1809713.jpeg,https://derpicdn.net/img/view/2018/8/18/1809713.jpeg,0,0.934547245502472,343,232,623,512,280,280,pinkie pie|twilight sparkle,heir-of-rick
1810452.jpeg,https://derpicdn.net/img/view/2018/8/19/1810452.jpeg,0,0.9973644614219666,949,1196,1279,1526,330,330,applejack|fluttershy|mane six|pinkie pie|rainbow dash|rarity|starlight glimmer|twilight sparkle,phoenixperegrine
1810452.jpeg,https://derpicdn.net/img/view/2018/8/19/1810452.jpeg,2,0.9833821058273317,470,726,840,1096,370,370,applejack|fluttershy|mane six|pinkie pie|rainbow dash|rarity|starlight glimmer|twilight sparkle,phoenixperegrine
1810452.jpeg,https://derpicdn.net/img/view/2018/8/19/1810452.jpeg,3,0.9294291138648988,261,92,695,526,434,434,applejack|fluttershy|mane six|pinkie pie|rainbow dash|rarity|starlight glimmer|twilight sparkle,phoenixperegrine
1810729.jpeg,https://derpicdn.net/img/view/2018/8/19/1810729.jpeg,0,0.9774672389030457,220,267,422,469,202,202,applejack|fluttershy|mane six|pinkie pie|princess cadance|rainbow dash|rarity|spike|twilight sparkle,dusty-munji
1810729.jpeg,https://derpicdn.net/img/view/2018/8/19/1810729.jpeg,1,0.935959815979004,386,200,680,494,294,294,applejack|fluttershy|mane six|pinkie pie|princess cadance|rainbow dash|rarity|spike|twilight sparkle,dusty-munji
1811070.jpeg,https://derpicdn.net/img/view/2018/8/19/1811070.jpeg,0,0.9987529516220092,0,7,963,989,963,982,princess celestia|twilight sparkle,magnaluna
1811108.jpeg,https://derpicdn.net/img/view/2018/8/19/1811108.jpeg,1,0.9477380514144896,46,1430,880,2264,834,834,princess celestia|princess luna|twilight sparkle,magnaluna
1811109.jpeg,https://derpicdn.net/img/view/2018/8/19/1811109.jpeg,1,0.9451767802238464,42,1418,882,2258,840,840,princess celestia|princess luna|twilight sparkle,magnaluna
1811337.jpeg,https://derpicdn.net/img/view/2018/8/20/1811337.jpeg,0,0.970494270324707,732,4478,2828,6574,2096,2096,applejack|fluttershy|mane six|pinkie pie|rainbow dash|rarity|twilight sparkle,techycutie
1812623.jpeg,https://derpicdn.net/img/view/2018/8/21/1812623.jpeg,0,0.9713196754455566,1326,42,1652,368,326,326,applejack|fluttershy|mane six|pinkie pie|rainbow dash|rarity|spike|twilight sparkle,pedantia
1815367.jpeg,https://derpicdn.net/img/view/2018/8/25/1815367.jpeg,0,0.9919832348823548,289,0,723,416,434,416,applejack|pinkie pie|rainbow dash|twilight sparkle,howxu
1816822.jpeg,https://derpicdn.net/img/view/2018/8/26/1816822.jpeg,0,0.9953327178955078,510,0,716,204,206,204,applejack|fluttershy|mane six|pinkie pie|rainbow dash|rarity|twilight sparkle,flash equestria photography
1816822.jpeg,https://derpicdn.net/img/view/2018/8/26/1816822.jpeg,2,0.9840195775032043,904,622,1064,782,160,160,applejack|fluttershy|mane six|pinkie pie|rainbow dash|rarity|twilight sparkle,flash equestria photography
1816822.jpeg,https://derpicdn.net/img/view/2018/8/26/1816822.jpeg,3,0.9753397107124328,508,617,694,803,186,186,applejack|fluttershy|mane six|pinkie pie|rainbow dash|rarity|twilight sparkle,flash equestria photography
1818125.jpeg,https://derpicdn.net/img/view/2018/8/27/1818125.jpeg,1,0.914054036140442,3755,828,5113,2186,1358,1358,princess cadance|princess celestia|princess luna|twilight sparkle,greenbrothersart
182104.jpeg,https://derpicdn.net/img/view/2012/12/14/182104.jpeg,0,0.9906492829322816,1092,609,1350,867,258,258,apple bloom|applejack|cutie mark crusaders|fluttershy|pinkie pie|princess celestia|princess luna|rainbow dash|rarity|scootaloo|spike|sweetie belle|trixie|twilight sparkle,chibi-jen-hen
182104.jpeg,https://derpicdn.net/img/view/2012/12/14/182104.jpeg,1,0.9690818786621094,58,288,304,534,246,246,apple bloom|applejack|cutie mark crusaders|fluttershy|pinkie pie|princess celestia|princess luna|rainbow dash|rarity|scootaloo|spike|sweetie belle|trixie|twilight sparkle,chibi-jen-hen
182104.jpeg,https://derpicdn.net/img/view/2012/12/14/182104.jpeg,3,0.9225351810455322,1049,0,1275,214,226,214,apple bloom|applejack|cutie mark crusaders|fluttershy|pinkie pie|princess celestia|princess luna|rainbow dash|rarity|scootaloo|spike|sweetie belle|trixie|twilight sparkle,chibi-jen-hen
1821111.jpeg,https://derpicdn.net/img/view/2018/8/31/1821111.jpeg,0,0.9946804642677308,156,1081,1328,2253,1172,1172,rainbow dash|twilight sparkle,calena
1825284.jpeg,https://derpicdn.net/img/view/2018/9/5/1825284.jpeg,0,0.9468926787376404,0,177,1412,1800,1412,1623,applejack|twilight sparkle,whitediamonds
1825286.jpeg,https://derpicdn.net/img/view/2018/9/5/1825286.jpeg,1,0.9508572816848756,0,177,1412,1800,1412,1623,applejack|twilight sparkle,whitediamonds
1826233.jpeg,https://derpicdn.net/img/view/2018/9/6/1826233.jpeg,0,0.9781240820884703,0,96,215,312,215,216,big macintosh|princess celestia|sunset shimmer|twilight sparkle,pixelkitties
1827468.jpeg,https://derpicdn.net/img/view/2018/9/8/1827468.jpeg,0,0.9761725068092346,25,62,713,750,688,688,pinkie pie|twilight sparkle,daisymeadows
1827960.jpeg,https://derpicdn.net/img/view/2018/9/8/1827960.jpeg,0,0.9472182393074036,702,0,1468,703,766,703,rainbow dash|twilight sparkle,timelordomega
1832234.jpeg,https://derpicdn.net/img/view/2018/9/14/1832234.jpeg,0,0.92389315366745,7264,0,9048,1752,1784,1752,sunset shimmer|twilight sparkle,imafutureguitarhero
1832952.jpeg,https://derpicdn.net/img/view/2018/9/15/1832952.jpeg,0,0.9991084933280944,815,1261,1241,1687,426,426,applejack|fluttershy|mane six|pinkie pie|rainbow dash|rarity|twilight sparkle,catlovergirl|rubenite
1832952.jpeg,https://derpicdn.net/img/view/2018/9/15/1832952.jpeg,1,0.9876112341880798,891,0,1197,302,306,302,applejack|fluttershy|mane six|pinkie pie|rainbow dash|rarity|twilight sparkle,catlovergirl|rubenite
1832952.jpeg,https://derpicdn.net/img/view/2018/9/15/1832952.jpeg,2,0.9375510811805724,48,1252,402,1606,354,354,applejack|fluttershy|mane six|pinkie pie|rainbow dash|rarity|twilight sparkle,catlovergirl|rubenite
1832952.jpeg,https://derpicdn.net/img/view/2018/9/15/1832952.jpeg,3,0.9048511385917664,20,0,376,351,356,351,applejack|fluttershy|mane six|pinkie pie|rainbow dash|rarity|twilight sparkle,catlovergirl|rubenite
1835893.jpeg,https://derpicdn.net/img/view/2018/9/18/1835893.jpeg,0,0.9896509647369384,305,0,1211,862,906,862,rainbow dash|spike|twilight sparkle,tsitra360
1836433.jpeg,https://derpicdn.net/img/view/2018/9/19/1836433.jpeg,0,0.9398755431175232,288,67,622,401,334,334,princess celestia|twilight sparkle,skunk bunk
1837278.jpeg,https://derpicdn.net/img/view/2018/9/20/1837278.jpeg,0,0.9704393744468688,1671,971,2111,1411,440,440,princess cadance|princess celestia|twilight sparkle,bunnycat
1837278.jpeg,https://derpicdn.net/img/view/2018/9/20/1837278.jpeg,1,0.9313995838165284,1033,144,1439,550,406,406,princess cadance|princess celestia|twilight sparkle,bunnycat
1841489.jpeg,https://derpicdn.net/img/view/2018/9/26/1841489.jpeg,0,0.970956563949585,13,45,600,647,587,602,applejack|fluttershy|mane six|pinkie pie|princess cadance|princess celestia|princess luna|queen chrysalis|rainbow dash|rarity|twilight sparkle,bluecrow
1841539.jpeg,https://derpicdn.net/img/view/2018/9/26/1841539.jpeg,0,0.9705442190170288,140,116,640,616,500,500,princess luna|twilight sparkle,amarynceus
1845450.jpeg,https://derpicdn.net/img/view/2018/10/1/1845450.jpeg,1,0.9902076721191406,566,1575,996,2005,430,430,starlight glimmer|twilight sparkle,monsterglad
1845450.jpeg,https://derpicdn.net/img/view/2018/10/1/1845450.jpeg,2,0.9886077046394348,123,713,729,1319,606,606,starlight glimmer|twilight sparkle,monsterglad
1845450.jpeg,https://derpicdn.net/img/view/2018/10/1/1845450.jpeg,3,0.9855293035507202,688,12,1252,588,564,576,starlight glimmer|twilight sparkle,monsterglad
1845450.jpeg,https://derpicdn.net/img/view/2018/10/1/1845450.jpeg,5,0.9072559475898744,14,1648,316,1950,302,302,starlight glimmer|twilight sparkle,monsterglad
1846450.jpeg,https://derpicdn.net/img/view/2018/10/2/1846450.jpeg,0,0.9914621114730836,19,0,531,494,512,494,applejack|twilight sparkle,xjenn9
1846500.jpeg,https://derpicdn.net/img/view/2018/10/2/1846500.jpeg,0,0.9977670907974244,668,83,1096,511,428,428,fluttershy|rarity|twilight sparkle,clefficia
1846500.jpeg,https://derpicdn.net/img/view/2018/10/2/1846500.jpeg,1,0.9954519867897034,293,808,819,1334,526,526,fluttershy|rarity|twilight sparkle,clefficia
1846925.jpeg,https://derpicdn.net/img/view/2018/10/3/1846925.jpeg,0,0.901882827281952,4625,780,6959,3114,2334,2334,sunset shimmer|twilight sparkle,imafutureguitarhero
1848160.jpeg,https://derpicdn.net/img/view/2018/10/4/1848160.jpeg,0,0.9975024461746216,297,1323,665,1691,368,368,applejack|fluttershy|mane six|pinkie pie|princess celestia|rainbow dash|rarity|twilight sparkle,pencils
1848160.jpeg,https://derpicdn.net/img/view/2018/10/4/1848160.jpeg,1,0.9395429491996764,374,460,970,1056,596,596,applejack|fluttershy|mane six|pinkie pie|princess celestia|rainbow dash|rarity|twilight sparkle,pencils
1848160.jpeg,https://derpicdn.net/img/view/2018/10/4/1848160.jpeg,2,0.9092473983764648,899,796,1280,1206,381,410,applejack|fluttershy|mane six|pinkie pie|princess celestia|rainbow dash|rarity|twilight sparkle,pencils
1850949.jpeg,https://derpicdn.net/img/view/2018/10/7/1850949.jpeg,0,0.962776243686676,586,1425,820,1659,234,234,princess celestia|twilight sparkle,mirroredsea
1852645.jpeg,https://derpicdn.net/img/view/2018/10/10/1852645.jpeg,0,0.9870295524597168,209,473,755,1019,546,546,rainbow dash|twilight sparkle,foughtdragon01
1852645.jpeg,https://derpicdn.net/img/view/2018/10/10/1852645.jpeg,1,0.9596351385116576,633,0,1193,501,560,501,rainbow dash|twilight sparkle,foughtdragon01
1852975.jpeg,https://derpicdn.net/img/view/2018/10/10/1852975.jpeg,0,0.9691248536109924,497,0,741,228,244,228,apple bloom|applejack|big macintosh|cutie mark crusaders|discord|fluttershy|granny smith|lightning dust|pinkie pie|princess celestia|rainbow dash|rarity|scootaloo|spike|spitfire|starlight glimmer|sweetie belle|trixie|twilight sparkle,dm29
1853047.jpeg,https://derpicdn.net/img/view/2018/10/10/1853047.jpeg,0,0.9989032745361328,186,135,462,411,276,276,princess luna|twilight sparkle,silfoe
1853795.jpeg,https://derpicdn.net/img/view/2018/10/11/1853795.jpeg,1,0.9984493255615234,476,231,652,407,176,176,applejack|fluttershy|mane six|pinkie pie|rainbow dash|rarity|starlight glimmer|sunset shimmer|trixie|twilight sparkle,caibaoreturn
1853795.jpeg,https://derpicdn.net/img/view/2018/10/11/1853795.jpeg,2,0.9957176446914672,301,219,487,405,186,186,applejack|fluttershy|mane six|pinkie pie|rainbow dash|rarity|starlight glimmer|sunset shimmer|trixie|twilight sparkle,caibaoreturn
1853855.jpeg,https://derpicdn.net/img/view/2018/10/11/1853855.jpeg,2,0.9175121784210204,0,388,143,552,143,164,apple bloom|applejack|cutie mark crusaders|fluttershy|mane six|pinkie pie|princess celestia|princess luna|rainbow dash|rarity|scootaloo|spike|starlight glimmer|sweetie belle|twilight sparkle,rubiowolf
1854714.jpeg,https://derpicdn.net/img/view/2018/10/12/1854714.jpeg,0,0.9954013824462892,146,395,534,783,388,388,rainbow dash|twilight sparkle,1jaz
1854714.jpeg,https://derpicdn.net/img/view/2018/10/12/1854714.jpeg,1,0.9859086275100708,824,119,1490,785,666,666,rainbow dash|twilight sparkle,1jaz
1854739.jpeg,https://derpicdn.net/img/view/2018/10/12/1854739.jpeg,0,0.9255006313323976,298,26,1162,848,864,822,starlight glimmer|trixie|twilight sparkle,sunibee
1855381.jpeg,https://derpicdn.net/img/view/2018/10/13/1855381.jpeg,0,0.9932114481925964,431,2480,1021,3070,590,590,applejack|fluttershy|mane six|pinkie pie|rainbow dash|rarity|twilight sparkle,caibaoreturn
1855381.jpeg,https://derpicdn.net/img/view/2018/10/13/1855381.jpeg,2,0.953052818775177,544,0,2048,1505,1504,1505,applejack|fluttershy|mane six|pinkie pie|rainbow dash|rarity|twilight sparkle,caibaoreturn
1855381.jpeg,https://derpicdn.net/img/view/2018/10/13/1855381.jpeg,3,0.9148973822593688,466,3147,1158,3839,692,692,applejack|fluttershy|mane six|pinkie pie|rainbow dash|rarity|twilight sparkle,caibaoreturn
1855874.jpeg,https://derpicdn.net/img/view/2018/10/14/1855874.jpeg,0,0.9857862591743468,394,13,664,283,270,270,applejack|fluttershy|mane six|pinkie pie|princess celestia|princess luna|rainbow dash|rarity|spike|starlight glimmer|sunset shimmer|twilight sparkle,tjpones
1855874.jpeg,https://derpicdn.net/img/view/2018/10/14/1855874.jpeg,1,0.965729832649231,746,387,1076,717,330,330,applejack|fluttershy|mane six|pinkie pie|princess celestia|princess luna|rainbow dash|rarity|spike|starlight glimmer|sunset shimmer|twilight sparkle,tjpones
1857829.jpeg,https://derpicdn.net/img/view/2018/10/16/1857829.jpeg,0,0.9963257312774658,530,0,960,404,430,404,applejack|fluttershy|pinkie pie|rainbow dash|rarity|twilight sparkle,trishalr
1858034.jpeg,https://derpicdn.net/img/view/2018/10/16/1858034.jpeg,0,0.9938907623291016,631,342,799,510,168,168,fluttershy|twilight sparkle,mysticalpha
1858034.jpeg,https://derpicdn.net/img/view/2018/10/16/1858034.jpeg,1,0.9924194812774658,509,341,703,535,194,194,fluttershy|twilight sparkle,mysticalpha
1858034.jpeg,https://derpicdn.net/img/view/2018/10/16/1858034.jpeg,2,0.9885498881340028,567,1034,767,1234,200,200,fluttershy|twilight sparkle,mysticalpha
1858034.jpeg,https://derpicdn.net/img/view/2018/10/16/1858034.jpeg,3,0.9437936544418336,569,724,761,916,192,192,fluttershy|twilight sparkle,mysticalpha
1859442.jpeg,https://derpicdn.net/img/view/2018/10/18/1859442.jpeg,2,0.9941063523292542,0,0,1142,1127,1142,1127,applejack|fluttershy|mane six|pinkie pie|rainbow dash|rarity|twilight sparkle,kittyrosie
1859699.jpeg,https://derpicdn.net/img/view/2018/10/18/1859699.jpeg,0,0.9993276000022888,14,63,612,661,598,598,starlight glimmer|twilight sparkle,
1859699.jpeg,https://derpicdn.net/img/view/2018/10/18/1859699.jpeg,1,0.9992893934249878,117,827,733,1443,616,616,starlight glimmer|twilight sparkle,
1861475.jpeg,https://derpicdn.net/img/view/2018/10/20/1861475.jpeg,1,0.988042950630188,635,473,1243,1081,608,608,fluttershy|rarity|trixie|twilight sparkle,pixelkitties
1861475.jpeg,https://derpicdn.net/img/view/2018/10/20/1861475.jpeg,2,0.9856886267662048,2082,597,2400,915,318,318,fluttershy|rarity|trixie|twilight sparkle,pixelkitties
1861585.jpeg,https://derpicdn.net/img/view/2018/10/20/1861585.jpeg,0,0.945816159248352,65,0,689,568,624,568,sunset shimmer|twilight sparkle,phyllismi
1862100.jpeg,https://derpicdn.net/img/view/2018/10/21/1862100.jpeg,0,0.9613105654716492,80,0,806,694,726,694,princess celestia|twilight sparkle,scorpion-89
1862361.jpeg,https://derpicdn.net/img/view/2018/10/21/1862361.jpeg,0,0.9900109171867372,721,67,1147,493,426,426,applejack|fluttershy|mane six|pinkie pie|rainbow dash|rarity|twilight sparkle,prr_hmhm
1862361.jpeg,https://derpicdn.net/img/view/2018/10/21/1862361.jpeg,1,0.990010678768158,58,357,442,741,384,384,applejack|fluttershy|mane six|pinkie pie|rainbow dash|rarity|twilight sparkle,prr_hmhm
1862361.jpeg,https://derpicdn.net/img/view/2018/10/21/1862361.jpeg,2,0.9615874290466307,481,157,851,527,370,370,applejack|fluttershy|mane six|pinkie pie|rainbow dash|rarity|twilight sparkle,prr_hmhm
1862985.jpeg,https://derpicdn.net/img/view/2018/10/22/1862985.jpeg,0,0.9838897585868835,174,760,982,1568,808,808,spike|starlight glimmer|twilight sparkle,gor1ck
1863850.jpeg,https://derpicdn.net/img/view/2018/10/23/1863850.jpeg,0,0.995657742023468,669,235,1171,737,502,502,applejack|fluttershy|mane six|pinkie pie|rainbow dash|rarity|twilight sparkle,love2eategg
1863850.jpeg,https://derpicdn.net/img/view/2018/10/23/1863850.jpeg,1,0.9853328466415404,1193,276,1611,694,418,418,applejack|fluttershy|mane six|pinkie pie|rainbow dash|rarity|twilight sparkle,love2eategg
1863850.jpeg,https://derpicdn.net/img/view/2018/10/23/1863850.jpeg,2,0.9730381369590759,168,231,674,737,506,506,applejack|fluttershy|mane six|pinkie pie|rainbow dash|rarity|twilight sparkle,love2eategg
1863850.jpeg,https://derpicdn.net/img/view/2018/10/23/1863850.jpeg,3,0.9079083204269408,2403,60,3147,804,744,744,applejack|fluttershy|mane six|pinkie pie|rainbow dash|rarity|twilight sparkle,love2eategg
1865477.jpeg,https://derpicdn.net/img/view/2018/10/25/1865477.jpeg,0,0.9626107215881348,870,3886,2028,5044,1158,1158,applejack|fluttershy|mane six|pinkie pie|rainbow dash|rarity|twilight sparkle,swordflash4
1866085.jpeg,https://derpicdn.net/img/view/2018/10/25/1866085.jpeg,0,0.9947980046272278,571,0,2187,1559,1616,1559,rarity|twilight sparkle,chub-wub
186630.jpeg,https://derpicdn.net/img/view/2012/12/18/186630.jpeg,0,0.9657479524612428,118,485,264,631,146,146,discord|princess luna|twilight sparkle,psychohazard
1867196.jpeg,https://derpicdn.net/img/view/2018/10/27/1867196.jpeg,0,0.9853451251983644,1116,432,1728,1044,612,612,spike|twilight sparkle,franschesco
1871984.jpeg,https://derpicdn.net/img/view/2018/11/1/1871984.jpeg,0,0.9992119073867798,1131,103,1481,453,350,350,applejack|twilight sparkle,obcor
1871984.jpeg,https://derpicdn.net/img/view/2018/11/1/1871984.jpeg,1,0.9724789261817932,479,164,935,620,456,456,applejack|twilight sparkle,obcor
1873033.jpeg,https://derpicdn.net/img/view/2018/11/2/1873033.jpeg,0,0.99335777759552,14,0,560,471,546,471,pinkie pie|twilight sparkle,yuyutsuka_0130
1873690.jpeg,https://derpicdn.net/img/view/2018/11/3/1873690.jpeg,0,0.99252849817276,1343,0,2261,783,918,783,pinkie pie|twilight sparkle,pupil
1873690.jpeg,https://derpicdn.net/img/view/2018/11/3/1873690.jpeg,1,0.9788867235183716,12,0,970,798,958,798,pinkie pie|twilight sparkle,pupil
1873693.jpeg,https://derpicdn.net/img/view/2018/11/3/1873693.jpeg,0,0.9965898990631104,1352,562,1778,988,426,426,apple bloom|applejack|cutie mark crusaders|fluttershy|mane six|pinkie pie|princess cadance|princess celestia|princess luna|queen chrysalis|rainbow dash|rarity|scootaloo|starlight glimmer|sunset shimmer|sweetie belle|trixie|twilight sparkle,pupil
1873693.jpeg,https://derpicdn.net/img/view/2018/11/3/1873693.jpeg,1,0.9806252121925354,78,27,484,433,406,406,apple bloom|applejack|cutie mark crusaders|fluttershy|mane six|pinkie pie|princess cadance|princess celestia|princess luna|queen chrysalis|rainbow dash|rarity|scootaloo|starlight glimmer|sunset shimmer|sweetie belle|trixie|twilight sparkle,pupil
1873693.jpeg,https://derpicdn.net/img/view/2018/11/3/1873693.jpeg,2,0.9749566912651062,739,0,1131,390,392,390,apple bloom|applejack|cutie mark crusaders|fluttershy|mane six|pinkie pie|princess cadance|princess celestia|princess luna|queen chrysalis|rainbow dash|rarity|scootaloo|starlight glimmer|sunset shimmer|sweetie belle|trixie|twilight sparkle,pupil
1873693.jpeg,https://derpicdn.net/img/view/2018/11/3/1873693.jpeg,4,0.9535719156265259,670,1190,1210,1730,540,540,apple bloom|applejack|cutie mark crusaders|fluttershy|mane six|pinkie pie|princess cadance|princess celestia|princess luna|queen chrysalis|rainbow dash|rarity|scootaloo|starlight glimmer|sunset shimmer|sweetie belle|trixie|twilight sparkle,pupil
1873693.jpeg,https://derpicdn.net/img/view/2018/11/3/1873693.jpeg,5,0.918984591960907,15,587,537,1109,522,522,apple bloom|applejack|cutie mark crusaders|fluttershy|mane six|pinkie pie|princess cadance|princess celestia|princess luna|queen chrysalis|rainbow dash|rarity|scootaloo|starlight glimmer|sunset shimmer|sweetie belle|trixie|twilight sparkle,pupil
1873924.jpeg,https://derpicdn.net/img/view/2018/11/3/1873924.jpeg,1,0.9455116987228394,1239,377,1433,571,194,194,spike|twilight sparkle,
1876121.jpeg,https://derpicdn.net/img/view/2018/11/6/1876121.jpeg,0,0.9971538186073304,606,205,888,487,282,282,applejack|fluttershy|mane six|pinkie pie|rainbow dash|rarity|twilight sparkle,colorfulcolor233
1876121.jpeg,https://derpicdn.net/img/view/2018/11/6/1876121.jpeg,1,0.980116069316864,49,220,297,468,248,248,applejack|fluttershy|mane six|pinkie pie|rainbow dash|rarity|twilight sparkle,colorfulcolor233
1876760.jpeg,https://derpicdn.net/img/view/2018/11/7/1876760.jpeg,0,0.9845767617225648,709,265,1027,583,318,318,princess celestia|spike|twilight sparkle,silfoe
1876761.jpeg,https://derpicdn.net/img/view/2018/11/7/1876761.jpeg,0,0.9954671859741212,90,127,484,521,394,394,princess luna|twilight sparkle,silfoe
1880213.jpeg,https://derpicdn.net/img/view/2018/11/12/1880213.jpeg,0,0.999452531337738,2005,780,2649,1424,644,644,applejack|fluttershy|mane six|pinkie pie|rainbow dash|rarity|starlight glimmer|twilight sparkle,liu ting
1880213.jpeg,https://derpicdn.net/img/view/2018/11/12/1880213.jpeg,1,0.9604423642158508,171,714,869,1412,698,698,applejack|fluttershy|mane six|pinkie pie|rainbow dash|rarity|starlight glimmer|twilight sparkle,liu ting
1880213.jpeg,https://derpicdn.net/img/view/2018/11/12/1880213.jpeg,2,0.9160524606704712,463,1981,1877,3395,1414,1414,applejack|fluttershy|mane six|pinkie pie|rainbow dash|rarity|starlight glimmer|twilight sparkle,liu ting
1880213.jpeg,https://derpicdn.net/img/view/2018/11/12/1880213.jpeg,3,0.9024603366851808,1602,139,2246,783,644,644,applejack|fluttershy|mane six|pinkie pie|rainbow dash|rarity|starlight glimmer|twilight sparkle,liu ting
1881629.jpeg,https://derpicdn.net/img/view/2018/11/13/1881629.jpeg,0,0.9917420148849488,350,941,1014,1605,664,664,pinkie pie|twilight sparkle,nekoshiei|gomanga
1881655.jpeg,https://derpicdn.net/img/view/2018/11/13/1881655.jpeg,0,0.9891624450683594,230,63,566,399,336,336,rainbow dash|twilight sparkle,tylerdashart
1881655.jpeg,https://derpicdn.net/img/view/2018/11/13/1881655.jpeg,1,0.9134758710861206,448,46,774,372,326,326,rainbow dash|twilight sparkle,tylerdashart
1883544.jpeg,https://derpicdn.net/img/view/2018/11/16/1883544.jpeg,0,0.9963566660881042,509,128,796,420,287,292,rainbow dash|twilight sparkle,flashlighttwi
1883741.jpeg,https://derpicdn.net/img/view/2018/11/16/1883741.jpeg,0,0.9136950969696044,2165,371,3387,1593,1222,1222,apple bloom|applejack|cutie mark crusaders|diamond tiara|fluttershy|mane six|pinkie pie|princess celestia|rainbow dash|rarity|scootaloo|silver spoon|starlight glimmer|sunset shimmer|sweetie belle|trixie|twilight sparkle,zidanemina
1887209.jpeg,https://derpicdn.net/img/view/2018/11/21/1887209.jpeg,1,0.9946606755256652,205,928,469,1192,264,264,applejack|fluttershy|mane six|pinkie pie|princess celestia|rainbow dash|rarity|twilight sparkle,pencils
1887510.jpeg,https://derpicdn.net/img/view/2018/11/21/1887510.jpeg,2,0.9366356730461121,1429,517,1887,975,458,458,applejack|fluttershy|mane six|pinkie pie|princess celestia|princess luna|rainbow dash|rarity|spike|twilight sparkle,andypriceart
1887510.jpeg,https://derpicdn.net/img/view/2018/11/21/1887510.jpeg,3,0.9238883852958679,14,0,418,403,404,403,applejack|fluttershy|mane six|pinkie pie|princess celestia|princess luna|rainbow dash|rarity|spike|twilight sparkle,andypriceart
1888213.jpeg,https://derpicdn.net/img/view/2018/11/22/1888213.jpeg,0,0.99705970287323,2015,1365,3249,2599,1234,1234,spike|twilight sparkle,garam
1888332.jpeg,https://derpicdn.net/img/view/2018/11/22/1888332.jpeg,0,0.9865565896034241,542,164,824,446,282,282,applejack|fluttershy|mane six|pinkie pie|rainbow dash|rarity|twilight sparkle,tylerdashart
1889154.jpeg,https://derpicdn.net/img/view/2018/11/23/1889154.jpeg,0,0.9983851313591005,975,1956,1709,2690,734,734,applejack|fluttershy|mane six|pinkie pie|princess celestia|princess luna|rainbow dash|rarity|spike|twilight sparkle,andypriceart
1889154.jpeg,https://derpicdn.net/img/view/2018/11/23/1889154.jpeg,1,0.9828490018844604,0,986,596,1692,596,706,applejack|fluttershy|mane six|pinkie pie|princess celestia|princess luna|rainbow dash|rarity|spike|twilight sparkle,andypriceart
1889154.jpeg,https://derpicdn.net/img/view/2018/11/23/1889154.jpeg,2,0.9338546991348268,411,2023,1067,2679,656,656,applejack|fluttershy|mane six|pinkie pie|princess celestia|princess luna|rainbow dash|rarity|spike|twilight sparkle,andypriceart
1890450.jpeg,https://derpicdn.net/img/view/2018/11/25/1890450.jpeg,0,0.99183851480484,2599,1243,3201,1845,602,602,applejack|fluttershy|mane six|pinkie pie|rainbow dash|rarity|twilight sparkle,jowybean
1890450.jpeg,https://derpicdn.net/img/view/2018/11/25/1890450.jpeg,1,0.985889196395874,2747,136,3265,654,518,518,applejack|fluttershy|mane six|pinkie pie|rainbow dash|rarity|twilight sparkle,jowybean
1890450.jpeg,https://derpicdn.net/img/view/2018/11/25/1890450.jpeg,2,0.9763551950454712,295,1393,873,1971,578,578,applejack|fluttershy|mane six|pinkie pie|rainbow dash|rarity|twilight sparkle,jowybean
1890466.jpeg,https://derpicdn.net/img/view/2018/11/25/1890466.jpeg,0,0.9735242128372192,1327,2676,2395,3744,1068,1068,sunset shimmer|twilight sparkle,jowybean
1891009.jpeg,https://derpicdn.net/img/view/2018/11/26/1891009.jpeg,0,0.9951629638671876,1460,2170,1722,2432,262,262,applejack|fluttershy|pinkie pie|princess celestia|rainbow dash|rarity|starlight glimmer|sunset shimmer|trixie|twilight sparkle,
1891009.jpeg,https://derpicdn.net/img/view/2018/11/26/1891009.jpeg,1,0.9855390191078186,1144,2174,1414,2444,270,270,applejack|fluttershy|pinkie pie|princess celestia|rainbow dash|rarity|starlight glimmer|sunset shimmer|trixie|twilight sparkle,
1891009.jpeg,https://derpicdn.net/img/view/2018/11/26/1891009.jpeg,2,0.9793913960456848,1511,748,1811,1048,300,300,applejack|fluttershy|pinkie pie|princess celestia|rainbow dash|rarity|starlight glimmer|sunset shimmer|trixie|twilight sparkle,
1891009.jpeg,https://derpicdn.net/img/view/2018/11/26/1891009.jpeg,4,0.9697713255882264,815,2890,1021,3096,206,206,applejack|fluttershy|pinkie pie|princess celestia|rainbow dash|rarity|starlight glimmer|sunset shimmer|trixie|twilight sparkle,
1891009.jpeg,https://derpicdn.net/img/view/2018/11/26/1891009.jpeg,5,0.964708924293518,1506,396,1782,672,276,276,applejack|fluttershy|pinkie pie|princess celestia|rainbow dash|rarity|starlight glimmer|sunset shimmer|trixie|twilight sparkle,
1891009.jpeg,https://derpicdn.net/img/view/2018/11/26/1891009.jpeg,6,0.9622149467468262,2884,722,3220,1058,336,336,applejack|fluttershy|pinkie pie|princess celestia|rainbow dash|rarity|starlight glimmer|sunset shimmer|trixie|twilight sparkle,
1891009.jpeg,https://derpicdn.net/img/view/2018/11/26/1891009.jpeg,7,0.9604611992836,1857,755,2093,991,236,236,applejack|fluttershy|pinkie pie|princess celestia|rainbow dash|rarity|starlight glimmer|sunset shimmer|trixie|twilight sparkle,
1891009.jpeg,https://derpicdn.net/img/view/2018/11/26/1891009.jpeg,8,0.9558849930763244,750,1082,1108,1440,358,358,applejack|fluttershy|pinkie pie|princess celestia|rainbow dash|rarity|starlight glimmer|sunset shimmer|trixie|twilight sparkle,
1891009.jpeg,https://derpicdn.net/img/view/2018/11/26/1891009.jpeg,9,0.9550142288208008,1107,41,1455,389,348,348,applejack|fluttershy|pinkie pie|princess celestia|rainbow dash|rarity|starlight glimmer|sunset shimmer|trixie|twilight sparkle,
1891009.jpeg,https://derpicdn.net/img/view/2018/11/26/1891009.jpeg,10,0.9515014886856079,431,758,719,1046,288,288,applejack|fluttershy|pinkie pie|princess celestia|rainbow dash|rarity|starlight glimmer|sunset shimmer|trixie|twilight sparkle,
1891009.jpeg,https://derpicdn.net/img/view/2018/11/26/1891009.jpeg,11,0.9482902288436892,42,368,408,734,366,366,applejack|fluttershy|pinkie pie|princess celestia|rainbow dash|rarity|starlight glimmer|sunset shimmer|trixie|twilight sparkle,
1891009.jpeg,https://derpicdn.net/img/view/2018/11/26/1891009.jpeg,12,0.9469858407974244,1861,2184,2105,2428,244,244,applejack|fluttershy|pinkie pie|princess celestia|rainbow dash|rarity|starlight glimmer|sunset shimmer|trixie|twilight sparkle,
1891009.jpeg,https://derpicdn.net/img/view/2018/11/26/1891009.jpeg,13,0.9451497793197632,25,19,437,431,412,412,applejack|fluttershy|pinkie pie|princess celestia|rainbow dash|rarity|starlight glimmer|sunset shimmer|trixie|twilight sparkle,
1891009.jpeg,https://derpicdn.net/img/view/2018/11/26/1891009.jpeg,14,0.9446572065353394,1835,1113,2111,1389,276,276,applejack|fluttershy|pinkie pie|princess celestia|rainbow dash|rarity|starlight glimmer|sunset shimmer|trixie|twilight sparkle,
1891009.jpeg,https://derpicdn.net/img/view/2018/11/26/1891009.jpeg,15,0.9230688214302064,71,2550,329,2808,258,258,applejack|fluttershy|pinkie pie|princess celestia|rainbow dash|rarity|starlight glimmer|sunset shimmer|trixie|twilight sparkle,
1891109.jpeg,https://derpicdn.net/img/view/2018/11/26/1891109.jpeg,0,0.9758976101875304,281,0,513,223,232,223,pinkie pie|twilight sparkle,jannel300
1891109.jpeg,https://derpicdn.net/img/view/2018/11/26/1891109.jpeg,2,0.9113301038742064,316,309,496,489,180,180,pinkie pie|twilight sparkle,jannel300
1891313.jpeg,https://derpicdn.net/img/view/2018/11/26/1891313.jpeg,0,0.9531605243682858,372,173,614,415,242,242,rainbow dash|twilight sparkle,tylerdashart
1892178.jpeg,https://derpicdn.net/img/view/2018/11/27/1892178.jpeg,0,0.9877429008483888,301,0,1665,1275,1364,1275,shining armor|twilight sparkle,evilfrenzy|crinkle cow
1892178.jpeg,https://derpicdn.net/img/view/2018/11/27/1892178.jpeg,1,0.9721127152442932,2106,0,3504,1266,1398,1266,shining armor|twilight sparkle,evilfrenzy|crinkle cow
1892652.jpeg,https://derpicdn.net/img/view/2018/11/28/1892652.jpeg,0,0.9268271327018738,758,312,1366,920,608,608,shining armor|twilight sparkle,stratodraw
1893832.jpeg,https://derpicdn.net/img/view/2018/11/29/1893832.jpeg,0,0.9853174090385436,302,124,720,542,418,418,fluttershy|twilight sparkle,princessmuffinart
1894767.jpeg,https://derpicdn.net/img/view/2018/11/30/1894767.jpeg,0,0.987542986869812,152,0,1762,1466,1610,1466,princess cadance|twilight sparkle,crystalsonatica
1894969.jpeg,https://derpicdn.net/img/view/2018/12/1/1894969.jpeg,0,0.97764253616333,936,63,1408,535,472,472,applejack|fluttershy|mane six|pinkie pie|rainbow dash|rarity|twilight sparkle,justp33chy
1896442.jpeg,https://derpicdn.net/img/view/2018/12/2/1896442.jpeg,0,0.9789981842041016,0,0,377,344,377,344,spike|twilight sparkle,kura
1897067.jpeg,https://derpicdn.net/img/view/2018/12/3/1897067.jpeg,0,0.9498746395111084,298,78,514,294,216,216,shining armor|twilight sparkle,nukilik
1897079.jpeg,https://derpicdn.net/img/view/2018/12/3/1897079.jpeg,0,0.9580222964286804,1233,0,2197,954,964,954,rarity|starlight glimmer|twilight sparkle,raikoh|morexis
1897488.jpeg,https://derpicdn.net/img/view/2018/12/4/1897488.jpeg,2,0.9385266304016112,1065,382,1280,630,215,248,trixie|twilight sparkle,rutkotka
1897488.jpeg,https://derpicdn.net/img/view/2018/12/4/1897488.jpeg,3,0.9125754833221436,262,138,406,282,144,144,trixie|twilight sparkle,rutkotka
1897488.jpeg,https://derpicdn.net/img/view/2018/12/4/1897488.jpeg,4,0.9006199240684509,259,371,441,553,182,182,trixie|twilight sparkle,rutkotka
1897565.jpeg,https://derpicdn.net/img/view/2018/12/4/1897565.jpeg,0,0.9478751420974731,336,22,782,468,446,446,princess cadance|princess celestia|princess luna|twilight sparkle,silfoe
1899343.jpeg,https://derpicdn.net/img/view/2018/12/5/1899343.jpeg,2,0.9887738823890686,145,369,597,821,452,452,pinkie pie|rainbow dash|rarity|twilight sparkle,kairean
1899381.jpeg,https://derpicdn.net/img/view/2018/12/5/1899381.jpeg,0,0.9995676875114441,118,0,1454,1192,1336,1192,applejack|fluttershy|mane six|pinkie pie|rainbow dash|rarity|twilight sparkle,yunlongchen
1899381.jpeg,https://derpicdn.net/img/view/2018/12/5/1899381.jpeg,1,0.993904948234558,3535,1884,4589,2938,1054,1054,applejack|fluttershy|mane six|pinkie pie|rainbow dash|rarity|twilight sparkle,yunlongchen
1899384.jpeg,https://derpicdn.net/img/view/2018/12/5/1899384.jpeg,0,0.9960897564888,0,1376,1143,2642,1143,1266,applejack|fluttershy|rainbow dash|twilight sparkle,yunlongchen
1899384.jpeg,https://derpicdn.net/img/view/2018/12/5/1899384.jpeg,1,0.995088279247284,1512,1576,2360,2424,848,848,applejack|fluttershy|rainbow dash|twilight sparkle,yunlongchen
1899384.jpeg,https://derpicdn.net/img/view/2018/12/5/1899384.jpeg,2,0.9897028207778932,0,0,731,687,731,687,applejack|fluttershy|rainbow dash|twilight sparkle,yunlongchen
1899384.jpeg,https://derpicdn.net/img/view/2018/12/5/1899384.jpeg,3,0.9215339422225952,990,12,1552,574,562,562,applejack|fluttershy|rainbow dash|twilight sparkle,yunlongchen
1899419.jpeg,https://derpicdn.net/img/view/2018/12/5/1899419.jpeg,0,0.9884446859359741,361,397,545,581,184,184,applejack|fluttershy|mane six|pinkie pie|rainbow dash|rarity|twilight sparkle,lispp
1899419.jpeg,https://derpicdn.net/img/view/2018/12/5/1899419.jpeg,1,0.9689379930496216,602,32,816,246,214,214,applejack|fluttershy|mane six|pinkie pie|rainbow dash|rarity|twilight sparkle,lispp
1899419.jpeg,https://derpicdn.net/img/view/2018/12/5/1899419.jpeg,3,0.9687527418136596,1,76,201,276,200,200,applejack|fluttershy|mane six|pinkie pie|rainbow dash|rarity|twilight sparkle,lispp
1899823.jpeg,https://derpicdn.net/img/view/2018/12/6/1899823.jpeg,0,0.9995038509368896,0,242,325,574,325,332,applejack|fluttershy|mane six|pinkie pie|rainbow dash|rarity|twilight sparkle,seamaggie
1901715.jpeg,https://derpicdn.net/img/view/2018/12/8/1901715.jpeg,0,0.9911316633224488,701,1086,1239,1624,538,538,applejack|fluttershy|mane six|pinkie pie|rainbow dash|rarity|twilight sparkle,viejillox64art
1901715.jpeg,https://derpicdn.net/img/view/2018/12/8/1901715.jpeg,1,0.9613544940948486,1122,1025,2024,1927,902,902,applejack|fluttershy|mane six|pinkie pie|rainbow dash|rarity|twilight sparkle,viejillox64art
1901715.jpeg,https://derpicdn.net/img/view/2018/12/8/1901715.jpeg,2,0.9550659060478208,162,43,648,529,486,486,applejack|fluttershy|mane six|pinkie pie|rainbow dash|rarity|twilight sparkle,viejillox64art
1902438.jpeg,https://derpicdn.net/img/view/2018/12/8/1902438.jpeg,0,0.9375686645507812,134,0,1460,1241,1326,1241,pinkie pie|rainbow dash|twilight sparkle,yunlongchen
1904035.jpeg,https://derpicdn.net/img/view/2018/12/10/1904035.jpeg,0,0.999432384967804,536,0,1050,456,514,456,princess cadance|princess celestia|princess luna|twilight sparkle,dashy21
1904035.jpeg,https://derpicdn.net/img/view/2018/12/10/1904035.jpeg,1,0.9972509145736694,0,0,481,466,481,466,princess cadance|princess celestia|princess luna|twilight sparkle,dashy21
1905168.jpeg,https://derpicdn.net/img/view/2018/12/11/1905168.jpeg,0,0.9898838400840759,701,107,1215,621,514,514,applejack|fluttershy|mane six|pinkie pie|rainbow dash|rarity|spike|twilight sparkle,phoenixrk49
1905421.jpeg,https://derpicdn.net/img/view/2018/12/11/1905421.jpeg,0,0.9957191348075868,69,43,427,401,358,358,rainbow dash|twilight sparkle,tylerdashart
1906508.jpeg,https://derpicdn.net/img/view/2018/12/12/1906508.jpeg,0,0.9995273947715759,1034,0,1476,420,442,420,applejack|fluttershy|mane six|pinkie pie|rainbow dash|rarity|twilight sparkle,dashy21
1906508.jpeg,https://derpicdn.net/img/view/2018/12/12/1906508.jpeg,1,0.9983189702033995,425,0,1031,505,606,505,applejack|fluttershy|mane six|pinkie pie|rainbow dash|rarity|twilight sparkle,dashy21
1906508.jpeg,https://derpicdn.net/img/view/2018/12/12/1906508.jpeg,3,0.9933046102523804,4,489,518,1000,514,511,applejack|fluttershy|mane six|pinkie pie|rainbow dash|rarity|twilight sparkle,dashy21
1909599.jpeg,https://derpicdn.net/img/view/2018/12/16/1909599.jpeg,0,0.9736039638519288,0,0,543,499,543,499,applejack|fluttershy|mane six|pinkie pie|rainbow dash|rarity|twilight sparkle,lavender_1227
1909599.jpeg,https://derpicdn.net/img/view/2018/12/16/1909599.jpeg,1,0.9264246821403505,707,0,1024,335,317,335,applejack|fluttershy|mane six|pinkie pie|rainbow dash|rarity|twilight sparkle,lavender_1227
1909622.jpeg,https://derpicdn.net/img/view/2018/12/16/1909622.jpeg,0,0.9780549407005308,738,1,1082,345,344,344,sunset shimmer|twilight sparkle,toughset
1909622.jpeg,https://derpicdn.net/img/view/2018/12/16/1909622.jpeg,1,0.9648081064224244,252,41,510,299,258,258,sunset shimmer|twilight sparkle,toughset
1910151.jpeg,https://derpicdn.net/img/view/2018/12/16/1910151.jpeg,0,0.9904248118400574,518,53,1000,535,482,482,rainbow dash|twilight sparkle,sozglitch
1912658.jpeg,https://derpicdn.net/img/view/2018/12/19/1912658.jpeg,0,0.9946961998939514,429,278,589,438,160,160,pinkie pie|spike|twilight sparkle,pencils
1912867.jpeg,https://derpicdn.net/img/view/2018/12/19/1912867.jpeg,0,0.9872072339057922,0,53,395,459,395,406,applejack|fluttershy|pinkie pie|trixie|twilight sparkle,pencils
1912972.jpeg,https://derpicdn.net/img/view/2018/12/19/1912972.jpeg,0,0.9744032621383668,505,110,1141,746,636,636,pinkie pie|rainbow dash|twilight sparkle,liaaqila
1912972.jpeg,https://derpicdn.net/img/view/2018/12/19/1912972.jpeg,1,0.9490106701850892,0,65,577,715,577,650,pinkie pie|rainbow dash|twilight sparkle,liaaqila
1913323.jpeg,https://derpicdn.net/img/view/2018/12/20/1913323.jpeg,1,0.9525004029273988,288,381,834,927,546,546,trixie|twilight sparkle,ss2sonic
1913432.jpeg,https://derpicdn.net/img/view/2018/12/20/1913432.jpeg,0,0.964618682861328,236,0,1816,1294,1580,1294,princess celestia|twilight sparkle,magnaluna
1913432.jpeg,https://derpicdn.net/img/view/2018/12/20/1913432.jpeg,1,0.9290165305137634,0,0,1040,942,1040,942,princess celestia|twilight sparkle,magnaluna
1913490.jpeg,https://derpicdn.net/img/view/2018/12/20/1913490.jpeg,0,0.9992532134056092,614,0,1342,655,728,655,princess celestia|twilight sparkle,magnaluna
1913491.jpeg,https://derpicdn.net/img/view/2018/12/20/1913491.jpeg,0,0.982465386390686,600,0,1574,863,974,863,princess luna|twilight sparkle,magnaluna
1914483.jpeg,https://derpicdn.net/img/view/2018/12/21/1914483.jpeg,0,0.9870999455451964,90,0,802,654,712,654,rainbow dash|twilight sparkle,fensu-san
1915878.jpeg,https://derpicdn.net/img/view/2018/12/22/1915878.jpeg,0,0.9839828610420228,375,418,1065,1108,690,690,applejack|fluttershy|mane six|pinkie pie|rainbow dash|rarity|twilight sparkle,stratodraw
1916063.jpeg,https://derpicdn.net/img/view/2018/12/23/1916063.jpeg,0,0.9676428437232972,854,4,1678,828,824,824,princess cadance|twilight sparkle,densosard
1916288.jpeg,https://derpicdn.net/img/view/2018/12/23/1916288.jpeg,1,0.936362326145172,1039,82,1891,934,852,852,applejack|fluttershy|pinkie pie|twilight sparkle,asheraart
1917863.jpeg,https://derpicdn.net/img/view/2018/12/24/1917863.jpeg,0,0.9702447652816772,913,383,1603,1073,690,690,rarity|twilight sparkle,ghost reviews
1918713.jpeg,https://derpicdn.net/img/view/2018/12/25/1918713.jpeg,0,0.9984177350997924,467,446,861,840,394,394,applejack|fluttershy|mane six|pinkie pie|rainbow dash|rarity|twilight sparkle,zakro
1918713.jpeg,https://derpicdn.net/img/view/2018/12/25/1918713.jpeg,2,0.992027759552002,149,506,491,848,342,342,applejack|fluttershy|mane six|pinkie pie|rainbow dash|rarity|twilight sparkle,zakro
1918713.jpeg,https://derpicdn.net/img/view/2018/12/25/1918713.jpeg,4,0.9681478142738342,1096,0,1428,283,332,283,applejack|fluttershy|mane six|pinkie pie|rainbow dash|rarity|twilight sparkle,zakro
1920205.jpeg,https://derpicdn.net/img/view/2018/12/27/1920205.jpeg,0,0.9785043597221376,493,4070,900,4496,407,426,apple bloom|applejack|cutie mark crusaders|pinkie pie|rainbow dash|rarity|scootaloo|sweetie belle|twilight sparkle,earthsong9405
1921304.jpeg,https://derpicdn.net/img/view/2018/12/29/1921304.jpeg,0,0.9204468131065368,259,0,883,529,624,529,rarity|twilight sparkle,pastel-pony-pictures
1922476.jpeg,https://derpicdn.net/img/view/2018/12/30/1922476.jpeg,1,0.9917740225791932,277,297,875,895,598,598,princess cadance|princess flurry heart|shining armor|spike|twilight sparkle,traupa
1922476.jpeg,https://derpicdn.net/img/view/2018/12/30/1922476.jpeg,2,0.9761053323745728,881,1467,1321,1907,440,440,princess cadance|princess flurry heart|shining armor|spike|twilight sparkle,traupa
1922476.jpeg,https://derpicdn.net/img/view/2018/12/30/1922476.jpeg,3,0.9386524558067322,184,1164,778,1758,594,594,princess cadance|princess flurry heart|shining armor|spike|twilight sparkle,traupa
1923591.jpeg,https://derpicdn.net/img/view/2019/1/1/1923591.jpeg,1,0.9981184005737304,420,98,742,420,322,322,apple bloom|cutie mark crusaders|scootaloo|sweetie belle|twilight sparkle,wangkingfun
1923662.jpeg,https://derpicdn.net/img/view/2019/1/1/1923662.jpeg,0,0.9718282222747804,731,146,1333,748,602,602,starlight glimmer|twilight sparkle,kolshica|jiuweidehuli
1923729.jpeg,https://derpicdn.net/img/view/2019/1/1/1923729.jpeg,1,0.9900822043418884,1661,571,2250,1173,589,602,applejack|fluttershy|mane six|pinkie pie|rainbow dash|rarity|twilight sparkle,tjpones
1923729.jpeg,https://derpicdn.net/img/view/2019/1/1/1923729.jpeg,2,0.9294677972793579,1054,565,1782,1293,728,728,applejack|fluttershy|mane six|pinkie pie|rainbow dash|rarity|twilight sparkle,tjpones
1924478.jpeg,https://derpicdn.net/img/view/2019/1/2/1924478.jpeg,1,0.9856079816818236,902,383,1348,829,446,446,princess cadance|princess celestia|princess flurry heart|princess luna|rarity|shining armor|spike|starlight glimmer|sweetie belle|twilight sparkle,silfoe
1926368.jpeg,https://derpicdn.net/img/view/2019/1/4/1926368.jpeg,0,0.9810543060302734,0,0,598,556,598,556,princess celestia|twilight sparkle,noupu
1927193.jpeg,https://derpicdn.net/img/view/2019/1/5/1927193.jpeg,0,0.9987207055091858,6,66,792,852,786,786,applejack|fluttershy|pinkie pie|rainbow dash|rarity|twilight sparkle,yanamosuda
1927193.jpeg,https://derpicdn.net/img/view/2019/1/5/1927193.jpeg,1,0.9961076378822328,797,0,1563,699,766,699,applejack|fluttershy|pinkie pie|rainbow dash|rarity|twilight sparkle,yanamosuda
1927193.jpeg,https://derpicdn.net/img/view/2019/1/5/1927193.jpeg,2,0.9809768795967102,1636,0,2480,857,844,857,applejack|fluttershy|pinkie pie|rainbow dash|rarity|twilight sparkle,yanamosuda
1927609.jpeg,https://derpicdn.net/img/view/2019/1/5/1927609.jpeg,0,0.995183527469635,453,0,715,254,262,254,trixie|twilight sparkle,dany-the-hell-fox
1928847.jpeg,https://derpicdn.net/img/view/2019/1/7/1928847.jpeg,0,0.9962807893753052,230,0,598,318,368,318,applejack|fluttershy|mane six|pinkie pie|rainbow dash|rarity|spike|twilight sparkle,tsukuda
1928847.jpeg,https://derpicdn.net/img/view/2019/1/7/1928847.jpeg,1,0.9714252352714542,96,170,342,416,246,246,applejack|fluttershy|mane six|pinkie pie|rainbow dash|rarity|spike|twilight sparkle,tsukuda
1929097.jpeg,https://derpicdn.net/img/view/2019/1/7/1929097.jpeg,1,0.9863476157188416,986,56,1478,548,492,492,princess cadance|princess celestia|princess flurry heart|princess luna|twilight sparkle,seamaggie
1930312.jpeg,https://derpicdn.net/img/view/2019/1/9/1930312.jpeg,0,0.9978500604629515,510,34,674,198,164,164,applejack|fluttershy|mane six|pinkie pie|rainbow dash|rarity|twilight sparkle,pia-sama
1930312.jpeg,https://derpicdn.net/img/view/2019/1/9/1930312.jpeg,1,0.9945891499519348,696,58,876,238,180,180,applejack|fluttershy|mane six|pinkie pie|rainbow dash|rarity|twilight sparkle,pia-sama
1931059.jpeg,https://derpicdn.net/img/view/2019/1/9/1931059.jpeg,0,0.99861478805542,122,1727,916,2521,794,794,applejack|fluttershy|mane six|pinkie pie|rainbow dash|rarity|twilight sparkle,vantiss
1931059.jpeg,https://derpicdn.net/img/view/2019/1/9/1931059.jpeg,1,0.9978906512260436,39,0,985,829,946,829,applejack|fluttershy|mane six|pinkie pie|rainbow dash|rarity|twilight sparkle,vantiss
1931059.jpeg,https://derpicdn.net/img/view/2019/1/9/1931059.jpeg,2,0.9958900809288024,1240,0,2032,695,792,695,applejack|fluttershy|mane six|pinkie pie|rainbow dash|rarity|twilight sparkle,vantiss
1931059.jpeg,https://derpicdn.net/img/view/2019/1/9/1931059.jpeg,3,0.9427474737167358,1310,1997,1976,2663,666,666,applejack|fluttershy|mane six|pinkie pie|rainbow dash|rarity|twilight sparkle,vantiss
1933451.jpeg,https://derpicdn.net/img/view/2019/1/12/1933451.jpeg,0,0.9782581925392152,0,139,399,557,399,418,applejack|princess celestia|twilight sparkle,kaemantis
1934624.jpeg,https://derpicdn.net/img/view/2019/1/13/1934624.jpeg,0,0.9119057655334472,285,28,623,366,338,338,spike|twilight sparkle,riukime
1934635.jpeg,https://derpicdn.net/img/view/2019/1/13/1934635.jpeg,0,0.9920735955238342,163,2,733,572,570,570,sunset shimmer|twilight sparkle,yakieringi014
1935776.jpeg,https://derpicdn.net/img/view/2019/1/15/1935776.jpeg,0,0.9837214946746826,3807,1208,4927,2328,1120,1120,spike|twilight sparkle,garam
1935776.jpeg,https://derpicdn.net/img/view/2019/1/15/1935776.jpeg,1,0.9575951099395752,1343,4535,1943,5135,600,600,spike|twilight sparkle,garam
1937959.jpeg,https://derpicdn.net/img/view/2019/1/17/1937959.jpeg,0,0.9934253692626952,740,254,1000,526,260,272,applejack|fluttershy|mane six|pinkie pie|princess celestia|princess luna|rainbow dash|rarity|twilight sparkle,tonyfleecs
1937959.jpeg,https://derpicdn.net/img/view/2019/1/17/1937959.jpeg,1,0.9860365390777588,339,1026,631,1318,292,292,applejack|fluttershy|mane six|pinkie pie|princess celestia|princess luna|rainbow dash|rarity|twilight sparkle,tonyfleecs
1937959.jpeg,https://derpicdn.net/img/view/2019/1/17/1937959.jpeg,2,0.9821733236312866,331,306,629,604,298,298,applejack|fluttershy|mane six|pinkie pie|princess celestia|princess luna|rainbow dash|rarity|twilight sparkle,tonyfleecs
1937959.jpeg,https://derpicdn.net/img/view/2019/1/17/1937959.jpeg,3,0.9801874756813048,179,508,529,858,350,350,applejack|fluttershy|mane six|pinkie pie|princess celestia|princess luna|rainbow dash|rarity|twilight sparkle,tonyfleecs
1937959.jpeg,https://derpicdn.net/img/view/2019/1/17/1937959.jpeg,4,0.9693300127983092,0,1039,272,1337,272,298,applejack|fluttershy|mane six|pinkie pie|princess celestia|princess luna|rainbow dash|rarity|twilight sparkle,tonyfleecs
1938755.jpeg,https://derpicdn.net/img/view/2019/1/18/1938755.jpeg,0,0.9434561133384703,640,0,878,236,238,236,applejack|fluttershy|mane six|pinkie pie|rainbow dash|rarity|starlight glimmer|twilight sparkle,xjenn9
1941832.jpeg,https://derpicdn.net/img/view/2019/1/22/1941832.jpeg,0,0.9978597164154052,323,1488,729,1894,406,406,applejack|fluttershy|mane six|pinkie pie|princess celestia|rainbow dash|rarity|twilight sparkle,pencils
1941832.jpeg,https://derpicdn.net/img/view/2019/1/22/1941832.jpeg,1,0.9908782839775084,401,511,1079,1189,678,678,applejack|fluttershy|mane six|pinkie pie|princess celestia|rainbow dash|rarity|twilight sparkle,pencils
1941832.jpeg,https://derpicdn.net/img/view/2019/1/22/1941832.jpeg,2,0.9488881826400756,989,873,1400,1331,411,458,applejack|fluttershy|mane six|pinkie pie|princess celestia|rainbow dash|rarity|twilight sparkle,pencils
1945189.jpeg,https://derpicdn.net/img/view/2019/1/26/1945189.jpeg,0,0.996451497077942,246,752,490,996,244,244,applejack|fluttershy|mane six|pinkie pie|princess celestia|princess luna|rainbow dash|rarity|twilight sparkle,tonyfleecs
1945189.jpeg,https://derpicdn.net/img/view/2019/1/26/1945189.jpeg,1,0.9783340692520142,272,253,448,429,176,176,applejack|fluttershy|mane six|pinkie pie|princess celestia|princess luna|rainbow dash|rarity|twilight sparkle,tonyfleecs
1945189.jpeg,https://derpicdn.net/img/view/2019/1/26/1945189.jpeg,2,0.9772564172744752,542,174,755,408,213,234,applejack|fluttershy|mane six|pinkie pie|princess celestia|princess luna|rainbow dash|rarity|twilight sparkle,tonyfleecs
1949270.jpeg,https://derpicdn.net/img/view/2019/1/31/1949270.jpeg,0,0.9962555170059204,679,0,935,214,256,214,applejack|fluttershy|mane six|pinkie pie|rainbow dash|rarity|twilight sparkle,zaphy1415926
1949270.jpeg,https://derpicdn.net/img/view/2019/1/31/1949270.jpeg,1,0.9915621280670166,24,256,258,490,234,234,applejack|fluttershy|mane six|pinkie pie|rainbow dash|rarity|twilight sparkle,zaphy1415926
1950105.jpeg,https://derpicdn.net/img/view/2019/2/1/1950105.jpeg,0,0.9928922057151794,3455,62,7911,4518,4456,4456,rainbow dash|twilight sparkle,darksly|mixermike622
1953248.jpeg,https://derpicdn.net/img/view/2019/2/4/1953248.jpeg,0,0.9408196806907654,653,79,949,375,296,296,applejack|fluttershy|mane six|pinkie pie|rainbow dash|rarity|twilight sparkle,xxiee
1953248.jpeg,https://derpicdn.net/img/view/2019/2/4/1953248.jpeg,1,0.916334867477417,954,86,1288,420,334,334,applejack|fluttershy|mane six|pinkie pie|rainbow dash|rarity|twilight sparkle,xxiee
1953296.jpeg,https://derpicdn.net/img/view/2019/2/4/1953296.jpeg,1,0.9282202124595642,3,6,333,336,330,330,rainbow dash|rarity|twilight sparkle,imoe_shichee
1953298.jpeg,https://derpicdn.net/img/view/2019/2/4/1953298.jpeg,0,0.9983556866645812,2838,1646,3268,2076,430,430,applejack|fluttershy|mane six|pinkie pie|princess celestia|princess flurry heart|princess luna|rainbow dash|rarity|starlight glimmer|trixie|twilight sparkle,imoe_shichee
1953298.jpeg,https://derpicdn.net/img/view/2019/2/4/1953298.jpeg,2,0.9937174320220948,2099,1492,2659,2052,560,560,applejack|fluttershy|mane six|pinkie pie|princess celestia|princess flurry heart|princess luna|rainbow dash|rarity|starlight glimmer|trixie|twilight sparkle,imoe_shichee
1953298.jpeg,https://derpicdn.net/img/view/2019/2/4/1953298.jpeg,5,0.9862598776817322,15,861,621,1467,606,606,applejack|fluttershy|mane six|pinkie pie|princess celestia|princess flurry heart|princess luna|rainbow dash|rarity|starlight glimmer|trixie|twilight sparkle,imoe_shichee
1953298.jpeg,https://derpicdn.net/img/view/2019/2/4/1953298.jpeg,6,0.9857472777366638,2971,757,3457,1243,486,486,applejack|fluttershy|mane six|pinkie pie|princess celestia|princess flurry heart|princess luna|rainbow dash|rarity|starlight glimmer|trixie|twilight sparkle,imoe_shichee
1953298.jpeg,https://derpicdn.net/img/view/2019/2/4/1953298.jpeg,7,0.9731224775314332,2272,13,2832,573,560,560,applejack|fluttershy|mane six|pinkie pie|princess celestia|princess flurry heart|princess luna|rainbow dash|rarity|starlight glimmer|trixie|twilight sparkle,imoe_shichee
1953299.jpeg,https://derpicdn.net/img/view/2019/2/4/1953299.jpeg,0,0.9997090697288512,830,72,1254,496,424,424,applejack|fluttershy|mane six|pinkie pie|rainbow dash|rarity|starlight glimmer|twilight sparkle,imoe_shichee
1953299.jpeg,https://derpicdn.net/img/view/2019/2/4/1953299.jpeg,2,0.9980093836784364,541,611,973,1043,432,432,applejack|fluttershy|mane six|pinkie pie|rainbow dash|rarity|starlight glimmer|twilight sparkle,imoe_shichee
1955436.jpeg,https://derpicdn.net/img/view/2019/2/7/1955436.jpeg,0,0.9362008571624756,229,403,433,607,204,204,applejack|fluttershy|mane six|pinkie pie|rainbow dash|rarity|spike|twilight sparkle,tonyfleecs
1955436.jpeg,https://derpicdn.net/img/view/2019/2/7/1955436.jpeg,1,0.9211392998695374,124,173,322,371,198,198,applejack|fluttershy|mane six|pinkie pie|rainbow dash|rarity|spike|twilight sparkle,tonyfleecs
1957381.jpeg,https://derpicdn.net/img/view/2019/2/9/1957381.jpeg,0,0.973137617111206,1470,162,2186,878,716,716,rarity|twilight sparkle,earthsong9405
1957497.jpeg,https://derpicdn.net/img/view/2019/2/9/1957497.jpeg,1,0.995189130306244,634,127,958,451,324,324,applejack|fluttershy|mane six|pinkie pie|rainbow dash|rarity|twilight sparkle,巫na
1959858.jpeg,https://derpicdn.net/img/view/2019/2/12/1959858.jpeg,0,0.9925952553749084,3477,317,4959,1799,1482,1482,princess cadance|princess celestia|princess luna|twilight sparkle,darksly
1960896.jpeg,https://derpicdn.net/img/view/2019/2/13/1960896.jpeg,0,0.9940901398658752,549,9,719,179,170,170,sunset shimmer|twilight sparkle,keeerooooo1
1960896.jpeg,https://derpicdn.net/img/view/2019/2/13/1960896.jpeg,1,0.9449783563613892,578,331,734,487,156,156,sunset shimmer|twilight sparkle,keeerooooo1
1962344.jpeg,https://derpicdn.net/img/view/2019/2/15/1962344.jpeg,0,0.999578893184662,1031,6,1869,844,838,838,discord|queen chrysalis|starlight glimmer|twilight sparkle,rougeredred
1962589.jpeg,https://derpicdn.net/img/view/2019/2/15/1962589.jpeg,0,0.9018269181251526,921,23,1363,465,442,442,applejack|fluttershy|mane six|pinkie pie|rainbow dash|rarity|starlight glimmer|twilight sparkle,strebiskunk
1963053.jpeg,https://derpicdn.net/img/view/2019/2/15/1963053.jpeg,0,0.98931884765625,368,0,810,423,442,423,princess cadance|twilight sparkle,styroponyworks
1963997.jpeg,https://derpicdn.net/img/view/2019/2/17/1963997.jpeg,0,0.9841413497924804,764,706,1054,996,290,290,applejack|fluttershy|mane six|pinkie pie|rainbow dash|rarity|sunset shimmer|twilight sparkle,nobody|ritalux
1964064.jpeg,https://derpicdn.net/img/view/2019/2/17/1964064.jpeg,0,0.956905722618103,741,1295,1079,1697,338,402,applejack|fluttershy|mane six|pinkie pie|rainbow dash|rarity|twilight sparkle,
1964460.jpeg,https://derpicdn.net/img/view/2019/2/17/1964460.jpeg,0,0.9125320315361024,778,1608,4200,4806,3422,3198,rainbow dash|twilight sparkle,liaaqila
1965387.jpeg,https://derpicdn.net/img/view/2019/2/18/1965387.jpeg,0,0.9981844425201416,30,140,296,406,266,266,apple bloom|applejack|fluttershy|mane six|pinkie pie|rainbow dash|rarity|twilight sparkle,kkmrarar
1965387.jpeg,https://derpicdn.net/img/view/2019/2/18/1965387.jpeg,1,0.9918059706687928,278,585,548,855,270,270,apple bloom|applejack|fluttershy|mane six|pinkie pie|rainbow dash|rarity|twilight sparkle,kkmrarar
1965804.jpeg,https://derpicdn.net/img/view/2019/2/19/1965804.jpeg,1,0.9567115902900696,710,412,892,594,182,182,applejack|fluttershy|mane six|pinkie pie|rainbow dash|rarity|twilight sparkle,kanashiipanda|shunya yamashita
196583.jpeg,https://derpicdn.net/img/view/2012/12/29/196583.jpeg,0,0.9756953120231628,325,123,583,381,258,258,pinkie pie|rainbow dash|twilight sparkle,bittenhard
196583.jpeg,https://derpicdn.net/img/view/2012/12/29/196583.jpeg,1,0.936409056186676,94,105,290,301,196,196,pinkie pie|rainbow dash|twilight sparkle,bittenhard
196583.jpeg,https://derpicdn.net/img/view/2012/12/29/196583.jpeg,2,0.9312655925750732,776,33,877,155,101,122,pinkie pie|rainbow dash|twilight sparkle,bittenhard
1966125.jpeg,https://derpicdn.net/img/view/2019/2/19/1966125.jpeg,0,0.9906017780303956,0,0,1072,900,1072,900,pinkie pie|starlight glimmer|twilight sparkle,
1966125.jpeg,https://derpicdn.net/img/view/2019/2/19/1966125.jpeg,1,0.9689244627952576,1132,274,1542,684,410,410,pinkie pie|starlight glimmer|twilight sparkle,
1966731.jpeg,https://derpicdn.net/img/view/2019/2/20/1966731.jpeg,0,0.9964471459388732,388,0,972,487,584,487,applejack|fluttershy|mane six|pinkie pie|queen chrysalis|rainbow dash|rarity|twilight sparkle,shoutingisfun
1966731.jpeg,https://derpicdn.net/img/view/2019/2/20/1966731.jpeg,1,0.9925564527511596,888,1,1300,413,412,412,applejack|fluttershy|mane six|pinkie pie|queen chrysalis|rainbow dash|rarity|twilight sparkle,shoutingisfun
1967129.jpeg,https://derpicdn.net/img/view/2019/2/20/1967129.jpeg,0,0.9768258929252625,31,0,417,267,386,267,rarity|twilight sparkle,nicxchy|lennonblack
1967476.jpeg,https://derpicdn.net/img/view/2019/2/20/1967476.jpeg,0,0.9643095135688782,221,40,927,746,706,706,spike|twilight sparkle,luciferamon
1967680.jpeg,https://derpicdn.net/img/view/2019/2/21/1967680.jpeg,1,0.9995749592781068,99,25,389,315,290,290,applejack|fluttershy|mane six|pinkie pie|rainbow dash|rarity|twilight sparkle,
1967680.jpeg,https://derpicdn.net/img/view/2019/2/21/1967680.jpeg,2,0.9976975321769714,910,10,1266,366,356,356,applejack|fluttershy|mane six|pinkie pie|rainbow dash|rarity|twilight sparkle,
1967680.jpeg,https://derpicdn.net/img/view/2019/2/21/1967680.jpeg,3,0.9973203539848328,548,730,810,992,262,262,applejack|fluttershy|mane six|pinkie pie|rainbow dash|rarity|twilight sparkle,
1967680.jpeg,https://derpicdn.net/img/view/2019/2/21/1967680.jpeg,4,0.9902697801589966,520,32,806,318,286,286,applejack|fluttershy|mane six|pinkie pie|rainbow dash|rarity|twilight sparkle,
1968789.jpeg,https://derpicdn.net/img/view/2019/2/22/1968789.jpeg,0,0.9829258322715759,50,499,222,671,172,172,applejack|fluttershy|mane six|pinkie pie|rainbow dash|rarity|spike|twilight sparkle,tonyfleecs
1968789.jpeg,https://derpicdn.net/img/view/2019/2/22/1968789.jpeg,1,0.9736475944519044,324,456,502,634,178,178,applejack|fluttershy|mane six|pinkie pie|rainbow dash|rarity|spike|twilight sparkle,tonyfleecs
1969374.jpeg,https://derpicdn.net/img/view/2019/2/23/1969374.jpeg,3,0.9240788221359252,854,1449,1018,1613,164,164,apple bloom|applejack|big macintosh|cutie mark crusaders|discord|fluttershy|granny smith|mane six|pinkie pie|princess cadance|princess celestia|princess flurry heart|princess luna|rainbow dash|rarity|scootaloo|shining armor|spike|spitfire|starlight glimmer|sunset shimmer|sweetie belle|trixie|twilight sparkle,conthauberger
1969374.jpeg,https://derpicdn.net/img/view/2019/2/23/1969374.jpeg,4,0.920517921447754,205,1594,361,1750,156,156,apple bloom|applejack|big macintosh|cutie mark crusaders|discord|fluttershy|granny smith|mane six|pinkie pie|princess cadance|princess celestia|princess flurry heart|princess luna|rainbow dash|rarity|scootaloo|shining armor|spike|spitfire|starlight glimmer|sunset shimmer|sweetie belle|trixie|twilight sparkle,conthauberger
1969714.jpeg,https://derpicdn.net/img/view/2019/2/23/1969714.jpeg,0,0.9574856162071228,139,0,485,316,346,316,spike|twilight sparkle,phoenixperegrine
1969720.jpeg,https://derpicdn.net/img/view/2019/2/23/1969720.jpeg,0,0.9934977889060974,45,37,333,325,288,288,applejack|fluttershy|rainbow dash|rarity|twilight sparkle,marybellamy
1969720.jpeg,https://derpicdn.net/img/view/2019/2/23/1969720.jpeg,1,0.9561253786087036,343,8,535,200,192,192,applejack|fluttershy|rainbow dash|rarity|twilight sparkle,marybellamy
1969720.jpeg,https://derpicdn.net/img/view/2019/2/23/1969720.jpeg,2,0.941470205783844,608,55,884,331,276,276,applejack|fluttershy|rainbow dash|rarity|twilight sparkle,marybellamy
1971442.jpeg,https://derpicdn.net/img/view/2019/2/25/1971442.jpeg,0,0.9701532125473022,86,970,280,1164,194,194,queen chrysalis|rainbow dash|twilight sparkle,jazzyz401
1972459.jpeg,https://derpicdn.net/img/view/2019/2/26/1972459.jpeg,0,0.9963713884353638,1107,2,1443,338,336,336,rainbow dash|twilight sparkle,espeonumbreonlover
1972459.jpeg,https://derpicdn.net/img/view/2019/2/26/1972459.jpeg,1,0.9348171949386596,80,0,810,672,730,672,rainbow dash|twilight sparkle,espeonumbreonlover
1972751.jpeg,https://derpicdn.net/img/view/2019/2/27/1972751.jpeg,1,0.9849135279655457,99,1532,1197,2630,1098,1098,fluttershy|pinkie pie|rainbow dash|twilight sparkle,animesoul
1972751.jpeg,https://derpicdn.net/img/view/2019/2/27/1972751.jpeg,2,0.9821370840072632,565,582,1589,1606,1024,1024,fluttershy|pinkie pie|rainbow dash|twilight sparkle,animesoul
1973195.jpeg,https://derpicdn.net/img/view/2019/2/27/1973195.jpeg,0,0.9993053674697876,775,149,1050,429,275,280,applejack|fluttershy|mane six|pinkie pie|rainbow dash|rarity|starlight glimmer|sunset shimmer|twilight sparkle,sophieascruggs
1973195.jpeg,https://derpicdn.net/img/view/2019/2/27/1973195.jpeg,1,0.9905809164047241,0,3,294,305,294,302,applejack|fluttershy|mane six|pinkie pie|rainbow dash|rarity|starlight glimmer|sunset shimmer|twilight sparkle,sophieascruggs
1973195.jpeg,https://derpicdn.net/img/view/2019/2/27/1973195.jpeg,2,0.9878000617027284,818,556,1050,802,232,246,applejack|fluttershy|mane six|pinkie pie|rainbow dash|rarity|starlight glimmer|sunset shimmer|twilight sparkle,sophieascruggs
1973195.jpeg,https://derpicdn.net/img/view/2019/2/27/1973195.jpeg,3,0.9868420958518982,516,368,804,656,288,288,applejack|fluttershy|mane six|pinkie pie|rainbow dash|rarity|starlight glimmer|sunset shimmer|twilight sparkle,sophieascruggs
1973195.jpeg,https://derpicdn.net/img/view/2019/2/27/1973195.jpeg,4,0.9557018876075744,0,379,242,633,242,254,applejack|fluttershy|mane six|pinkie pie|rainbow dash|rarity|starlight glimmer|sunset shimmer|twilight sparkle,sophieascruggs
1973425.jpeg,https://derpicdn.net/img/view/2019/2/28/1973425.jpeg,0,0.9858659505844116,44,619,630,1205,586,586,applejack|twilight sparkle,saphi-boo
1975397.jpeg,https://derpicdn.net/img/view/2019/3/2/1975397.jpeg,0,0.9923797249794006,543,0,1280,672,737,672,starlight glimmer|twilight sparkle,princeoftheivess
1978724.jpeg,https://derpicdn.net/img/view/2019/3/6/1978724.jpeg,1,0.9892693758010864,1022,2192,1744,2914,722,722,applejack|fluttershy|mane six|pinkie pie|rainbow dash|rarity|twilight sparkle,liaaqila
1979147.jpeg,https://derpicdn.net/img/view/2019/3/7/1979147.jpeg,1,0.9814751148223876,201,179,515,493,314,314,applejack|fluttershy|mane six|pinkie pie|rainbow dash|rarity|twilight sparkle,kittykatkay
1979147.jpeg,https://derpicdn.net/img/view/2019/3/7/1979147.jpeg,3,0.918042242527008,360,317,678,635,318,318,applejack|fluttershy|mane six|pinkie pie|rainbow dash|rarity|twilight sparkle,kittykatkay
1982880.jpeg,https://derpicdn.net/img/view/2019/3/11/1982880.jpeg,0,0.997896373271942,43,119,1709,1785,1666,1666,spike|twilight sparkle,tjpones
1982880.jpeg,https://derpicdn.net/img/view/2019/3/11/1982880.jpeg,1,0.9163302779197692,1686,1064,3000,2440,1314,1376,spike|twilight sparkle,tjpones
1983910.jpeg,https://derpicdn.net/img/view/2019/3/12/1983910.jpeg,0,0.9981493949890136,869,80,1497,708,628,628,princess celestia|twilight sparkle,rd_3024
1984047.jpeg,https://derpicdn.net/img/view/2019/3/13/1984047.jpeg,0,0.979724645614624,0,88,1718,1756,1718,1668,princess luna|twilight sparkle,magnaluna
1985597.jpeg,https://derpicdn.net/img/view/2019/3/14/1985597.jpeg,0,0.9618866443634032,179,528,385,734,206,206,applejack|fluttershy|pinkie pie|rainbow dash|twilight sparkle,
1985607.jpeg,https://derpicdn.net/img/view/2019/3/14/1985607.jpeg,0,0.9052806496620178,1192,485,1508,801,316,316,applejack|fluttershy|pinkie pie|rainbow dash|rarity|twilight sparkle,
198584.jpeg,https://derpicdn.net/img/view/2012/12/31/198584.jpeg,0,0.963981866836548,0,602,232,850,232,248,applejack|big macintosh|fluttershy|pinkie pie|rainbow dash|rarity|twilight sparkle,magistra
198584.jpeg,https://derpicdn.net/img/view/2012/12/31/198584.jpeg,2,0.9078651070594788,261,265,467,471,206,206,applejack|big macintosh|fluttershy|pinkie pie|rainbow dash|rarity|twilight sparkle,magistra
198682.jpeg,https://derpicdn.net/img/view/2012/12/31/198682.jpeg,0,0.9989876747131348,362,0,584,198,222,198,applejack|fluttershy|mane six|pinkie pie|rainbow dash|rarity|twilight sparkle,shepherd0821
198682.jpeg,https://derpicdn.net/img/view/2012/12/31/198682.jpeg,1,0.9988423585891724,65,417,303,655,238,238,applejack|fluttershy|mane six|pinkie pie|rainbow dash|rarity|twilight sparkle,shepherd0821
198682.jpeg,https://derpicdn.net/img/view/2012/12/31/198682.jpeg,2,0.9964691996574402,727,409,911,593,184,184,applejack|fluttershy|mane six|pinkie pie|rainbow dash|rarity|twilight sparkle,shepherd0821
198682.jpeg,https://derpicdn.net/img/view/2012/12/31/198682.jpeg,3,0.9959483742713928,46,0,250,191,204,191,applejack|fluttershy|mane six|pinkie pie|rainbow dash|rarity|twilight sparkle,shepherd0821
198682.jpeg,https://derpicdn.net/img/view/2012/12/31/198682.jpeg,5,0.9541537165641784,378,407,600,629,222,222,applejack|fluttershy|mane six|pinkie pie|rainbow dash|rarity|twilight sparkle,shepherd0821
1987511.jpeg,https://derpicdn.net/img/view/2019/3/16/1987511.jpeg,0,0.9983826875686646,1169,0,1867,572,698,572,applejack|fluttershy|twilight sparkle,royal
1987511.jpeg,https://derpicdn.net/img/view/2019/3/16/1987511.jpeg,1,0.9958791136741638,623,0,1341,557,718,557,applejack|fluttershy|twilight sparkle,royal
1987511.jpeg,https://derpicdn.net/img/view/2019/3/16/1987511.jpeg,2,0.9956809878349304,164,0,818,516,654,516,applejack|fluttershy|twilight sparkle,royal
1987526.jpeg,https://derpicdn.net/img/view/2019/3/16/1987526.jpeg,0,0.9897173047065736,2445,332,3635,1522,1190,1190,applejack|fluttershy|mane six|pinkie pie|rainbow dash|rarity|twilight sparkle,royal
1987526.jpeg,https://derpicdn.net/img/view/2019/3/16/1987526.jpeg,1,0.9882190227508544,115,1912,959,2756,844,844,applejack|fluttershy|mane six|pinkie pie|rainbow dash|rarity|twilight sparkle,royal
1987526.jpeg,https://derpicdn.net/img/view/2019/3/16/1987526.jpeg,3,0.9694214463233948,1276,0,2214,903,938,903,applejack|fluttershy|mane six|pinkie pie|rainbow dash|rarity|twilight sparkle,royal
1987613.jpeg,https://derpicdn.net/img/view/2019/3/16/1987613.jpeg,0,0.9854777455329896,129,22,377,270,248,248,rarity|twilight sparkle,pinkkoffin
1988415.jpeg,https://derpicdn.net/img/view/2019/3/17/1988415.jpeg,0,0.9471943974494934,750,545,940,735,190,190,applejack|fluttershy|mane six|pinkie pie|princess cadance|rainbow dash|rarity|scootaloo|shining armor|spike|starlight glimmer|sweetie belle|trixie|twilight sparkle,
1988415.jpeg,https://derpicdn.net/img/view/2019/3/17/1988415.jpeg,1,0.9177159070968628,0,537,180,733,180,196,applejack|fluttershy|mane six|pinkie pie|princess cadance|rainbow dash|rarity|scootaloo|shining armor|spike|starlight glimmer|sweetie belle|trixie|twilight sparkle,
1989575.jpeg,https://derpicdn.net/img/view/2019/3/18/1989575.jpeg,0,0.9992135763168336,0,2160,717,2912,717,752,applejack|fluttershy|mane six|pinkie pie|rainbow dash|rarity|twilight sparkle,mysteryart716
1989575.jpeg,https://derpicdn.net/img/view/2019/3/18/1989575.jpeg,1,0.9988017082214355,1156,0,1794,627,638,627,applejack|fluttershy|mane six|pinkie pie|rainbow dash|rarity|twilight sparkle,mysteryart716
1989575.jpeg,https://derpicdn.net/img/view/2019/3/18/1989575.jpeg,2,0.9972354173660278,1030,1744,1846,2560,816,816,applejack|fluttershy|mane six|pinkie pie|rainbow dash|rarity|twilight sparkle,mysteryart716
1989575.jpeg,https://derpicdn.net/img/view/2019/3/18/1989575.jpeg,5,0.9429824352264404,359,1178,1313,2132,954,954,applejack|fluttershy|mane six|pinkie pie|rainbow dash|rarity|twilight sparkle,mysteryart716
1990548.jpeg,https://derpicdn.net/img/view/2019/3/20/1990548.jpeg,0,0.9932084679603576,566,344,760,538,194,194,big macintosh|princess celestia|princess luna|twilight sparkle,andypriceart
1990758.jpeg,https://derpicdn.net/img/view/2019/3/20/1990758.jpeg,0,0.9798017144203186,206,159,622,575,416,416,sunset shimmer|twilight sparkle,colorfulcolor233
1990758.jpeg,https://derpicdn.net/img/view/2019/3/20/1990758.jpeg,1,0.9656748175621032,615,124,1039,548,424,424,sunset shimmer|twilight sparkle,colorfulcolor233
199125.jpeg,https://derpicdn.net/img/view/2013/1/1/199125.jpeg,0,0.9894154667854308,348,42,636,330,288,288,applejack|big macintosh|fluttershy|pinkie pie|rainbow dash|rarity|twilight sparkle,add7899
1992602.jpeg,https://derpicdn.net/img/view/2019/3/23/1992602.jpeg,0,0.9908130764961244,253,418,451,616,198,198,applejack|fluttershy|mane six|pinkie pie|princess celestia|princess luna|rainbow dash|rarity|spike|twilight sparkle,colorfulcolor233
1994823.jpeg,https://derpicdn.net/img/view/2019/3/25/1994823.jpeg,0,0.9991526603698728,1847,0,2519,647,672,647,applejack|pinkie pie|rarity|spike|twilight sparkle,evilbob0|elenanava19
1994823.jpeg,https://derpicdn.net/img/view/2019/3/25/1994823.jpeg,1,0.9930538535118104,197,576,1315,1694,1118,1118,applejack|pinkie pie|rarity|spike|twilight sparkle,evilbob0|elenanava19
1994832.jpeg,https://derpicdn.net/img/view/2019/3/25/1994832.jpeg,1,0.9929065704345704,136,975,406,1245,270,270,applejack|pinkie pie|rarity|spike|twilight sparkle,evilbob0|elenanava19
1994832.jpeg,https://derpicdn.net/img/view/2019/3/25/1994832.jpeg,3,0.9890256524086,778,982,1034,1238,256,256,applejack|pinkie pie|rarity|spike|twilight sparkle,evilbob0|elenanava19
1994832.jpeg,https://derpicdn.net/img/view/2019/3/25/1994832.jpeg,4,0.9421862363815308,681,369,925,613,244,244,applejack|pinkie pie|rarity|spike|twilight sparkle,evilbob0|elenanava19
1995179.jpeg,https://derpicdn.net/img/view/2019/3/26/1995179.jpeg,0,0.9809663891792296,1452,652,1868,1068,416,416,applejack|fluttershy|mane six|pinkie pie|rainbow dash|rarity|spike|twilight sparkle,joy-ang
1995179.jpeg,https://derpicdn.net/img/view/2019/3/26/1995179.jpeg,2,0.910465657711029,1070,522,1628,1080,558,558,applejack|fluttershy|mane six|pinkie pie|rainbow dash|rarity|spike|twilight sparkle,joy-ang
1995410.jpeg,https://derpicdn.net/img/view/2019/3/26/1995410.jpeg,0,0.93729966878891,206,727,526,1047,320,320,apple bloom|applejack|big macintosh|cutie mark crusaders|fluttershy|granny smith|pinkie pie|princess celestia|princess luna|rainbow dash|scootaloo|spitfire|sweetie belle|twilight sparkle,tony cliff
1997576.jpeg,https://derpicdn.net/img/view/2019/3/29/1997576.jpeg,0,0.9973347783088684,41,809,295,1063,254,254,applejack|fluttershy|mane six|pinkie pie|rainbow dash|rarity|twilight sparkle,erufi
1997576.jpeg,https://derpicdn.net/img/view/2019/3/29/1997576.jpeg,4,0.9356385469436646,365,768,613,1016,248,248,applejack|fluttershy|mane six|pinkie pie|rainbow dash|rarity|twilight sparkle,erufi
1997864.jpeg,https://derpicdn.net/img/view/2019/3/29/1997864.jpeg,1,0.9795440435409546,262,465,542,745,280,280,applejack|fluttershy|mane six|pinkie pie|rainbow dash|rarity|twilight sparkle,holivi
1997864.jpeg,https://derpicdn.net/img/view/2019/3/29/1997864.jpeg,2,0.9281198382377625,257,842,753,1338,496,496,applejack|fluttershy|mane six|pinkie pie|rainbow dash|rarity|twilight sparkle,holivi
1998448.jpeg,https://derpicdn.net/img/view/2019/3/30/1998448.jpeg,0,0.983601987361908,73,13,477,417,404,404,rainbow dash|twilight sparkle,phoenixperegrine
1999012.jpeg,https://derpicdn.net/img/view/2019/3/31/1999012.jpeg,0,0.9988351464271544,632,121,864,353,232,232,applejack|fluttershy|mane six|pinkie pie|rainbow dash|rarity|twilight sparkle,honeyl17
1999012.jpeg,https://derpicdn.net/img/view/2019/3/31/1999012.jpeg,1,0.982511043548584,404,35,668,299,264,264,applejack|fluttershy|mane six|pinkie pie|rainbow dash|rarity|twilight sparkle,honeyl17
1999012.jpeg,https://derpicdn.net/img/view/2019/3/31/1999012.jpeg,2,0.9319185614585876,15,167,363,515,348,348,applejack|fluttershy|mane six|pinkie pie|rainbow dash|rarity|twilight sparkle,honeyl17
1999012.jpeg,https://derpicdn.net/img/view/2019/3/31/1999012.jpeg,3,0.9169179797172546,398,355,628,585,230,230,applejack|fluttershy|mane six|pinkie pie|rainbow dash|rarity|twilight sparkle,honeyl17
1999904.jpeg,https://derpicdn.net/img/view/2019/4/1/1999904.jpeg,0,0.9345851540565492,92,0,536,383,444,383,princess luna|twilight sparkle,xxcandycartoonxx|illuminatiums|bri-sta
2001251.jpeg,https://derpicdn.net/img/view/2019/4/2/2001251.jpeg,0,0.9685460329055786,300,574,1034,1308,734,734,applejack|fluttershy|mane six|pinkie pie|rainbow dash|rarity|sunset shimmer|twilight sparkle,jen-neigh
2001251.jpeg,https://derpicdn.net/img/view/2019/4/2/2001251.jpeg,1,0.9522063136100768,940,698,1502,1260,562,562,applejack|fluttershy|mane six|pinkie pie|rainbow dash|rarity|sunset shimmer|twilight sparkle,jen-neigh
2001458.jpeg,https://derpicdn.net/img/view/2019/4/3/2001458.jpeg,0,0.9892775416374208,1287,1847,3106,3991,1819,2144,sunset shimmer|twilight sparkle,
2001458.jpeg,https://derpicdn.net/img/view/2019/4/3/2001458.jpeg,1,0.9859793186187744,1540,0,3106,1539,1566,1539,sunset shimmer|twilight sparkle,
2003552.jpeg,https://derpicdn.net/img/view/2019/4/5/2003552.jpeg,0,0.987212300300598,1173,17,4319,3163,3146,3146,sunset shimmer|twilight sparkle,imafutureguitarhero
2004279.jpeg,https://derpicdn.net/img/view/2019/4/6/2004279.jpeg,0,0.958931803703308,187,0,821,608,634,608,starlight glimmer|trixie|twilight sparkle,moku222222
2006932.jpeg,https://derpicdn.net/img/view/2019/4/8/2006932.jpeg,0,0.998776376247406,46,443,420,817,374,374,applejack|rarity|spike|twilight sparkle,
2006932.jpeg,https://derpicdn.net/img/view/2019/4/8/2006932.jpeg,1,0.9901118874549866,446,187,1138,879,692,692,applejack|rarity|spike|twilight sparkle,
2008551.jpeg,https://derpicdn.net/img/view/2019/4/10/2008551.jpeg,0,0.9936586022377014,1624,406,2436,1218,812,812,spike|starlight glimmer|twilight sparkle,jowybean
2008553.jpeg,https://derpicdn.net/img/view/2019/4/10/2008553.jpeg,0,0.9943615794181824,1014,1230,1462,1678,448,448,discord|twilight sparkle,jowybean
2008776.jpeg,https://derpicdn.net/img/view/2019/4/11/2008776.jpeg,0,0.9306226968765259,646,0,1430,675,784,675,pinkie pie|rarity|twilight sparkle,incendiaryboobs
2008827.jpeg,https://derpicdn.net/img/view/2019/4/11/2008827.jpeg,0,0.9796307682991028,0,0,5100,4517,5100,4517,rainbow dash|sunset shimmer|twilight sparkle,brekrofmadness
2009203.jpeg,https://derpicdn.net/img/view/2019/4/11/2009203.jpeg,0,0.976308286190033,298,80,866,648,568,568,pinkie pie|spike|twilight sparkle,dearmary
2012037.jpeg,https://derpicdn.net/img/view/2019/4/14/2012037.jpeg,0,0.9776252508163452,0,548,813,1390,813,842,applejack|fluttershy|mane six|pinkie pie|rainbow dash|rarity|twilight sparkle,potetecyu_to
2012037.jpeg,https://derpicdn.net/img/view/2019/4/14/2012037.jpeg,1,0.960980236530304,1129,321,1885,1077,756,756,applejack|fluttershy|mane six|pinkie pie|rainbow dash|rarity|twilight sparkle,potetecyu_to
2012251.jpeg,https://derpicdn.net/img/view/2019/4/14/2012251.jpeg,0,0.9979256987571716,103,32,439,368,336,336,applejack|fluttershy|mane six|pinkie pie|rainbow dash|rarity|twilight sparkle,nota_mano
2012251.jpeg,https://derpicdn.net/img/view/2019/4/14/2012251.jpeg,2,0.9818108677864076,900,65,1310,475,410,410,applejack|fluttershy|mane six|pinkie pie|rainbow dash|rarity|twilight sparkle,nota_mano
2013413.jpeg,https://derpicdn.net/img/view/2019/4/15/2013413.jpeg,0,0.9991779923439026,551,43,1019,511,468,468,applejack|rarity|twilight sparkle,darkknighthoof
2014832.jpeg,https://derpicdn.net/img/view/2019/4/17/2014832.jpeg,1,0.945430338382721,742,0,1050,300,308,300,applejack|fluttershy|mane six|pinkie pie|rainbow dash|rarity|spike|twilight sparkle,sadtrooper
2015539.jpeg,https://derpicdn.net/img/view/2019/4/18/2015539.jpeg,0,0.9818121790885924,145,226,577,658,432,432,spike|starlight glimmer|twilight sparkle,yakieringi014
2015723.jpeg,https://derpicdn.net/img/view/2019/4/18/2015723.jpeg,1,0.9924798607826232,723,1063,1331,1671,608,608,applejack|fluttershy|mane six|pinkie pie|rainbow dash|rarity|twilight sparkle,canvymamamoo
2015723.jpeg,https://derpicdn.net/img/view/2019/4/18/2015723.jpeg,2,0.992459774017334,233,1069,751,1587,518,518,applejack|fluttershy|mane six|pinkie pie|rainbow dash|rarity|twilight sparkle,canvymamamoo
2021064.jpeg,https://derpicdn.net/img/view/2019/4/23/2021064.jpeg,0,0.9995928406715392,0,413,377,815,377,402,applejack|discord|fluttershy|mane six|pinkie pie|rainbow dash|rarity|twilight sparkle,andypriceart
2021064.jpeg,https://derpicdn.net/img/view/2019/4/23/2021064.jpeg,1,0.98915696144104,5,1097,441,1518,436,421,applejack|discord|fluttershy|mane six|pinkie pie|rainbow dash|rarity|twilight sparkle,andypriceart
2021064.jpeg,https://derpicdn.net/img/view/2019/4/23/2021064.jpeg,3,0.9131916761398317,632,1086,960,1414,328,328,applejack|discord|fluttershy|mane six|pinkie pie|rainbow dash|rarity|twilight sparkle,andypriceart
2021211.jpeg,https://derpicdn.net/img/view/2019/4/23/2021211.jpeg,1,0.926164209842682,1793,2138,3066,3426,1273,1288,fluttershy|pinkie pie|rainbow dash|rarity|twilight sparkle,animesoul
2021664.jpeg,https://derpicdn.net/img/view/2019/4/24/2021664.jpeg,0,0.988047182559967,203,226,613,636,410,410,princess celestia|princess luna|twilight sparkle,upperthemoon
2021933.jpeg,https://derpicdn.net/img/view/2019/4/24/2021933.jpeg,1,0.9560338854789734,218,143,858,783,640,640,princess celestia|twilight sparkle,puetsua
2022706.jpeg,https://derpicdn.net/img/view/2019/4/25/2022706.jpeg,0,0.949518084526062,1014,272,1394,652,380,380,princess cadance|shining armor|twilight sparkle,kirillk
2024283.jpeg,https://derpicdn.net/img/view/2019/4/27/2024283.jpeg,0,0.9987608194351196,171,0,635,441,464,441,applejack|fluttershy|mane six|pinkie pie|rainbow dash|rarity|twilight sparkle,canvymamamoo
2024283.jpeg,https://derpicdn.net/img/view/2019/4/27/2024283.jpeg,3,0.9561712145805359,55,1064,751,1760,696,696,applejack|fluttershy|mane six|pinkie pie|rainbow dash|rarity|twilight sparkle,canvymamamoo
2025819.jpeg,https://derpicdn.net/img/view/2019/4/28/2025819.jpeg,0,0.996069610118866,158,1085,526,1453,368,368,applejack|fluttershy|mane six|pinkie pie|princess celestia|princess luna|rainbow dash|rarity|spike|twilight sparkle,earthsong9405
2025819.jpeg,https://derpicdn.net/img/view/2019/4/28/2025819.jpeg,3,0.9860999584197998,602,557,1010,965,408,408,applejack|fluttershy|mane six|pinkie pie|princess celestia|princess luna|rainbow dash|rarity|spike|twilight sparkle,earthsong9405
2025819.jpeg,https://derpicdn.net/img/view/2019/4/28/2025819.jpeg,4,0.9631345868110656,596,91,976,471,380,380,applejack|fluttershy|mane six|pinkie pie|princess celestia|princess luna|rainbow dash|rarity|spike|twilight sparkle,earthsong9405
2025845.jpeg,https://derpicdn.net/img/view/2019/4/28/2025845.jpeg,0,0.9901285171508788,447,66,711,330,264,264,spike|twilight sparkle,renciel
2025845.jpeg,https://derpicdn.net/img/view/2019/4/28/2025845.jpeg,1,0.9540050625801086,621,2,1073,454,452,452,spike|twilight sparkle,renciel
2025923.jpeg,https://derpicdn.net/img/view/2019/4/28/2025923.jpeg,0,0.9944434165954592,324,0,670,270,346,270,applejack|rainbow dash|twilight sparkle,silfoe|doc rainbow
2025923.jpeg,https://derpicdn.net/img/view/2019/4/28/2025923.jpeg,1,0.9717738032341005,25,428,369,772,344,344,applejack|rainbow dash|twilight sparkle,silfoe|doc rainbow
2025923.jpeg,https://derpicdn.net/img/view/2019/4/28/2025923.jpeg,2,0.9677419066429138,1253,67,1673,487,420,420,applejack|rainbow dash|twilight sparkle,silfoe|doc rainbow
2029118.jpeg,https://derpicdn.net/img/view/2019/5/2/2029118.jpeg,0,0.980622947216034,1259,173,1801,715,542,542,apple bloom|applejack|big macintosh|fluttershy|mane six|pinkie pie|rainbow dash|rarity|scootaloo|sweetie belle|twilight sparkle,jeroen01
203030.jpeg,https://derpicdn.net/img/view/2013/1/5/203030.jpeg,0,0.9990562200546264,352,543,868,1059,516,516,apple bloom|big macintosh|pinkie pie|rainbow dash|rarity|scootaloo|spike|sweetie belle|twilight sparkle,harwick
2030328.jpeg,https://derpicdn.net/img/view/2019/5/4/2030328.jpeg,0,0.9964242577552797,969,0,2605,1247,1636,1247,princess cadance|princess flurry heart|shining armor|spike|twilight sparkle,angusdra
2032037.jpeg,https://derpicdn.net/img/view/2019/5/6/2032037.jpeg,1,0.990614891052246,166,345,378,557,212,212,applejack|fluttershy|mane six|pinkie pie|rainbow dash|rarity|spike|twilight sparkle,papyjr13
2032037.jpeg,https://derpicdn.net/img/view/2019/5/6/2032037.jpeg,2,0.9771706461906432,614,829,782,997,168,168,applejack|fluttershy|mane six|pinkie pie|rainbow dash|rarity|spike|twilight sparkle,papyjr13
2032037.jpeg,https://derpicdn.net/img/view/2019/5/6/2032037.jpeg,4,0.9424084424972534,418,550,666,798,248,248,applejack|fluttershy|mane six|pinkie pie|rainbow dash|rarity|spike|twilight sparkle,papyjr13
2032969.jpeg,https://derpicdn.net/img/view/2019/5/7/2032969.jpeg,0,0.976708710193634,127,56,443,372,316,316,rarity|twilight sparkle,radiantrealm
2032969.jpeg,https://derpicdn.net/img/view/2019/5/7/2032969.jpeg,1,0.97016042470932,331,52,675,396,344,344,rarity|twilight sparkle,radiantrealm
2033236.jpeg,https://derpicdn.net/img/view/2019/5/7/2033236.jpeg,0,0.9932823181152344,445,1323,1199,2077,754,754,spike|starlight glimmer|twilight sparkle,jowybean
2033236.jpeg,https://derpicdn.net/img/view/2019/5/7/2033236.jpeg,1,0.9364123940467834,968,700,1494,1226,526,526,spike|starlight glimmer|twilight sparkle,jowybean
2033313.jpeg,https://derpicdn.net/img/view/2019/5/7/2033313.jpeg,0,0.9984646439552308,21,249,683,911,662,662,starlight glimmer|sunset shimmer|twilight sparkle,ncmares
2036708.jpeg,https://derpicdn.net/img/view/2019/5/11/2036708.jpeg,1,0.9921744465827942,2345,1650,4355,3660,2010,2010,applejack|fluttershy|mane six|pinkie pie|rainbow dash|rarity|twilight sparkle,chub-wub
2036869.jpeg,https://derpicdn.net/img/view/2019/5/12/2036869.jpeg,1,0.9919378161430359,83,290,773,980,690,690,princess cadance|princess flurry heart|princess luna|twilight sparkle,silfoe
2037448.jpeg,https://derpicdn.net/img/view/2019/5/12/2037448.jpeg,0,0.9572114944458008,191,260,571,640,380,380,princess celestia|twilight sparkle,maytee
2037588.jpeg,https://derpicdn.net/img/view/2019/5/12/2037588.jpeg,0,0.9776685833930968,1001,1527,1255,1863,254,336,applejack|fluttershy|rainbow dash|rarity|sunset shimmer|twilight sparkle,
2037588.jpeg,https://derpicdn.net/img/view/2019/5/12/2037588.jpeg,1,0.9407240152359008,283,175,667,559,384,384,applejack|fluttershy|rainbow dash|rarity|sunset shimmer|twilight sparkle,
2039004.jpeg,https://derpicdn.net/img/view/2019/5/14/2039004.jpeg,2,0.99528306722641,55,2013,847,2805,792,792,princess luna|twilight sparkle,magnaluna
2039004.jpeg,https://derpicdn.net/img/view/2019/5/14/2039004.jpeg,3,0.9951689839363098,765,115,1359,709,594,594,princess luna|twilight sparkle,magnaluna
2040117.jpeg,https://derpicdn.net/img/view/2019/5/16/2040117.jpeg,0,0.987410008907318,179,0,451,272,272,272,applejack|fluttershy|mane six|pinkie pie|rainbow dash|rarity|spike|twilight sparkle,koviry
2040117.jpeg,https://derpicdn.net/img/view/2019/5/16/2040117.jpeg,1,0.9504389762878418,770,228,1042,500,272,272,applejack|fluttershy|mane six|pinkie pie|rainbow dash|rarity|spike|twilight sparkle,koviry
2040117.jpeg,https://derpicdn.net/img/view/2019/5/16/2040117.jpeg,2,0.9084255695343018,618,680,908,970,290,290,applejack|fluttershy|mane six|pinkie pie|rainbow dash|rarity|spike|twilight sparkle,koviry
2040119.jpeg,https://derpicdn.net/img/view/2019/5/16/2040119.jpeg,0,0.9936290383338928,367,1038,833,1504,466,466,rarity|twilight sparkle,koviry
2040284.jpeg,https://derpicdn.net/img/view/2019/5/16/2040284.jpeg,0,0.94082373380661,697,105,1195,603,498,498,fluttershy|spike|twilight sparkle,stormygeddon
2040722.jpeg,https://derpicdn.net/img/view/2019/5/16/2040722.jpeg,0,0.9959700703620912,1365,335,2237,1207,872,872,pinkie pie|twilight sparkle,jowybean
2041064.jpeg,https://derpicdn.net/img/view/2019/5/17/2041064.jpeg,0,0.9230640530586244,165,377,367,579,202,202,applejack|fluttershy|mane six|pinkie pie|rainbow dash|rarity|spike|twilight sparkle,brendahickey
2044653.jpeg,https://derpicdn.net/img/view/2019/5/20/2044653.jpeg,1,0.9845510125160216,131,1885,1559,3313,1428,1428,applejack|fluttershy|mane six|pinkie pie|rainbow dash|rarity|spike|twilight sparkle,zaratus
2044653.jpeg,https://derpicdn.net/img/view/2019/5/20/2044653.jpeg,2,0.9796147346496582,158,3325,912,4079,754,754,applejack|fluttershy|mane six|pinkie pie|rainbow dash|rarity|spike|twilight sparkle,zaratus
2046011.jpeg,https://derpicdn.net/img/view/2019/5/22/2046011.jpeg,0,0.9930279850959778,791,203,1003,415,212,212,queen chrysalis|twilight sparkle,
2046011.jpeg,https://derpicdn.net/img/view/2019/5/22/2046011.jpeg,1,0.9753330945968628,357,0,567,210,210,210,queen chrysalis|twilight sparkle,
2046011.jpeg,https://derpicdn.net/img/view/2019/5/22/2046011.jpeg,2,0.9719662070274352,832,418,1112,698,280,280,queen chrysalis|twilight sparkle,
2046011.jpeg,https://derpicdn.net/img/view/2019/5/22/2046011.jpeg,3,0.9207156300544742,1023,204,1287,468,264,264,queen chrysalis|twilight sparkle,
2047696.jpeg,https://derpicdn.net/img/view/2019/5/24/2047696.jpeg,0,0.9856572151184082,407,70,577,240,170,170,rainbow dash|twilight sparkle,novaintellus
2052335.jpeg,https://derpicdn.net/img/view/2019/5/29/2052335.jpeg,0,0.9890397787094116,378,0,1302,884,924,884,sunset shimmer|twilight sparkle,draymanor57
2055268.jpeg,https://derpicdn.net/img/view/2019/6/1/2055268.jpeg,0,0.9881735444068908,0,0,580,508,580,508,spike|twilight sparkle,badumsquish
2055468.jpeg,https://derpicdn.net/img/view/2019/6/1/2055468.jpeg,0,0.9749590158462524,753,40,1559,846,806,806,applejack|fluttershy|pinkie pie|rainbow dash|rarity|twilight sparkle,silfoe
2055468.jpeg,https://derpicdn.net/img/view/2019/6/1/2055468.jpeg,1,0.9180303812026978,2074,1417,2448,1791,374,374,applejack|fluttershy|pinkie pie|rainbow dash|rarity|twilight sparkle,silfoe
2057955.jpeg,https://derpicdn.net/img/view/2019/6/4/2057955.jpeg,0,0.992494821548462,749,0,1650,923,901,923,princess cadance|shining armor|twilight sparkle,silfoe
2057958.jpeg,https://derpicdn.net/img/view/2019/6/4/2057958.jpeg,0,0.9880287051200868,101,0,1631,1275,1530,1275,princess cadance|twilight sparkle,silfoe
2058536.jpeg,https://derpicdn.net/img/view/2019/6/5/2058536.jpeg,0,0.9972587823867798,427,0,1021,556,594,556,pinkie pie|twilight sparkle,kakumlp
2059262.jpeg,https://derpicdn.net/img/view/2019/6/6/2059262.jpeg,0,0.96316260099411,853,676,1143,966,290,290,discord|queen chrysalis|shining armor|twilight sparkle,leavingcrow
2062048.jpeg,https://derpicdn.net/img/view/2019/6/10/2062048.jpeg,1,0.9936698079109192,644,344,870,570,226,226,princess flurry heart|spike|starlight glimmer|trixie|twilight sparkle,artiecanvas
2062048.jpeg,https://derpicdn.net/img/view/2019/6/10/2062048.jpeg,3,0.9783902168273926,1038,144,1280,386,242,242,princess flurry heart|spike|starlight glimmer|trixie|twilight sparkle,artiecanvas
2062913.jpeg,https://derpicdn.net/img/view/2019/6/11/2062913.jpeg,1,0.9285905957221984,429,327,783,681,354,354,applejack|fluttershy|mane six|pinkie pie|rainbow dash|rarity|twilight sparkle,xxmaikhanhflarexx
2062913.jpeg,https://derpicdn.net/img/view/2019/6/11/2062913.jpeg,2,0.9160996079444884,381,654,727,1000,346,346,applejack|fluttershy|mane six|pinkie pie|rainbow dash|rarity|twilight sparkle,xxmaikhanhflarexx
2073044.jpeg,https://derpicdn.net/img/view/2019/6/23/2073044.jpeg,0,0.9972650408744812,800,599,1072,871,272,272,princess luna|twilight sparkle,bel-assa
2073044.jpeg,https://derpicdn.net/img/view/2019/6/23/2073044.jpeg,1,0.9596571326255798,328,268,694,634,366,366,princess luna|twilight sparkle,bel-assa
2073214.jpeg,https://derpicdn.net/img/view/2019/6/23/2073214.jpeg,0,0.931443691253662,1399,1906,2463,2970,1064,1064,rainbow dash|twilight sparkle,silfoe
2073391.jpeg,https://derpicdn.net/img/view/2019/6/23/2073391.jpeg,0,0.9940982460975648,0,620,824,1522,824,902,applejack|fluttershy|mane six|pinkie pie|rainbow dash|rarity|twilight sparkle,
2073391.jpeg,https://derpicdn.net/img/view/2019/6/23/2073391.jpeg,1,0.9842402935028076,809,1118,1539,1848,730,730,applejack|fluttershy|mane six|pinkie pie|rainbow dash|rarity|twilight sparkle,
2073391.jpeg,https://derpicdn.net/img/view/2019/6/23/2073391.jpeg,2,0.9600425958633424,1419,491,2107,1309,688,818,applejack|fluttershy|mane six|pinkie pie|rainbow dash|rarity|twilight sparkle,
2073393.jpeg,https://derpicdn.net/img/view/2019/6/23/2073393.jpeg,1,0.9578200578689576,1343,0,2107,930,764,930,applejack|fluttershy|mane six|pinkie pie|princess celestia|princess luna|rainbow dash|rarity|twilight sparkle,
2073393.jpeg,https://derpicdn.net/img/view/2019/6/23/2073393.jpeg,2,0.9523349404335022,1189,1098,1769,1678,580,580,applejack|fluttershy|mane six|pinkie pie|princess celestia|princess luna|rainbow dash|rarity|twilight sparkle,
2073393.jpeg,https://derpicdn.net/img/view/2019/6/23/2073393.jpeg,3,0.9303560256958008,1172,2031,2012,2871,840,840,applejack|fluttershy|mane six|pinkie pie|princess celestia|princess luna|rainbow dash|rarity|twilight sparkle,
2073396.jpeg,https://derpicdn.net/img/view/2019/6/23/2073396.jpeg,0,0.974450409412384,930,195,1584,849,654,654,apple bloom|applejack|cutie mark crusaders|discord|fluttershy|mane six|pinkie pie|princess celestia|princess luna|rainbow dash|rarity|scootaloo|spike|starlight glimmer|sweetie belle|trixie|twilight sparkle,
2073396.jpeg,https://derpicdn.net/img/view/2019/6/23/2073396.jpeg,1,0.9592320919036864,920,1111,1558,1749,638,638,apple bloom|applejack|cutie mark crusaders|discord|fluttershy|mane six|pinkie pie|princess celestia|princess luna|rainbow dash|rarity|scootaloo|spike|starlight glimmer|sweetie belle|trixie|twilight sparkle,
2073396.jpeg,https://derpicdn.net/img/view/2019/6/23/2073396.jpeg,2,0.9577368497848512,0,80,601,820,601,740,apple bloom|applejack|cutie mark crusaders|discord|fluttershy|mane six|pinkie pie|princess celestia|princess luna|rainbow dash|rarity|scootaloo|spike|starlight glimmer|sweetie belle|trixie|twilight sparkle,
2073471.jpeg,https://derpicdn.net/img/view/2019/6/23/2073471.jpeg,0,0.99626487493515,466,203,966,703,500,500,pinkie pie|twilight sparkle,
2073471.jpeg,https://derpicdn.net/img/view/2019/6/23/2073471.jpeg,1,0.9803088307380676,564,855,1042,1333,478,478,pinkie pie|twilight sparkle,
2073658.jpeg,https://derpicdn.net/img/view/2019/6/24/2073658.jpeg,0,0.9831623435020448,908,239,1854,1185,946,946,pinkie pie|twilight sparkle,mrm|ponythroat
2073971.jpeg,https://derpicdn.net/img/view/2019/6/24/2073971.jpeg,0,0.9268512129783628,150,0,658,494,508,494,applejack|fluttershy|mane six|pinkie pie|rainbow dash|rarity|twilight sparkle,inkypsycho
2074089.jpeg,https://derpicdn.net/img/view/2019/6/24/2074089.jpeg,0,0.9726319313049316,527,350,2775,2598,2248,2248,spike|twilight sparkle,ahekao
2074184.jpeg,https://derpicdn.net/img/view/2019/6/24/2074184.jpeg,1,0.9796876311302184,1982,78,3064,1160,1082,1082,starlight glimmer|twilight sparkle,blasphemyrose
2074558.jpeg,https://derpicdn.net/img/view/2019/6/24/2074558.jpeg,0,0.9978899359703064,1728,564,2148,984,420,420,applejack|fluttershy|mane six|pinkie pie|rainbow dash|rarity|twilight sparkle,abarai
2076667.jpeg,https://derpicdn.net/img/view/2019/6/27/2076667.jpeg,0,0.9991371631622314,0,1766,706,2488,706,722,applejack|fluttershy|mane six|pinkie pie|rainbow dash|rarity|twilight sparkle,dvixie
2076667.jpeg,https://derpicdn.net/img/view/2019/6/27/2076667.jpeg,2,0.9966968894004822,1921,1258,2639,1976,718,718,applejack|fluttershy|mane six|pinkie pie|rainbow dash|rarity|twilight sparkle,dvixie
2076667.jpeg,https://derpicdn.net/img/view/2019/6/27/2076667.jpeg,3,0.9956693649291992,0,0,605,596,605,596,applejack|fluttershy|mane six|pinkie pie|rainbow dash|rarity|twilight sparkle,dvixie
2077546.jpeg,https://derpicdn.net/img/view/2019/6/28/2077546.jpeg,1,0.9703540205955504,547,370,2755,2578,2208,2208,spike|twilight sparkle,ahekao
2078529.jpeg,https://derpicdn.net/img/view/2019/6/29/2078529.jpeg,0,0.996840000152588,53,236,521,704,468,468,applejack|fluttershy|pinkie pie|rarity|twilight sparkle,
2078529.jpeg,https://derpicdn.net/img/view/2019/6/29/2078529.jpeg,1,0.9943048357963562,1056,303,1320,567,264,264,applejack|fluttershy|pinkie pie|rarity|twilight sparkle,
2078547.jpeg,https://derpicdn.net/img/view/2019/6/29/2078547.jpeg,0,0.9875954985618592,778,362,1068,652,290,290,applejack|fluttershy|rainbow dash|rarity|twilight sparkle,
2079284.jpeg,https://derpicdn.net/img/view/2019/6/30/2079284.jpeg,0,0.9581167101860046,0,389,1360,1987,1360,1598,starlight glimmer|twilight sparkle,garammasara
2080093.jpeg,https://derpicdn.net/img/view/2019/7/1/2080093.jpeg,0,0.9948925375938416,841,225,1187,571,346,346,princess celestia|princess luna|twilight sparkle,plotcore
2080093.jpeg,https://derpicdn.net/img/view/2019/7/1/2080093.jpeg,1,0.9739763140678406,309,325,587,603,278,278,princess celestia|princess luna|twilight sparkle,plotcore
2080737.jpeg,https://derpicdn.net/img/view/2019/7/1/2080737.jpeg,2,0.985424280166626,772,1075,1110,1413,338,338,applejack|fluttershy|mane six|pinkie pie|rainbow dash|rarity|twilight sparkle,
2080737.jpeg,https://derpicdn.net/img/view/2019/7/1/2080737.jpeg,4,0.9680429697036744,87,1003,497,1413,410,410,applejack|fluttershy|mane six|pinkie pie|rainbow dash|rarity|twilight sparkle,
2081145.jpeg,https://derpicdn.net/img/view/2019/7/2/2081145.jpeg,0,0.9936453104019164,409,291,929,811,520,520,fluttershy|spike|twilight sparkle,satv12
2081145.jpeg,https://derpicdn.net/img/view/2019/7/2/2081145.jpeg,1,0.966111183166504,1077,296,1555,774,478,478,fluttershy|spike|twilight sparkle,satv12
2081145.jpeg,https://derpicdn.net/img/view/2019/7/2/2081145.jpeg,2,0.952134370803833,1460,344,1814,698,354,354,fluttershy|spike|twilight sparkle,satv12
2081422.jpeg,https://derpicdn.net/img/view/2019/7/2/2081422.jpeg,0,0.9827550649642944,139,0,839,648,700,648,applejack|fluttershy|mane six|pinkie pie|rainbow dash|rarity|twilight sparkle,阿桑桑桑dudu
2081422.jpeg,https://derpicdn.net/img/view/2019/7/2/2081422.jpeg,1,0.9511088132858276,0,422,308,792,308,370,applejack|fluttershy|mane six|pinkie pie|rainbow dash|rarity|twilight sparkle,阿桑桑桑dudu
2081802.jpeg,https://derpicdn.net/img/view/2019/7/3/2081802.jpeg,0,0.9194232225418092,72,362,264,554,192,192,fluttershy|pinkie pie|rainbow dash|twilight sparkle,zoe persico
2081976.jpeg,https://derpicdn.net/img/view/2019/7/3/2081976.jpeg,0,0.9977112412452698,254,338,436,520,182,182,pinkie pie|sunset shimmer|twilight sparkle,pencils
2081976.jpeg,https://derpicdn.net/img/view/2019/7/3/2081976.jpeg,1,0.9972503185272216,377,64,571,258,194,194,pinkie pie|sunset shimmer|twilight sparkle,pencils
2081976.jpeg,https://derpicdn.net/img/view/2019/7/3/2081976.jpeg,2,0.9795917272567748,143,23,363,243,220,220,pinkie pie|sunset shimmer|twilight sparkle,pencils
2081976.jpeg,https://derpicdn.net/img/view/2019/7/3/2081976.jpeg,3,0.9338210821151732,584,89,724,229,140,140,pinkie pie|sunset shimmer|twilight sparkle,pencils
2082465.jpeg,https://derpicdn.net/img/view/2019/7/4/2082465.jpeg,0,0.9512566924095154,50,1108,376,1434,326,326,applejack|fluttershy|mane six|pinkie pie|rainbow dash|rarity|spike|twilight sparkle,nanook123
2082840.jpeg,https://derpicdn.net/img/view/2019/7/4/2082840.jpeg,0,0.9859696626663208,58,178,514,634,456,456,spike|starlight glimmer|trixie|twilight sparkle,satv12
2082853.jpeg,https://derpicdn.net/img/view/2019/7/4/2082853.jpeg,0,0.9229042530059814,32,42,684,694,652,652,fluttershy|spike|twilight sparkle,satv12
2082952.jpeg,https://derpicdn.net/img/view/2019/7/4/2082952.jpeg,0,0.9997498393058776,922,687,1280,1059,358,372,starlight glimmer|trixie|twilight sparkle,dstears
2082952.jpeg,https://derpicdn.net/img/view/2019/7/4/2082952.jpeg,1,0.9986931681632996,192,511,456,775,264,264,starlight glimmer|trixie|twilight sparkle,dstears
2083806.jpeg,https://derpicdn.net/img/view/2019/7/5/2083806.jpeg,0,0.9893584251403807,432,4,700,272,268,268,spike|twilight sparkle,alex-kellar
2084446.jpeg,https://derpicdn.net/img/view/2019/7/6/2084446.jpeg,0,0.9364742040634156,850,0,1911,913,1061,913,pinkie pie|twilight sparkle,
2084454.jpeg,https://derpicdn.net/img/view/2019/7/6/2084454.jpeg,0,0.9796150922775269,924,0,1512,571,588,571,pinkie pie|twilight sparkle,
2085074.jpeg,https://derpicdn.net/img/view/2019/7/7/2085074.jpeg,1,0.9785131812095642,856,34,1028,206,172,172,applejack|fluttershy|mane six|pinkie pie|rainbow dash|rarity|twilight sparkle,eeviart
2087091.jpeg,https://derpicdn.net/img/view/2019/7/9/2087091.jpeg,0,0.9971716403961182,999,144,1419,564,420,420,applejack|fluttershy|mane six|pinkie pie|rainbow dash|rarity|twilight sparkle,
2087091.jpeg,https://derpicdn.net/img/view/2019/7/9/2087091.jpeg,1,0.9957086443901062,408,313,744,649,336,336,applejack|fluttershy|mane six|pinkie pie|rainbow dash|rarity|twilight sparkle,
2087091.jpeg,https://derpicdn.net/img/view/2019/7/9/2087091.jpeg,2,0.9376791715621948,1532,306,1920,726,388,420,applejack|fluttershy|mane six|pinkie pie|rainbow dash|rarity|twilight sparkle,
2087091.jpeg,https://derpicdn.net/img/view/2019/7/9/2087091.jpeg,3,0.9316604733467102,715,210,1093,588,378,378,applejack|fluttershy|mane six|pinkie pie|rainbow dash|rarity|twilight sparkle,
2092467.jpeg,https://derpicdn.net/img/view/2019/7/15/2092467.jpeg,0,0.9300713539123536,356,50,516,210,160,160,applejack|fluttershy|mane six|pinkie pie|rainbow dash|rarity|spike|twilight sparkle,
2093007.jpeg,https://derpicdn.net/img/view/2019/7/16/2093007.jpeg,0,0.9954007863998412,163,2017,975,2829,812,812,princess luna|twilight sparkle,maytee|asimos|kirillk
2093793.jpeg,https://derpicdn.net/img/view/2019/7/17/2093793.jpeg,0,0.987712025642395,143,158,981,996,838,838,princess luna|twilight sparkle,magnaluna
2094768.jpeg,https://derpicdn.net/img/view/2019/7/18/2094768.jpeg,0,0.999187469482422,491,527,721,795,230,268,applejack|fluttershy|mane six|pinkie pie|rainbow dash|rarity|twilight sparkle,meekcheep
2094948.jpeg,https://derpicdn.net/img/view/2019/7/18/2094948.jpeg,0,0.9410049915313721,179,122,477,420,298,298,rarity|twilight sparkle,kingkero
2096307.jpeg,https://derpicdn.net/img/view/2019/7/20/2096307.jpeg,0,0.99705970287323,0,918,566,1512,566,594,applejack|fluttershy|mane six|pinkie pie|rainbow dash|rarity|twilight sparkle,etoz
2096307.jpeg,https://derpicdn.net/img/view/2019/7/20/2096307.jpeg,1,0.994785487651825,2039,171,2600,777,561,606,applejack|fluttershy|mane six|pinkie pie|rainbow dash|rarity|twilight sparkle,etoz
2096307.jpeg,https://derpicdn.net/img/view/2019/7/20/2096307.jpeg,2,0.9903771281242372,771,2247,1257,2733,486,486,applejack|fluttershy|mane six|pinkie pie|rainbow dash|rarity|twilight sparkle,etoz
2096307.jpeg,https://derpicdn.net/img/view/2019/7/20/2096307.jpeg,3,0.9889006018638612,1304,2505,1736,2937,432,432,applejack|fluttershy|mane six|pinkie pie|rainbow dash|rarity|twilight sparkle,etoz
2096307.jpeg,https://derpicdn.net/img/view/2019/7/20/2096307.jpeg,4,0.9860133528709412,1588,513,1968,893,380,380,applejack|fluttershy|mane six|pinkie pie|rainbow dash|rarity|twilight sparkle,etoz
2096307.jpeg,https://derpicdn.net/img/view/2019/7/20/2096307.jpeg,5,0.9854690432548524,1320,0,1852,482,532,482,applejack|fluttershy|mane six|pinkie pie|rainbow dash|rarity|twilight sparkle,etoz
2096307.jpeg,https://derpicdn.net/img/view/2019/7/20/2096307.jpeg,6,0.9849529862403872,685,1180,1299,1794,614,614,applejack|fluttershy|mane six|pinkie pie|rainbow dash|rarity|twilight sparkle,etoz
2096307.jpeg,https://derpicdn.net/img/view/2019/7/20/2096307.jpeg,7,0.9826195240020752,3,0,565,529,562,529,applejack|fluttershy|mane six|pinkie pie|rainbow dash|rarity|twilight sparkle,etoz
2096307.jpeg,https://derpicdn.net/img/view/2019/7/20/2096307.jpeg,8,0.9777077436447144,28,1948,634,2554,606,606,applejack|fluttershy|mane six|pinkie pie|rainbow dash|rarity|twilight sparkle,etoz
2096307.jpeg,https://derpicdn.net/img/view/2019/7/20/2096307.jpeg,9,0.9732338190078736,1221,894,1941,1614,720,720,applejack|fluttershy|mane six|pinkie pie|rainbow dash|rarity|twilight sparkle,etoz
2096307.jpeg,https://derpicdn.net/img/view/2019/7/20/2096307.jpeg,10,0.9600552320480348,1300,1932,1866,2498,566,566,applejack|fluttershy|mane six|pinkie pie|rainbow dash|rarity|twilight sparkle,etoz
2096990.jpeg,https://derpicdn.net/img/view/2019/7/20/2096990.jpeg,0,0.9441023468971252,43,320,341,618,298,298,pinkie pie|twilight sparkle,puri__kyua
2097093.jpeg,https://derpicdn.net/img/view/2019/7/20/2097093.jpeg,0,0.9737287163734436,761,81,1387,707,626,626,princess celestia|princess luna|twilight sparkle,magnaluna
2099493.jpeg,https://derpicdn.net/img/view/2019/7/23/2099493.jpeg,0,0.9679023623466492,0,18,530,539,530,521,starlight glimmer|trixie|twilight sparkle,samyvillaly
2101409.jpeg,https://derpicdn.net/img/view/2019/7/26/2101409.jpeg,0,0.9538064002990724,0,0,333,430,333,430,applejack|twilight sparkle,
2101586.jpeg,https://derpicdn.net/img/view/2019/7/26/2101586.jpeg,0,0.9871617555618286,279,173,647,541,368,368,pinkie pie|twilight sparkle,heir-of-rick
2103121.jpeg,https://derpicdn.net/img/view/2019/7/28/2103121.jpeg,0,0.9970271587371826,602,0,1298,666,696,666,shining armor|twilight sparkle,ali-selle
2105298.jpeg,https://derpicdn.net/img/view/2019/7/31/2105298.jpeg,0,0.9647582769393921,458,104,804,450,346,346,applejack|fluttershy|mane six|pinkie pie|princess cadance|princess celestia|princess luna|rainbow dash|rarity|shining armor|starlight glimmer|trixie|twilight sparkle,quakehoof
2105298.jpeg,https://derpicdn.net/img/view/2019/7/31/2105298.jpeg,1,0.9162703156471252,1521,382,1793,654,272,272,applejack|fluttershy|mane six|pinkie pie|princess cadance|princess celestia|princess luna|rainbow dash|rarity|shining armor|starlight glimmer|trixie|twilight sparkle,quakehoof
2105539.jpeg,https://derpicdn.net/img/view/2019/7/31/2105539.jpeg,1,0.9976208806037904,671,108,1171,608,500,500,applejack|fluttershy|mane six|pinkie pie|rainbow dash|rarity|spike|twilight sparkle,princrim
2105539.jpeg,https://derpicdn.net/img/view/2019/7/31/2105539.jpeg,2,0.9969801306724548,0,130,408,594,408,464,applejack|fluttershy|mane six|pinkie pie|rainbow dash|rarity|spike|twilight sparkle,princrim
2105539.jpeg,https://derpicdn.net/img/view/2019/7/31/2105539.jpeg,5,0.9438444972038268,263,209,775,721,512,512,applejack|fluttershy|mane six|pinkie pie|rainbow dash|rarity|spike|twilight sparkle,princrim
2106032.jpeg,https://derpicdn.net/img/view/2019/7/31/2106032.jpeg,1,0.9888781309127808,524,373,760,609,236,236,princess cadance|princess celestia|princess luna|twilight sparkle,omny87
2106551.jpeg,https://derpicdn.net/img/view/2019/8/1/2106551.jpeg,0,0.9733204841613772,1295,306,1585,596,290,290,applejack|fluttershy|mane six|pinkie pie|rainbow dash|rarity|spike|twilight sparkle,
2107854.jpeg,https://derpicdn.net/img/view/2019/8/3/2107854.jpeg,0,0.9265769124031068,169,0,647,438,478,438,rainbow dash|twilight sparkle,castaspellliana
2107854.jpeg,https://derpicdn.net/img/view/2019/8/3/2107854.jpeg,1,0.9260608553886414,482,113,852,483,370,370,rainbow dash|twilight sparkle,castaspellliana
2108402.jpeg,https://derpicdn.net/img/view/2019/8/4/2108402.jpeg,0,0.99908185005188,18,0,414,371,396,371,shining armor|twilight sparkle,castaspellliana
2110512.jpeg,https://derpicdn.net/img/view/2019/8/6/2110512.jpeg,0,0.9350377321243286,0,409,541,1069,541,660,applejack|fluttershy|mane six|pinkie pie|rainbow dash|rarity|twilight sparkle,techycutie
2110512.jpeg,https://derpicdn.net/img/view/2019/8/6/2110512.jpeg,1,0.9022976160049438,655,464,1170,1084,515,620,applejack|fluttershy|mane six|pinkie pie|rainbow dash|rarity|twilight sparkle,techycutie
2110786.jpeg,https://derpicdn.net/img/view/2019/8/6/2110786.jpeg,0,0.996671497821808,910,357,1532,979,622,622,princess cadance|shining armor|twilight sparkle,incendiaryboobs
2110786.jpeg,https://derpicdn.net/img/view/2019/8/6/2110786.jpeg,1,0.99534010887146,370,226,1016,872,646,646,princess cadance|shining armor|twilight sparkle,incendiaryboobs
2111132.jpeg,https://derpicdn.net/img/view/2019/8/7/2111132.jpeg,0,0.9823758602142334,381,729,657,1005,276,276,princess cadance|princess flurry heart|shining armor|spike|twilight sparkle,maytee
2111132.jpeg,https://derpicdn.net/img/view/2019/8/7/2111132.jpeg,1,0.972607970237732,939,617,1243,921,304,304,princess cadance|princess flurry heart|shining armor|spike|twilight sparkle,maytee
2111132.jpeg,https://derpicdn.net/img/view/2019/8/7/2111132.jpeg,2,0.9629145264625548,200,683,460,943,260,260,princess cadance|princess flurry heart|shining armor|spike|twilight sparkle,maytee
2111266.jpeg,https://derpicdn.net/img/view/2019/8/7/2111266.jpeg,2,0.9097654819488524,1070,414,1450,794,380,380,sunset shimmer|twilight sparkle,5mmumm5
2111609.jpeg,https://derpicdn.net/img/view/2019/8/7/2111609.jpeg,0,0.9842259883880616,1872,262,2748,1138,876,876,spike|twilight sparkle,harwick
2112588.jpeg,https://derpicdn.net/img/view/2019/8/8/2112588.jpeg,0,0.9921735525131226,63,27,509,473,446,446,applejack|fluttershy|pinkie pie|rainbow dash|rarity|sunset shimmer|twilight sparkle,martonszucsstudio
2112818.jpeg,https://derpicdn.net/img/view/2019/8/9/2112818.jpeg,0,0.9974905848503112,556,144,1076,664,520,520,rarity|twilight sparkle,moh_mlp2
2112819.jpeg,https://derpicdn.net/img/view/2019/8/9/2112819.jpeg,0,0.905376136302948,292,100,922,730,630,630,spike|twilight sparkle,moh_mlp2
2112825.jpeg,https://derpicdn.net/img/view/2019/8/9/2112825.jpeg,0,0.9835619926452636,341,410,963,1032,622,622,rainbow dash|twilight sparkle,moh_mlp2
2113580.jpeg,https://derpicdn.net/img/view/2019/8/10/2113580.jpeg,0,0.9959999322891236,852,0,1262,358,410,358,applejack|fluttershy|mane six|pinkie pie|rainbow dash|rarity|twilight sparkle,gleamydreams
2113580.jpeg,https://derpicdn.net/img/view/2019/8/10/2113580.jpeg,1,0.9910217523574828,49,352,371,674,322,322,applejack|fluttershy|mane six|pinkie pie|rainbow dash|rarity|twilight sparkle,gleamydreams
2113580.jpeg,https://derpicdn.net/img/view/2019/8/10/2113580.jpeg,3,0.9588510394096376,859,321,1247,709,388,388,applejack|fluttershy|mane six|pinkie pie|rainbow dash|rarity|twilight sparkle,gleamydreams
2113752.jpeg,https://derpicdn.net/img/view/2019/8/10/2113752.jpeg,0,0.9890035390853882,1375,0,1835,455,460,455,apple bloom|cutie mark crusaders|rarity|scootaloo|sweetie belle|twilight sparkle,tingsan
2113764.jpeg,https://derpicdn.net/img/view/2019/8/10/2113764.jpeg,0,0.9985016584396362,501,0,1031,512,530,512,applejack|fluttershy|mane six|pinkie pie|rainbow dash|rarity|twilight sparkle,valiantstar00
2113764.jpeg,https://derpicdn.net/img/view/2019/8/10/2113764.jpeg,1,0.9886066317558287,487,717,971,1201,484,484,applejack|fluttershy|mane six|pinkie pie|rainbow dash|rarity|twilight sparkle,valiantstar00
2113764.jpeg,https://derpicdn.net/img/view/2019/8/10/2113764.jpeg,2,0.933452308177948,1033,148,1491,606,458,458,applejack|fluttershy|mane six|pinkie pie|rainbow dash|rarity|twilight sparkle,valiantstar00
2116543.jpeg,https://derpicdn.net/img/view/2019/8/12/2116543.jpeg,0,0.9209088683128356,872,621,1496,1245,624,624,princess celestia|twilight sparkle,raikoh
2117361.jpeg,https://derpicdn.net/img/view/2019/8/13/2117361.jpeg,0,0.9355106949806212,696,0,1884,952,1188,952,pinkie pie|twilight sparkle,
2118053.jpeg,https://derpicdn.net/img/view/2019/8/14/2118053.jpeg,0,0.9063354730606079,0,60,464,742,464,682,pinkie pie|twilight sparkle,
2118214.jpeg,https://derpicdn.net/img/view/2019/8/14/2118214.jpeg,0,0.9974584579467772,760,206,1152,598,392,392,princess celestia|twilight sparkle,leavingcrow
2119455.jpeg,https://derpicdn.net/img/view/2019/8/16/2119455.jpeg,0,0.92854243516922,501,107,693,299,192,192,applejack|fluttershy|mane six|pinkie pie|rainbow dash|rarity|spike|starlight glimmer|twilight sparkle,
2119905.jpeg,https://derpicdn.net/img/view/2019/8/16/2119905.jpeg,0,0.9969538450241088,81,590,649,1158,568,568,sunset shimmer|twilight sparkle,snowillusory
2120082.jpeg,https://derpicdn.net/img/view/2019/8/17/2120082.jpeg,0,0.9716606736183168,0,0,594,573,594,573,fluttershy|twilight sparkle,nicoletta baldari
2120243.jpeg,https://derpicdn.net/img/view/2019/8/17/2120243.jpeg,0,0.9531425833702089,226,105,678,557,452,452,applejack|fluttershy|mane six|pinkie pie|rainbow dash|rarity|starlight glimmer|twilight sparkle,snowillusory
2123144.jpeg,https://derpicdn.net/img/view/2019/8/20/2123144.jpeg,0,0.9166825413703918,873,236,1365,728,492,492,princess cadance|princess celestia|princess luna|queen chrysalis|twilight sparkle,thelunarmoon
2123185.jpeg,https://derpicdn.net/img/view/2019/8/20/2123185.jpeg,0,0.9866005778312684,346,367,640,675,294,308,applejack|fluttershy|mane six|pinkie pie|rainbow dash|rarity|twilight sparkle,
2123185.jpeg,https://derpicdn.net/img/view/2019/8/20/2123185.jpeg,1,0.9764711856842041,393,162,499,268,106,106,applejack|fluttershy|mane six|pinkie pie|rainbow dash|rarity|twilight sparkle,
2123185.jpeg,https://derpicdn.net/img/view/2019/8/20/2123185.jpeg,2,0.9231173396110536,474,171,596,293,122,122,applejack|fluttershy|mane six|pinkie pie|rainbow dash|rarity|twilight sparkle,
2125360.jpeg,https://derpicdn.net/img/view/2019/8/23/2125360.jpeg,0,0.9953964352607728,803,67,1381,645,578,578,applejack|fluttershy|mane six|pinkie pie|rainbow dash|rarity|twilight sparkle,satv12
2125427.jpeg,https://derpicdn.net/img/view/2019/8/23/2125427.jpeg,0,0.9027873873710632,34,0,628,568,594,568,pinkie pie|twilight sparkle,akainu_pony
2125430.jpeg,https://derpicdn.net/img/view/2019/8/23/2125430.jpeg,0,0.9714351296424866,4,13,518,527,514,514,pinkie pie|twilight sparkle,akainu_pony
2125968.jpeg,https://derpicdn.net/img/view/2019/8/24/2125968.jpeg,0,0.9369999766349792,318,296,546,524,228,228,trixie|twilight sparkle,crystal-secret
2126304.jpeg,https://derpicdn.net/img/view/2019/8/24/2126304.jpeg,0,0.9974881410598756,18,0,350,324,332,324,applejack|fluttershy|mane six|pinkie pie|rainbow dash|rarity|twilight sparkle,dalapony
2126304.jpeg,https://derpicdn.net/img/view/2019/8/24/2126304.jpeg,1,0.9884116649627686,490,118,798,426,308,308,applejack|fluttershy|mane six|pinkie pie|rainbow dash|rarity|twilight sparkle,dalapony
2128154.jpeg,https://derpicdn.net/img/view/2019/8/26/2128154.jpeg,0,0.9975293278694152,507,476,775,744,268,268,princess celestia|princess luna|spike|twilight sparkle,
2129474.jpeg,https://derpicdn.net/img/view/2019/8/27/2129474.jpeg,0,0.9467169642448424,0,0,1906,1563,1906,1563,applejack|fluttershy|mane six|pinkie pie|rainbow dash|rarity|twilight sparkle,evomanaphy
2130614.jpeg,https://derpicdn.net/img/view/2019/8/29/2130614.jpeg,0,0.927875816822052,0,0,361,369,361,369,apple bloom|applejack|twilight sparkle,
2134217.jpeg,https://derpicdn.net/img/view/2019/9/2/2134217.jpeg,0,0.96573406457901,0,0,480,466,480,466,starlight glimmer|twilight sparkle,
2135588.jpeg,https://derpicdn.net/img/view/2019/9/3/2135588.jpeg,0,0.9110744595527648,0,0,399,383,399,383,spike|twilight sparkle,andypriceart
2136037.jpeg,https://derpicdn.net/img/view/2019/9/4/2136037.jpeg,1,0.925364911556244,6898,244,7684,1030,786,786,applejack|fluttershy|pinkie pie|rainbow dash|rarity|sunset shimmer|twilight sparkle,5mmumm5
2136122.jpeg,https://derpicdn.net/img/view/2019/9/4/2136122.jpeg,0,0.9708512425422668,0,0,787,746,787,746,applejack|fluttershy|mane six|pinkie pie|rainbow dash|rarity|twilight sparkle,moh_mlp2
2136122.jpeg,https://derpicdn.net/img/view/2019/9/4/2136122.jpeg,1,0.9564027190208436,0,814,1081,1908,1081,1094,applejack|fluttershy|mane six|pinkie pie|rainbow dash|rarity|twilight sparkle,moh_mlp2
2136368.jpeg,https://derpicdn.net/img/view/2019/9/4/2136368.jpeg,0,0.9906641840934752,633,351,855,573,222,222,applejack|fluttershy|mane six|pinkie pie|rainbow dash|rarity|spike|twilight sparkle,
2136559.jpeg,https://derpicdn.net/img/view/2019/9/4/2136559.jpeg,1,0.9695647358894348,2830,260,4330,1760,1500,1500,applejack|fluttershy|mane six|pinkie pie|rainbow dash|rarity|spike|twilight sparkle,hiccupsdoesart
2136559.jpeg,https://derpicdn.net/img/view/2019/9/4/2136559.jpeg,2,0.950336217880249,1654,151,3168,1665,1514,1514,applejack|fluttershy|mane six|pinkie pie|rainbow dash|rarity|spike|twilight sparkle,hiccupsdoesart
2136624.jpeg,https://derpicdn.net/img/view/2019/9/4/2136624.jpeg,0,0.9574187994003296,397,0,619,194,222,194,applejack|fluttershy|mane six|pinkie pie|rainbow dash|rarity|spike|twilight sparkle,erufi
2136811.jpeg,https://derpicdn.net/img/view/2019/9/5/2136811.jpeg,0,0.9989860653877258,631,2,1071,442,440,440,rarity|sunset shimmer|twilight sparkle,sadtrooper
2136811.jpeg,https://derpicdn.net/img/view/2019/9/5/2136811.jpeg,1,0.9983863234519958,941,923,1437,1419,496,496,rarity|sunset shimmer|twilight sparkle,sadtrooper
2136811.jpeg,https://derpicdn.net/img/view/2019/9/5/2136811.jpeg,2,0.996941328048706,394,1343,928,1877,534,534,rarity|sunset shimmer|twilight sparkle,sadtrooper
2139631.jpeg,https://derpicdn.net/img/view/2019/9/8/2139631.jpeg,0,0.9937801361083984,127,1305,1257,2435,1130,1130,applejack|fluttershy|mane six|pinkie pie|rainbow dash|rarity|twilight sparkle,
2139631.jpeg,https://derpicdn.net/img/view/2019/9/8/2139631.jpeg,1,0.9238566756248474,973,0,2949,1686,1976,1686,applejack|fluttershy|mane six|pinkie pie|rainbow dash|rarity|twilight sparkle,
2140213.jpeg,https://derpicdn.net/img/view/2019/9/9/2140213.jpeg,0,0.9732547998428344,434,0,1312,823,878,823,applejack|fluttershy|rarity|twilight sparkle,tohupo
2141291.jpeg,https://derpicdn.net/img/view/2019/9/10/2141291.jpeg,2,0.9991094470024108,212,670,548,1006,336,336,spike|twilight sparkle,glitterstar2000
2141291.jpeg,https://derpicdn.net/img/view/2019/9/10/2141291.jpeg,3,0.9630198478698728,590,638,916,964,326,326,spike|twilight sparkle,glitterstar2000
2142072.jpeg,https://derpicdn.net/img/view/2019/9/12/2142072.jpeg,0,0.9394966959953308,49,0,320,309,271,309,pinkie pie|rarity|spike|twilight sparkle,
2143607.jpeg,https://derpicdn.net/img/view/2019/9/14/2143607.jpeg,0,0.9978587031364441,757,318,1067,628,310,310,applejack|fluttershy|mane six|pinkie pie|rainbow dash|rarity|twilight sparkle,nokrats
2143607.jpeg,https://derpicdn.net/img/view/2019/9/14/2143607.jpeg,2,0.9408926367759703,305,179,593,467,288,288,applejack|fluttershy|mane six|pinkie pie|rainbow dash|rarity|twilight sparkle,nokrats
2143607.jpeg,https://derpicdn.net/img/view/2019/9/14/2143607.jpeg,3,0.9365221858024596,150,456,466,772,316,316,applejack|fluttershy|mane six|pinkie pie|rainbow dash|rarity|twilight sparkle,nokrats
2143826.jpeg,https://derpicdn.net/img/view/2019/9/14/2143826.jpeg,1,0.9608743786811828,343,84,765,506,422,422,spike|twilight sparkle,14-bis
2144211.jpeg,https://derpicdn.net/img/view/2019/9/14/2144211.jpeg,0,0.9566029906272888,258,0,1191,1033,933,1033,pinkie pie|twilight sparkle,pucksterv
2147175.jpeg,https://derpicdn.net/img/view/2019/9/18/2147175.jpeg,0,0.9967451095581056,772,0,1242,462,470,462,princess celestia|twilight sparkle,punky-pigeon
2148381.jpeg,https://derpicdn.net/img/view/2019/9/20/2148381.jpeg,0,0.9963960647583008,475,80,701,306,226,226,applejack|fluttershy|mane six|pinkie pie|rainbow dash|rarity|twilight sparkle,turonie
2148381.jpeg,https://derpicdn.net/img/view/2019/9/20/2148381.jpeg,1,0.9852920174598694,147,319,381,553,234,234,applejack|fluttershy|mane six|pinkie pie|rainbow dash|rarity|twilight sparkle,turonie
2148381.jpeg,https://derpicdn.net/img/view/2019/9/20/2148381.jpeg,2,0.9751483798027042,138,101,394,357,256,256,applejack|fluttershy|mane six|pinkie pie|rainbow dash|rarity|twilight sparkle,turonie
2148381.jpeg,https://derpicdn.net/img/view/2019/9/20/2148381.jpeg,3,0.9724540114402772,338,446,536,644,198,198,applejack|fluttershy|mane six|pinkie pie|rainbow dash|rarity|twilight sparkle,turonie
2149477.jpeg,https://derpicdn.net/img/view/2019/9/21/2149477.jpeg,0,0.9970316886901855,660,0,1272,537,612,537,applejack|fluttershy|mane six|pinkie pie|rainbow dash|rarity|twilight sparkle,dumddeer
2149477.jpeg,https://derpicdn.net/img/view/2019/9/21/2149477.jpeg,1,0.990178644657135,0,723,596,1325,596,602,applejack|fluttershy|mane six|pinkie pie|rainbow dash|rarity|twilight sparkle,dumddeer
2149477.jpeg,https://derpicdn.net/img/view/2019/9/21/2149477.jpeg,2,0.972839891910553,0,18,527,560,527,542,applejack|fluttershy|mane six|pinkie pie|rainbow dash|rarity|twilight sparkle,dumddeer
2149477.jpeg,https://derpicdn.net/img/view/2019/9/21/2149477.jpeg,3,0.9622173309326172,653,720,1293,1360,640,640,applejack|fluttershy|mane six|pinkie pie|rainbow dash|rarity|twilight sparkle,dumddeer
2149477.jpeg,https://derpicdn.net/img/view/2019/9/21/2149477.jpeg,4,0.9511534571647644,1339,785,1927,1373,588,588,applejack|fluttershy|mane six|pinkie pie|rainbow dash|rarity|twilight sparkle,dumddeer
2150453.jpeg,https://derpicdn.net/img/view/2019/9/22/2150453.jpeg,2,0.9439924359321594,66,334,202,470,136,136,applejack|fluttershy|pinkie pie|rainbow dash|rarity|twilight sparkle,lightdarksoysauce
2153338.jpeg,https://derpicdn.net/img/view/2019/9/26/2153338.jpeg,0,0.9974566698074341,700,0,2778,1629,2078,1629,princess cadance|twilight sparkle,crystal2riolu
2153338.jpeg,https://derpicdn.net/img/view/2019/9/26/2153338.jpeg,1,0.9806737899780272,468,883,1460,1875,992,992,princess cadance|twilight sparkle,crystal2riolu
2157482.jpeg,https://derpicdn.net/img/view/2019/10/1/2157482.jpeg,0,0.978668749332428,346,1247,754,1655,408,408,pinkie pie|rainbow dash|twilight sparkle,colorfulcolor233
2157482.jpeg,https://derpicdn.net/img/view/2019/10/1/2157482.jpeg,2,0.9231406450271606,644,663,1246,1265,602,602,pinkie pie|rainbow dash|twilight sparkle,colorfulcolor233
2157487.jpeg,https://derpicdn.net/img/view/2019/10/1/2157487.jpeg,0,0.9933184385299684,366,142,556,332,190,190,applejack|fluttershy|mane six|pinkie pie|rainbow dash|rarity|spike|sunset shimmer|twilight sparkle,
2157487.jpeg,https://derpicdn.net/img/view/2019/10/1/2157487.jpeg,1,0.99176287651062,10,46,190,226,180,180,applejack|fluttershy|mane six|pinkie pie|rainbow dash|rarity|spike|sunset shimmer|twilight sparkle,
2157487.jpeg,https://derpicdn.net/img/view/2019/10/1/2157487.jpeg,2,0.9857802391052246,528,0,735,180,207,180,applejack|fluttershy|mane six|pinkie pie|rainbow dash|rarity|spike|sunset shimmer|twilight sparkle,
2157487.jpeg,https://derpicdn.net/img/view/2019/10/1/2157487.jpeg,3,0.91492360830307,303,302,473,472,170,170,applejack|fluttershy|mane six|pinkie pie|rainbow dash|rarity|spike|sunset shimmer|twilight sparkle,
2157674.jpeg,https://derpicdn.net/img/view/2019/10/1/2157674.jpeg,0,0.9579240679740906,274,1390,552,1668,278,278,spike|twilight sparkle,celestial-rainstorm
2159078.jpeg,https://derpicdn.net/img/view/2019/10/3/2159078.jpeg,0,0.9767068028450012,324,157,486,319,162,162,applejack|fluttershy|mane six|pinkie pie|princess cadance|princess celestia|princess luna|rainbow dash|rarity|spike|twilight sparkle,kolshica
2163144.jpeg,https://derpicdn.net/img/view/2019/10/8/2163144.jpeg,0,0.9975331425666808,4288,2509,5864,4085,1576,1576,discord|spike|twilight sparkle,pokemonka225dw
2163750.jpeg,https://derpicdn.net/img/view/2019/10/9/2163750.jpeg,0,0.9992422461509703,790,1117,1468,1795,678,678,princess celestia|spike|starlight glimmer|twilight sparkle,wispy tuft
2163750.jpeg,https://derpicdn.net/img/view/2019/10/9/2163750.jpeg,1,0.9931142330169678,1307,1297,1943,1933,636,636,princess celestia|spike|starlight glimmer|twilight sparkle,wispy tuft
2163750.jpeg,https://derpicdn.net/img/view/2019/10/9/2163750.jpeg,2,0.9368871450424194,254,79,890,715,636,636,princess celestia|spike|starlight glimmer|twilight sparkle,wispy tuft
2163883.jpeg,https://derpicdn.net/img/view/2019/10/9/2163883.jpeg,0,0.9991588592529296,606,0,1152,487,546,487,applejack|fluttershy|mane six|pinkie pie|rainbow dash|rarity|twilight sparkle,siripim111
2163883.jpeg,https://derpicdn.net/img/view/2019/10/9/2163883.jpeg,1,0.9893649816513062,1005,145,1589,729,584,584,applejack|fluttershy|mane six|pinkie pie|rainbow dash|rarity|twilight sparkle,siripim111
2164020.jpeg,https://derpicdn.net/img/view/2019/10/9/2164020.jpeg,1,0.9137238264083862,110,266,654,810,544,544,spike|twilight sparkle,riukime
2164173.jpeg,https://derpicdn.net/img/view/2019/10/9/2164173.jpeg,0,0.9797332882881165,828,1087,1114,1373,286,286,applejack|fluttershy|mane six|pinkie pie|rainbow dash|rarity|twilight sparkle,
2164509.jpeg,https://derpicdn.net/img/view/2019/10/10/2164509.jpeg,0,0.9072933197021484,426,635,1568,1777,1142,1142,rarity|twilight sparkle,selenophile
2164882.jpeg,https://derpicdn.net/img/view/2019/10/10/2164882.jpeg,0,0.962440013885498,1829,0,2813,810,984,810,applejack|fluttershy|mane six|pinkie pie|rainbow dash|rarity|spike|twilight sparkle,dashyoshi
2164882.jpeg,https://derpicdn.net/img/view/2019/10/10/2164882.jpeg,1,0.9419867396354676,1579,1115,2301,1837,722,722,applejack|fluttershy|mane six|pinkie pie|rainbow dash|rarity|spike|twilight sparkle,dashyoshi
2164882.jpeg,https://derpicdn.net/img/view/2019/10/10/2164882.jpeg,2,0.914056360721588,2804,1204,3468,1868,664,664,applejack|fluttershy|mane six|pinkie pie|rainbow dash|rarity|spike|twilight sparkle,dashyoshi
2166577.jpeg,https://derpicdn.net/img/view/2019/10/12/2166577.jpeg,1,0.998049795627594,643,38,889,284,246,246,applejack|fluttershy|mane six|pinkie pie|rainbow dash|rarity|spike|starlight glimmer|twilight sparkle,cozmicpandawolf
2166577.jpeg,https://derpicdn.net/img/view/2019/10/12/2166577.jpeg,3,0.9534198641777042,160,291,432,563,272,272,applejack|fluttershy|mane six|pinkie pie|rainbow dash|rarity|spike|starlight glimmer|twilight sparkle,cozmicpandawolf
2166650.jpeg,https://derpicdn.net/img/view/2019/10/12/2166650.jpeg,0,0.9700875878334044,661,377,900,667,239,290,applejack|fluttershy|mane six|pinkie pie|princess celestia|princess luna|rainbow dash|rarity|spike|twilight sparkle,ladyanidraws
2166650.jpeg,https://derpicdn.net/img/view/2019/10/12/2166650.jpeg,1,0.9399267435073853,0,421,381,867,381,446,applejack|fluttershy|mane six|pinkie pie|princess celestia|princess luna|rainbow dash|rarity|spike|twilight sparkle,ladyanidraws
2166686.jpeg,https://derpicdn.net/img/view/2019/10/12/2166686.jpeg,0,0.9766866564750672,173,0,839,556,666,556,starlight glimmer|twilight sparkle,suirano
2166734.jpeg,https://derpicdn.net/img/view/2019/10/12/2166734.jpeg,0,0.939669132232666,674,432,920,678,246,246,applejack|fluttershy|mane six|pinkie pie|rainbow dash|rarity|spike|twilight sparkle,kittypaintyt
2166734.jpeg,https://derpicdn.net/img/view/2019/10/12/2166734.jpeg,1,0.9255873560905457,288,239,582,533,294,294,applejack|fluttershy|mane six|pinkie pie|rainbow dash|rarity|spike|twilight sparkle,kittypaintyt
2166991.jpeg,https://derpicdn.net/img/view/2019/10/13/2166991.jpeg,1,0.9072436094284058,387,337,595,545,208,208,applejack|fluttershy|mane six|pinkie pie|rainbow dash|rarity|twilight sparkle,spindlespice
2167018.jpeg,https://derpicdn.net/img/view/2019/10/13/2167018.jpeg,0,0.9882027506828308,798,920,1080,1202,282,282,applejack|fluttershy|mane six|pinkie pie|princess cadance|princess celestia|princess luna|rainbow dash|rarity|starlight glimmer|sunset shimmer|trixie|twilight sparkle,sibashen
2167018.jpeg,https://derpicdn.net/img/view/2019/10/13/2167018.jpeg,1,0.9842698574066162,1036,829,1366,1159,330,330,applejack|fluttershy|mane six|pinkie pie|princess cadance|princess celestia|princess luna|rainbow dash|rarity|starlight glimmer|sunset shimmer|trixie|twilight sparkle,sibashen
2167018.jpeg,https://derpicdn.net/img/view/2019/10/13/2167018.jpeg,2,0.9815833568572998,562,685,872,995,310,310,applejack|fluttershy|mane six|pinkie pie|princess cadance|princess celestia|princess luna|rainbow dash|rarity|starlight glimmer|sunset shimmer|trixie|twilight sparkle,sibashen
2167018.jpeg,https://derpicdn.net/img/view/2019/10/13/2167018.jpeg,3,0.9759169220924376,662,1171,1016,1525,354,354,applejack|fluttershy|mane six|pinkie pie|princess cadance|princess celestia|princess luna|rainbow dash|rarity|starlight glimmer|sunset shimmer|trixie|twilight sparkle,sibashen
2167018.jpeg,https://derpicdn.net/img/view/2019/10/13/2167018.jpeg,4,0.9758151173591614,1635,480,1965,810,330,330,applejack|fluttershy|mane six|pinkie pie|princess cadance|princess celestia|princess luna|rainbow dash|rarity|starlight glimmer|sunset shimmer|trixie|twilight sparkle,sibashen
2167018.jpeg,https://derpicdn.net/img/view/2019/10/13/2167018.jpeg,5,0.9576148986816406,228,779,554,1105,326,326,applejack|fluttershy|mane six|pinkie pie|princess cadance|princess celestia|princess luna|rainbow dash|rarity|starlight glimmer|sunset shimmer|trixie|twilight sparkle,sibashen
2167018.jpeg,https://derpicdn.net/img/view/2019/10/13/2167018.jpeg,6,0.9461000561714172,171,142,581,552,410,410,applejack|fluttershy|mane six|pinkie pie|princess cadance|princess celestia|princess luna|rainbow dash|rarity|starlight glimmer|sunset shimmer|trixie|twilight sparkle,sibashen
2167181.jpeg,https://derpicdn.net/img/view/2019/10/13/2167181.jpeg,1,0.9773980379104614,772,379,1190,797,418,418,applejack|fluttershy|pinkie pie|rainbow dash|rarity|twilight sparkle,magnificent-arsehole
2167181.jpeg,https://derpicdn.net/img/view/2019/10/13/2167181.jpeg,2,0.9733252525329592,1051,358,1493,800,442,442,applejack|fluttershy|pinkie pie|rainbow dash|rarity|twilight sparkle,magnificent-arsehole
2167181.jpeg,https://derpicdn.net/img/view/2019/10/13/2167181.jpeg,4,0.9512813091278076,446,308,902,764,456,456,applejack|fluttershy|pinkie pie|rainbow dash|rarity|twilight sparkle,magnificent-arsehole
2167183.jpeg,https://derpicdn.net/img/view/2019/10/13/2167183.jpeg,2,0.95441073179245,756,360,1210,814,454,454,applejack|fluttershy|pinkie pie|rainbow dash|rarity|twilight sparkle,magnificent-arsehole
2167183.jpeg,https://derpicdn.net/img/view/2019/10/13/2167183.jpeg,3,0.9248340129852296,654,43,1096,485,442,442,applejack|fluttershy|pinkie pie|rainbow dash|rarity|twilight sparkle,magnificent-arsehole
2167305.jpeg,https://derpicdn.net/img/view/2019/10/13/2167305.jpeg,0,0.9992401599884032,231,14,529,312,298,298,applejack|fluttershy|mane six|pinkie pie|rainbow dash|rarity|twilight sparkle,flutterluv
2167305.jpeg,https://derpicdn.net/img/view/2019/10/13/2167305.jpeg,1,0.9514251947402954,173,293,487,607,314,314,applejack|fluttershy|mane six|pinkie pie|rainbow dash|rarity|twilight sparkle,flutterluv
216756.jpeg,https://derpicdn.net/img/view/2013/1/18/216756.jpeg,0,0.9487542510032654,536,0,760,221,224,221,spike|twilight sparkle,earthsong9405
2167605.jpeg,https://derpicdn.net/img/view/2019/10/13/2167605.jpeg,0,0.9932520389556884,172,0,830,602,658,602,applejack|fluttershy|mane six|pinkie pie|rainbow dash|rarity|twilight sparkle,victoreach|ayvie-art
2167605.jpeg,https://derpicdn.net/img/view/2019/10/13/2167605.jpeg,1,0.964408040046692,955,17,1599,661,644,644,applejack|fluttershy|mane six|pinkie pie|rainbow dash|rarity|twilight sparkle,victoreach|ayvie-art
2167605.jpeg,https://derpicdn.net/img/view/2019/10/13/2167605.jpeg,2,0.9407808184623718,124,524,832,1232,708,708,applejack|fluttershy|mane six|pinkie pie|rainbow dash|rarity|twilight sparkle,victoreach|ayvie-art
2167642.jpeg,https://derpicdn.net/img/view/2019/10/13/2167642.jpeg,0,0.994551420211792,218,788,540,1110,322,322,applejack|fluttershy|mane six|pinkie pie|rainbow dash|rarity|spike|twilight sparkle,nekubi
2167642.jpeg,https://derpicdn.net/img/view/2019/10/13/2167642.jpeg,1,0.9909968376159668,53,418,431,796,378,378,applejack|fluttershy|mane six|pinkie pie|rainbow dash|rarity|spike|twilight sparkle,nekubi
2167642.jpeg,https://derpicdn.net/img/view/2019/10/13/2167642.jpeg,3,0.9455933570861816,111,34,403,326,292,292,applejack|fluttershy|mane six|pinkie pie|rainbow dash|rarity|spike|twilight sparkle,nekubi
2167729.jpeg,https://derpicdn.net/img/view/2019/10/13/2167729.jpeg,0,0.9950687289237976,704,154,974,424,270,270,applejack|fluttershy|mane six|pinkie pie|rainbow dash|rarity|twilight sparkle,eeviart
2167729.jpeg,https://derpicdn.net/img/view/2019/10/13/2167729.jpeg,2,0.9268072247505188,192,150,424,382,232,232,applejack|fluttershy|mane six|pinkie pie|rainbow dash|rarity|twilight sparkle,eeviart
2167774.jpeg,https://derpicdn.net/img/view/2019/10/13/2167774.jpeg,1,0.9820601344108582,8,691,966,1649,958,958,applejack|fluttershy|mane six|pinkie pie|rainbow dash|rarity|spike|starlight glimmer|twilight sparkle,poulped
2167774.jpeg,https://derpicdn.net/img/view/2019/10/13/2167774.jpeg,2,0.9707346558570862,1176,948,1656,1428,480,480,applejack|fluttershy|mane six|pinkie pie|rainbow dash|rarity|spike|starlight glimmer|twilight sparkle,poulped
2167774.jpeg,https://derpicdn.net/img/view/2019/10/13/2167774.jpeg,3,0.9658936858177184,1422,485,1842,905,420,420,applejack|fluttershy|mane six|pinkie pie|rainbow dash|rarity|spike|starlight glimmer|twilight sparkle,poulped
2167845.jpeg,https://derpicdn.net/img/view/2019/10/13/2167845.jpeg,0,0.9511798620224,732,202,1382,852,650,650,applejack|fluttershy|mane six|pinkie pie|rainbow dash|rarity|spike|twilight sparkle,dashyoshi
2167845.jpeg,https://derpicdn.net/img/view/2019/10/13/2167845.jpeg,1,0.9278072118759156,967,745,1429,1207,462,462,applejack|fluttershy|mane six|pinkie pie|rainbow dash|rarity|spike|twilight sparkle,dashyoshi
2168040.jpeg,https://derpicdn.net/img/view/2019/10/13/2168040.jpeg,0,0.9965357780456544,476,35,704,263,228,228,applejack|fluttershy|mane six|pinkie pie|rainbow dash|rarity|sunset shimmer|twilight sparkle,yuki-zakuro
2168040.jpeg,https://derpicdn.net/img/view/2019/10/13/2168040.jpeg,1,0.9860588312149048,80,0,346,217,266,217,applejack|fluttershy|mane six|pinkie pie|rainbow dash|rarity|sunset shimmer|twilight sparkle,yuki-zakuro
2168040.jpeg,https://derpicdn.net/img/view/2019/10/13/2168040.jpeg,3,0.9353758692741394,20,174,210,364,190,190,applejack|fluttershy|mane six|pinkie pie|rainbow dash|rarity|sunset shimmer|twilight sparkle,yuki-zakuro
2168040.jpeg,https://derpicdn.net/img/view/2019/10/13/2168040.jpeg,4,0.9335494041442872,67,358,415,675,348,317,applejack|fluttershy|mane six|pinkie pie|rainbow dash|rarity|sunset shimmer|twilight sparkle,yuki-zakuro
2168205.jpeg,https://derpicdn.net/img/view/2019/10/14/2168205.jpeg,0,0.9920704960823059,798,565,1196,963,398,398,applejack|discord|fluttershy|mane six|pinkie pie|rainbow dash|rarity|spike|twilight sparkle,imaginekayla
2168205.jpeg,https://derpicdn.net/img/view/2019/10/14/2168205.jpeg,1,0.9774637818336488,561,176,1049,664,488,488,applejack|discord|fluttershy|mane six|pinkie pie|rainbow dash|rarity|spike|twilight sparkle,imaginekayla
2168325.jpeg,https://derpicdn.net/img/view/2019/10/14/2168325.jpeg,0,0.9800401329994202,834,114,1156,436,322,322,applejack|fluttershy|mane six|pinkie pie|rainbow dash|rarity|spike|twilight sparkle,chickenwhite
2168489.jpeg,https://derpicdn.net/img/view/2019/10/14/2168489.jpeg,0,0.9868975877761841,1467,556,2105,1194,638,638,applejack|fluttershy|mane six|pinkie pie|rainbow dash|rarity|spike|twilight sparkle,the-minuscule-task
2168605.jpeg,https://derpicdn.net/img/view/2019/10/14/2168605.jpeg,0,0.9993295073509216,1078,102,1576,600,498,498,applejack|fluttershy|mane six|pinkie pie|rainbow dash|rarity|twilight sparkle,tyuubatu
2168605.jpeg,https://derpicdn.net/img/view/2019/10/14/2168605.jpeg,2,0.9901760816574096,297,740,627,1070,330,330,applejack|fluttershy|mane six|pinkie pie|rainbow dash|rarity|twilight sparkle,tyuubatu
2168605.jpeg,https://derpicdn.net/img/view/2019/10/14/2168605.jpeg,3,0.966101348400116,602,698,1018,1114,416,416,applejack|fluttershy|mane six|pinkie pie|rainbow dash|rarity|twilight sparkle,tyuubatu
2168659.jpeg,https://derpicdn.net/img/view/2019/10/14/2168659.jpeg,0,0.9990553259849548,522,155,898,531,376,376,rarity|twilight sparkle,lilfunkman
2168659.jpeg,https://derpicdn.net/img/view/2019/10/14/2168659.jpeg,1,0.9937757253646852,158,256,546,644,388,388,rarity|twilight sparkle,lilfunkman
2168674.jpeg,https://derpicdn.net/img/view/2019/10/14/2168674.jpeg,1,0.9836073517799376,945,317,1280,715,335,398,applejack|fluttershy|mane six|pinkie pie|rainbow dash|rarity|spike|twilight sparkle,karsithedog
2168732.jpeg,https://derpicdn.net/img/view/2019/10/14/2168732.jpeg,0,0.9349334239959716,601,58,739,196,138,138,applejack|fluttershy|mane six|pinkie pie|rainbow dash|rarity|spike|twilight sparkle,jonfawkes
2169530.jpeg,https://derpicdn.net/img/view/2019/10/15/2169530.jpeg,0,0.9957045316696168,119,761,865,1507,746,746,princess celestia|twilight sparkle,jowybean
2169535.jpeg,https://derpicdn.net/img/view/2019/10/15/2169535.jpeg,0,0.9954072833061218,722,2781,1910,3969,1188,1188,applejack|fluttershy|mane six|pinkie pie|princess celestia|princess luna|queen chrysalis|rainbow dash|rarity|spike|twilight sparkle,jowybean
2169535.jpeg,https://derpicdn.net/img/view/2019/10/15/2169535.jpeg,1,0.9868849515914916,2811,2680,3521,3390,710,710,applejack|fluttershy|mane six|pinkie pie|princess celestia|princess luna|queen chrysalis|rainbow dash|rarity|spike|twilight sparkle,jowybean
2169535.jpeg,https://derpicdn.net/img/view/2019/10/15/2169535.jpeg,3,0.9779021739959716,2223,338,3613,1728,1390,1390,applejack|fluttershy|mane six|pinkie pie|princess celestia|princess luna|queen chrysalis|rainbow dash|rarity|spike|twilight sparkle,jowybean
2169535.jpeg,https://derpicdn.net/img/view/2019/10/15/2169535.jpeg,4,0.9778464436531068,1814,3027,2680,3893,866,866,applejack|fluttershy|mane six|pinkie pie|princess celestia|princess luna|queen chrysalis|rainbow dash|rarity|spike|twilight sparkle,jowybean
2169535.jpeg,https://derpicdn.net/img/view/2019/10/15/2169535.jpeg,5,0.9667909741401672,2850,3573,3562,4285,712,712,applejack|fluttershy|mane six|pinkie pie|princess celestia|princess luna|queen chrysalis|rainbow dash|rarity|spike|twilight sparkle,jowybean
2169898.jpeg,https://derpicdn.net/img/view/2019/10/15/2169898.jpeg,0,0.9804199934005736,0,74,655,796,655,722,applejack|discord|twilight sparkle,light262
2169901.jpeg,https://derpicdn.net/img/view/2019/10/15/2169901.jpeg,0,0.9906108975410458,40,0,1812,1643,1772,1643,rainbow dash|sunset shimmer|twilight sparkle,light262
2170612.jpeg,https://derpicdn.net/img/view/2019/10/16/2170612.jpeg,1,0.9894896149635316,773,45,1015,287,242,242,applejack|discord|fluttershy|mane six|pinkie pie|princess celestia|princess luna|rainbow dash|rarity|spike|starlight glimmer|twilight sparkle,blazemizu
2170612.jpeg,https://derpicdn.net/img/view/2019/10/16/2170612.jpeg,3,0.9212867021560668,380,129,602,351,222,222,applejack|discord|fluttershy|mane six|pinkie pie|princess celestia|princess luna|rainbow dash|rarity|spike|starlight glimmer|twilight sparkle,blazemizu
2171017.jpeg,https://derpicdn.net/img/view/2019/10/16/2171017.jpeg,0,0.9978983402252196,97,0,589,409,492,409,princess celestia|princess luna|twilight sparkle,kozachokzrotom
2171017.jpeg,https://derpicdn.net/img/view/2019/10/16/2171017.jpeg,1,0.9049167037010192,795,94,1021,320,226,226,princess celestia|princess luna|twilight sparkle,kozachokzrotom
2171055.jpeg,https://derpicdn.net/img/view/2019/10/16/2171055.jpeg,2,0.9749298691749572,1541,386,1979,824,438,438,applejack|fluttershy|mane six|pinkie pie|rainbow dash|rarity|spike|twilight sparkle,atlas-66
2171055.jpeg,https://derpicdn.net/img/view/2019/10/16/2171055.jpeg,3,0.9474257230758668,809,150,1221,562,412,412,applejack|fluttershy|mane six|pinkie pie|rainbow dash|rarity|spike|twilight sparkle,atlas-66
2171130.jpeg,https://derpicdn.net/img/view/2019/10/16/2171130.jpeg,0,0.9945276379585266,315,0,591,269,276,269,applejack|fluttershy|mane six|pinkie pie|rainbow dash|rarity|spike|twilight sparkle,katarinacipcic
2173206.jpeg,https://derpicdn.net/img/view/2019/10/19/2173206.jpeg,0,0.997541069984436,891,606,1205,920,314,314,applejack|fluttershy|mane six|pinkie pie|rainbow dash|rarity|spike|twilight sparkle,sozglitch
2173206.jpeg,https://derpicdn.net/img/view/2019/10/19/2173206.jpeg,1,0.9853786826133728,661,663,917,919,256,256,applejack|fluttershy|mane six|pinkie pie|rainbow dash|rarity|spike|twilight sparkle,sozglitch
2173206.jpeg,https://derpicdn.net/img/view/2019/10/19/2173206.jpeg,3,0.9806606769561768,1151,0,1461,296,310,296,applejack|fluttershy|mane six|pinkie pie|rainbow dash|rarity|spike|twilight sparkle,sozglitch
2173206.jpeg,https://derpicdn.net/img/view/2019/10/19/2173206.jpeg,4,0.9790355563163756,428,648,700,920,272,272,applejack|fluttershy|mane six|pinkie pie|rainbow dash|rarity|spike|twilight sparkle,sozglitch
2173232.jpeg,https://derpicdn.net/img/view/2019/10/19/2173232.jpeg,0,0.9296098947525024,1036,2285,1984,3233,948,948,shining armor|twilight sparkle,poecillia-gracilis19
2173243.jpeg,https://derpicdn.net/img/view/2019/10/19/2173243.jpeg,0,0.9885053634643556,825,0,1839,905,1014,905,applejack|fluttershy|mane six|pinkie pie|rainbow dash|rarity|twilight sparkle,katputze
2173690.jpeg,https://derpicdn.net/img/view/2019/10/19/2173690.jpeg,0,0.9973630905151368,11,521,379,889,368,368,spike|twilight sparkle,mew-me
2173780.jpeg,https://derpicdn.net/img/view/2019/10/19/2173780.jpeg,0,0.9684385061264038,223,15,473,265,250,250,princess celestia|twilight sparkle,kozachokzrotom
2173899.jpeg,https://derpicdn.net/img/view/2019/10/19/2173899.jpeg,0,0.9961338639259338,1722,753,2420,1451,698,698,applejack|fluttershy|mane six|pinkie pie|rainbow dash|rarity|starlight glimmer|twilight sparkle,citi
2173903.jpeg,https://derpicdn.net/img/view/2019/10/19/2173903.jpeg,0,0.94501131772995,1051,269,1253,471,202,202,applejack|discord|fluttershy|mane six|pinkie pie|rainbow dash|rarity|twilight sparkle,tinybenz
2174073.jpeg,https://derpicdn.net/img/view/2019/10/20/2174073.jpeg,0,0.9986824989318848,532,218,1054,740,522,522,spike|twilight sparkle,vylfgor
2174136.jpeg,https://derpicdn.net/img/view/2019/10/20/2174136.jpeg,0,0.996902585029602,2004,677,2906,1579,902,902,applejack|fluttershy|mane six|pinkie pie|rainbow dash|rarity|twilight sparkle,ludwigspectre
2174136.jpeg,https://derpicdn.net/img/view/2019/10/20/2174136.jpeg,2,0.9834735989570618,1571,855,2277,1561,706,706,applejack|fluttershy|mane six|pinkie pie|rainbow dash|rarity|twilight sparkle,ludwigspectre
2174185.jpeg,https://derpicdn.net/img/view/2019/10/20/2174185.jpeg,0,0.9989162683486938,792,567,1284,1059,492,492,applejack|fluttershy|mane six|pinkie pie|rainbow dash|rarity|spike|twilight sparkle,leadhooves
2174185.jpeg,https://derpicdn.net/img/view/2019/10/20/2174185.jpeg,2,0.9697480201721193,527,752,921,1146,394,394,applejack|fluttershy|mane six|pinkie pie|rainbow dash|rarity|spike|twilight sparkle,leadhooves
2174900.jpeg,https://derpicdn.net/img/view/2019/10/20/2174900.jpeg,1,0.9497330188751221,496,406,756,666,260,260,applejack|fluttershy|mane six|pinkie pie|rainbow dash|rarity|spike|twilight sparkle,mattings
2174900.jpeg,https://derpicdn.net/img/view/2019/10/20/2174900.jpeg,3,0.9090227484703064,388,113,642,367,254,254,applejack|fluttershy|mane six|pinkie pie|rainbow dash|rarity|spike|twilight sparkle,mattings
2175473.jpeg,https://derpicdn.net/img/view/2019/10/21/2175473.jpeg,0,0.9703623056411744,772,270,1063,628,291,358,applejack|fluttershy|pinkie pie|rainbow dash|rarity|spike|starlight glimmer|twilight sparkle,lizardwithhat
2176482.jpeg,https://derpicdn.net/img/view/2019/10/22/2176482.jpeg,0,0.970494270324707,468,787,802,1121,334,334,applejack|fluttershy|mane six|pinkie pie|rainbow dash|rarity|twilight sparkle,riocin765
2176482.jpeg,https://derpicdn.net/img/view/2019/10/22/2176482.jpeg,1,0.9469394087791444,340,257,696,613,356,356,applejack|fluttershy|mane six|pinkie pie|rainbow dash|rarity|twilight sparkle,riocin765
2176482.jpeg,https://derpicdn.net/img/view/2019/10/22/2176482.jpeg,2,0.913704752922058,726,314,1082,670,356,356,applejack|fluttershy|mane six|pinkie pie|rainbow dash|rarity|twilight sparkle,riocin765
2177569.jpeg,https://derpicdn.net/img/view/2019/10/24/2177569.jpeg,0,0.993257224559784,48,68,318,338,270,270,princess luna|twilight sparkle,dellakitt
2177645.jpeg,https://derpicdn.net/img/view/2019/10/24/2177645.jpeg,0,0.9689117074012756,918,1192,1448,1722,530,530,fluttershy|rainbow dash|rarity|twilight sparkle,gigi|khilx|opossumberry
2177645.jpeg,https://derpicdn.net/img/view/2019/10/24/2177645.jpeg,1,0.9072498679161072,1455,1004,1977,1526,522,522,fluttershy|rainbow dash|rarity|twilight sparkle,gigi|khilx|opossumberry
2179424.jpeg,https://derpicdn.net/img/view/2019/10/26/2179424.jpeg,0,0.9944506883621216,0,570,346,922,346,352,applejack|fluttershy|mane six|pinkie pie|rainbow dash|rarity|spike|twilight sparkle,sycotei-b
2179424.jpeg,https://derpicdn.net/img/view/2019/10/26/2179424.jpeg,2,0.952642858028412,795,100,1257,562,462,462,applejack|fluttershy|mane six|pinkie pie|rainbow dash|rarity|spike|twilight sparkle,sycotei-b
2179424.jpeg,https://derpicdn.net/img/view/2019/10/26/2179424.jpeg,3,0.93860524892807,883,535,1280,947,397,412,applejack|fluttershy|mane six|pinkie pie|rainbow dash|rarity|spike|twilight sparkle,sycotei-b
2179748.jpeg,https://derpicdn.net/img/view/2019/10/26/2179748.jpeg,0,0.9987318515777588,389,805,687,1103,298,298,applejack|fluttershy|mane six|pinkie pie|rainbow dash|rarity|spike|twilight sparkle,hobilo
2179748.jpeg,https://derpicdn.net/img/view/2019/10/26/2179748.jpeg,2,0.9520431756973268,15,0,589,545,574,545,applejack|fluttershy|mane six|pinkie pie|rainbow dash|rarity|spike|twilight sparkle,hobilo
2179748.jpeg,https://derpicdn.net/img/view/2019/10/26/2179748.jpeg,3,0.9470361471176147,726,872,1050,1196,324,324,applejack|fluttershy|mane six|pinkie pie|rainbow dash|rarity|spike|twilight sparkle,hobilo
2179748.jpeg,https://derpicdn.net/img/view/2019/10/26/2179748.jpeg,4,0.9361891746520996,118,884,416,1182,298,298,applejack|fluttershy|mane six|pinkie pie|rainbow dash|rarity|spike|twilight sparkle,hobilo
2179748.jpeg,https://derpicdn.net/img/view/2019/10/26/2179748.jpeg,5,0.9155546426773072,177,434,439,696,262,262,applejack|fluttershy|mane six|pinkie pie|rainbow dash|rarity|spike|twilight sparkle,hobilo
2180204.jpeg,https://derpicdn.net/img/view/2019/10/27/2180204.jpeg,0,0.9996466636657716,1187,725,2137,1675,950,950,pinkie pie|princess luna|twilight sparkle,not-ordinary-pony
2180978.jpeg,https://derpicdn.net/img/view/2019/10/28/2180978.jpeg,0,0.9116784930229188,521,137,1019,635,498,498,spike|starlight glimmer|twilight sparkle,mew-me
2181062.jpeg,https://derpicdn.net/img/view/2019/10/28/2181062.jpeg,1,0.9958987236022948,684,28,1058,402,374,374,shining armor|twilight sparkle,royalshark
2181434.jpeg,https://derpicdn.net/img/view/2019/10/28/2181434.jpeg,0,0.9996639490127563,824,128,1664,968,840,840,apple bloom|applejack|big macintosh|cutie mark crusaders|discord|fluttershy|pinkie pie|princess cadance|princess celestia|princess flurry heart|princess luna|rainbow dash|rarity|scootaloo|shining armor|spike|starlight glimmer|sunset shimmer|sweetie belle|twilight sparkle,littlenaughtypony
2181434.jpeg,https://derpicdn.net/img/view/2019/10/28/2181434.jpeg,1,0.9989996552467346,1746,0,2682,893,936,893,apple bloom|applejack|big macintosh|cutie mark crusaders|discord|fluttershy|pinkie pie|princess cadance|princess celestia|princess flurry heart|princess luna|rainbow dash|rarity|scootaloo|shining armor|spike|starlight glimmer|sunset shimmer|sweetie belle|twilight sparkle,littlenaughtypony
2181434.jpeg,https://derpicdn.net/img/view/2019/10/28/2181434.jpeg,2,0.9925864338874816,335,4121,1215,5001,880,880,apple bloom|applejack|big macintosh|cutie mark crusaders|discord|fluttershy|pinkie pie|princess cadance|princess celestia|princess flurry heart|princess luna|rainbow dash|rarity|scootaloo|shining armor|spike|starlight glimmer|sunset shimmer|sweetie belle|twilight sparkle,littlenaughtypony
2181434.jpeg,https://derpicdn.net/img/view/2019/10/28/2181434.jpeg,3,0.990414261817932,1556,1477,2388,2309,832,832,apple bloom|applejack|big macintosh|cutie mark crusaders|discord|fluttershy|pinkie pie|princess cadance|princess celestia|princess flurry heart|princess luna|rainbow dash|rarity|scootaloo|shining armor|spike|starlight glimmer|sunset shimmer|sweetie belle|twilight sparkle,littlenaughtypony
2181434.jpeg,https://derpicdn.net/img/view/2019/10/28/2181434.jpeg,4,0.9784650802612304,4527,3893,5359,4725,832,832,apple bloom|applejack|big macintosh|cutie mark crusaders|discord|fluttershy|pinkie pie|princess cadance|princess celestia|princess flurry heart|princess luna|rainbow dash|rarity|scootaloo|shining armor|spike|starlight glimmer|sunset shimmer|sweetie belle|twilight sparkle,littlenaughtypony
2183985.jpeg,https://derpicdn.net/img/view/2019/10/31/2183985.jpeg,0,0.9888141751289368,248,356,546,654,298,298,applejack|fluttershy|mane six|pinkie pie|rainbow dash|rarity|twilight sparkle,aschenstern
2185185.jpeg,https://derpicdn.net/img/view/2019/11/2/2185185.jpeg,0,0.9909170269966124,0,787,445,1301,445,514,fluttershy|rainbow dash|starlight glimmer|twilight sparkle,a-vodka-mutini
2185185.jpeg,https://derpicdn.net/img/view/2019/11/2/2185185.jpeg,1,0.9835540652275084,700,0,1128,419,428,419,fluttershy|rainbow dash|starlight glimmer|twilight sparkle,a-vodka-mutini
2185185.jpeg,https://derpicdn.net/img/view/2019/11/2/2185185.jpeg,2,0.9812040328979492,58,21,418,381,360,360,fluttershy|rainbow dash|starlight glimmer|twilight sparkle,a-vodka-mutini
2185185.jpeg,https://derpicdn.net/img/view/2019/11/2/2185185.jpeg,3,0.9771147966384888,383,193,751,561,368,368,fluttershy|rainbow dash|starlight glimmer|twilight sparkle,a-vodka-mutini
2185226.jpeg,https://derpicdn.net/img/view/2019/11/2/2185226.jpeg,0,0.9861077666282654,0,6,396,492,396,486,princess celestia|twilight sparkle,
2185523.jpeg,https://derpicdn.net/img/view/2019/11/2/2185523.jpeg,1,0.9643160700798036,113,993,401,1281,288,288,applejack|fluttershy|mane six|pinkie pie|rainbow dash|rarity|twilight sparkle,shunya yamashita
2185523.jpeg,https://derpicdn.net/img/view/2019/11/2/2185523.jpeg,4,0.906749665737152,1744,1038,1998,1292,254,254,applejack|fluttershy|mane six|pinkie pie|rainbow dash|rarity|twilight sparkle,shunya yamashita
2187403.jpeg,https://derpicdn.net/img/view/2019/11/4/2187403.jpeg,0,0.9963538646697998,440,206,718,484,278,278,applejack|fluttershy|mane six|pinkie pie|rainbow dash|rarity|starlight glimmer|twilight sparkle,tjpones
2187698.jpeg,https://derpicdn.net/img/view/2019/11/4/2187698.jpeg,0,0.9581535458564758,764,215,1520,971,756,756,spike|twilight sparkle,gamorangetana
2187712.jpeg,https://derpicdn.net/img/view/2019/11/4/2187712.jpeg,0,0.9661581516265868,805,73,975,243,170,170,applejack|fluttershy|mane six|pinkie pie|rainbow dash|rarity|twilight sparkle,skirtzzz
218782.jpeg,https://derpicdn.net/img/view/2013/1/20/218782.jpeg,0,0.9720974564552308,24,0,196,153,172,153,applejack|fluttershy|mane six|pinkie pie|rainbow dash|rarity|twilight sparkle,earthsong9405
2189025.jpeg,https://derpicdn.net/img/view/2019/11/6/2189025.jpeg,0,0.9670137763023376,427,923,1029,1525,602,602,pinkie pie|twilight sparkle,insanitylittlered
2189025.jpeg,https://derpicdn.net/img/view/2019/11/6/2189025.jpeg,1,0.9461621046066284,1039,311,1471,743,432,432,pinkie pie|twilight sparkle,insanitylittlered
2190058.jpeg,https://derpicdn.net/img/view/2019/11/8/2190058.jpeg,0,0.9537144303321838,580,31,688,139,108,108,applejack|fluttershy|pinkie pie|rainbow dash|rarity|twilight sparkle,queenmackdrama|azaleasdolls
2190478.jpeg,https://derpicdn.net/img/view/2019/11/8/2190478.jpeg,0,0.9953349828720092,1017,60,1363,406,346,346,applejack|fluttershy|mane six|pinkie pie|rainbow dash|rarity|twilight sparkle,kelniferion
2190478.jpeg,https://derpicdn.net/img/view/2019/11/8/2190478.jpeg,1,0.95158189535141,1058,339,1370,651,312,312,applejack|fluttershy|mane six|pinkie pie|rainbow dash|rarity|twilight sparkle,kelniferion
2192490.jpeg,https://derpicdn.net/img/view/2019/11/10/2192490.jpeg,0,0.994024932384491,1199,30,2048,1004,849,974,applejack|fluttershy|mane six|pinkie pie|rainbow dash|rarity|spike|twilight sparkle,pinksparkle224
2192505.jpeg,https://derpicdn.net/img/view/2019/11/10/2192505.jpeg,1,0.9934419989585876,1845,75,2737,967,892,892,applejack|fluttershy|mane six|pinkie pie|rainbow dash|rarity|twilight sparkle,osaru_onsen
2192505.jpeg,https://derpicdn.net/img/view/2019/11/10/2192505.jpeg,2,0.9889963269233704,1797,920,2501,1624,704,704,applejack|fluttershy|mane six|pinkie pie|rainbow dash|rarity|twilight sparkle,osaru_onsen
2192505.jpeg,https://derpicdn.net/img/view/2019/11/10/2192505.jpeg,3,0.9814556837081908,1224,1209,1826,1811,602,602,applejack|fluttershy|mane six|pinkie pie|rainbow dash|rarity|twilight sparkle,osaru_onsen
2192505.jpeg,https://derpicdn.net/img/view/2019/11/10/2192505.jpeg,4,0.9479346871376038,1159,199,1919,959,760,760,applejack|fluttershy|mane six|pinkie pie|rainbow dash|rarity|twilight sparkle,osaru_onsen
2193376.jpeg,https://derpicdn.net/img/view/2019/11/11/2193376.jpeg,0,0.9969366192817688,981,0,2599,1502,1618,1502,applejack|fluttershy|mane six|pinkie pie|rainbow dash|rarity|twilight sparkle,rysunkowasucharia
2193707.jpeg,https://derpicdn.net/img/view/2019/11/12/2193707.jpeg,0,0.9812798500061036,1011,45,1451,485,440,440,rarity|twilight sparkle,pastel-pony-pictures
2193735.jpeg,https://derpicdn.net/img/view/2019/11/12/2193735.jpeg,0,0.9950281381607056,83,79,425,421,342,342,applejack|fluttershy|mane six|pinkie pie|rainbow dash|rarity|twilight sparkle,s-bis
2194138.jpeg,https://derpicdn.net/img/view/2019/11/12/2194138.jpeg,0,0.9974185824394226,1123,0,1611,482,488,482,applejack|fluttershy|mane six|pinkie pie|rainbow dash|rarity|twilight sparkle,andrew hickinbottom
2194138.jpeg,https://derpicdn.net/img/view/2019/11/12/2194138.jpeg,1,0.9941895008087158,44,698,430,1084,386,386,applejack|fluttershy|mane six|pinkie pie|rainbow dash|rarity|twilight sparkle,andrew hickinbottom
2194138.jpeg,https://derpicdn.net/img/view/2019/11/12/2194138.jpeg,2,0.9820362329483032,535,690,961,1116,426,426,applejack|fluttershy|mane six|pinkie pie|rainbow dash|rarity|twilight sparkle,andrew hickinbottom
2194138.jpeg,https://derpicdn.net/img/view/2019/11/12/2194138.jpeg,3,0.9609665870666504,3,48,397,442,394,394,applejack|fluttershy|mane six|pinkie pie|rainbow dash|rarity|twilight sparkle,andrew hickinbottom
2194138.jpeg,https://derpicdn.net/img/view/2019/11/12/2194138.jpeg,4,0.9472089409828186,1314,637,1700,1023,386,386,applejack|fluttershy|mane six|pinkie pie|rainbow dash|rarity|twilight sparkle,andrew hickinbottom
2194427.jpeg,https://derpicdn.net/img/view/2019/11/13/2194427.jpeg,0,0.9993634223937988,604,1248,1470,2114,866,866,applejack|fluttershy|mane six|pinkie pie|rainbow dash|rarity|twilight sparkle,shanooloo
2194427.jpeg,https://derpicdn.net/img/view/2019/11/13/2194427.jpeg,1,0.9846939444541932,1392,487,2074,1169,682,682,applejack|fluttershy|mane six|pinkie pie|rainbow dash|rarity|twilight sparkle,shanooloo
2194427.jpeg,https://derpicdn.net/img/view/2019/11/13/2194427.jpeg,2,0.9651665091514589,566,2565,1458,3457,892,892,applejack|fluttershy|mane six|pinkie pie|rainbow dash|rarity|twilight sparkle,shanooloo
2194484.jpeg,https://derpicdn.net/img/view/2019/11/13/2194484.jpeg,0,0.9961507320404052,1308,118,2634,1444,1326,1326,applejack|fluttershy|mane six|pinkie pie|rainbow dash|rarity|twilight sparkle,technicalogical
2194484.jpeg,https://derpicdn.net/img/view/2019/11/13/2194484.jpeg,1,0.9917823076248168,0,0,1336,1314,1336,1314,applejack|fluttershy|mane six|pinkie pie|rainbow dash|rarity|twilight sparkle,technicalogical
2194945.jpeg,https://derpicdn.net/img/view/2019/11/13/2194945.jpeg,0,0.9930866360664368,1393,0,2045,537,652,537,applejack|fluttershy|mane six|pinkie pie|rainbow dash|rarity|spike|twilight sparkle,
2194945.jpeg,https://derpicdn.net/img/view/2019/11/13/2194945.jpeg,1,0.97691148519516,495,0,1049,491,554,491,applejack|fluttershy|mane six|pinkie pie|rainbow dash|rarity|spike|twilight sparkle,
2195636.jpeg,https://derpicdn.net/img/view/2019/11/14/2195636.jpeg,0,0.9968839287757874,1516,2754,2612,3850,1096,1096,applejack|fluttershy|mane six|pinkie pie|rainbow dash|rarity|twilight sparkle,cartoonboyfriends
2195636.jpeg,https://derpicdn.net/img/view/2019/11/14/2195636.jpeg,1,0.9469472765922546,0,61,1413,1507,1413,1446,applejack|fluttershy|mane six|pinkie pie|rainbow dash|rarity|twilight sparkle,cartoonboyfriends
2198641.jpeg,https://derpicdn.net/img/view/2019/11/17/2198641.jpeg,0,0.9601458311080932,935,461,1615,1141,680,680,applejack|fluttershy|mane six|pinkie pie|rainbow dash|rarity|twilight sparkle,asajiopie01
2198876.jpeg,https://derpicdn.net/img/view/2019/11/17/2198876.jpeg,0,0.9992035031318665,1299,0,1791,448,492,448,rarity|twilight sparkle,pastel-pony-pictures
2198876.jpeg,https://derpicdn.net/img/view/2019/11/17/2198876.jpeg,1,0.9908518791198728,0,0,653,563,653,563,rarity|twilight sparkle,pastel-pony-pictures
219940.jpeg,https://derpicdn.net/img/view/2013/1/21/219940.jpeg,1,0.9732053875923156,429,99,641,311,212,212,applejack|fluttershy|mane six|pinkie pie|rainbow dash|rarity|twilight sparkle,shepherd0821
219940.jpeg,https://derpicdn.net/img/view/2013/1/21/219940.jpeg,4,0.9203925728797911,615,87,795,267,180,180,applejack|fluttershy|mane six|pinkie pie|rainbow dash|rarity|twilight sparkle,shepherd0821
2199477.jpeg,https://derpicdn.net/img/view/2019/11/18/2199477.jpeg,0,0.9772545695304872,2840,832,3190,1182,350,350,applejack|fluttershy|mane six|pinkie pie|rainbow dash|rarity|spike|twilight sparkle,vindhov
2199477.jpeg,https://derpicdn.net/img/view/2019/11/18/2199477.jpeg,2,0.9596791863441468,1520,737,1822,1039,302,302,applejack|fluttershy|mane six|pinkie pie|rainbow dash|rarity|spike|twilight sparkle,vindhov
2201858.jpeg,https://derpicdn.net/img/view/2019/11/21/2201858.jpeg,0,0.9665488600730896,1961,1809,2409,2257,448,448,spike|twilight sparkle,emeraldgalaxy
2202204.jpeg,https://derpicdn.net/img/view/2019/11/21/2202204.jpeg,1,0.9873867630958556,935,201,1179,445,244,244,applejack|fluttershy|mane six|pinkie pie|rainbow dash|rarity|spike|twilight sparkle,andypriceart
2202204.jpeg,https://derpicdn.net/img/view/2019/11/21/2202204.jpeg,2,0.9728168249130248,166,890,450,1174,284,284,applejack|fluttershy|mane six|pinkie pie|rainbow dash|rarity|spike|twilight sparkle,andypriceart
2203392.jpeg,https://derpicdn.net/img/view/2019/11/23/2203392.jpeg,0,0.947841227054596,278,37,1280,1091,1002,1054,rarity|twilight sparkle,laps-sp
2203392.jpeg,https://derpicdn.net/img/view/2019/11/23/2203392.jpeg,1,0.9308848977088928,0,0,913,906,913,906,rarity|twilight sparkle,laps-sp
2204171.jpeg,https://derpicdn.net/img/view/2019/11/24/2204171.jpeg,0,0.9899096488952636,38,240,324,526,286,286,princess cadance|shining armor|twilight sparkle,inuhoshi-to-darkpen
2204535.jpeg,https://derpicdn.net/img/view/2019/11/24/2204535.jpeg,1,0.9749268293380736,509,11,1693,1195,1184,1184,rarity|twilight sparkle,foxbeast
2208334.jpeg,https://derpicdn.net/img/view/2019/11/29/2208334.jpeg,0,0.9947639107704164,1627,91,2709,1173,1082,1082,applejack|fluttershy|mane six|pinkie pie|rainbow dash|rarity|twilight sparkle,helicityponi
2208334.jpeg,https://derpicdn.net/img/view/2019/11/29/2208334.jpeg,1,0.972976803779602,176,178,1080,1082,904,904,applejack|fluttershy|mane six|pinkie pie|rainbow dash|rarity|twilight sparkle,helicityponi
2208806.jpeg,https://derpicdn.net/img/view/2019/11/30/2208806.jpeg,0,0.9955126643180848,762,0,1186,387,424,387,rarity|twilight sparkle,vbastv|bastbrushie
2208923.jpeg,https://derpicdn.net/img/view/2019/11/30/2208923.jpeg,0,0.9872577786445618,428,0,880,427,452,427,pinkie pie|rarity|twilight sparkle,linaprime
2208923.jpeg,https://derpicdn.net/img/view/2019/11/30/2208923.jpeg,1,0.9295687675476074,9,247,429,667,420,420,pinkie pie|rarity|twilight sparkle,linaprime
2209296.jpeg,https://derpicdn.net/img/view/2019/11/30/2209296.jpeg,0,0.9890629649162292,48,209,356,517,308,308,princess luna|queen chrysalis|starlight glimmer|sunset shimmer|trixie|twilight sparkle,dstears
2209296.jpeg,https://derpicdn.net/img/view/2019/11/30/2209296.jpeg,2,0.9647947549819946,321,111,673,463,352,352,princess luna|queen chrysalis|starlight glimmer|sunset shimmer|trixie|twilight sparkle,dstears
2211099.jpeg,https://derpicdn.net/img/view/2019/12/2/2211099.jpeg,0,0.9976359009742736,82,0,338,247,256,247,princess cadance|princess celestia|princess flurry heart|princess luna|twilight sparkle,firepetalfox
2211099.jpeg,https://derpicdn.net/img/view/2019/12/2/2211099.jpeg,1,0.9646384119987488,320,746,534,960,214,214,princess cadance|princess celestia|princess flurry heart|princess luna|twilight sparkle,firepetalfox
2215053.jpeg,https://derpicdn.net/img/view/2019/12/7/2215053.jpeg,1,0.9906865954399108,0,0,636,568,636,568,sunset shimmer|twilight sparkle,bakki
2215491.jpeg,https://derpicdn.net/img/view/2019/12/8/2215491.jpeg,0,0.9549618363380432,0,7,547,561,547,554,spike|twilight sparkle,jhayarr23
2216257.jpeg,https://derpicdn.net/img/view/2019/12/9/2216257.jpeg,0,0.9140027165412904,761,220,1021,480,260,260,applejack|fluttershy|mane six|pinkie pie|rainbow dash|rarity|twilight sparkle,cutieanimals
2216336.jpeg,https://derpicdn.net/img/view/2019/12/9/2216336.jpeg,0,0.9939408302307128,409,297,690,605,281,308,applejack|fluttershy|pinkie pie|princess luna|rainbow dash|rarity|starlight glimmer|twilight sparkle,kura
2217836.jpeg,https://derpicdn.net/img/view/2019/12/11/2217836.jpeg,0,0.9922822713851928,1500,386,2352,1238,852,852,princess celestia|twilight sparkle,magnaluna
2219226.jpeg,https://derpicdn.net/img/view/2019/12/12/2219226.jpeg,0,0.9981033802032472,61,107,287,333,226,226,rarity|spike|starlight glimmer|twilight sparkle,styroponyworks
2219452.jpeg,https://derpicdn.net/img/view/2019/12/13/2219452.jpeg,0,0.9736475348472596,441,517,997,1073,556,556,sunset shimmer|twilight sparkle,ohjeetorig
2220442.jpeg,https://derpicdn.net/img/view/2019/12/14/2220442.jpeg,0,0.9769531488418579,1247,1856,2011,2620,764,764,applejack|fluttershy|mane six|pinkie pie|rainbow dash|rarity|twilight sparkle,sirmasterdufel
2220730.jpeg,https://derpicdn.net/img/view/2019/12/14/2220730.jpeg,0,0.9901072382926941,463,2,1115,654,652,652,sunset shimmer|twilight sparkle,5mmumm5
2220730.jpeg,https://derpicdn.net/img/view/2019/12/14/2220730.jpeg,1,0.9271007776260376,0,8,677,700,677,692,sunset shimmer|twilight sparkle,5mmumm5
2221798.jpeg,https://derpicdn.net/img/view/2019/12/16/2221798.jpeg,0,0.9038234353065492,0,0,720,620,720,620,rainbow dash|twilight sparkle,occultusion
2223163.jpeg,https://derpicdn.net/img/view/2019/12/17/2223163.jpeg,0,0.9968019127845764,721,1285,1163,1727,442,442,applejack|fluttershy|mane six|pinkie pie|rainbow dash|rarity|spike|twilight sparkle,brendahickey
2223163.jpeg,https://derpicdn.net/img/view/2019/12/17/2223163.jpeg,1,0.9962955713272096,375,1064,817,1506,442,442,applejack|fluttershy|mane six|pinkie pie|rainbow dash|rarity|spike|twilight sparkle,brendahickey
2223163.jpeg,https://derpicdn.net/img/view/2019/12/17/2223163.jpeg,2,0.9864863753318788,670,996,1022,1348,352,352,applejack|fluttershy|mane six|pinkie pie|rainbow dash|rarity|spike|twilight sparkle,brendahickey
2223163.jpeg,https://derpicdn.net/img/view/2019/12/17/2223163.jpeg,5,0.92141455411911,355,1446,703,1794,348,348,applejack|fluttershy|mane six|pinkie pie|rainbow dash|rarity|spike|twilight sparkle,brendahickey
2223731.jpeg,https://derpicdn.net/img/view/2019/12/18/2223731.jpeg,0,0.9991353750228882,3693,1245,4685,2237,992,992,applejack|fluttershy|mane six|pinkie pie|rainbow dash|rarity|twilight sparkle,lightisanasshole
2223731.jpeg,https://derpicdn.net/img/view/2019/12/18/2223731.jpeg,1,0.9979562759399414,1902,478,3200,1776,1298,1298,applejack|fluttershy|mane six|pinkie pie|rainbow dash|rarity|twilight sparkle,lightisanasshole
228674.jpeg,https://derpicdn.net/img/view/2013/1/30/228674.jpeg,0,0.9840295314788818,53,122,211,280,158,158,fluttershy|spike|twilight sparkle,carelessdoodler
228674.jpeg,https://derpicdn.net/img/view/2013/1/30/228674.jpeg,1,0.9835147857666016,357,154,487,284,130,130,fluttershy|spike|twilight sparkle,carelessdoodler
232728.jpeg,https://derpicdn.net/img/view/2013/2/3/232728.jpeg,1,0.9850994348526,69,286,377,594,308,308,princess celestia|princess luna|trixie|twilight sparkle,johnjoseco
232728.jpeg,https://derpicdn.net/img/view/2013/2/3/232728.jpeg,2,0.9811747074127196,204,50,568,414,364,364,princess celestia|princess luna|trixie|twilight sparkle,johnjoseco
232728.jpeg,https://derpicdn.net/img/view/2013/2/3/232728.jpeg,3,0.9509485960006714,741,141,999,399,258,258,princess celestia|princess luna|trixie|twilight sparkle,johnjoseco
233242.jpeg,https://derpicdn.net/img/view/2013/2/4/233242.jpeg,0,0.9827769994735718,193,245,423,475,230,230,princess celestia|princess luna|trixie|twilight sparkle,johnjoseco
233242.jpeg,https://derpicdn.net/img/view/2013/2/4/233242.jpeg,1,0.9766105413436892,124,24,414,314,290,290,princess celestia|princess luna|trixie|twilight sparkle,johnjoseco
233242.jpeg,https://derpicdn.net/img/view/2013/2/4/233242.jpeg,3,0.9156951308250428,520,94,718,292,198,198,princess celestia|princess luna|trixie|twilight sparkle,johnjoseco
235151.jpeg,https://derpicdn.net/img/view/2013/2/6/235151.jpeg,0,0.9550021886825562,1030,67,1372,409,342,342,rarity|trixie|twilight sparkle,pluckyninja
235151.jpeg,https://derpicdn.net/img/view/2013/2/6/235151.jpeg,1,0.9532803893089294,153,5,561,413,408,408,rarity|trixie|twilight sparkle,pluckyninja
239010.jpeg,https://derpicdn.net/img/view/2013/2/10/239010.jpeg,0,0.9993488192558287,758,320,1170,732,412,412,princess celestia|twilight sparkle,ss2sonic
239010.jpeg,https://derpicdn.net/img/view/2013/2/10/239010.jpeg,1,0.9733869433403016,379,69,883,573,504,504,princess celestia|twilight sparkle,ss2sonic
241365.jpeg,https://derpicdn.net/img/view/2013/2/12/241365.jpeg,0,0.9887937903404236,317,35,655,373,338,338,spike|twilight sparkle,dot-doll
242510.jpeg,https://derpicdn.net/img/view/2013/2/14/242510.jpeg,0,0.9950143694877625,403,36,799,432,396,396,princess celestia|twilight sparkle,slavedemorto
242641.jpeg,https://derpicdn.net/img/view/2013/2/14/242641.jpeg,1,0.9337432980537416,801,713,1505,1417,704,704,applejack|fluttershy|mane six|pinkie pie|rainbow dash|rarity|twilight sparkle,janji009
246031.jpeg,https://derpicdn.net/img/view/2013/2/17/246031.jpeg,0,0.998372495174408,359,448,539,628,180,180,trixie|twilight sparkle,digoraccoon
246031.jpeg,https://derpicdn.net/img/view/2013/2/17/246031.jpeg,3,0.9441910386085508,423,723,639,939,216,216,trixie|twilight sparkle,digoraccoon
246745.jpeg,https://derpicdn.net/img/view/2013/2/17/246745.jpeg,0,0.9584438800811768,356,343,618,605,262,262,applejack|fluttershy|mane six|pinkie pie|rainbow dash|rarity|twilight sparkle,keterok
246867.jpeg,https://derpicdn.net/img/view/2013/2/17/246867.jpeg,0,0.9913013577461244,537,136,1127,726,590,590,rainbow dash|twilight sparkle,lostzilla
247230.jpeg,https://derpicdn.net/img/view/2013/2/18/247230.jpeg,0,0.9042342901229858,138,43,432,337,294,294,applejack|rainbow dash|twilight sparkle,anibaruthecat
248125.jpeg,https://derpicdn.net/img/view/2013/2/18/248125.jpeg,1,0.9949944019317628,54,191,320,457,266,266,applejack|fluttershy|mane six|pinkie pie|rainbow dash|rarity|twilight sparkle,shepherd0821
251767.jpeg,https://derpicdn.net/img/view/2013/2/22/251767.jpeg,0,0.9995903372764589,546,0,878,331,332,331,rarity|twilight sparkle,earthsong9405
251767.jpeg,https://derpicdn.net/img/view/2013/2/22/251767.jpeg,1,0.9993603825569152,374,3,614,243,240,240,rarity|twilight sparkle,earthsong9405
251943.jpeg,https://derpicdn.net/img/view/2013/2/22/251943.jpeg,0,0.9523532390594482,2918,695,3810,1587,892,892,applejack|fluttershy|mane six|pinkie pie|rainbow dash|rarity|spike|twilight sparkle,1vladislav
252858.jpeg,https://derpicdn.net/img/view/2013/2/23/252858.jpeg,0,0.9964195489883424,1246,148,1974,876,728,728,princess celestia|princess luna|twilight sparkle,harwick
252858.jpeg,https://derpicdn.net/img/view/2013/2/23/252858.jpeg,1,0.9759331345558168,334,236,1442,1344,1108,1108,princess celestia|princess luna|twilight sparkle,harwick
253792.jpeg,https://derpicdn.net/img/view/2013/2/24/253792.jpeg,0,0.9380054473876952,0,496,428,972,428,476,princess celestia|princess luna|twilight sparkle,foxi-5
259779.jpeg,https://derpicdn.net/img/view/2013/3/2/259779.jpeg,0,0.9656076431274414,468,500,878,910,410,410,princess celestia|twilight sparkle,deathcutlet|michelangelo
264399.jpeg,https://derpicdn.net/img/view/2013/3/6/264399.jpeg,1,0.984820544719696,556,0,1016,414,460,414,princess celestia|twilight sparkle,johnjoseco
269843.jpeg,https://derpicdn.net/img/view/2013/3/13/269843.jpeg,0,0.9867267012596128,168,49,396,277,228,228,fluttershy|twilight sparkle,polywomple
270415.jpeg,https://derpicdn.net/img/view/2013/3/14/270415.jpeg,1,0.9864498972892758,202,0,1134,790,932,790,applejack|pinkie pie|twilight sparkle,yulyeen
272774.jpeg,https://derpicdn.net/img/view/2013/3/17/272774.jpeg,0,0.9873253107070924,1771,36,2023,288,252,252,applejack|fluttershy|mane six|pinkie pie|rainbow dash|rarity|twilight sparkle,polywomple
272774.jpeg,https://derpicdn.net/img/view/2013/3/17/272774.jpeg,1,0.9191272854804992,1333,31,1577,275,244,244,applejack|fluttershy|mane six|pinkie pie|rainbow dash|rarity|twilight sparkle,polywomple
278609.jpeg,https://derpicdn.net/img/view/2013/3/24/278609.jpeg,1,0.9498291611671448,1207,328,2065,1186,858,858,applejack|fluttershy|pinkie pie|rainbow dash|rarity|twilight sparkle,metadragonart
280934.jpeg,https://derpicdn.net/img/view/2013/3/27/280934.jpeg,0,0.9767721891403198,419,0,657,202,238,202,apple bloom|applejack|big macintosh|fluttershy|mane six|pinkie pie|rainbow dash|rarity|spike|sweetie belle|twilight sparkle,shutterflye
281281.jpeg,https://derpicdn.net/img/view/2013/3/28/281281.jpeg,0,0.9873701333999634,225,558,569,902,344,344,princess cadance|princess celestia|princess luna|queen chrysalis|twilight sparkle,newyorkx3
281281.jpeg,https://derpicdn.net/img/view/2013/3/28/281281.jpeg,1,0.9813562631607056,824,693,1206,1075,382,382,princess cadance|princess celestia|princess luna|queen chrysalis|twilight sparkle,newyorkx3
281501.jpeg,https://derpicdn.net/img/view/2013/3/28/281501.jpeg,0,0.9953915476799012,232,42,750,560,518,518,pinkie pie|twilight sparkle,kimbawest|jojocoso
281501.jpeg,https://derpicdn.net/img/view/2013/3/28/281501.jpeg,1,0.99049973487854,716,64,1194,542,478,478,pinkie pie|twilight sparkle,kimbawest|jojocoso
281639.jpeg,https://derpicdn.net/img/view/2013/3/28/281639.jpeg,0,0.9950706958770752,323,126,503,306,180,180,spike|twilight sparkle,el-yeguero
281639.jpeg,https://derpicdn.net/img/view/2013/3/28/281639.jpeg,1,0.9213292002677916,153,142,321,310,168,168,spike|twilight sparkle,el-yeguero
282412.jpeg,https://derpicdn.net/img/view/2013/3/29/282412.jpeg,1,0.9944005012512208,570,325,828,583,258,258,applejack|fluttershy|mane six|pinkie pie|rainbow dash|rarity|twilight sparkle,fatcakes
282663.jpeg,https://derpicdn.net/img/view/2013/3/29/282663.jpeg,0,0.95897376537323,787,387,1235,835,448,448,princess cadance|princess celestia|princess luna|twilight sparkle,newyorkx3
285475.jpeg,https://derpicdn.net/img/view/2013/4/1/285475.jpeg,0,0.992184042930603,550,284,778,512,228,228,applejack|fluttershy|mane six|pinkie pie|rainbow dash|rarity|twilight sparkle,mol
287355.jpeg,https://derpicdn.net/img/view/2013/4/3/287355.jpeg,0,0.9756694436073304,410,29,1140,759,730,730,spike|twilight sparkle,ss2sonic
292821.jpeg,https://derpicdn.net/img/view/2013/4/9/292821.jpeg,0,0.9652954339981079,433,1105,691,1358,258,253,princess celestia|princess luna|twilight sparkle,newyorkx3
297713.jpeg,https://derpicdn.net/img/view/2013/4/14/297713.jpeg,0,0.9990155696868896,96,58,390,352,294,294,fluttershy|twilight sparkle,blabyloo229
299574.jpeg,https://derpicdn.net/img/view/2013/4/16/299574.jpeg,0,0.9221034646034241,338,760,848,1270,510,510,princess cadance|princess celestia|princess luna|twilight sparkle,joakaha
299574.jpeg,https://derpicdn.net/img/view/2013/4/16/299574.jpeg,1,0.9180857539176941,874,815,1350,1291,476,476,princess cadance|princess celestia|princess luna|twilight sparkle,joakaha
301392.jpeg,https://derpicdn.net/img/view/2013/4/18/301392.jpeg,0,0.971632719039917,587,11,963,387,376,376,applejack|fluttershy|pinkie pie|rainbow dash|rarity|twilight sparkle,raynesgem
301600.jpeg,https://derpicdn.net/img/view/2013/4/18/301600.jpeg,0,0.9591305255889891,1430,133,1620,323,190,190,apple bloom|applejack|big macintosh|braeburn|cutie mark crusaders|diamond tiara|fluttershy|granny smith|mane six|pinkie pie|princess celestia|princess luna|rainbow dash|rarity|scootaloo|silver spoon|spike|sweetie belle|trixie|twilight sparkle,solar-slash
301600.jpeg,https://derpicdn.net/img/view/2013/4/18/301600.jpeg,1,0.9482055902481079,2472,533,2694,755,222,222,apple bloom|applejack|big macintosh|braeburn|cutie mark crusaders|diamond tiara|fluttershy|granny smith|mane six|pinkie pie|princess celestia|princess luna|rainbow dash|rarity|scootaloo|silver spoon|spike|sweetie belle|trixie|twilight sparkle,solar-slash
308536.jpeg,https://derpicdn.net/img/view/2013/4/26/308536.jpeg,0,0.9942891001701356,491,636,829,974,338,338,queen chrysalis|sunset shimmer|twilight sparkle,fox-moonglow
309796.jpeg,https://derpicdn.net/img/view/2013/4/27/309796.jpeg,0,0.9981698393821716,1179,178,1875,874,696,696,applejack|rarity|sweetie belle|twilight sparkle,chibi-jen-hen
309796.jpeg,https://derpicdn.net/img/view/2013/4/27/309796.jpeg,1,0.9959691166877748,668,1345,1248,1925,580,580,applejack|rarity|sweetie belle|twilight sparkle,chibi-jen-hen
310052.jpeg,https://derpicdn.net/img/view/2013/4/27/310052.jpeg,0,0.9990730285644532,619,139,995,515,376,376,rainbow dash|twilight sparkle,alasou
310052.jpeg,https://derpicdn.net/img/view/2013/4/27/310052.jpeg,1,0.9951746463775636,325,125,677,477,352,352,rainbow dash|twilight sparkle,alasou
310883.jpeg,https://derpicdn.net/img/view/2013/4/28/310883.jpeg,0,0.991186022758484,61,131,205,275,144,144,apple bloom|applejack|big macintosh|fluttershy|mane six|pinkie pie|rainbow dash|rarity|shining armor|sweetie belle|twilight sparkle,sibsy
310883.jpeg,https://derpicdn.net/img/view/2013/4/28/310883.jpeg,1,0.9857945442199708,378,71,642,335,264,264,apple bloom|applejack|big macintosh|fluttershy|mane six|pinkie pie|rainbow dash|rarity|shining armor|sweetie belle|twilight sparkle,sibsy
313518.jpeg,https://derpicdn.net/img/view/2013/5/1/313518.jpeg,0,0.9871068000793456,0,322,143,468,143,146,applejack|big macintosh|fluttershy|pinkie pie|princess celestia|princess luna|rainbow dash|rarity|spike|twilight sparkle,inuhoshi-to-darkpen
314618.jpeg,https://derpicdn.net/img/view/2013/5/2/314618.jpeg,1,0.9018968343734741,98,263,640,805,542,542,princess cadance|princess celestia|princess luna|twilight sparkle,ladymonotone
317021.jpeg,https://derpicdn.net/img/view/2013/5/5/317021.jpeg,0,0.9895232915878296,1100,2424,1938,3262,838,838,spike|twilight sparkle,kaeveris
329527.jpeg,https://derpicdn.net/img/view/2013/5/20/329527.jpeg,0,0.9341236352920532,1934,501,2716,1283,782,782,applejack|fluttershy|mane six|pinkie pie|rainbow dash|rarity|spike|twilight sparkle,ss2sonic
330304.jpeg,https://derpicdn.net/img/view/2013/5/21/330304.jpeg,0,0.9712016582489014,627,0,2500,2276,1873,2276,shining armor|twilight sparkle,surgicalarts
332631.jpeg,https://derpicdn.net/img/view/2013/5/24/332631.jpeg,2,0.94098699092865,1370,834,1556,1020,186,186,apple bloom|applejack|big macintosh|cutie mark crusaders|discord|fluttershy|mane six|pinkie pie|rainbow dash|rarity|scootaloo|shining armor|spike|sweetie belle|trixie|twilight sparkle,doublewbrothers
333919.jpeg,https://derpicdn.net/img/view/2013/5/26/333919.jpeg,0,0.9928895831108092,714,822,1294,1402,580,580,fluttershy|twilight sparkle,otakuap
334141.jpeg,https://derpicdn.net/img/view/2013/5/26/334141.jpeg,0,0.9967949986457824,1968,636,2496,1164,528,528,applejack|fluttershy|mane six|pinkie pie|rainbow dash|rarity|spike|twilight sparkle,agenthisui
334959.jpeg,https://derpicdn.net/img/view/2013/5/27/334959.jpeg,0,0.9570301175117492,0,106,1089,1246,1089,1140,rainbow dash|twilight sparkle,xquiizitgam3r
335173.jpeg,https://derpicdn.net/img/view/2013/5/28/335173.jpeg,0,0.9633347988128662,632,0,820,160,188,160,applejack|fluttershy|mane six|pinkie pie|rainbow dash|rarity|twilight sparkle,adyon
335460.jpeg,https://derpicdn.net/img/view/2013/5/28/335460.jpeg,0,0.9997645020484924,95,0,601,454,506,454,pinkie pie|twilight sparkle,prodigymysoul
338654.jpeg,https://derpicdn.net/img/view/2013/6/1/338654.jpeg,1,0.9883688688278198,245,47,385,187,140,140,spike|twilight sparkle,fulgenscat95
338875.jpeg,https://derpicdn.net/img/view/2013/6/2/338875.jpeg,0,0.9975277781486512,1315,654,1931,1270,616,616,applejack|discord|fluttershy|pinkie pie|rainbow dash|rarity|spike|twilight sparkle,saturdaymorningproj
338875.jpeg,https://derpicdn.net/img/view/2013/6/2/338875.jpeg,2,0.965739369392395,1673,766,2169,1314,496,548,applejack|discord|fluttershy|pinkie pie|rainbow dash|rarity|spike|twilight sparkle,saturdaymorningproj
340207.jpeg,https://derpicdn.net/img/view/2013/6/4/340207.jpeg,0,0.9740342497825624,352,0,1062,689,710,689,spike|twilight sparkle,mlpegasis4898
340995.jpeg,https://derpicdn.net/img/view/2013/6/5/340995.jpeg,0,0.9947482347488404,613,230,795,412,182,182,spike|twilight sparkle,ichibangravity
342041.jpeg,https://derpicdn.net/img/view/2013/6/7/342041.jpeg,0,0.9867376685142516,120,39,386,305,266,266,princess celestia|twilight sparkle,phurie
342056.jpeg,https://derpicdn.net/img/view/2013/6/7/342056.jpeg,0,0.9539387822151184,242,0,572,289,330,289,trixie|twilight sparkle,phurie
343938.jpeg,https://derpicdn.net/img/view/2013/6/9/343938.jpeg,0,0.9606464505195618,338,33,596,291,258,258,applejack|fluttershy|mane six|pinkie pie|rainbow dash|rarity|twilight sparkle,johnjoseco
346327.jpeg,https://derpicdn.net/img/view/2013/6/11/346327.jpeg,0,0.997908890247345,55,546,361,852,306,306,apple bloom|applejack|babs seed|cutie mark crusaders|fluttershy|mane six|pinkie pie|princess celestia|rainbow dash|rarity|scootaloo|spike|spitfire|sweetie belle|twilight sparkle,mintystitch
346682.jpeg,https://derpicdn.net/img/view/2013/6/12/346682.jpeg,1,0.9246229529380798,394,786,1566,1958,1172,1172,spike|twilight sparkle,doublewbrothers
347591.jpeg,https://derpicdn.net/img/view/2013/6/13/347591.jpeg,0,0.9913284778594972,335,0,567,214,232,214,applejack|fluttershy|mane six|pinkie pie|rainbow dash|rarity|spike|twilight sparkle,shepherd0821
347591.jpeg,https://derpicdn.net/img/view/2013/6/13/347591.jpeg,1,0.9801246523857116,841,331,1059,549,218,218,applejack|fluttershy|mane six|pinkie pie|rainbow dash|rarity|spike|twilight sparkle,shepherd0821
347591.jpeg,https://derpicdn.net/img/view/2013/6/13/347591.jpeg,2,0.9694873690605164,216,277,404,465,188,188,applejack|fluttershy|mane six|pinkie pie|rainbow dash|rarity|spike|twilight sparkle,shepherd0821
347591.jpeg,https://derpicdn.net/img/view/2013/6/13/347591.jpeg,3,0.9661730527877808,652,32,900,280,248,248,applejack|fluttershy|mane six|pinkie pie|rainbow dash|rarity|spike|twilight sparkle,shepherd0821
347591.jpeg,https://derpicdn.net/img/view/2013/6/13/347591.jpeg,4,0.938389778137207,513,62,733,282,220,220,applejack|fluttershy|mane six|pinkie pie|rainbow dash|rarity|spike|twilight sparkle,shepherd0821
347844.jpeg,https://derpicdn.net/img/view/2013/6/13/347844.jpeg,0,0.9886541366577148,36,33,230,227,194,194,fluttershy|rainbow dash|twilight sparkle,mr-tiaa
347844.jpeg,https://derpicdn.net/img/view/2013/6/13/347844.jpeg,1,0.9712992310523988,214,17,398,201,184,184,fluttershy|rainbow dash|twilight sparkle,mr-tiaa
349087.jpeg,https://derpicdn.net/img/view/2013/6/15/349087.jpeg,1,0.9992782473564148,1730,264,2102,636,372,372,applejack|fluttershy|mane six|pinkie pie|rainbow dash|rarity|twilight sparkle,araraginatsuki
349087.jpeg,https://derpicdn.net/img/view/2013/6/15/349087.jpeg,2,0.9955126047134399,65,273,415,623,350,350,applejack|fluttershy|mane six|pinkie pie|rainbow dash|rarity|twilight sparkle,araraginatsuki
349087.jpeg,https://derpicdn.net/img/view/2013/6/15/349087.jpeg,3,0.9891297221183776,725,287,1079,641,354,354,applejack|fluttershy|mane six|pinkie pie|rainbow dash|rarity|twilight sparkle,araraginatsuki
352327.jpeg,https://derpicdn.net/img/view/2013/6/19/352327.jpeg,0,0.9400392174720764,1485,272,2261,1048,776,776,pinkie pie|twilight sparkle,helenasherzblut
352431.jpeg,https://derpicdn.net/img/view/2013/6/19/352431.jpeg,0,0.9921575784683228,431,421,543,533,112,112,apple bloom|applejack|babs seed|big macintosh|braeburn|cutie mark crusaders|discord|fluttershy|granny smith|lightning dust|mane six|pinkie pie|princess cadance|princess celestia|queen chrysalis|rainbow dash|rarity|scootaloo|shining armor|soarin'|spike|spitfire|sweetie belle|trixie|twilight sparkle,kenket|spainfischer
353442.jpeg,https://derpicdn.net/img/view/2013/6/21/353442.jpeg,0,0.9793063998222352,431,199,593,361,162,162,applejack|fluttershy|mane six|pinkie pie|rainbow dash|rarity|spike|twilight sparkle,tzelly-el
353442.jpeg,https://derpicdn.net/img/view/2013/6/21/353442.jpeg,2,0.9145241379737854,184,104,394,314,210,210,applejack|fluttershy|mane six|pinkie pie|rainbow dash|rarity|spike|twilight sparkle,tzelly-el
353739.jpeg,https://derpicdn.net/img/view/2013/6/21/353739.jpeg,0,0.9977648258209229,429,491,1249,1311,820,820,princess cadance|twilight sparkle,longren|mcstalins
353911.jpeg,https://derpicdn.net/img/view/2013/6/21/353911.jpeg,0,0.9954859614372252,674,1049,1724,2099,1050,1050,applejack|rainbow dash|twilight sparkle,graystripe64
353911.jpeg,https://derpicdn.net/img/view/2013/6/21/353911.jpeg,1,0.993338108062744,1596,1294,2868,2566,1272,1272,applejack|rainbow dash|twilight sparkle,graystripe64
354045.jpeg,https://derpicdn.net/img/view/2013/6/22/354045.jpeg,0,0.9530245661735536,600,456,784,640,184,184,applejack|fluttershy|mane six|pinkie pie|rainbow dash|rarity|twilight sparkle,kutuyatti
355636.jpeg,https://derpicdn.net/img/view/2013/6/24/355636.jpeg,0,0.9915717244148254,3554,180,4604,1230,1050,1050,applejack|fluttershy|mane six|pinkie pie|rainbow dash|rarity|spike|sweetie belle|twilight sparkle,xenalollie
355731.jpeg,https://derpicdn.net/img/view/2013/6/24/355731.jpeg,0,0.9820927977561952,448,40,1376,968,928,928,apple bloom|applejack|cutie mark crusaders|rainbow dash|rarity|scootaloo|sweetie belle|twilight sparkle,captainpudgemuffin
356999.jpeg,https://derpicdn.net/img/view/2013/6/25/356999.jpeg,0,0.9712426662445068,762,373,1076,665,314,292,fluttershy|trixie|twilight sparkle,velgarn
360812.jpeg,https://derpicdn.net/img/view/2013/6/30/360812.jpeg,0,0.998964548110962,714,493,1220,999,506,506,princess cadance|shining armor|spike|twilight sparkle,ruberphoenix
361608.jpeg,https://derpicdn.net/img/view/2013/7/1/361608.jpeg,0,0.9725239872932434,572,139,838,405,266,266,trixie|twilight sparkle,mechagen
361843.jpeg,https://derpicdn.net/img/view/2013/7/1/361843.jpeg,0,0.9644403457641602,21,670,445,1094,424,424,applejack|fluttershy|rainbow dash|twilight sparkle,jowybean
361876.jpeg,https://derpicdn.net/img/view/2013/7/1/361876.jpeg,0,0.9663552641868592,0,840,375,1264,375,424,princess celestia|princess luna|twilight sparkle,newyorkx3
362335.jpeg,https://derpicdn.net/img/view/2013/7/2/362335.jpeg,1,0.9923539161682128,523,59,809,345,286,286,trixie|twilight sparkle,digoraccoon
366230.jpeg,https://derpicdn.net/img/view/2013/7/7/366230.jpeg,0,0.9923385977745056,311,136,461,286,150,150,rainbow dash|twilight sparkle,fadri
366230.jpeg,https://derpicdn.net/img/view/2013/7/7/366230.jpeg,1,0.9478342533111572,202,1,328,127,126,126,rainbow dash|twilight sparkle,fadri
367494.jpeg,https://derpicdn.net/img/view/2013/7/8/367494.jpeg,0,0.9544865489006042,210,1,500,291,290,290,rainbow dash|twilight sparkle,mechagen
369214.jpeg,https://derpicdn.net/img/view/2013/7/10/369214.jpeg,0,0.9973684549331664,0,0,394,372,394,372,applejack|rainbow dash|twilight sparkle,nanook123
370080.jpeg,https://derpicdn.net/img/view/2013/7/11/370080.jpeg,0,0.9662207961082458,2550,1033,3414,1897,864,864,princess celestia|twilight sparkle,pridark
377567.jpeg,https://derpicdn.net/img/view/2013/7/18/377567.jpeg,0,0.9587100148200988,7097,788,8113,1804,1016,1016,applejack|fluttershy|mane six|pinkie pie|princess cadance|rainbow dash|rarity|spike|twilight sparkle,unnop64
377567.jpeg,https://derpicdn.net/img/view/2013/7/18/377567.jpeg,2,0.9303123354911804,3675,62,4513,900,838,838,applejack|fluttershy|mane six|pinkie pie|princess cadance|rainbow dash|rarity|spike|twilight sparkle,unnop64
377743.jpeg,https://derpicdn.net/img/view/2013/7/18/377743.jpeg,1,0.994784653186798,1477,1536,2000,2102,523,566,applejack|fluttershy|mane six|pinkie pie|princess celestia|princess luna|queen chrysalis|rainbow dash|rarity|spike|twilight sparkle,starbat
381320.jpeg,https://derpicdn.net/img/view/2013/7/22/381320.jpeg,0,0.9869111776351928,978,0,1510,477,532,477,applejack|fluttershy|mane six|pinkie pie|rainbow dash|rarity|twilight sparkle,shepherd0821
381320.jpeg,https://derpicdn.net/img/view/2013/7/22/381320.jpeg,2,0.9115755558013916,590,149,826,385,236,236,applejack|fluttershy|mane six|pinkie pie|rainbow dash|rarity|twilight sparkle,shepherd0821
381838.jpeg,https://derpicdn.net/img/view/2013/7/23/381838.jpeg,0,0.9253213405609132,1428,1055,1914,1541,486,486,princess celestia|spike|twilight sparkle,jackjacko-eponymous
382637.jpeg,https://derpicdn.net/img/view/2013/7/24/382637.jpeg,0,0.9941468834877014,1048,675,1874,1501,826,826,princess luna|twilight sparkle,erovoid
382637.jpeg,https://derpicdn.net/img/view/2013/7/24/382637.jpeg,1,0.989740788936615,621,990,1183,1552,562,562,princess luna|twilight sparkle,erovoid
383821.jpeg,https://derpicdn.net/img/view/2013/7/29/383821.jpeg,1,0.9598328471183776,470,0,804,282,334,282,applejack|big macintosh|fluttershy|granny smith|mane six|pinkie pie|rainbow dash|rarity|spike|twilight sparkle,suikuzu
384061.jpeg,https://derpicdn.net/img/view/2013/7/29/384061.jpeg,0,0.9797425270080566,285,294,595,604,310,310,shining armor|twilight sparkle,sweetangeldelight
384223.jpeg,https://derpicdn.net/img/view/2013/7/29/384223.jpeg,0,0.9417122602462769,271,238,629,596,358,358,princess celestia|twilight sparkle,newyorkx3
388422.jpeg,https://derpicdn.net/img/view/2013/8/1/388422.jpeg,0,0.9915847182273864,108,0,710,443,602,443,fluttershy|twilight sparkle,tzulin520
388445.jpeg,https://derpicdn.net/img/view/2013/8/1/388445.jpeg,0,0.9573889374732972,1034,1217,1749,2061,715,844,applejack|fluttershy|pinkie pie|rainbow dash|rarity|twilight sparkle,jowybean
389741.jpeg,https://derpicdn.net/img/view/2013/8/3/389741.jpeg,0,0.9846412539482116,0,67,2361,2579,2361,2512,discord|queen chrysalis|twilight sparkle,terkatoriam
389989.jpeg,https://derpicdn.net/img/view/2013/8/3/389989.jpeg,0,0.9992685317993164,67,119,261,313,194,194,applejack|fluttershy|mane six|pinkie pie|rainbow dash|rarity|twilight sparkle,merionminor
389989.jpeg,https://derpicdn.net/img/view/2013/8/3/389989.jpeg,1,0.985632598400116,573,0,783,203,210,203,applejack|fluttershy|mane six|pinkie pie|rainbow dash|rarity|twilight sparkle,merionminor
389989.jpeg,https://derpicdn.net/img/view/2013/8/3/389989.jpeg,2,0.9707267284393308,320,129,500,309,180,180,applejack|fluttershy|mane six|pinkie pie|rainbow dash|rarity|twilight sparkle,merionminor
389989.jpeg,https://derpicdn.net/img/view/2013/8/3/389989.jpeg,3,0.9665200710296632,209,246,381,418,172,172,applejack|fluttershy|mane six|pinkie pie|rainbow dash|rarity|twilight sparkle,merionminor
390585.jpeg,https://derpicdn.net/img/view/2013/8/4/390585.jpeg,1,0.9846618175506592,641,122,1097,578,456,456,applejack|fluttershy|mane six|pinkie pie|rainbow dash|rarity|spike|twilight sparkle,lizleeillustration
390585.jpeg,https://derpicdn.net/img/view/2013/8/4/390585.jpeg,2,0.9792968034744264,164,465,574,875,410,410,applejack|fluttershy|mane six|pinkie pie|rainbow dash|rarity|spike|twilight sparkle,lizleeillustration
390585.jpeg,https://derpicdn.net/img/view/2013/8/4/390585.jpeg,3,0.9589149355888368,1142,254,1448,624,306,370,applejack|fluttershy|mane six|pinkie pie|rainbow dash|rarity|spike|twilight sparkle,lizleeillustration
395221.jpeg,https://derpicdn.net/img/view/2013/8/9/395221.jpeg,0,0.9489145278930664,709,170,1095,556,386,386,princess celestia|twilight sparkle,newyorkx3
396177.jpeg,https://derpicdn.net/img/view/2013/8/10/396177.jpeg,0,0.9949148297309875,576,1571,1090,2085,514,514,applejack|fluttershy|pinkie pie|rainbow dash|rarity|spike|twilight sparkle,tsitra360|demoncat8
396177.jpeg,https://derpicdn.net/img/view/2013/8/10/396177.jpeg,1,0.9863850474357604,1389,244,2051,906,662,662,applejack|fluttershy|pinkie pie|rainbow dash|rarity|spike|twilight sparkle,tsitra360|demoncat8
396177.jpeg,https://derpicdn.net/img/view/2013/8/10/396177.jpeg,2,0.9719979166984558,1607,970,2100,1524,493,554,applejack|fluttershy|pinkie pie|rainbow dash|rarity|spike|twilight sparkle,tsitra360|demoncat8
396177.jpeg,https://derpicdn.net/img/view/2013/8/10/396177.jpeg,3,0.9636911749839784,250,993,834,1577,584,584,applejack|fluttershy|pinkie pie|rainbow dash|rarity|spike|twilight sparkle,tsitra360|demoncat8
396177.jpeg,https://derpicdn.net/img/view/2013/8/10/396177.jpeg,5,0.9400663375854492,322,302,944,924,622,622,applejack|fluttershy|pinkie pie|rainbow dash|rarity|spike|twilight sparkle,tsitra360|demoncat8
398309.jpeg,https://derpicdn.net/img/view/2013/8/12/398309.jpeg,0,0.9829093813896179,387,0,747,320,360,320,spike|twilight sparkle,k-otic-studios|evilskunk
398353.jpeg,https://derpicdn.net/img/view/2013/8/12/398353.jpeg,0,0.99552720785141,30,0,520,419,490,419,spike|twilight sparkle,aruurara
398353.jpeg,https://derpicdn.net/img/view/2013/8/12/398353.jpeg,1,0.984256625175476,763,0,1167,323,404,323,spike|twilight sparkle,aruurara
399300.jpeg,https://derpicdn.net/img/view/2013/8/13/399300.jpeg,0,0.9968023896217346,782,0,1570,771,788,771,spike|twilight sparkle,marik azemus34
399768.jpeg,https://derpicdn.net/img/view/2013/8/14/399768.jpeg,0,0.9213865399360656,583,938,855,1210,272,272,applejack|fluttershy|mane six|pinkie pie|rainbow dash|rarity|twilight sparkle,chibi-jen-hen
405721.jpeg,https://derpicdn.net/img/view/2013/8/20/405721.jpeg,0,0.9978175759315492,239,472,1319,1552,1080,1080,trixie|twilight sparkle,pridark
405721.jpeg,https://derpicdn.net/img/view/2013/8/20/405721.jpeg,1,0.9816631078720092,1595,500,2685,1590,1090,1090,trixie|twilight sparkle,pridark
406737.jpeg,https://derpicdn.net/img/view/2013/8/22/406737.jpeg,0,0.9862844944000244,339,250,605,516,266,266,applejack|fluttershy|mane six|pinkie pie|rainbow dash|rarity|twilight sparkle,ellisarts
406737.jpeg,https://derpicdn.net/img/view/2013/8/22/406737.jpeg,1,0.9781005382537842,587,40,845,298,258,258,applejack|fluttershy|mane six|pinkie pie|rainbow dash|rarity|twilight sparkle,ellisarts
410334.jpeg,https://derpicdn.net/img/view/2013/8/25/410334.jpeg,0,0.9886670112609864,209,79,671,541,462,462,trixie|twilight sparkle,foxda
410334.jpeg,https://derpicdn.net/img/view/2013/8/25/410334.jpeg,1,0.9198830723762512,606,125,998,517,392,392,trixie|twilight sparkle,foxda
411087.jpeg,https://derpicdn.net/img/view/2013/8/26/411087.jpeg,0,0.944717526435852,1350,219,1682,551,332,332,applejack|fluttershy|mane six|pinkie pie|princess luna|rainbow dash|rarity|spike|twilight sparkle,harwick
414848.jpeg,https://derpicdn.net/img/view/2013/8/30/414848.jpeg,0,0.9776447415351868,11,0,331,300,320,300,applejack|fluttershy|mane six|pinkie pie|rainbow dash|rarity|twilight sparkle,shadowh00f
415953.jpeg,https://derpicdn.net/img/view/2013/9/1/415953.jpeg,0,0.9375470876693726,824,73,1032,281,208,208,spike|twilight sparkle,tswt
416875.jpeg,https://derpicdn.net/img/view/2013/9/2/416875.jpeg,0,0.96751469373703,920,433,1190,703,270,270,apple bloom|babs seed|cutie mark crusaders|scootaloo|sweetie belle|twilight sparkle,pinkuh
416875.jpeg,https://derpicdn.net/img/view/2013/9/2/416875.jpeg,1,0.9113682508468628,317,82,649,414,332,332,apple bloom|babs seed|cutie mark crusaders|scootaloo|sweetie belle|twilight sparkle,pinkuh
419889.jpeg,https://derpicdn.net/img/view/2013/9/5/419889.jpeg,2,0.9896280765533448,0,857,398,1327,398,470,apple bloom|applejack|cutie mark crusaders|fluttershy|mane six|pinkie pie|princess luna|rainbow dash|rarity|scootaloo|sweetie belle|trixie|twilight sparkle,ninjaham
419889.jpeg,https://derpicdn.net/img/view/2013/9/5/419889.jpeg,5,0.9835522770881652,332,0,602,269,270,269,apple bloom|applejack|cutie mark crusaders|fluttershy|mane six|pinkie pie|princess luna|rainbow dash|rarity|scootaloo|sweetie belle|trixie|twilight sparkle,ninjaham
419939.jpeg,https://derpicdn.net/img/view/2013/9/5/419939.jpeg,1,0.9754027724266052,383,1573,921,2111,538,538,applejack|fluttershy|mane six|pinkie pie|rainbow dash|spike|twilight sparkle,jowybean
422453.jpeg,https://derpicdn.net/img/view/2013/9/8/422453.jpeg,0,0.9997709393501282,918,290,1216,588,298,298,spike|twilight sparkle,jowybean|xhazxmatx
422453.jpeg,https://derpicdn.net/img/view/2013/9/8/422453.jpeg,1,0.9976475238800048,74,1160,354,1440,280,280,spike|twilight sparkle,jowybean|xhazxmatx
422453.jpeg,https://derpicdn.net/img/view/2013/9/8/422453.jpeg,2,0.9755095839500428,914,0,1190,268,276,268,spike|twilight sparkle,jowybean|xhazxmatx
422453.jpeg,https://derpicdn.net/img/view/2013/9/8/422453.jpeg,3,0.9122148752212524,617,1257,895,1535,278,278,spike|twilight sparkle,jowybean|xhazxmatx
423492.jpeg,https://derpicdn.net/img/view/2013/9/9/423492.jpeg,0,0.964651346206665,373,2005,759,2391,386,386,applejack|fluttershy|pinkie pie|rainbow dash|rarity|scootaloo|twilight sparkle,wolfjedisamuel
426362.jpeg,https://derpicdn.net/img/view/2013/9/13/426362.jpeg,0,0.9820614457130432,226,760,596,1130,370,370,fluttershy|princess celestia|rarity|twilight sparkle,tonyfleecs
426362.jpeg,https://derpicdn.net/img/view/2013/9/13/426362.jpeg,1,0.9808408617973328,477,752,881,1156,404,404,fluttershy|princess celestia|rarity|twilight sparkle,tonyfleecs
432032.jpeg,https://derpicdn.net/img/view/2013/9/21/432032.jpeg,0,0.9290536046028136,190,0,852,698,662,698,rainbow dash|twilight sparkle,carligercarl
433550.jpeg,https://derpicdn.net/img/view/2013/9/23/433550.jpeg,0,0.9006389379501343,308,307,756,755,448,448,spike|twilight sparkle,wolfjedisamuel
437228.jpeg,https://derpicdn.net/img/view/2013/9/28/437228.jpeg,0,0.9728096127510072,546,291,800,577,254,286,apple bloom|applejack|big macintosh|fluttershy|granny smith|pinkie pie|princess celestia|rainbow dash|rarity|twilight sparkle,angieness|andypriceart
438143.jpeg,https://derpicdn.net/img/view/2013/9/30/438143.jpeg,0,0.9704896211624146,201,752,443,994,242,242,spike|twilight sparkle,midnight-wizard
440096.jpeg,https://derpicdn.net/img/view/2013/10/2/440096.jpeg,0,0.9945734143257141,523,72,743,292,220,220,rarity|twilight sparkle,masssssan|inoue
440096.jpeg,https://derpicdn.net/img/view/2013/10/2/440096.jpeg,1,0.9736648797988892,126,0,440,291,314,291,rarity|twilight sparkle,masssssan|inoue
441678.jpeg,https://derpicdn.net/img/view/2013/10/4/441678.jpeg,0,0.9888292551040648,1630,1010,2334,1714,704,704,spike|trixie|twilight sparkle,jowybean
445511.jpeg,https://derpicdn.net/img/view/2013/10/10/445511.jpeg,0,0.9943897724151612,447,77,781,411,334,334,princess luna|twilight sparkle,raikoh
447961.jpeg,https://derpicdn.net/img/view/2013/10/13/447961.jpeg,0,0.9603046178817748,504,414,712,622,208,208,fluttershy|pinkie pie|twilight sparkle,yulyeen
449635.jpeg,https://derpicdn.net/img/view/2013/10/15/449635.jpeg,1,0.94081711769104,0,3,453,479,453,476,applejack|twilight sparkle,suirano
449773.jpeg,https://derpicdn.net/img/view/2013/10/16/449773.jpeg,0,0.9970321655273438,686,401,900,651,214,250,applejack|fluttershy|mane six|pinkie pie|rainbow dash|rarity|spike|twilight sparkle,tsitra360
449773.jpeg,https://derpicdn.net/img/view/2013/10/16/449773.jpeg,1,0.9965127110481262,253,675,481,903,228,228,applejack|fluttershy|mane six|pinkie pie|rainbow dash|rarity|spike|twilight sparkle,tsitra360
449773.jpeg,https://derpicdn.net/img/view/2013/10/16/449773.jpeg,2,0.9744377136230468,100,424,360,684,260,260,applejack|fluttershy|mane six|pinkie pie|rainbow dash|rarity|spike|twilight sparkle,tsitra360
449773.jpeg,https://derpicdn.net/img/view/2013/10/16/449773.jpeg,3,0.9721575379371644,591,108,881,398,290,290,applejack|fluttershy|mane six|pinkie pie|rainbow dash|rarity|spike|twilight sparkle,tsitra360
449945.jpeg,https://derpicdn.net/img/view/2013/10/16/449945.jpeg,0,0.9922887682914734,108,0,506,398,398,398,applejack|twilight sparkle,suirano
450199.jpeg,https://derpicdn.net/img/view/2013/10/16/450199.jpeg,0,0.9908545613288879,344,451,624,731,280,280,fluttershy|rainbow dash|twilight sparkle,irigulus
455429.jpeg,https://derpicdn.net/img/view/2013/10/24/455429.jpeg,1,0.9399343132972716,2127,225,2495,593,368,368,pinkie pie|rainbow dash|twilight sparkle,otakuap
455980.jpeg,https://derpicdn.net/img/view/2013/10/25/455980.jpeg,0,0.9989063739776612,434,580,1362,1508,928,928,apple bloom|pinkie pie|twilight sparkle,marik azemus34
455980.jpeg,https://derpicdn.net/img/view/2013/10/25/455980.jpeg,1,0.9956112504005432,2551,917,3329,1695,778,778,apple bloom|pinkie pie|twilight sparkle,marik azemus34
456287.jpeg,https://derpicdn.net/img/view/2013/10/25/456287.jpeg,0,0.9888094067573548,609,4,900,334,291,330,princess cadance|twilight sparkle,andypriceart
456287.jpeg,https://derpicdn.net/img/view/2013/10/25/456287.jpeg,1,0.9884215593338012,0,1004,202,1250,202,246,princess cadance|twilight sparkle,andypriceart
459157.jpeg,https://derpicdn.net/img/view/2013/10/29/459157.jpeg,0,0.981752336025238,0,0,548,559,548,559,trixie|twilight sparkle,inkwel-mlp
459157.jpeg,https://derpicdn.net/img/view/2013/10/29/459157.jpeg,1,0.9319430589675904,672,7,1200,537,528,530,trixie|twilight sparkle,inkwel-mlp
462988.jpeg,https://derpicdn.net/img/view/2013/11/2/462988.jpeg,0,0.9962224960327148,221,134,477,390,256,256,pinkie pie|rainbow dash|twilight sparkle,bakki
462992.jpeg,https://derpicdn.net/img/view/2013/11/2/462992.jpeg,0,0.9958117008209229,220,132,480,392,260,260,pinkie pie|rainbow dash|twilight sparkle,bakki
463705.jpeg,https://derpicdn.net/img/view/2013/11/3/463705.jpeg,0,0.9944811463356018,216,130,478,392,262,262,pinkie pie|rainbow dash|twilight sparkle,bakki
465716.jpeg,https://derpicdn.net/img/view/2013/11/6/465716.jpeg,0,0.9443149566650392,464,47,670,253,206,206,spike|twilight sparkle,garam
470162.jpeg,https://derpicdn.net/img/view/2013/11/11/470162.jpeg,0,0.9942370057106018,400,417,1006,1023,606,606,pinkie pie|twilight sparkle,kanashiipanda
471140.jpeg,https://derpicdn.net/img/view/2013/11/12/471140.jpeg,0,0.9756073951721193,0,0,1410,1292,1410,1292,trixie|twilight sparkle,bakki
471965.jpeg,https://derpicdn.net/img/view/2013/11/13/471965.jpeg,1,0.99742990732193,480,312,734,566,254,254,princess celestia|princess luna|trixie|twilight sparkle,rainybed
476298.jpeg,https://derpicdn.net/img/view/2013/11/19/476298.jpeg,2,0.947615683078766,117,27,365,275,248,248,rarity|spike|twilight sparkle,ethanqix
479762.jpeg,https://derpicdn.net/img/view/2013/11/24/479762.jpeg,0,0.9617156386375428,748,0,1280,426,532,426,discord|pinkie pie|princess celestia|princess luna|twilight sparkle,suikuzu
479762.jpeg,https://derpicdn.net/img/view/2013/11/24/479762.jpeg,1,0.91886168718338,7,375,263,631,256,256,discord|pinkie pie|princess celestia|princess luna|twilight sparkle,suikuzu
481466.jpeg,https://derpicdn.net/img/view/2013/11/25/481466.jpeg,0,0.9165562391281128,290,134,508,352,218,218,pinkie pie|twilight sparkle,fadri
481606.jpeg,https://derpicdn.net/img/view/2013/11/25/481606.jpeg,0,0.9653102159500122,7,239,247,479,240,240,princess celestia|twilight sparkle,ruhje
484563.jpeg,https://derpicdn.net/img/view/2013/11/28/484563.jpeg,0,0.969227135181427,505,1013,1039,1547,534,534,applejack|fluttershy|mane six|pinkie pie|rainbow dash|rarity|twilight sparkle,rawshaw
488178.jpeg,https://derpicdn.net/img/view/2013/12/2/488178.jpeg,0,0.9861704111099244,395,57,619,281,224,224,rainbow dash|twilight sparkle,flying-fox
489323.jpeg,https://derpicdn.net/img/view/2013/12/4/489323.jpeg,0,0.96710866689682,241,936,789,1484,548,548,rainbow dash|twilight sparkle,wild-hearts|kikirdcz
490108.jpeg,https://derpicdn.net/img/view/2013/12/5/490108.jpeg,0,0.9858903884887696,4542,200,5512,1170,970,970,princess celestia|trixie|twilight sparkle,artknorke
490650.jpeg,https://derpicdn.net/img/view/2013/12/6/490650.jpeg,1,0.94843327999115,266,827,662,1223,396,396,apple bloom|applejack|big macintosh|cutie mark crusaders|discord|fluttershy|mane six|pinkie pie|rainbow dash|rarity|scootaloo|sweetie belle|trixie|twilight sparkle,doublewbrothers
494903.jpeg,https://derpicdn.net/img/view/2013/12/11/494903.jpeg,1,0.9584129452705384,1127,436,1309,618,182,182,applejack|fluttershy|mane six|pinkie pie|rainbow dash|rarity|twilight sparkle,invisibleguy-ponyman
494903.jpeg,https://derpicdn.net/img/view/2013/12/11/494903.jpeg,2,0.9146665334701538,573,203,933,563,360,360,applejack|fluttershy|mane six|pinkie pie|rainbow dash|rarity|twilight sparkle,invisibleguy-ponyman
494923.jpeg,https://derpicdn.net/img/view/2013/12/11/494923.jpeg,0,0.9991025328636168,1184,0,1890,695,706,695,rainbow dash|twilight sparkle,mysticalpha
494923.jpeg,https://derpicdn.net/img/view/2013/12/11/494923.jpeg,1,0.9783426523208618,777,496,1559,1278,782,782,rainbow dash|twilight sparkle,mysticalpha
495278.jpeg,https://derpicdn.net/img/view/2013/12/12/495278.jpeg,0,0.9973297119140624,263,0,629,363,366,363,spike|twilight sparkle,kaylathedragoness
495278.jpeg,https://derpicdn.net/img/view/2013/12/12/495278.jpeg,1,0.9647631049156188,484,742,794,1052,310,310,spike|twilight sparkle,kaylathedragoness
500635.jpeg,https://derpicdn.net/img/view/2013/12/18/500635.jpeg,2,0.902185559272766,1891,573,2535,1217,644,644,applejack|big macintosh|fluttershy|princess luna|rainbow dash|twilight sparkle,neonlightwolf
501222.jpeg,https://derpicdn.net/img/view/2013/12/19/501222.jpeg,1,0.9851962327957152,895,1111,1325,1541,430,430,applejack|fluttershy|mane six|pinkie pie|rainbow dash|rarity|twilight sparkle,rainbowjune
501222.jpeg,https://derpicdn.net/img/view/2013/12/19/501222.jpeg,2,0.9149250984191896,675,194,955,474,280,280,applejack|fluttershy|mane six|pinkie pie|rainbow dash|rarity|twilight sparkle,rainbowjune
501490.jpeg,https://derpicdn.net/img/view/2013/12/20/501490.jpeg,0,0.9968770146369934,415,0,649,181,234,181,applejack|fluttershy|mane six|pinkie pie|princess cadance|princess celestia|princess luna|queen chrysalis|rainbow dash|rarity|twilight sparkle,artzy-shy
501490.jpeg,https://derpicdn.net/img/view/2013/12/20/501490.jpeg,1,0.9865280389785768,164,0,402,184,238,184,applejack|fluttershy|mane six|pinkie pie|princess cadance|princess celestia|princess luna|queen chrysalis|rainbow dash|rarity|twilight sparkle,artzy-shy
501490.jpeg,https://derpicdn.net/img/view/2013/12/20/501490.jpeg,2,0.9816551804542542,1,49,211,259,210,210,applejack|fluttershy|mane six|pinkie pie|princess cadance|princess celestia|princess luna|queen chrysalis|rainbow dash|rarity|twilight sparkle,artzy-shy
503756.jpeg,https://derpicdn.net/img/view/2013/12/22/503756.jpeg,0,0.9434624910354614,0,33,623,767,623,734,applejack|fluttershy|mane six|pinkie pie|rainbow dash|rarity|spike|twilight sparkle,mysticalpha
505702.jpeg,https://derpicdn.net/img/view/2013/12/24/505702.jpeg,0,0.9948650002479552,938,304,1262,628,324,324,applejack|fluttershy|pinkie pie|rainbow dash|rarity|twilight sparkle,nolycs
505702.jpeg,https://derpicdn.net/img/view/2013/12/24/505702.jpeg,2,0.9598212838172911,64,27,446,409,382,382,applejack|fluttershy|pinkie pie|rainbow dash|rarity|twilight sparkle,nolycs
505702.jpeg,https://derpicdn.net/img/view/2013/12/24/505702.jpeg,3,0.9450943470001221,444,319,768,643,324,324,applejack|fluttershy|pinkie pie|rainbow dash|rarity|twilight sparkle,nolycs
508723.jpeg,https://derpicdn.net/img/view/2013/12/28/508723.jpeg,1,0.9918472766876221,289,230,693,634,404,404,applejack|fluttershy|mane six|pinkie pie|princess celestia|rainbow dash|rarity|twilight sparkle,brendahickey
511508.jpeg,https://derpicdn.net/img/view/2014/1/1/511508.jpeg,0,0.9643553495407104,1124,31,1492,399,368,368,applejack|fluttershy|mane six|pinkie pie|rainbow dash|rarity|twilight sparkle,yichiau
511735.jpeg,https://derpicdn.net/img/view/2014/1/1/511735.jpeg,1,0.9747170805931092,381,1681,881,2181,500,500,applejack|fluttershy|mane six|pinkie pie|princess luna|rainbow dash|rarity|twilight sparkle,artist-apprentice587
511807.jpeg,https://derpicdn.net/img/view/2014/1/1/511807.jpeg,0,0.9988851547241212,628,575,1720,1667,1092,1092,trixie|twilight sparkle,bluntwhiskey
512225.jpeg,https://derpicdn.net/img/view/2014/1/1/512225.jpeg,0,0.9745513796806335,354,517,510,673,156,156,princess celestia|princess luna|trixie|twilight sparkle,johnjoseco
513436.jpeg,https://derpicdn.net/img/view/2014/1/3/513436.jpeg,0,0.9928691983222958,2157,310,3015,1168,858,858,princess celestia|twilight sparkle,neko-me
513759.jpeg,https://derpicdn.net/img/view/2014/1/3/513759.jpeg,0,0.9763420820236206,2354,101,2956,703,602,602,applejack|big macintosh|fluttershy|mane six|pinkie pie|rainbow dash|rarity|spike|twilight sparkle,jmz|elosande
517542.jpeg,https://derpicdn.net/img/view/2014/1/7/517542.jpeg,0,0.9383490085601808,27,94,187,254,160,160,applejack|fluttershy|mane six|pinkie pie|rainbow dash|rarity|twilight sparkle,sonicpegasus
522216.jpeg,https://derpicdn.net/img/view/2014/1/12/522216.jpeg,0,0.9500341415405272,463,234,753,524,290,290,fluttershy|princess luna|twilight sparkle,wolfjedisamuel
524962.jpeg,https://derpicdn.net/img/view/2014/1/15/524962.jpeg,0,0.955600082874298,380,171,762,553,382,382,princess luna|twilight sparkle,true-amateur
532927.jpeg,https://derpicdn.net/img/view/2014/1/24/532927.jpeg,0,0.9016084671020508,707,37,1229,559,522,522,rainbow dash|twilight sparkle,requiemmedley
533389.jpeg,https://derpicdn.net/img/view/2014/1/25/533389.jpeg,0,0.941435158252716,649,102,1147,600,498,498,princess cadance|twilight sparkle,frostykat13
533411.jpeg,https://derpicdn.net/img/view/2014/1/25/533411.jpeg,0,0.9500529170036316,378,0,1156,654,778,654,rainbow dash|twilight sparkle,applemarshmallows
534049.jpeg,https://derpicdn.net/img/view/2014/1/25/534049.jpeg,0,0.9949965476989746,1163,257,1659,753,496,496,discord|princess cadance|twilight sparkle,raikoh
534230.jpeg,https://derpicdn.net/img/view/2014/1/25/534230.jpeg,0,0.9986494779586792,501,336,763,598,262,262,discord|princess cadance|twilight sparkle,johnjoseco
534806.jpeg,https://derpicdn.net/img/view/2014/1/26/534806.jpeg,0,0.9851838946342468,0,469,157,655,157,186,applejack|fluttershy|mane six|pinkie pie|princess celestia|princess luna|rainbow dash|rarity|twilight sparkle,kaceymeg
535099.jpeg,https://derpicdn.net/img/view/2014/1/26/535099.jpeg,1,0.904940903186798,215,478,707,970,492,492,discord|princess cadance|twilight sparkle,twotigermoon
536111.jpeg,https://derpicdn.net/img/view/2014/1/27/536111.jpeg,0,0.982217252254486,246,404,622,780,376,376,applejack|fluttershy|mane six|pinkie pie|rainbow dash|rarity|twilight sparkle,harwick
536111.jpeg,https://derpicdn.net/img/view/2014/1/27/536111.jpeg,1,0.9815986156463624,1174,0,1636,437,462,437,applejack|fluttershy|mane six|pinkie pie|rainbow dash|rarity|twilight sparkle,harwick
542301.jpeg,https://derpicdn.net/img/view/2014/2/3/542301.jpeg,0,0.9989277720451356,150,144,360,354,210,210,princess celestia|princess luna|twilight sparkle,johnjoseco
542301.jpeg,https://derpicdn.net/img/view/2014/2/3/542301.jpeg,1,0.962748110294342,413,94,657,338,244,244,princess celestia|princess luna|twilight sparkle,johnjoseco
543901.jpeg,https://derpicdn.net/img/view/2014/2/5/543901.jpeg,0,0.9985975623130798,625,45,1255,675,630,630,applejack|rainbow dash|twilight sparkle,conicer
543901.jpeg,https://derpicdn.net/img/view/2014/2/5/543901.jpeg,1,0.9618400931358336,1294,253,1916,875,622,622,applejack|rainbow dash|twilight sparkle,conicer
545117.jpeg,https://derpicdn.net/img/view/2014/2/6/545117.jpeg,0,0.992435097694397,101,105,295,299,194,194,pinkie pie|princess celestia|princess luna|twilight sparkle,el-yeguero
548647.jpeg,https://derpicdn.net/img/view/2014/2/10/548647.jpeg,0,0.9691642522811892,165,338,355,528,190,190,pinkie pie|spike|twilight sparkle,hazurasinner
549750.jpeg,https://derpicdn.net/img/view/2014/2/12/549750.jpeg,0,0.9795168042182922,420,452,736,745,316,293,applejack|fluttershy|lightning dust|mane six|pinkie pie|rainbow dash|rarity|spike|trixie|twilight sparkle,laliiyeaah
549750.jpeg,https://derpicdn.net/img/view/2014/2/12/549750.jpeg,1,0.967372477054596,129,64,373,308,244,244,applejack|fluttershy|lightning dust|mane six|pinkie pie|rainbow dash|rarity|spike|trixie|twilight sparkle,laliiyeaah
549750.jpeg,https://derpicdn.net/img/view/2014/2/12/549750.jpeg,2,0.9656817317008972,655,405,949,699,294,294,applejack|fluttershy|lightning dust|mane six|pinkie pie|rainbow dash|rarity|spike|trixie|twilight sparkle,laliiyeaah
550768.jpeg,https://derpicdn.net/img/view/2014/2/13/550768.jpeg,0,0.9901120066642758,224,118,652,546,428,428,shining armor|twilight sparkle,corsairsedge
551168.jpeg,https://derpicdn.net/img/view/2014/2/13/551168.jpeg,0,0.979200541973114,2208,1873,2824,2489,616,616,applejack|fluttershy|mane six|pinkie pie|rainbow dash|rarity|scootaloo|soarin'|spike|spitfire|twilight sparkle,peichenphilip
554698.jpeg,https://derpicdn.net/img/view/2014/2/17/554698.jpeg,0,0.9568852186203004,475,332,785,642,310,310,princess celestia|twilight sparkle,kolshica
555687.jpeg,https://derpicdn.net/img/view/2014/2/18/555687.jpeg,0,0.9106844067573548,675,214,1019,558,344,344,applejack|fluttershy|mane six|pinkie pie|rainbow dash|rarity|twilight sparkle,tacokurt
558683.jpeg,https://derpicdn.net/img/view/2014/2/22/558683.jpeg,0,0.9856265187263488,729,740,1109,1120,380,380,applejack|discord|fluttershy|mane six|pinkie pie|princess celestia|queen chrysalis|rainbow dash|rarity|sunset shimmer|twilight sparkle,hoodedtomsi
558683.jpeg,https://derpicdn.net/img/view/2014/2/22/558683.jpeg,1,0.9854369759559632,1129,44,1591,506,462,462,applejack|discord|fluttershy|mane six|pinkie pie|princess celestia|queen chrysalis|rainbow dash|rarity|sunset shimmer|twilight sparkle,hoodedtomsi
558683.jpeg,https://derpicdn.net/img/view/2014/2/22/558683.jpeg,2,0.98167085647583,401,187,863,649,462,462,applejack|discord|fluttershy|mane six|pinkie pie|princess celestia|queen chrysalis|rainbow dash|rarity|sunset shimmer|twilight sparkle,hoodedtomsi
559739.jpeg,https://derpicdn.net/img/view/2014/2/23/559739.jpeg,0,0.9965274333953856,1463,0,3885,2395,2422,2395,apple bloom|cutie mark crusaders|scootaloo|sweetie belle|twilight sparkle,bloodyhellhayden
559739.jpeg,https://derpicdn.net/img/view/2014/2/23/559739.jpeg,1,0.9733595848083496,3412,2546,5500,4804,2088,2258,apple bloom|cutie mark crusaders|scootaloo|sweetie belle|twilight sparkle,bloodyhellhayden
559739.jpeg,https://derpicdn.net/img/view/2014/2/23/559739.jpeg,2,0.9349550008773804,310,2536,2492,4718,2182,2182,apple bloom|cutie mark crusaders|scootaloo|sweetie belle|twilight sparkle,bloodyhellhayden
560806.jpeg,https://derpicdn.net/img/view/2014/2/24/560806.jpeg,0,0.9880736470222472,353,195,1399,1241,1046,1046,applejack|fluttershy|mane six|pinkie pie|rainbow dash|rarity|twilight sparkle,joycall6
561293.jpeg,https://derpicdn.net/img/view/2014/2/25/561293.jpeg,0,0.9095479249954224,141,459,589,907,448,448,princess celestia|twilight sparkle,aquagalaxy
561402.jpeg,https://derpicdn.net/img/view/2014/2/25/561402.jpeg,0,0.9314415454864502,515,37,803,325,288,288,applejack|fluttershy|mane six|pinkie pie|rainbow dash|rarity|spike|twilight sparkle,maytee
562218.jpeg,https://derpicdn.net/img/view/2014/2/26/562218.jpeg,0,0.9926579594612122,2408,827,3812,2231,1404,1404,trixie|twilight sparkle,laliiyeaah
562218.jpeg,https://derpicdn.net/img/view/2014/2/26/562218.jpeg,1,0.98115336894989,1266,430,2806,1970,1540,1540,trixie|twilight sparkle,laliiyeaah
564466.jpeg,https://derpicdn.net/img/view/2014/3/1/564466.jpeg,1,0.9646192193031312,242,219,562,539,320,320,spike|twilight sparkle,tswt
564466.jpeg,https://derpicdn.net/img/view/2014/3/1/564466.jpeg,2,0.959413468837738,514,371,712,569,198,198,spike|twilight sparkle,tswt
565406.jpeg,https://derpicdn.net/img/view/2014/3/2/565406.jpeg,0,0.9926489591598512,2083,1059,2629,1605,546,546,applejack|fluttershy|mane six|pinkie pie|rainbow dash|rarity|spike|twilight sparkle,jowybean
565531.jpeg,https://derpicdn.net/img/view/2014/3/3/565531.jpeg,0,0.9908082485198976,406,195,1144,933,738,738,applejack|rainbow dash|twilight sparkle,neko-me
565538.jpeg,https://derpicdn.net/img/view/2014/3/3/565538.jpeg,0,0.999589741230011,0,24,534,578,534,554,applejack|fluttershy|pinkie pie|princess celestia|rainbow dash|rarity|sunset shimmer|twilight sparkle,heir-of-rick
565538.jpeg,https://derpicdn.net/img/view/2014/3/3/565538.jpeg,1,0.9959163069725036,2390,941,2878,1429,488,488,applejack|fluttershy|pinkie pie|princess celestia|rainbow dash|rarity|sunset shimmer|twilight sparkle,heir-of-rick
565538.jpeg,https://derpicdn.net/img/view/2014/3/3/565538.jpeg,2,0.9939921498298644,661,1046,1113,1498,452,452,applejack|fluttershy|pinkie pie|princess celestia|rainbow dash|rarity|sunset shimmer|twilight sparkle,heir-of-rick
565538.jpeg,https://derpicdn.net/img/view/2014/3/3/565538.jpeg,3,0.9795438647270204,1974,0,2734,658,760,658,applejack|fluttershy|pinkie pie|princess celestia|rainbow dash|rarity|sunset shimmer|twilight sparkle,heir-of-rick
565538.jpeg,https://derpicdn.net/img/view/2014/3/3/565538.jpeg,5,0.96213561296463,83,1017,573,1507,490,490,applejack|fluttershy|pinkie pie|princess celestia|rainbow dash|rarity|sunset shimmer|twilight sparkle,heir-of-rick
567730.jpeg,https://derpicdn.net/img/view/2014/3/6/567730.jpeg,0,0.9948415756225586,934,12,1094,172,160,160,fluttershy|rainbow dash|twilight sparkle,my-magic-dream
567730.jpeg,https://derpicdn.net/img/view/2014/3/6/567730.jpeg,1,0.9927802681922911,515,7,695,187,180,180,fluttershy|rainbow dash|twilight sparkle,my-magic-dream
567730.jpeg,https://derpicdn.net/img/view/2014/3/6/567730.jpeg,2,0.9831444025039672,118,11,308,201,190,190,fluttershy|rainbow dash|twilight sparkle,my-magic-dream
569799.jpeg,https://derpicdn.net/img/view/2014/3/8/569799.jpeg,0,0.9716731905937196,245,105,531,391,286,286,applejack|twilight sparkle,shnider
570422.jpeg,https://derpicdn.net/img/view/2014/3/9/570422.jpeg,0,0.997519552707672,0,497,275,779,275,282,applejack|fluttershy|mane six|pinkie pie|rainbow dash|rarity|twilight sparkle,uotapo
570422.jpeg,https://derpicdn.net/img/view/2014/3/9/570422.jpeg,1,0.994617998600006,240,345,500,605,260,260,applejack|fluttershy|mane six|pinkie pie|rainbow dash|rarity|twilight sparkle,uotapo
570422.jpeg,https://derpicdn.net/img/view/2014/3/9/570422.jpeg,2,0.9940410852432252,61,63,333,335,272,272,applejack|fluttershy|mane six|pinkie pie|rainbow dash|rarity|twilight sparkle,uotapo
570422.jpeg,https://derpicdn.net/img/view/2014/3/9/570422.jpeg,3,0.9635626673698424,459,75,761,377,302,302,applejack|fluttershy|mane six|pinkie pie|rainbow dash|rarity|twilight sparkle,uotapo
571442.jpeg,https://derpicdn.net/img/view/2014/3/10/571442.jpeg,0,0.9884645938873292,502,262,748,542,246,280,spike|twilight sparkle,locksto
576243.jpeg,https://derpicdn.net/img/view/2014/3/15/576243.jpeg,0,0.9853896498680116,264,14,580,330,316,316,shining armor|trixie|twilight sparkle,evehly
576598.jpeg,https://derpicdn.net/img/view/2014/3/16/576598.jpeg,0,0.994994044303894,1368,0,2118,657,750,657,fluttershy|twilight sparkle,mistydash
577039.jpeg,https://derpicdn.net/img/view/2014/3/16/577039.jpeg,0,0.9121136665344238,1062,1142,1826,1906,764,764,pinkie pie|twilight sparkle,captainpudgemuffin
577631.jpeg,https://derpicdn.net/img/view/2014/3/17/577631.jpeg,0,0.9600017070770264,882,51,1074,243,192,192,applejack|fluttershy|mane six|pinkie pie|rainbow dash|rarity|trixie|twilight sparkle,harwick
578243.jpeg,https://derpicdn.net/img/view/2014/3/17/578243.jpeg,0,0.9859760403633118,138,182,404,448,266,266,discord|twilight sparkle,kenket|spainfischer
579351.jpeg,https://derpicdn.net/img/view/2014/3/19/579351.jpeg,0,0.9973084926605223,1049,545,1397,897,348,352,applejack|fluttershy|mane six|pinkie pie|princess celestia|rainbow dash|rarity|twilight sparkle,andypriceart
579351.jpeg,https://derpicdn.net/img/view/2014/3/19/579351.jpeg,3,0.9853426814079284,706,231,940,465,234,234,applejack|fluttershy|mane six|pinkie pie|princess celestia|rainbow dash|rarity|twilight sparkle,andypriceart
595132.jpeg,https://derpicdn.net/img/view/2014/4/7/595132.jpeg,0,0.9451797604560852,1335,0,1631,282,296,282,rainbow dash|twilight sparkle,viistar
595299.jpeg,https://derpicdn.net/img/view/2014/4/7/595299.jpeg,0,0.9661939740180968,0,8,265,284,265,276,princess cadance|princess celestia|princess luna|twilight sparkle,amy30535
595800.jpeg,https://derpicdn.net/img/view/2014/4/8/595800.jpeg,0,0.9988574981689452,654,1201,1164,1711,510,510,applejack|fluttershy|mane six|pinkie pie|rainbow dash|rarity|spike|twilight sparkle,audrarius
596244.jpeg,https://derpicdn.net/img/view/2014/4/9/596244.jpeg,0,0.9964034557342528,4,561,910,1467,906,906,rarity|twilight sparkle,conicer
596385.jpeg,https://derpicdn.net/img/view/2014/4/9/596385.jpeg,0,0.9895939826965332,310,299,610,599,300,300,applejack|big macintosh|twilight sparkle,amy30535
596789.jpeg,https://derpicdn.net/img/view/2014/4/9/596789.jpeg,1,0.9714921712875366,430,606,624,800,194,194,shining armor|twilight sparkle,tonyfleecs
596799.jpeg,https://derpicdn.net/img/view/2014/4/9/596799.jpeg,0,0.9949938654899596,1266,1392,1684,1810,418,418,shining armor|twilight sparkle,chadthomas
596799.jpeg,https://derpicdn.net/img/view/2014/4/9/596799.jpeg,1,0.973206639289856,727,1518,1451,2242,724,724,shining armor|twilight sparkle,chadthomas
597483.jpeg,https://derpicdn.net/img/view/2014/4/10/597483.jpeg,0,0.9245815277099608,0,109,1580,2049,1580,1940,applejack|fluttershy|mane six|pinkie pie|princess celestia|princess luna|rainbow dash|rarity|twilight sparkle,spiritofthwwolf
598109.jpeg,https://derpicdn.net/img/view/2014/4/11/598109.jpeg,0,0.9962359666824341,0,74,146,226,146,152,applejack|fluttershy|mane six|pinkie pie|rainbow dash|rarity|twilight sparkle,spainfischer
599561.jpeg,https://derpicdn.net/img/view/2014/4/13/599561.jpeg,0,0.9577365517616272,550,105,1000,555,450,450,rainbow dash|twilight sparkle,vtruss1
600159.jpeg,https://derpicdn.net/img/view/2014/4/14/600159.jpeg,0,0.9483929872512816,582,160,978,556,396,396,pinkie pie|rainbow dash|twilight sparkle,labba94
604801.jpeg,https://derpicdn.net/img/view/2014/4/19/604801.jpeg,0,0.9915834665298462,347,52,573,278,226,226,princess celestia|twilight sparkle,theunununium
604882.jpeg,https://derpicdn.net/img/view/2014/4/19/604882.jpeg,0,0.9941806793212892,461,127,721,387,260,260,fluttershy|twilight sparkle,gamermac
604882.jpeg,https://derpicdn.net/img/view/2014/4/19/604882.jpeg,1,0.9904376268386841,22,116,300,394,278,278,fluttershy|twilight sparkle,gamermac
605290.jpeg,https://derpicdn.net/img/view/2014/4/20/605290.jpeg,0,0.9545670747756958,566,162,874,470,308,308,pinkie pie|rarity|twilight sparkle,tonyfleecs
607999.jpeg,https://derpicdn.net/img/view/2014/4/23/607999.jpeg,0,0.9970431923866272,606,491,1002,887,396,396,applejack|fluttershy|mane six|pinkie pie|rainbow dash|rarity|twilight sparkle,pekou
607999.jpeg,https://derpicdn.net/img/view/2014/4/23/607999.jpeg,1,0.9842082262039183,430,202,664,436,234,234,applejack|fluttershy|mane six|pinkie pie|rainbow dash|rarity|twilight sparkle,pekou
607999.jpeg,https://derpicdn.net/img/view/2014/4/23/607999.jpeg,3,0.9551039338111876,94,402,310,618,216,216,applejack|fluttershy|mane six|pinkie pie|rainbow dash|rarity|twilight sparkle,pekou
608742.jpeg,https://derpicdn.net/img/view/2014/4/24/608742.jpeg,0,0.9983758926391602,331,156,585,410,254,254,applejack|fluttershy|mane six|pinkie pie|rainbow dash|rarity|twilight sparkle,lord-phillock
610670.jpeg,https://derpicdn.net/img/view/2014/4/26/610670.jpeg,0,0.9928178787231444,158,206,540,588,382,382,princess cadance|princess luna|twilight sparkle,johnjoseco
610724.jpeg,https://derpicdn.net/img/view/2014/4/26/610724.jpeg,0,0.995582103729248,204,669,506,971,302,302,applejack|fluttershy|mane six|pinkie pie|rainbow dash|rarity|twilight sparkle,s4vin
610724.jpeg,https://derpicdn.net/img/view/2014/4/26/610724.jpeg,1,0.9698070883750916,669,725,977,1033,308,308,applejack|fluttershy|mane six|pinkie pie|rainbow dash|rarity|twilight sparkle,s4vin
611453.jpeg,https://derpicdn.net/img/view/2014/4/27/611453.jpeg,0,0.9858373403549194,162,0,692,470,530,470,princess cadance|princess celestia|princess luna|twilight sparkle,alloyrabbit
614870.jpeg,https://derpicdn.net/img/view/2014/5/1/614870.jpeg,0,0.9930586218833924,324,0,680,311,356,311,rainbow dash|twilight sparkle,irigulus
614870.jpeg,https://derpicdn.net/img/view/2014/5/1/614870.jpeg,1,0.9857434630393982,0,0,314,276,314,276,rainbow dash|twilight sparkle,irigulus
614981.jpeg,https://derpicdn.net/img/view/2014/5/1/614981.jpeg,0,0.9839355349540708,1708,1006,2450,1748,742,742,sunset shimmer|twilight sparkle,dshou
614981.jpeg,https://derpicdn.net/img/view/2014/5/1/614981.jpeg,1,0.9772772789001464,562,614,1092,1144,530,530,sunset shimmer|twilight sparkle,dshou
614981.jpeg,https://derpicdn.net/img/view/2014/5/1/614981.jpeg,2,0.9126610159873962,949,607,1459,1117,510,510,sunset shimmer|twilight sparkle,dshou
616085.jpeg,https://derpicdn.net/img/view/2014/5/3/616085.jpeg,0,0.9757331609725952,672,60,1024,412,352,352,trixie|twilight sparkle,hobbes-maxwell
617387.jpeg,https://derpicdn.net/img/view/2014/5/4/617387.jpeg,1,0.9867252111434937,122,22,844,744,722,722,pinkie pie|twilight sparkle,macheteponies
618885.jpeg,https://derpicdn.net/img/view/2014/5/6/618885.jpeg,0,0.9982045888900756,942,108,2124,1290,1182,1182,rainbow dash|twilight sparkle,captainpudgemuffin
621958.jpeg,https://derpicdn.net/img/view/2014/5/10/621958.jpeg,0,0.9841845631599426,511,269,687,445,176,176,discord|pinkie pie|princess celestia|rainbow dash|twilight sparkle,thecreator9
622572.jpeg,https://derpicdn.net/img/view/2014/5/10/622572.jpeg,0,0.9684450030326844,80,119,286,325,206,206,rainbow dash|twilight sparkle,spainfischer|kenket
623491.jpeg,https://derpicdn.net/img/view/2014/5/11/623491.jpeg,0,0.96882563829422,158,0,698,427,540,427,shining armor|twilight sparkle,joycall6
623579.jpeg,https://derpicdn.net/img/view/2014/5/11/623579.jpeg,1,0.9917894005775452,549,459,1121,1031,572,572,princess cadance|princess celestia|princess luna|twilight sparkle,mysticalpha
623579.jpeg,https://derpicdn.net/img/view/2014/5/11/623579.jpeg,2,0.9409658908843994,1657,334,2183,860,526,526,princess cadance|princess celestia|princess luna|twilight sparkle,mysticalpha
623820.jpeg,https://derpicdn.net/img/view/2014/5/11/623820.jpeg,0,0.994629442691803,438,282,954,798,516,516,rainbow dash|twilight sparkle,xcopyen002
624356.jpeg,https://derpicdn.net/img/view/2014/5/12/624356.jpeg,0,0.9861060976982116,662,152,900,396,238,244,discord|fluttershy|twilight sparkle,mistydash
624356.jpeg,https://derpicdn.net/img/view/2014/5/12/624356.jpeg,1,0.9532214999198914,254,106,552,404,298,298,discord|fluttershy|twilight sparkle,mistydash
625264.jpeg,https://derpicdn.net/img/view/2014/5/13/625264.jpeg,0,0.9644163250923156,1494,303,1768,577,274,274,applejack|fluttershy|mane six|pinkie pie|rainbow dash|rarity|twilight sparkle,doomsp0rk
625264.jpeg,https://derpicdn.net/img/view/2014/5/13/625264.jpeg,1,0.9557828307151794,161,379,449,667,288,288,applejack|fluttershy|mane six|pinkie pie|rainbow dash|rarity|twilight sparkle,doomsp0rk
629388.jpeg,https://derpicdn.net/img/view/2014/5/17/629388.jpeg,0,0.9993691444396972,240,726,422,908,182,182,applejack|fluttershy|mane six|pinkie pie|rainbow dash|rarity|twilight sparkle,amy30535
629388.jpeg,https://derpicdn.net/img/view/2014/5/17/629388.jpeg,1,0.9796237349510192,529,474,700,646,171,172,applejack|fluttershy|mane six|pinkie pie|rainbow dash|rarity|twilight sparkle,amy30535
631309.jpeg,https://derpicdn.net/img/view/2014/5/19/631309.jpeg,0,0.9951131343841552,646,155,890,399,244,244,princess cadance|princess celestia|princess luna|twilight sparkle,makidotsukashi
631309.jpeg,https://derpicdn.net/img/view/2014/5/19/631309.jpeg,1,0.9521762132644652,421,288,635,502,214,214,princess cadance|princess celestia|princess luna|twilight sparkle,makidotsukashi
631505.jpeg,https://derpicdn.net/img/view/2014/5/20/631505.jpeg,1,0.938268780708313,2481,891,3405,1815,924,924,applejack|fluttershy|mane six|pinkie pie|rainbow dash|rarity|twilight sparkle,jowybean
633939.jpeg,https://derpicdn.net/img/view/2014/5/22/633939.jpeg,0,0.9962901473045348,95,491,287,683,192,192,applejack|discord|fluttershy|pinkie pie|princess celestia|rainbow dash|rarity|spike|twilight sparkle,bravelyart
633939.jpeg,https://derpicdn.net/img/view/2014/5/22/633939.jpeg,1,0.9848170280456544,485,584,745,844,260,260,applejack|discord|fluttershy|pinkie pie|princess celestia|rainbow dash|rarity|spike|twilight sparkle,bravelyart
633939.jpeg,https://derpicdn.net/img/view/2014/5/22/633939.jpeg,2,0.9431966543197632,155,639,375,859,220,220,applejack|discord|fluttershy|pinkie pie|princess celestia|rainbow dash|rarity|spike|twilight sparkle,bravelyart
633939.jpeg,https://derpicdn.net/img/view/2014/5/22/633939.jpeg,3,0.9318503737449646,659,665,849,855,190,190,applejack|discord|fluttershy|pinkie pie|princess celestia|rainbow dash|rarity|spike|twilight sparkle,bravelyart
633939.jpeg,https://derpicdn.net/img/view/2014/5/22/633939.jpeg,4,0.910142421722412,0,611,226,843,226,232,applejack|discord|fluttershy|pinkie pie|princess celestia|rainbow dash|rarity|spike|twilight sparkle,bravelyart
634198.jpeg,https://derpicdn.net/img/view/2014/5/23/634198.jpeg,0,0.9912217855453492,608,301,1028,721,420,420,apple bloom|applejack|big macintosh|cutie mark crusaders|diamond tiara|discord|fluttershy|granny smith|pinkie pie|princess cadance|princess celestia|princess luna|rainbow dash|rarity|scootaloo|shining armor|silver spoon|soarin'|spike|spitfire|sweetie belle|twilight sparkle,seriousdog
634268.jpeg,https://derpicdn.net/img/view/2014/5/23/634268.jpeg,0,0.9985958933830258,622,98,986,462,364,364,applejack|fluttershy|mane six|pinkie pie|rainbow dash|rarity|twilight sparkle,kounyoukai
634783.jpeg,https://derpicdn.net/img/view/2014/5/23/634783.jpeg,0,0.9450860023498536,23,84,245,306,222,222,applejack|fluttershy|mane six|pinkie pie|rainbow dash|rarity|twilight sparkle,
634783.jpeg,https://derpicdn.net/img/view/2014/5/23/634783.jpeg,1,0.9283187985420228,448,285,630,511,182,226,applejack|fluttershy|mane six|pinkie pie|rainbow dash|rarity|twilight sparkle,
636185.jpeg,https://derpicdn.net/img/view/2014/5/25/636185.jpeg,0,0.9996850490570068,1050,242,1274,466,224,224,applejack|fluttershy|mane six|pinkie pie|rainbow dash|rarity|twilight sparkle,evian
636185.jpeg,https://derpicdn.net/img/view/2014/5/25/636185.jpeg,1,0.9975940585136414,38,0,382,303,344,303,applejack|fluttershy|mane six|pinkie pie|rainbow dash|rarity|twilight sparkle,evian
636185.jpeg,https://derpicdn.net/img/view/2014/5/25/636185.jpeg,2,0.9943559765815736,0,239,216,455,216,216,applejack|fluttershy|mane six|pinkie pie|rainbow dash|rarity|twilight sparkle,evian
636185.jpeg,https://derpicdn.net/img/view/2014/5/25/636185.jpeg,4,0.9537843465805054,889,0,1249,313,360,313,applejack|fluttershy|mane six|pinkie pie|rainbow dash|rarity|twilight sparkle,evian
637572.jpeg,https://derpicdn.net/img/view/2014/5/26/637572.jpeg,0,0.980116605758667,327,459,525,657,198,198,discord|princess cadance|twilight sparkle,kounyoukai
637978.jpeg,https://derpicdn.net/img/view/2014/5/27/637978.jpeg,0,0.9161229133605956,414,49,674,309,260,260,fluttershy|princess celestia|rainbow dash|twilight sparkle,miokomata
638033.jpeg,https://derpicdn.net/img/view/2014/5/27/638033.jpeg,0,0.9881716966629028,274,345,706,777,432,432,princess cadance|princess celestia|princess luna|twilight sparkle,rariedash
638463.jpeg,https://derpicdn.net/img/view/2014/5/27/638463.jpeg,1,0.9448896050453186,1679,614,2179,1114,500,500,applejack|fluttershy|mane six|pinkie pie|rainbow dash|rarity|twilight sparkle,romus91|alasou
638463.jpeg,https://derpicdn.net/img/view/2014/5/27/638463.jpeg,2,0.9149422645568848,707,232,1217,742,510,510,applejack|fluttershy|mane six|pinkie pie|rainbow dash|rarity|twilight sparkle,romus91|alasou
638807.jpeg,https://derpicdn.net/img/view/2014/5/28/638807.jpeg,0,0.9928770661354064,1474,33,1986,545,512,512,princess cadance|princess celestia|princess luna|twilight sparkle,darksittich
638807.jpeg,https://derpicdn.net/img/view/2014/5/28/638807.jpeg,2,0.9667162299156188,1042,36,1486,480,444,444,princess cadance|princess celestia|princess luna|twilight sparkle,darksittich
638807.jpeg,https://derpicdn.net/img/view/2014/5/28/638807.jpeg,3,0.946361005306244,533,48,951,466,418,418,princess cadance|princess celestia|princess luna|twilight sparkle,darksittich
639984.jpeg,https://derpicdn.net/img/view/2014/5/29/639984.jpeg,1,0.9299232959747314,3369,0,3883,491,514,491,applejack|fluttershy|mane six|pinkie pie|rainbow dash|rarity|spike|twilight sparkle,shnider
639984.jpeg,https://derpicdn.net/img/view/2014/5/29/639984.jpeg,2,0.9045162796974182,754,28,1320,594,566,566,applejack|fluttershy|mane six|pinkie pie|rainbow dash|rarity|spike|twilight sparkle,shnider
642110.jpeg,https://derpicdn.net/img/view/2014/6/1/642110.jpeg,0,0.9936542510986328,1129,340,1459,670,330,330,princess cadance|princess celestia|princess luna|twilight sparkle,moeru789
642110.jpeg,https://derpicdn.net/img/view/2014/6/1/642110.jpeg,1,0.9856612086296082,759,743,1137,1121,378,378,princess cadance|princess celestia|princess luna|twilight sparkle,moeru789
642110.jpeg,https://derpicdn.net/img/view/2014/6/1/642110.jpeg,2,0.948928952217102,181,339,545,703,364,364,princess cadance|princess celestia|princess luna|twilight sparkle,moeru789
642110.jpeg,https://derpicdn.net/img/view/2014/6/1/642110.jpeg,3,0.9228063225746156,790,0,1120,280,330,280,princess cadance|princess celestia|princess luna|twilight sparkle,moeru789
643348.jpeg,https://derpicdn.net/img/view/2014/6/2/643348.jpeg,0,0.9016674757003784,1245,0,1887,545,642,545,rainbow dash|twilight sparkle,mysticalpha
643530.jpeg,https://derpicdn.net/img/view/2014/6/3/643530.jpeg,0,0.930460512638092,7,0,223,199,216,199,applejack|fluttershy|mane six|pinkie pie|rainbow dash|rarity|twilight sparkle,flying-fox
643530.jpeg,https://derpicdn.net/img/view/2014/6/3/643530.jpeg,1,0.9228335618972778,315,0,569,231,254,231,applejack|fluttershy|mane six|pinkie pie|rainbow dash|rarity|twilight sparkle,flying-fox
645901.jpeg,https://derpicdn.net/img/view/2014/6/5/645901.jpeg,0,0.9601342678070068,368,76,670,378,302,302,rainbow dash|twilight sparkle,girlieginger
645901.jpeg,https://derpicdn.net/img/view/2014/6/5/645901.jpeg,1,0.9080071449279784,282,167,524,409,242,242,rainbow dash|twilight sparkle,girlieginger
646037.jpeg,https://derpicdn.net/img/view/2014/6/6/646037.jpeg,0,0.989454448223114,5408,4239,6629,5533,1221,1294,apple bloom|applejack|cutie mark crusaders|fluttershy|mane six|pinkie pie|princess cadance|princess celestia|princess luna|rainbow dash|rarity|scootaloo|spike|sweetie belle|twilight sparkle,ostichristian
646037.jpeg,https://derpicdn.net/img/view/2014/6/6/646037.jpeg,1,0.9891115427017212,3507,4703,4603,5799,1096,1096,apple bloom|applejack|cutie mark crusaders|fluttershy|mane six|pinkie pie|princess cadance|princess celestia|princess luna|rainbow dash|rarity|scootaloo|spike|sweetie belle|twilight sparkle,ostichristian
646037.jpeg,https://derpicdn.net/img/view/2014/6/6/646037.jpeg,2,0.9537677168846128,4340,3501,5388,4549,1048,1048,apple bloom|applejack|cutie mark crusaders|fluttershy|mane six|pinkie pie|princess cadance|princess celestia|princess luna|rainbow dash|rarity|scootaloo|spike|sweetie belle|twilight sparkle,ostichristian
646842.jpeg,https://derpicdn.net/img/view/2014/6/6/646842.jpeg,0,0.9924173951148988,0,0,241,302,241,302,big macintosh|fluttershy|rainbow dash|twilight sparkle,doomy
646842.jpeg,https://derpicdn.net/img/view/2014/6/6/646842.jpeg,1,0.9785131812095642,115,0,497,356,382,356,big macintosh|fluttershy|rainbow dash|twilight sparkle,doomy
648782.jpeg,https://derpicdn.net/img/view/2014/6/9/648782.jpeg,0,0.9318481087684632,211,86,401,276,190,190,spike|twilight sparkle,yote
648824.jpeg,https://derpicdn.net/img/view/2014/6/9/648824.jpeg,0,0.9884367585182192,976,162,1316,502,340,340,applejack|fluttershy|mane six|pinkie pie|princess celestia|rainbow dash|rarity|twilight sparkle,apzzang
648824.jpeg,https://derpicdn.net/img/view/2014/6/9/648824.jpeg,1,0.9813176393508912,994,1076,1298,1380,304,304,applejack|fluttershy|mane six|pinkie pie|princess celestia|rainbow dash|rarity|twilight sparkle,apzzang
648824.jpeg,https://derpicdn.net/img/view/2014/6/9/648824.jpeg,2,0.9588427543640136,162,1105,390,1333,228,228,applejack|fluttershy|mane six|pinkie pie|princess celestia|rainbow dash|rarity|twilight sparkle,apzzang
648824.jpeg,https://derpicdn.net/img/view/2014/6/9/648824.jpeg,3,0.9451829195022584,569,263,869,563,300,300,applejack|fluttershy|mane six|pinkie pie|princess celestia|rainbow dash|rarity|twilight sparkle,apzzang
649481.jpeg,https://derpicdn.net/img/view/2014/6/10/649481.jpeg,0,0.9906402230262756,826,1762,1226,2162,400,400,discord|twilight sparkle,xeternalflamebryx
650014.jpeg,https://derpicdn.net/img/view/2014/6/10/650014.jpeg,0,0.9155648350715636,139,182,345,388,206,206,princess cadance|princess celestia|princess luna|twilight sparkle,erinkarsath
650065.jpeg,https://derpicdn.net/img/view/2014/6/10/650065.jpeg,0,0.9987768530845642,272,13,576,317,304,304,trixie|twilight sparkle,hector-llg
650065.jpeg,https://derpicdn.net/img/view/2014/6/10/650065.jpeg,1,0.9975463747978208,586,118,870,402,284,284,trixie|twilight sparkle,hector-llg
650783.jpeg,https://derpicdn.net/img/view/2014/6/11/650783.jpeg,0,0.9957877397537231,483,91,663,271,180,180,apple bloom|big macintosh|rainbow dash|twilight sparkle,pasikon
652502.jpeg,https://derpicdn.net/img/view/2014/6/13/652502.jpeg,0,0.9987629652023317,0,264,322,594,322,330,princess celestia|twilight sparkle,trace-101
656046.jpeg,https://derpicdn.net/img/view/2014/6/18/656046.jpeg,1,0.9046076536178588,805,611,1229,1035,424,424,applejack|fluttershy|mane six|pinkie pie|rainbow dash|rarity|twilight sparkle,nayshie
656345.jpeg,https://derpicdn.net/img/view/2014/6/18/656345.jpeg,0,0.9690830707550048,282,205,488,411,206,206,applejack|fluttershy|mane six|pinkie pie|rainbow dash|rarity|twilight sparkle,nayshie
656345.jpeg,https://derpicdn.net/img/view/2014/6/18/656345.jpeg,1,0.9602952599525452,0,201,92,307,92,106,applejack|fluttershy|mane six|pinkie pie|rainbow dash|rarity|twilight sparkle,nayshie
656908.jpeg,https://derpicdn.net/img/view/2014/6/19/656908.jpeg,0,0.9810124635696412,230,676,468,914,238,238,applejack|fluttershy|mane six|pinkie pie|princess celestia|princess luna|rainbow dash|rarity|spike|twilight sparkle,
657602.jpeg,https://derpicdn.net/img/view/2014/6/20/657602.jpeg,0,0.9982082843780518,760,0,1048,282,288,282,applejack|fluttershy|mane six|pinkie pie|rainbow dash|rarity|spike|twilight sparkle,inkwell
657602.jpeg,https://derpicdn.net/img/view/2014/6/20/657602.jpeg,1,0.9678325057029724,323,256,525,458,202,202,applejack|fluttershy|mane six|pinkie pie|rainbow dash|rarity|spike|twilight sparkle,inkwell
659176.jpeg,https://derpicdn.net/img/view/2014/6/22/659176.jpeg,0,0.9821316599845886,361,1034,679,1352,318,318,princess celestia|twilight sparkle,viwrastupr|tsaoshin
659605.jpeg,https://derpicdn.net/img/view/2014/6/23/659605.jpeg,4,0.9807933568954468,24,675,906,1557,882,882,applejack|fluttershy|princess luna|rainbow dash|rarity|spitfire|trixie|twilight sparkle,jinzhan
660832.jpeg,https://derpicdn.net/img/view/2014/6/24/660832.jpeg,2,0.9505296349525452,343,309,600,579,257,270,applejack|fluttershy|mane six|pinkie pie|princess cadance|princess celestia|princess luna|rainbow dash|rarity|twilight sparkle,pekou
661992.jpeg,https://derpicdn.net/img/view/2014/6/26/661992.jpeg,0,0.9526423811912536,2672,497,3596,1421,924,924,spike|twilight sparkle,mechagen
662170.jpeg,https://derpicdn.net/img/view/2014/6/26/662170.jpeg,0,0.9897777438163756,1608,1563,1998,1953,390,390,applejack|fluttershy|mane six|pinkie pie|rainbow dash|rarity|twilight sparkle,phantomtsubasa
662583.jpeg,https://derpicdn.net/img/view/2014/6/27/662583.jpeg,0,0.9953515529632568,585,504,889,808,304,304,applejack|fluttershy|mane six|pinkie pie|rainbow dash|rarity|twilight sparkle,kairean
662583.jpeg,https://derpicdn.net/img/view/2014/6/27/662583.jpeg,1,0.9899150729179382,373,863,665,1155,292,292,applejack|fluttershy|mane six|pinkie pie|rainbow dash|rarity|twilight sparkle,kairean
662583.jpeg,https://derpicdn.net/img/view/2014/6/27/662583.jpeg,2,0.9314224123954772,111,492,437,818,326,326,applejack|fluttershy|mane six|pinkie pie|rainbow dash|rarity|twilight sparkle,kairean
663189.jpeg,https://derpicdn.net/img/view/2014/6/28/663189.jpeg,1,0.995568573474884,683,0,1255,523,572,523,apple bloom|applejack|big macintosh|cutie mark crusaders|diamond tiara|discord|fluttershy|granny smith|mane six|pinkie pie|princess cadance|princess celestia|princess luna|rainbow dash|rarity|scootaloo|silver spoon|soarin'|spike|spitfire|sweetie belle|twilight sparkle,hoodedtomsi
663189.jpeg,https://derpicdn.net/img/view/2014/6/28/663189.jpeg,2,0.9833984971046448,1719,447,2177,905,458,458,apple bloom|applejack|big macintosh|cutie mark crusaders|diamond tiara|discord|fluttershy|granny smith|mane six|pinkie pie|princess cadance|princess celestia|princess luna|rainbow dash|rarity|scootaloo|silver spoon|soarin'|spike|spitfire|sweetie belle|twilight sparkle,hoodedtomsi
663189.jpeg,https://derpicdn.net/img/view/2014/6/28/663189.jpeg,3,0.9709395170211792,1458,224,1928,694,470,470,apple bloom|applejack|big macintosh|cutie mark crusaders|diamond tiara|discord|fluttershy|granny smith|mane six|pinkie pie|princess cadance|princess celestia|princess luna|rainbow dash|rarity|scootaloo|silver spoon|soarin'|spike|spitfire|sweetie belle|twilight sparkle,hoodedtomsi
663189.jpeg,https://derpicdn.net/img/view/2014/6/28/663189.jpeg,4,0.9655919075012208,1490,1220,1910,1640,420,420,apple bloom|applejack|big macintosh|cutie mark crusaders|diamond tiara|discord|fluttershy|granny smith|mane six|pinkie pie|princess cadance|princess celestia|princess luna|rainbow dash|rarity|scootaloo|silver spoon|soarin'|spike|spitfire|sweetie belle|twilight sparkle,hoodedtomsi
666813.jpeg,https://derpicdn.net/img/view/2014/7/3/666813.jpeg,0,0.9810532331466676,0,469,202,673,202,204,apple bloom|applejack|babs seed|big macintosh|braeburn|diamond tiara|discord|fluttershy|granny smith|lightning dust|pinkie pie|princess cadance|princess celestia|princess luna|queen chrysalis|rainbow dash|rarity|scootaloo|shining armor|silver spoon|spike|spitfire|sunset shimmer|sweetie belle|trixie|twilight sparkle,amy mebberson
666813.jpeg,https://derpicdn.net/img/view/2014/7/3/666813.jpeg,1,0.9777568578720092,492,760,702,970,210,210,apple bloom|applejack|babs seed|big macintosh|braeburn|diamond tiara|discord|fluttershy|granny smith|lightning dust|pinkie pie|princess cadance|princess celestia|princess luna|queen chrysalis|rainbow dash|rarity|scootaloo|shining armor|silver spoon|spike|spitfire|sunset shimmer|sweetie belle|trixie|twilight sparkle,amy mebberson
666813.jpeg,https://derpicdn.net/img/view/2014/7/3/666813.jpeg,2,0.9766260385513306,310,477,480,647,170,170,apple bloom|applejack|babs seed|big macintosh|braeburn|diamond tiara|discord|fluttershy|granny smith|lightning dust|pinkie pie|princess cadance|princess celestia|princess luna|queen chrysalis|rainbow dash|rarity|scootaloo|shining armor|silver spoon|spike|spitfire|sunset shimmer|sweetie belle|trixie|twilight sparkle,amy mebberson
666813.jpeg,https://derpicdn.net/img/view/2014/7/3/666813.jpeg,3,0.9694583415985109,111,778,269,936,158,158,apple bloom|applejack|babs seed|big macintosh|braeburn|diamond tiara|discord|fluttershy|granny smith|lightning dust|pinkie pie|princess cadance|princess celestia|princess luna|queen chrysalis|rainbow dash|rarity|scootaloo|shining armor|silver spoon|spike|spitfire|sunset shimmer|sweetie belle|trixie|twilight sparkle,amy mebberson
666813.jpeg,https://derpicdn.net/img/view/2014/7/3/666813.jpeg,4,0.9650302529335022,0,774,193,988,193,214,apple bloom|applejack|babs seed|big macintosh|braeburn|diamond tiara|discord|fluttershy|granny smith|lightning dust|pinkie pie|princess cadance|princess celestia|princess luna|queen chrysalis|rainbow dash|rarity|scootaloo|shining armor|silver spoon|spike|spitfire|sunset shimmer|sweetie belle|trixie|twilight sparkle,amy mebberson
666813.jpeg,https://derpicdn.net/img/view/2014/7/3/666813.jpeg,5,0.9619897603988647,518,192,680,354,162,162,apple bloom|applejack|babs seed|big macintosh|braeburn|diamond tiara|discord|fluttershy|granny smith|lightning dust|pinkie pie|princess cadance|princess celestia|princess luna|queen chrysalis|rainbow dash|rarity|scootaloo|shining armor|silver spoon|spike|spitfire|sunset shimmer|sweetie belle|trixie|twilight sparkle,amy mebberson
666813.jpeg,https://derpicdn.net/img/view/2014/7/3/666813.jpeg,8,0.9146864414215088,786,914,940,1068,154,154,apple bloom|applejack|babs seed|big macintosh|braeburn|diamond tiara|discord|fluttershy|granny smith|lightning dust|pinkie pie|princess cadance|princess celestia|princess luna|queen chrysalis|rainbow dash|rarity|scootaloo|shining armor|silver spoon|spike|spitfire|sunset shimmer|sweetie belle|trixie|twilight sparkle,amy mebberson
668562.jpeg,https://derpicdn.net/img/view/2014/7/6/668562.jpeg,0,0.9868440032005308,611,354,1121,864,510,510,princess celestia|princess luna|twilight sparkle,argodaemon
668562.jpeg,https://derpicdn.net/img/view/2014/7/6/668562.jpeg,2,0.9130241274833679,191,283,599,691,408,408,princess celestia|princess luna|twilight sparkle,argodaemon
670315.jpeg,https://derpicdn.net/img/view/2014/7/8/670315.jpeg,0,0.946506679058075,759,730,1017,988,258,258,applejack|fluttershy|pinkie pie|princess cadance|princess celestia|princess luna|rainbow dash|rarity|shining armor|twilight sparkle,meekcheep
670315.jpeg,https://derpicdn.net/img/view/2014/7/8/670315.jpeg,1,0.9422078132629396,207,769,539,1101,332,332,applejack|fluttershy|pinkie pie|princess cadance|princess celestia|princess luna|rainbow dash|rarity|shining armor|twilight sparkle,meekcheep
670315.jpeg,https://derpicdn.net/img/view/2014/7/8/670315.jpeg,2,0.9126123785972596,26,633,254,861,228,228,applejack|fluttershy|pinkie pie|princess cadance|princess celestia|princess luna|rainbow dash|rarity|shining armor|twilight sparkle,meekcheep
670315.jpeg,https://derpicdn.net/img/view/2014/7/8/670315.jpeg,3,0.9037938117980956,394,155,724,485,330,330,applejack|fluttershy|pinkie pie|princess cadance|princess celestia|princess luna|rainbow dash|rarity|shining armor|twilight sparkle,meekcheep
670772.jpeg,https://derpicdn.net/img/view/2014/7/9/670772.jpeg,0,0.984235405921936,198,441,336,579,138,138,princess celestia|princess luna|twilight sparkle,
672735.jpeg,https://derpicdn.net/img/view/2014/7/11/672735.jpeg,0,0.9673334956169128,448,0,1580,1041,1132,1041,shining armor|twilight sparkle,skecchiart
676089.jpeg,https://derpicdn.net/img/view/2014/7/16/676089.jpeg,0,0.9811214804649352,746,141,981,411,235,270,applejack|fluttershy|mane six|pinkie pie|princess celestia|princess luna|rainbow dash|rarity|twilight sparkle,tonyfleecs
679512.jpeg,https://derpicdn.net/img/view/2014/7/20/679512.jpeg,0,0.9758885502815248,616,257,1004,645,388,388,trixie|twilight sparkle,poniesforparents
680666.jpeg,https://derpicdn.net/img/view/2014/7/22/680666.jpeg,0,0.9851192831993104,103,1889,1019,2805,916,916,discord|fluttershy|pinkie pie|queen chrysalis|twilight sparkle,mileymouse101
680666.jpeg,https://derpicdn.net/img/view/2014/7/22/680666.jpeg,1,0.966116428375244,1268,1890,2156,2778,888,888,discord|fluttershy|pinkie pie|queen chrysalis|twilight sparkle,mileymouse101
680666.jpeg,https://derpicdn.net/img/view/2014/7/22/680666.jpeg,2,0.9563384652137756,698,1774,1724,2800,1026,1026,discord|fluttershy|pinkie pie|queen chrysalis|twilight sparkle,mileymouse101
681695.jpeg,https://derpicdn.net/img/view/2014/7/23/681695.jpeg,1,0.9026889204978944,668,593,1020,945,352,352,princess luna|rainbow dash|spitfire|twilight sparkle,seanica
683121.jpeg,https://derpicdn.net/img/view/2014/7/25/683121.jpeg,0,0.9908262491226196,58,85,704,731,646,646,rainbow dash|twilight sparkle,joycall6
684174.jpeg,https://derpicdn.net/img/view/2014/7/26/684174.jpeg,0,0.9819642305374146,448,313,664,529,216,216,princess cadance|princess celestia|princess luna|twilight sparkle,chibi-jen-hen
684174.jpeg,https://derpicdn.net/img/view/2014/7/26/684174.jpeg,1,0.9409547448158264,301,100,581,380,280,280,princess cadance|princess celestia|princess luna|twilight sparkle,chibi-jen-hen
684174.jpeg,https://derpicdn.net/img/view/2014/7/26/684174.jpeg,2,0.9353219270706176,623,242,887,506,264,264,princess cadance|princess celestia|princess luna|twilight sparkle,chibi-jen-hen
685509.jpeg,https://derpicdn.net/img/view/2014/7/28/685509.jpeg,0,0.9840939044952391,292,0,614,284,322,284,princess cadance|princess celestia|princess luna|twilight sparkle,freesavanna
686303.jpeg,https://derpicdn.net/img/view/2014/7/29/686303.jpeg,0,0.991057813167572,507,1599,1047,2139,540,540,apple bloom|twilight sparkle,mohawkrex
686303.jpeg,https://derpicdn.net/img/view/2014/7/29/686303.jpeg,1,0.9680606722831726,1595,1545,2087,2037,492,492,apple bloom|twilight sparkle,mohawkrex
687039.jpeg,https://derpicdn.net/img/view/2014/7/30/687039.jpeg,0,0.9947991371154784,946,2015,1694,2763,748,748,spike|twilight sparkle,anonopony
689521.jpeg,https://derpicdn.net/img/view/2014/8/2/689521.jpeg,0,0.9992327690124512,588,393,1039,849,451,456,rarity|trixie|twilight sparkle,amy mebberson
689931.jpeg,https://derpicdn.net/img/view/2014/8/3/689931.jpeg,0,0.9616599678993224,203,187,441,425,238,238,applejack|fluttershy|mane six|pinkie pie|rainbow dash|rarity|spike|twilight sparkle,toonbaboon
689931.jpeg,https://derpicdn.net/img/view/2014/8/3/689931.jpeg,1,0.9416006803512572,51,229,271,449,220,220,applejack|fluttershy|mane six|pinkie pie|rainbow dash|rarity|spike|twilight sparkle,toonbaboon
694970.jpeg,https://derpicdn.net/img/view/2014/8/8/694970.jpeg,2,0.9971802830696106,0,380,403,792,403,412,apple bloom|applejack|babs seed|big macintosh|braeburn|cutie mark crusaders|discord|fluttershy|granny smith|lightning dust|mane six|pinkie pie|princess cadance|princess celestia|princess luna|queen chrysalis|rainbow dash|rarity|scootaloo|shining armor|soarin'|spike|spitfire|sunset shimmer|sweetie belle|trixie|twilight sparkle,spainfischer|kenket
694970.jpeg,https://derpicdn.net/img/view/2014/8/8/694970.jpeg,4,0.9949243068695068,1938,722,2456,1240,518,518,apple bloom|applejack|babs seed|big macintosh|braeburn|cutie mark crusaders|discord|fluttershy|granny smith|lightning dust|mane six|pinkie pie|princess cadance|princess celestia|princess luna|queen chrysalis|rainbow dash|rarity|scootaloo|shining armor|soarin'|spike|spitfire|sunset shimmer|sweetie belle|trixie|twilight sparkle,spainfischer|kenket
694970.jpeg,https://derpicdn.net/img/view/2014/8/8/694970.jpeg,5,0.9946003556251526,839,390,1213,764,374,374,apple bloom|applejack|babs seed|big macintosh|braeburn|cutie mark crusaders|discord|fluttershy|granny smith|lightning dust|mane six|pinkie pie|princess cadance|princess celestia|princess luna|queen chrysalis|rainbow dash|rarity|scootaloo|shining armor|soarin'|spike|spitfire|sunset shimmer|sweetie belle|trixie|twilight sparkle,spainfischer|kenket
694970.jpeg,https://derpicdn.net/img/view/2014/8/8/694970.jpeg,6,0.9929078817367554,3624,1192,3962,1530,338,338,apple bloom|applejack|babs seed|big macintosh|braeburn|cutie mark crusaders|discord|fluttershy|granny smith|lightning dust|mane six|pinkie pie|princess cadance|princess celestia|princess luna|queen chrysalis|rainbow dash|rarity|scootaloo|shining armor|soarin'|spike|spitfire|sunset shimmer|sweetie belle|trixie|twilight sparkle,spainfischer|kenket
694970.jpeg,https://derpicdn.net/img/view/2014/8/8/694970.jpeg,7,0.9912275671958924,3155,1117,3657,1619,502,502,apple bloom|applejack|babs seed|big macintosh|braeburn|cutie mark crusaders|discord|fluttershy|granny smith|lightning dust|mane six|pinkie pie|princess cadance|princess celestia|princess luna|queen chrysalis|rainbow dash|rarity|scootaloo|shining armor|soarin'|spike|spitfire|sunset shimmer|sweetie belle|trixie|twilight sparkle,spainfischer|kenket
694970.jpeg,https://derpicdn.net/img/view/2014/8/8/694970.jpeg,11,0.9839050769805908,2718,1038,3326,1646,608,608,apple bloom|applejack|babs seed|big macintosh|braeburn|cutie mark crusaders|discord|fluttershy|granny smith|lightning dust|mane six|pinkie pie|princess cadance|princess celestia|princess luna|queen chrysalis|rainbow dash|rarity|scootaloo|shining armor|soarin'|spike|spitfire|sunset shimmer|sweetie belle|trixie|twilight sparkle,spainfischer|kenket
694970.jpeg,https://derpicdn.net/img/view/2014/8/8/694970.jpeg,12,0.9812010526657104,665,1046,1273,1654,608,608,apple bloom|applejack|babs seed|big macintosh|braeburn|cutie mark crusaders|discord|fluttershy|granny smith|lightning dust|mane six|pinkie pie|princess cadance|princess celestia|princess luna|queen chrysalis|rainbow dash|rarity|scootaloo|shining armor|soarin'|spike|spitfire|sunset shimmer|sweetie belle|trixie|twilight sparkle,spainfischer|kenket
694970.jpeg,https://derpicdn.net/img/view/2014/8/8/694970.jpeg,15,0.9797810316085817,3144,283,3702,841,558,558,apple bloom|applejack|babs seed|big macintosh|braeburn|cutie mark crusaders|discord|fluttershy|granny smith|lightning dust|mane six|pinkie pie|princess cadance|princess celestia|princess luna|queen chrysalis|rainbow dash|rarity|scootaloo|shining armor|soarin'|spike|spitfire|sunset shimmer|sweetie belle|trixie|twilight sparkle,spainfischer|kenket
694970.jpeg,https://derpicdn.net/img/view/2014/8/8/694970.jpeg,16,0.9790431261062622,800,706,1300,1206,500,500,apple bloom|applejack|babs seed|big macintosh|braeburn|cutie mark crusaders|discord|fluttershy|granny smith|lightning dust|mane six|pinkie pie|princess cadance|princess celestia|princess luna|queen chrysalis|rainbow dash|rarity|scootaloo|shining armor|soarin'|spike|spitfire|sunset shimmer|sweetie belle|trixie|twilight sparkle,spainfischer|kenket
694970.jpeg,https://derpicdn.net/img/view/2014/8/8/694970.jpeg,19,0.9694790840148926,695,1886,1281,2400,586,514,apple bloom|applejack|babs seed|big macintosh|braeburn|cutie mark crusaders|discord|fluttershy|granny smith|lightning dust|mane six|pinkie pie|princess cadance|princess celestia|princess luna|queen chrysalis|rainbow dash|rarity|scootaloo|shining armor|soarin'|spike|spitfire|sunset shimmer|sweetie belle|trixie|twilight sparkle,spainfischer|kenket
694970.jpeg,https://derpicdn.net/img/view/2014/8/8/694970.jpeg,22,0.9625951647758484,2384,1181,2822,1619,438,438,apple bloom|applejack|babs seed|big macintosh|braeburn|cutie mark crusaders|discord|fluttershy|granny smith|lightning dust|mane six|pinkie pie|princess cadance|princess celestia|princess luna|queen chrysalis|rainbow dash|rarity|scootaloo|shining armor|soarin'|spike|spitfire|sunset shimmer|sweetie belle|trixie|twilight sparkle,spainfischer|kenket
694970.jpeg,https://derpicdn.net/img/view/2014/8/8/694970.jpeg,23,0.9621790647506714,1145,0,1657,433,512,433,apple bloom|applejack|babs seed|big macintosh|braeburn|cutie mark crusaders|discord|fluttershy|granny smith|lightning dust|mane six|pinkie pie|princess cadance|princess celestia|princess luna|queen chrysalis|rainbow dash|rarity|scootaloo|shining armor|soarin'|spike|spitfire|sunset shimmer|sweetie belle|trixie|twilight sparkle,spainfischer|kenket
694970.jpeg,https://derpicdn.net/img/view/2014/8/8/694970.jpeg,24,0.9556215405464172,693,1513,1205,2025,512,512,apple bloom|applejack|babs seed|big macintosh|braeburn|cutie mark crusaders|discord|fluttershy|granny smith|lightning dust|mane six|pinkie pie|princess cadance|princess celestia|princess luna|queen chrysalis|rainbow dash|rarity|scootaloo|shining armor|soarin'|spike|spitfire|sunset shimmer|sweetie belle|trixie|twilight sparkle,spainfischer|kenket
694970.jpeg,https://derpicdn.net/img/view/2014/8/8/694970.jpeg,25,0.9538837671279908,291,0,887,460,596,460,apple bloom|applejack|babs seed|big macintosh|braeburn|cutie mark crusaders|discord|fluttershy|granny smith|lightning dust|mane six|pinkie pie|princess cadance|princess celestia|princess luna|queen chrysalis|rainbow dash|rarity|scootaloo|shining armor|soarin'|spike|spitfire|sunset shimmer|sweetie belle|trixie|twilight sparkle,spainfischer|kenket
694970.jpeg,https://derpicdn.net/img/view/2014/8/8/694970.jpeg,27,0.9442991614341736,2325,306,2875,856,550,550,apple bloom|applejack|babs seed|big macintosh|braeburn|cutie mark crusaders|discord|fluttershy|granny smith|lightning dust|mane six|pinkie pie|princess cadance|princess celestia|princess luna|queen chrysalis|rainbow dash|rarity|scootaloo|shining armor|soarin'|spike|spitfire|sunset shimmer|sweetie belle|trixie|twilight sparkle,spainfischer|kenket
694970.jpeg,https://derpicdn.net/img/view/2014/8/8/694970.jpeg,28,0.943003237247467,3601,1565,4000,1983,399,418,apple bloom|applejack|babs seed|big macintosh|braeburn|cutie mark crusaders|discord|fluttershy|granny smith|lightning dust|mane six|pinkie pie|princess cadance|princess celestia|princess luna|queen chrysalis|rainbow dash|rarity|scootaloo|shining armor|soarin'|spike|spitfire|sunset shimmer|sweetie belle|trixie|twilight sparkle,spainfischer|kenket
694970.jpeg,https://derpicdn.net/img/view/2014/8/8/694970.jpeg,29,0.9361870884895324,2777,739,3257,1219,480,480,apple bloom|applejack|babs seed|big macintosh|braeburn|cutie mark crusaders|discord|fluttershy|granny smith|lightning dust|mane six|pinkie pie|princess cadance|princess celestia|princess luna|queen chrysalis|rainbow dash|rarity|scootaloo|shining armor|soarin'|spike|spitfire|sunset shimmer|sweetie belle|trixie|twilight sparkle,spainfischer|kenket
694970.jpeg,https://derpicdn.net/img/view/2014/8/8/694970.jpeg,31,0.9166145324707032,290,1873,902,2400,612,527,apple bloom|applejack|babs seed|big macintosh|braeburn|cutie mark crusaders|discord|fluttershy|granny smith|lightning dust|mane six|pinkie pie|princess cadance|princess celestia|princess luna|queen chrysalis|rainbow dash|rarity|scootaloo|shining armor|soarin'|spike|spitfire|sunset shimmer|sweetie belle|trixie|twilight sparkle,spainfischer|kenket
696611.jpeg,https://derpicdn.net/img/view/2014/8/10/696611.jpeg,0,0.9958269000053406,877,407,1600,1189,723,782,apple bloom|applejack|cutie mark crusaders|fluttershy|mane six|pinkie pie|princess celestia|princess luna|rainbow dash|rarity|scootaloo|sweetie belle|trixie|twilight sparkle,joycall6
696611.jpeg,https://derpicdn.net/img/view/2014/8/10/696611.jpeg,1,0.9958255290985109,675,2209,1073,2607,398,398,apple bloom|applejack|cutie mark crusaders|fluttershy|mane six|pinkie pie|princess celestia|princess luna|rainbow dash|rarity|scootaloo|sweetie belle|trixie|twilight sparkle,joycall6
696611.jpeg,https://derpicdn.net/img/view/2014/8/10/696611.jpeg,2,0.9852237701416016,195,1844,561,2210,366,366,apple bloom|applejack|cutie mark crusaders|fluttershy|mane six|pinkie pie|princess celestia|princess luna|rainbow dash|rarity|scootaloo|sweetie belle|trixie|twilight sparkle,joycall6
696611.jpeg,https://derpicdn.net/img/view/2014/8/10/696611.jpeg,3,0.9795342683792114,394,376,1180,1162,786,786,apple bloom|applejack|cutie mark crusaders|fluttershy|mane six|pinkie pie|princess celestia|princess luna|rainbow dash|rarity|scootaloo|sweetie belle|trixie|twilight sparkle,joycall6
696611.jpeg,https://derpicdn.net/img/view/2014/8/10/696611.jpeg,4,0.9275521636009216,30,2117,684,2771,654,654,apple bloom|applejack|cutie mark crusaders|fluttershy|mane six|pinkie pie|princess celestia|princess luna|rainbow dash|rarity|scootaloo|sweetie belle|trixie|twilight sparkle,joycall6
696936.jpeg,https://derpicdn.net/img/view/2014/8/11/696936.jpeg,0,0.9979055523872375,492,185,694,387,202,202,princess cadance|princess celestia|princess luna|twilight sparkle,fleshsong
696936.jpeg,https://derpicdn.net/img/view/2014/8/11/696936.jpeg,1,0.9088359475135804,341,216,515,390,174,174,princess cadance|princess celestia|princess luna|twilight sparkle,fleshsong
699201.jpeg,https://derpicdn.net/img/view/2014/8/14/699201.jpeg,0,0.9899765253067015,1553,300,2257,1004,704,704,applejack|fluttershy|mane six|pinkie pie|rainbow dash|rarity|twilight sparkle,mkogwheel
699877.jpeg,https://derpicdn.net/img/view/2014/8/15/699877.jpeg,0,0.9236012697219848,3,191,949,1137,946,946,applejack|fluttershy|mane six|pinkie pie|rainbow dash|rarity|twilight sparkle,madisonmadlossen
699877.jpeg,https://derpicdn.net/img/view/2014/8/15/699877.jpeg,1,0.9058473110198976,657,1012,1883,2238,1226,1226,applejack|fluttershy|mane six|pinkie pie|rainbow dash|rarity|twilight sparkle,madisonmadlossen
699945.jpeg,https://derpicdn.net/img/view/2014/8/15/699945.jpeg,0,0.9991286396980286,980,114,1794,928,814,814,rainbow dash|twilight sparkle,nekojackun
700680.jpeg,https://derpicdn.net/img/view/2014/8/16/700680.jpeg,0,0.9194900393486024,0,544,208,754,208,210,applejack|fluttershy|mane six|pinkie pie|rainbow dash|rarity|twilight sparkle,diana leto
700680.jpeg,https://derpicdn.net/img/view/2014/8/16/700680.jpeg,1,0.9040263295173644,0,271,169,453,169,182,applejack|fluttershy|mane six|pinkie pie|rainbow dash|rarity|twilight sparkle,diana leto
704182.jpeg,https://derpicdn.net/img/view/2014/8/20/704182.jpeg,0,0.9411062002182008,0,511,199,711,199,200,applejack|fluttershy|mane six|pinkie pie|rainbow dash|rarity|twilight sparkle,diana leto
704317.jpeg,https://derpicdn.net/img/view/2014/8/20/704317.jpeg,0,0.9527269005775452,0,0,589,592,589,592,rainbow dash|twilight sparkle,ponythroat
706255.jpeg,https://derpicdn.net/img/view/2014/8/23/706255.jpeg,0,0.9800735116004944,130,156,318,344,188,188,applejack|fluttershy|mane six|pinkie pie|rainbow dash|rarity|twilight sparkle,amy30535
706255.jpeg,https://derpicdn.net/img/view/2014/8/23/706255.jpeg,1,0.9788457751274108,537,309,729,501,192,192,applejack|fluttershy|mane six|pinkie pie|rainbow dash|rarity|twilight sparkle,amy30535
706255.jpeg,https://derpicdn.net/img/view/2014/8/23/706255.jpeg,2,0.950572907924652,310,51,502,243,192,192,applejack|fluttershy|mane six|pinkie pie|rainbow dash|rarity|twilight sparkle,amy30535
706551.jpeg,https://derpicdn.net/img/view/2014/8/23/706551.jpeg,1,0.970145583152771,0,546,453,1024,453,478,apple bloom|cutie mark crusaders|princess celestia|princess luna|scootaloo|spike|sweetie belle|twilight sparkle,viraljp
706551.jpeg,https://derpicdn.net/img/view/2014/8/23/706551.jpeg,2,0.9448456168174744,245,457,789,1001,544,544,apple bloom|cutie mark crusaders|princess celestia|princess luna|scootaloo|spike|sweetie belle|twilight sparkle,viraljp
708620.jpeg,https://derpicdn.net/img/view/2014/8/26/708620.jpeg,1,0.9204226732254028,1878,1511,3076,2709,1198,1198,princess cadance|princess celestia|princess luna|twilight sparkle,theroyalprincesses
709454.jpeg,https://derpicdn.net/img/view/2014/8/27/709454.jpeg,0,0.9575874209403992,0,110,200,356,200,246,apple bloom|applejack|babs seed|big macintosh|braeburn|cutie mark crusaders|diamond tiara|fluttershy|granny smith|pinkie pie|princess cadance|princess celestia|princess luna|rainbow dash|rarity|scootaloo|shining armor|silver spoon|spike|spitfire|sweetie belle|trixie|twilight sparkle,tonyfleecs
709532.jpeg,https://derpicdn.net/img/view/2014/8/27/709532.jpeg,0,0.9971017241477966,472,93,856,477,384,384,pinkie pie|twilight sparkle,obcor
710164.jpeg,https://derpicdn.net/img/view/2014/8/29/710164.jpeg,1,0.9920350909233092,397,1358,1425,2386,1028,1028,applejack|fluttershy|mane six|pinkie pie|rainbow dash|rarity|twilight sparkle,
710369.jpeg,https://derpicdn.net/img/view/2014/8/29/710369.jpeg,1,0.963637351989746,2049,182,2661,794,612,612,applejack|fluttershy|rarity|twilight sparkle,jggjqm522
710369.jpeg,https://derpicdn.net/img/view/2014/8/29/710369.jpeg,2,0.9377254247665404,455,628,1463,1636,1008,1008,applejack|fluttershy|rarity|twilight sparkle,jggjqm522
711087.jpeg,https://derpicdn.net/img/view/2014/8/30/711087.jpeg,0,0.9696848392486572,18,243,266,491,248,248,apple bloom|babs seed|cutie mark crusaders|diamond tiara|princess cadance|scootaloo|shining armor|silver spoon|spike|sweetie belle|twilight sparkle,uotapo
711087.jpeg,https://derpicdn.net/img/view/2014/8/30/711087.jpeg,1,0.9578638076782228,625,112,893,380,268,268,apple bloom|babs seed|cutie mark crusaders|diamond tiara|princess cadance|scootaloo|shining armor|silver spoon|spike|sweetie belle|twilight sparkle,uotapo
714984.jpeg,https://derpicdn.net/img/view/2014/9/4/714984.jpeg,1,0.9758639335632324,311,205,533,427,222,222,princess cadance|princess celestia|princess luna|twilight sparkle,mysticalpha
715096.jpeg,https://derpicdn.net/img/view/2014/9/4/715096.jpeg,1,0.9891042709350586,38,873,320,1155,282,282,applejack|discord|fluttershy|mane six|pinkie pie|rainbow dash|rarity|spike|spitfire|twilight sparkle,
716277.jpeg,https://derpicdn.net/img/view/2014/9/6/716277.jpeg,0,0.9742569327354432,39,309,387,657,348,348,applejack|fluttershy|pinkie pie|rainbow dash|rarity|twilight sparkle,s4vin
717342.jpeg,https://derpicdn.net/img/view/2014/9/7/717342.jpeg,0,0.9905169010162354,131,88,437,394,306,306,fluttershy|twilight sparkle,keikowashere
718357.jpeg,https://derpicdn.net/img/view/2014/9/9/718357.jpeg,0,0.9658530354499816,159,0,761,524,602,524,rainbow dash|twilight sparkle,nekocrispy
718479.jpeg,https://derpicdn.net/img/view/2014/9/9/718479.jpeg,0,0.9857017993927002,30,75,492,537,462,462,princess celestia|rainbow dash|soarin'|twilight sparkle,biosonic100
721831.jpeg,https://derpicdn.net/img/view/2014/9/14/721831.jpeg,1,0.9360591769218444,268,35,502,269,234,234,spike|twilight sparkle,thefazoob
722929.jpeg,https://derpicdn.net/img/view/2014/9/16/722929.jpeg,0,0.9955583810806274,220,336,902,1018,682,682,princess cadance|princess celestia|princess luna|twilight sparkle,rose-beuty
723074.jpeg,https://derpicdn.net/img/view/2014/9/16/723074.jpeg,0,0.9987715482711792,679,0,1281,589,602,589,applejack|fluttershy|mane six|pinkie pie|rainbow dash|rarity|twilight sparkle,kikirdcz
723074.jpeg,https://derpicdn.net/img/view/2014/9/16/723074.jpeg,1,0.987191677093506,1429,1151,1931,1653,502,502,applejack|fluttershy|mane six|pinkie pie|rainbow dash|rarity|twilight sparkle,kikirdcz
723074.jpeg,https://derpicdn.net/img/view/2014/9/16/723074.jpeg,2,0.9163104891777042,95,1075,697,1677,602,602,applejack|fluttershy|mane six|pinkie pie|rainbow dash|rarity|twilight sparkle,kikirdcz
723144.jpeg,https://derpicdn.net/img/view/2014/9/16/723144.jpeg,0,0.9870697855949402,1880,1417,2326,1863,446,446,applejack|fluttershy|mane six|pinkie pie|rainbow dash|rarity|spike|twilight sparkle,captainpudgemuffin
723790.jpeg,https://derpicdn.net/img/view/2014/9/17/723790.jpeg,0,0.9726760387420654,27,1058,285,1316,258,258,applejack|fluttershy|mane six|pinkie pie|rainbow dash|rarity|twilight sparkle,agnesgarbowska
723791.jpeg,https://derpicdn.net/img/view/2014/9/17/723791.jpeg,0,0.9726812243461608,582,558,988,1046,406,488,pinkie pie|twilight sparkle,amy mebberson
724100.jpeg,https://derpicdn.net/img/view/2014/9/17/724100.jpeg,0,0.9284583926200868,930,71,1128,269,198,198,apple bloom|applejack|big macintosh|cutie mark crusaders|fluttershy|mane six|pinkie pie|rainbow dash|rarity|scootaloo|sweetie belle|twilight sparkle,stigma-photon
725549.jpeg,https://derpicdn.net/img/view/2014/9/19/725549.jpeg,1,0.992863118648529,103,890,399,1186,296,296,applejack|big macintosh|discord|fluttershy|mane six|pinkie pie|rainbow dash|rarity|spike|twilight sparkle,sparklesthestarfox
727048.jpeg,https://derpicdn.net/img/view/2014/9/22/727048.jpeg,0,0.934429168701172,1017,370,1563,916,546,546,rainbow dash|twilight sparkle,1231redflame
728269.jpeg,https://derpicdn.net/img/view/2014/9/24/728269.jpeg,0,0.9838225245475768,548,841,890,1183,342,342,applejack|fluttershy|mane six|pinkie pie|princess cadance|princess celestia|princess luna|rainbow dash|rarity|shining armor|spike|twilight sparkle,edvagreen
728627.jpeg,https://derpicdn.net/img/view/2014/9/24/728627.jpeg,0,0.9684366583824158,188,0,1156,781,968,781,discord|twilight sparkle,joakaha
730243.jpeg,https://derpicdn.net/img/view/2014/9/27/730243.jpeg,1,0.9843306541442872,665,54,1381,770,716,716,applejack|fluttershy|mane six|pinkie pie|princess celestia|princess luna|rainbow dash|rarity|spike|twilight sparkle,pastelspooks
734906.jpeg,https://derpicdn.net/img/view/2014/10/3/734906.jpeg,0,0.9987868666648864,1154,306,1982,1134,828,828,applejack|rainbow dash|rarity|twilight sparkle,peichenphilip
734906.jpeg,https://derpicdn.net/img/view/2014/10/3/734906.jpeg,1,0.9907030463218688,2081,228,2921,1068,840,840,applejack|rainbow dash|rarity|twilight sparkle,peichenphilip
734906.jpeg,https://derpicdn.net/img/view/2014/10/3/734906.jpeg,2,0.9478210210800172,85,1783,577,2275,492,492,applejack|rainbow dash|rarity|twilight sparkle,peichenphilip
737034.jpeg,https://derpicdn.net/img/view/2014/10/6/737034.jpeg,1,0.9326186180114746,165,63,657,555,492,492,princess celestia|twilight sparkle,kolshica
737155.jpeg,https://derpicdn.net/img/view/2014/10/6/737155.jpeg,0,0.9971923828125,128,45,568,485,440,440,princess cadance|princess celestia|princess luna|shining armor|twilight sparkle,pandan009
737300.jpeg,https://derpicdn.net/img/view/2014/10/6/737300.jpeg,0,0.9997478127479552,1222,424,1994,1196,772,772,spike|twilight sparkle,piesarts
738804.jpeg,https://derpicdn.net/img/view/2014/10/8/738804.jpeg,0,0.9977108240127563,428,326,930,828,502,502,princess cadance|princess celestia|princess luna|twilight sparkle,helenasherzblut
738804.jpeg,https://derpicdn.net/img/view/2014/10/8/738804.jpeg,1,0.9836817383766174,1350,983,1848,1481,498,498,princess cadance|princess celestia|princess luna|twilight sparkle,helenasherzblut
738804.jpeg,https://derpicdn.net/img/view/2014/10/8/738804.jpeg,2,0.9461057782173156,696,1618,1078,2000,382,382,princess cadance|princess celestia|princess luna|twilight sparkle,helenasherzblut
739465.jpeg,https://derpicdn.net/img/view/2014/10/9/739465.jpeg,0,0.9396936893463136,3397,1082,4403,2088,1006,1006,princess celestia|princess luna|rainbow dash|twilight sparkle,devinian
739474.jpeg,https://derpicdn.net/img/view/2014/10/9/739474.jpeg,0,0.9568005800247192,0,19,405,429,405,410,spike|twilight sparkle,suenden-hund
739512.jpeg,https://derpicdn.net/img/view/2014/10/9/739512.jpeg,0,0.9346341490745544,1074,0,1920,786,846,786,princess cadance|twilight sparkle,dragonfoxgirl
740257.jpeg,https://derpicdn.net/img/view/2014/10/10/740257.jpeg,2,0.9785855412483216,190,309,526,645,336,336,applejack|fluttershy|mane six|pinkie pie|rainbow dash|rarity|twilight sparkle,mistydash
740665.jpeg,https://derpicdn.net/img/view/2014/10/11/740665.jpeg,1,0.9861348867416382,762,181,1412,831,650,650,trixie|twilight sparkle,kloudmutt
741074.jpeg,https://derpicdn.net/img/view/2014/10/11/741074.jpeg,0,0.9923335313796996,1420,563,1720,863,300,300,apple bloom|big macintosh|fluttershy|granny smith|pinkie pie|rarity|twilight sparkle,saturdaymorningproj
741074.jpeg,https://derpicdn.net/img/view/2014/10/11/741074.jpeg,1,0.9906527996063232,668,343,1000,675,332,332,apple bloom|big macintosh|fluttershy|granny smith|pinkie pie|rarity|twilight sparkle,saturdaymorningproj
741074.jpeg,https://derpicdn.net/img/view/2014/10/11/741074.jpeg,2,0.9169039130210876,88,851,530,1293,442,442,apple bloom|big macintosh|fluttershy|granny smith|pinkie pie|rarity|twilight sparkle,saturdaymorningproj
741898.jpeg,https://derpicdn.net/img/view/2014/10/13/741898.jpeg,0,0.9974831342697144,856,437,1440,1021,584,584,applejack|fluttershy|mane six|pinkie pie|rainbow dash|rarity|twilight sparkle,souleatersaku90
742462.jpeg,https://derpicdn.net/img/view/2014/10/13/742462.jpeg,0,0.9993438124656676,0,293,325,647,325,354,apple bloom|applejack|big macintosh|cutie mark crusaders|fluttershy|pinkie pie|princess cadance|princess celestia|princess luna|rainbow dash|rarity|scootaloo|shining armor|spike|sweetie belle|trixie|twilight sparkle,cartoonartist|senseijiufu
742462.jpeg,https://derpicdn.net/img/view/2014/10/13/742462.jpeg,2,0.9966518878936768,0,763,297,1101,297,338,apple bloom|applejack|big macintosh|cutie mark crusaders|fluttershy|pinkie pie|princess cadance|princess celestia|princess luna|rainbow dash|rarity|scootaloo|shining armor|spike|sweetie belle|trixie|twilight sparkle,cartoonartist|senseijiufu
742462.jpeg,https://derpicdn.net/img/view/2014/10/13/742462.jpeg,4,0.9820301532745358,686,894,954,1162,268,268,apple bloom|applejack|big macintosh|cutie mark crusaders|fluttershy|pinkie pie|princess cadance|princess celestia|princess luna|rainbow dash|rarity|scootaloo|shining armor|spike|sweetie belle|trixie|twilight sparkle,cartoonartist|senseijiufu
742462.jpeg,https://derpicdn.net/img/view/2014/10/13/742462.jpeg,5,0.9657588005065918,351,975,623,1247,272,272,apple bloom|applejack|big macintosh|cutie mark crusaders|fluttershy|pinkie pie|princess cadance|princess celestia|princess luna|rainbow dash|rarity|scootaloo|shining armor|spike|sweetie belle|trixie|twilight sparkle,cartoonartist|senseijiufu
742462.jpeg,https://derpicdn.net/img/view/2014/10/13/742462.jpeg,9,0.9185968637466432,253,615,545,907,292,292,apple bloom|applejack|big macintosh|cutie mark crusaders|fluttershy|pinkie pie|princess cadance|princess celestia|princess luna|rainbow dash|rarity|scootaloo|shining armor|spike|sweetie belle|trixie|twilight sparkle,cartoonartist|senseijiufu
743739.jpeg,https://derpicdn.net/img/view/2014/10/15/743739.jpeg,0,0.971063196659088,968,13,1098,143,130,130,apple bloom|applejack|big macintosh|braeburn|cutie mark crusaders|discord|fluttershy|mane six|pinkie pie|princess cadance|princess celestia|princess luna|queen chrysalis|rainbow dash|rarity|scootaloo|shining armor|soarin'|spike|spitfire|sunset shimmer|sweetie belle|trixie|twilight sparkle,jezebeltart
743739.jpeg,https://derpicdn.net/img/view/2014/10/15/743739.jpeg,2,0.9464569687843324,730,1335,916,1521,186,186,apple bloom|applejack|big macintosh|braeburn|cutie mark crusaders|discord|fluttershy|mane six|pinkie pie|princess cadance|princess celestia|princess luna|queen chrysalis|rainbow dash|rarity|scootaloo|shining armor|soarin'|spike|spitfire|sunset shimmer|sweetie belle|trixie|twilight sparkle,jezebeltart
744617.jpeg,https://derpicdn.net/img/view/2014/10/17/744617.jpeg,0,0.996928870677948,391,140,589,338,198,198,applejack|fluttershy|mane six|pinkie pie|princess cadance|princess celestia|princess luna|rainbow dash|rarity|spike|twilight sparkle,kolshica
744617.jpeg,https://derpicdn.net/img/view/2014/10/17/744617.jpeg,1,0.9850876927375792,238,0,476,210,238,210,applejack|fluttershy|mane six|pinkie pie|princess cadance|princess celestia|princess luna|rainbow dash|rarity|spike|twilight sparkle,kolshica
744617.jpeg,https://derpicdn.net/img/view/2014/10/17/744617.jpeg,2,0.9623708128929138,514,243,820,549,306,306,applejack|fluttershy|mane six|pinkie pie|princess cadance|princess celestia|princess luna|rainbow dash|rarity|spike|twilight sparkle,kolshica
744697.jpeg,https://derpicdn.net/img/view/2014/10/17/744697.jpeg,0,0.950533092021942,425,0,735,306,310,306,trixie|twilight sparkle,dewdrop-210
745147.jpeg,https://derpicdn.net/img/view/2014/10/18/745147.jpeg,0,0.995721697807312,401,91,665,355,264,264,princess celestia|princess luna|twilight sparkle,backlash91|denmawarlight
745833.jpeg,https://derpicdn.net/img/view/2014/10/19/745833.jpeg,0,0.9958413243293762,0,0,492,433,492,433,applejack|fluttershy|mane six|pinkie pie|rainbow dash|rarity|twilight sparkle,beda-the-rabbit
745833.jpeg,https://derpicdn.net/img/view/2014/10/19/745833.jpeg,1,0.9935374259948728,748,386,1252,890,504,504,applejack|fluttershy|mane six|pinkie pie|rainbow dash|rarity|twilight sparkle,beda-the-rabbit
745833.jpeg,https://derpicdn.net/img/view/2014/10/19/745833.jpeg,3,0.9074228405952454,380,422,848,890,468,468,applejack|fluttershy|mane six|pinkie pie|rainbow dash|rarity|twilight sparkle,beda-the-rabbit
746646.jpeg,https://derpicdn.net/img/view/2014/10/20/746646.jpeg,0,0.9395435452461244,264,0,628,351,364,351,apple bloom|cutie mark crusaders|rainbow dash|scootaloo|sweetie belle|twilight sparkle,neroscottkennedy
746884.jpeg,https://derpicdn.net/img/view/2014/10/20/746884.jpeg,0,0.9319211840629578,491,117,707,333,216,216,applejack|fluttershy|mane six|pinkie pie|rainbow dash|rarity|twilight sparkle,mistydash
748652.jpeg,https://derpicdn.net/img/view/2014/10/23/748652.jpeg,0,0.9871247410774232,42,813,340,1111,298,298,applejack|fluttershy|mane six|pinkie pie|rainbow dash|rarity|twilight sparkle,andypriceart
751700.jpeg,https://derpicdn.net/img/view/2014/10/27/751700.jpeg,0,0.933351755142212,639,0,1825,1095,1186,1095,spike|twilight sparkle,kikirdcz
751700.jpeg,https://derpicdn.net/img/view/2014/10/27/751700.jpeg,1,0.9039294719696044,1634,199,2300,865,666,666,spike|twilight sparkle,kikirdcz
756411.jpeg,https://derpicdn.net/img/view/2014/11/2/756411.jpeg,0,0.9942101836204528,1019,411,1277,669,258,258,princess cadance|princess celestia|princess luna|sunset shimmer|twilight sparkle,seanica
756730.jpeg,https://derpicdn.net/img/view/2014/11/3/756730.jpeg,0,0.9952147006988524,1431,1509,1936,2023,505,514,applejack|fluttershy|mane six|pinkie pie|rainbow dash|rarity|twilight sparkle,hayley1432
757186.jpeg,https://derpicdn.net/img/view/2014/11/3/757186.jpeg,0,0.9679117202758788,791,58,1333,600,542,542,applejack|fluttershy|mane six|pinkie pie|rainbow dash|rarity|twilight sparkle,madisonlossen
758666.jpeg,https://derpicdn.net/img/view/2014/11/5/758666.jpeg,0,0.9917537569999696,426,0,668,242,242,242,applejack|fluttershy|mane six|pinkie pie|rainbow dash|rarity|twilight sparkle,jezebeltart
758666.jpeg,https://derpicdn.net/img/view/2014/11/5/758666.jpeg,1,0.9850981831550598,165,0,385,212,220,212,applejack|fluttershy|mane six|pinkie pie|rainbow dash|rarity|twilight sparkle,jezebeltart
759330.jpeg,https://derpicdn.net/img/view/2014/11/6/759330.jpeg,0,0.9295922517776488,370,10,770,410,400,400,rainbow dash|twilight sparkle,mistydash
762015.jpeg,https://derpicdn.net/img/view/2014/11/10/762015.jpeg,0,0.9832947850227356,561,0,1097,461,536,461,rarity|twilight sparkle,dutchgirl626|rosieu
762015.jpeg,https://derpicdn.net/img/view/2014/11/10/762015.jpeg,1,0.9660094380378724,192,5,694,507,502,502,rarity|twilight sparkle,dutchgirl626|rosieu
766668.jpeg,https://derpicdn.net/img/view/2014/11/17/766668.jpeg,0,0.9695841073989868,1703,1281,2753,2331,1050,1050,spike|twilight sparkle,coberlink|norithecat
767541.jpeg,https://derpicdn.net/img/view/2014/11/19/767541.jpeg,1,0.9023182988166808,116,356,304,544,188,188,applejack|fluttershy|mane six|pinkie pie|rainbow dash|rarity|twilight sparkle,andypriceart
770819.jpeg,https://derpicdn.net/img/view/2014/11/24/770819.jpeg,0,0.9602517485618592,274,0,786,437,512,437,princess celestia|princess luna|twilight sparkle,f-nar
771190.jpeg,https://derpicdn.net/img/view/2014/11/24/771190.jpeg,0,0.999202311038971,988,176,1490,678,502,502,shining armor|twilight sparkle,wan1357
771190.jpeg,https://derpicdn.net/img/view/2014/11/24/771190.jpeg,1,0.9650754928588868,168,0,732,484,564,484,shining armor|twilight sparkle,wan1357
771721.jpeg,https://derpicdn.net/img/view/2014/11/25/771721.jpeg,0,0.9237767457962036,421,165,619,363,198,198,spike|twilight sparkle,nukilik
772239.jpeg,https://derpicdn.net/img/view/2014/11/26/772239.jpeg,0,0.9700341224670408,1737,0,4200,2358,2463,2358,rainbow dash|twilight sparkle,riouku
774738.jpeg,https://derpicdn.net/img/view/2014/11/30/774738.jpeg,0,0.995739996433258,231,42,919,730,688,688,rainbow dash|twilight sparkle,joycall6
775033.jpeg,https://derpicdn.net/img/view/2014/11/30/775033.jpeg,0,0.9952817559242249,308,7,506,205,198,198,applejack|fluttershy|mane six|pinkie pie|rainbow dash|rarity|twilight sparkle,grandifloru
775033.jpeg,https://derpicdn.net/img/view/2014/11/30/775033.jpeg,1,0.9906641840934752,0,596,204,818,204,222,applejack|fluttershy|mane six|pinkie pie|rainbow dash|rarity|twilight sparkle,grandifloru
775033.jpeg,https://derpicdn.net/img/view/2014/11/30/775033.jpeg,2,0.9875154495239258,18,0,212,190,194,190,applejack|fluttershy|mane six|pinkie pie|rainbow dash|rarity|twilight sparkle,grandifloru
775033.jpeg,https://derpicdn.net/img/view/2014/11/30/775033.jpeg,3,0.9738940596580504,0,306,238,588,238,282,applejack|fluttershy|mane six|pinkie pie|rainbow dash|rarity|twilight sparkle,grandifloru
776081.jpeg,https://derpicdn.net/img/view/2014/12/1/776081.jpeg,0,0.9980711936950684,531,341,999,809,468,468,applejack|fluttershy|mane six|pinkie pie|rainbow dash|rarity|sunset shimmer|twilight sparkle,yukomaussi
776457.jpeg,https://derpicdn.net/img/view/2014/12/2/776457.jpeg,0,0.998284876346588,522,362,980,820,458,458,rarity|trixie|twilight sparkle,darkdoomer
776457.jpeg,https://derpicdn.net/img/view/2014/12/2/776457.jpeg,1,0.997725248336792,981,422,1405,846,424,424,rarity|trixie|twilight sparkle,darkdoomer
776457.jpeg,https://derpicdn.net/img/view/2014/12/2/776457.jpeg,2,0.9880476593971252,1341,422,1739,820,398,398,rarity|trixie|twilight sparkle,darkdoomer
776457.jpeg,https://derpicdn.net/img/view/2014/12/2/776457.jpeg,3,0.9514595866203308,173,522,501,850,328,328,rarity|trixie|twilight sparkle,darkdoomer
776587.jpeg,https://derpicdn.net/img/view/2014/12/2/776587.jpeg,1,0.9644427299499512,233,0,363,124,130,124,applejack|fluttershy|mane six|pinkie pie|rainbow dash|rarity|twilight sparkle,calyartist
776587.jpeg,https://derpicdn.net/img/view/2014/12/2/776587.jpeg,2,0.949410617351532,341,0,481,140,140,140,applejack|fluttershy|mane six|pinkie pie|rainbow dash|rarity|twilight sparkle,calyartist
778126.jpeg,https://derpicdn.net/img/view/2014/12/4/778126.jpeg,1,0.9765684008598328,3747,1894,4801,2948,1054,1054,applejack|fluttershy|mane six|pinkie pie|rainbow dash|rarity|twilight sparkle,jamesjackobgermany
781298.jpeg,https://derpicdn.net/img/view/2014/12/9/781298.jpeg,0,0.9953336715698242,432,73,788,429,356,356,princess cadance|princess luna|twilight sparkle,islamilenaria
781354.jpeg,https://derpicdn.net/img/view/2014/12/9/781354.jpeg,0,0.9951636791229248,23,0,357,323,334,323,fluttershy|pinkie pie|rainbow dash|rarity|twilight sparkle,bluse
781639.jpeg,https://derpicdn.net/img/view/2014/12/9/781639.jpeg,0,0.995115041732788,359,79,533,253,174,174,pinkie pie|rarity|twilight sparkle,nukilik
782759.jpeg,https://derpicdn.net/img/view/2014/12/11/782759.jpeg,0,0.9980619549751282,784,163,1220,599,436,436,applejack|fluttershy|mane six|pinkie pie|rainbow dash|rarity|twilight sparkle,pshyzomancer
784344.jpeg,https://derpicdn.net/img/view/2014/12/13/784344.jpeg,0,0.9922516942024232,179,171,547,539,368,368,sunset shimmer|twilight sparkle,teammagix
784344.jpeg,https://derpicdn.net/img/view/2014/12/13/784344.jpeg,1,0.9306979179382324,512,199,870,557,358,358,sunset shimmer|twilight sparkle,teammagix
784644.jpeg,https://derpicdn.net/img/view/2014/12/14/784644.jpeg,0,0.9243825674057008,123,28,425,330,302,302,sunset shimmer|twilight sparkle,creatorofpony
785759.jpeg,https://derpicdn.net/img/view/2014/12/15/785759.jpeg,0,0.9638586044311525,385,0,1925,1463,1540,1463,rainbow dash|twilight sparkle,mysticalpha
785759.jpeg,https://derpicdn.net/img/view/2014/12/15/785759.jpeg,1,0.9442859888076782,1751,284,2325,858,574,574,rainbow dash|twilight sparkle,mysticalpha
786060.jpeg,https://derpicdn.net/img/view/2014/12/16/786060.jpeg,0,0.9965712428092957,152,231,678,757,526,526,fluttershy|princess celestia|princess luna|rainbow dash|twilight sparkle,joycall6
786060.jpeg,https://derpicdn.net/img/view/2014/12/16/786060.jpeg,1,0.9324921369552612,596,193,1166,763,570,570,fluttershy|princess celestia|princess luna|rainbow dash|twilight sparkle,joycall6
786488.jpeg,https://derpicdn.net/img/view/2014/12/17/786488.jpeg,1,0.9594039916992188,303,653,1509,1859,1206,1206,rarity|spike|twilight sparkle,dinodraketakethecake
788503.jpeg,https://derpicdn.net/img/view/2014/12/20/788503.jpeg,0,0.9972723722457886,1741,1903,2417,2579,676,676,princess celestia|princess luna|rainbow dash|spike|trixie|twilight sparkle,silfoe
788503.jpeg,https://derpicdn.net/img/view/2014/12/20/788503.jpeg,1,0.996920108795166,0,2915,781,3825,781,910,princess celestia|princess luna|rainbow dash|spike|trixie|twilight sparkle,silfoe
788503.jpeg,https://derpicdn.net/img/view/2014/12/20/788503.jpeg,2,0.9716741442680359,81,1873,779,2571,698,698,princess celestia|princess luna|rainbow dash|spike|trixie|twilight sparkle,silfoe
788503.jpeg,https://derpicdn.net/img/view/2014/12/20/788503.jpeg,3,0.9612656235694884,2567,1373,3456,2315,889,942,princess celestia|princess luna|rainbow dash|spike|trixie|twilight sparkle,silfoe
788503.jpeg,https://derpicdn.net/img/view/2014/12/20/788503.jpeg,4,0.9344783425331116,2573,2411,3456,3433,883,1022,princess celestia|princess luna|rainbow dash|spike|trixie|twilight sparkle,silfoe
788503.jpeg,https://derpicdn.net/img/view/2014/12/20/788503.jpeg,5,0.9318171739578248,2164,0,3310,1137,1146,1137,princess celestia|princess luna|rainbow dash|spike|trixie|twilight sparkle,silfoe
791775.jpeg,https://derpicdn.net/img/view/2014/12/24/791775.jpeg,0,0.9898450374603271,1612,1366,2484,2238,872,872,applejack|discord|fluttershy|mane six|pinkie pie|princess celestia|princess luna|rainbow dash|rarity|spike|twilight sparkle,seer45
792512.jpeg,https://derpicdn.net/img/view/2014/12/25/792512.jpeg,0,0.9261862635612488,276,0,958,606,682,606,trixie|twilight sparkle,pearlyiridescence
793880.jpeg,https://derpicdn.net/img/view/2014/12/27/793880.jpeg,0,0.9836811423301696,172,163,476,467,304,304,pinkie pie|twilight sparkle,vogelchan
794568.jpeg,https://derpicdn.net/img/view/2014/12/28/794568.jpeg,0,0.9830958247184752,1627,521,2587,1481,960,960,rainbow dash|rarity|spike|twilight sparkle,falco9998
794568.jpeg,https://derpicdn.net/img/view/2014/12/28/794568.jpeg,1,0.979228138923645,664,1099,1592,2027,928,928,rainbow dash|rarity|spike|twilight sparkle,falco9998
795364.jpeg,https://derpicdn.net/img/view/2014/12/29/795364.jpeg,0,0.9838361740112304,1863,188,2281,606,418,418,applejack|fluttershy|mane six|pinkie pie|rainbow dash|rarity|twilight sparkle,twilytrinky
795734.jpeg,https://derpicdn.net/img/view/2014/12/30/795734.jpeg,1,0.9868844747543336,431,0,809,371,378,371,applejack|fluttershy|mane six|pinkie pie|rainbow dash|rarity|twilight sparkle,ponygoddess
795734.jpeg,https://derpicdn.net/img/view/2014/12/30/795734.jpeg,2,0.9634244441986084,0,749,507,1359,507,610,applejack|fluttershy|mane six|pinkie pie|rainbow dash|rarity|twilight sparkle,ponygoddess
799914.jpeg,https://derpicdn.net/img/view/2015/1/5/799914.jpeg,0,0.9963006377220154,763,152,1169,558,406,406,princess cadance|princess celestia|princess luna|twilight sparkle,skecchiart
802075.jpeg,https://derpicdn.net/img/view/2015/1/8/802075.jpeg,2,0.9823876619338988,769,372,949,552,180,180,apple bloom|applejack|fluttershy|mane six|pinkie pie|rainbow dash|rarity|twilight sparkle,noben
802870.jpeg,https://derpicdn.net/img/view/2015/1/9/802870.jpeg,0,0.9839871525764464,1941,391,2425,875,484,484,princess cadance|princess celestia|princess luna|twilight sparkle,silfoe
802870.jpeg,https://derpicdn.net/img/view/2015/1/9/802870.jpeg,1,0.9826410412788392,190,663,746,1219,556,556,princess cadance|princess celestia|princess luna|twilight sparkle,silfoe
804725.jpeg,https://derpicdn.net/img/view/2015/1/12/804725.jpeg,0,0.9985115528106692,437,0,911,409,474,409,pinkie pie|twilight sparkle,dawntrotter
804725.jpeg,https://derpicdn.net/img/view/2015/1/12/804725.jpeg,2,0.994547426700592,23,0,491,421,468,421,pinkie pie|twilight sparkle,dawntrotter
805173.jpeg,https://derpicdn.net/img/view/2015/1/13/805173.jpeg,0,0.9474257230758668,660,808,984,1132,324,324,discord|princess cadance|princess celestia|princess luna|shining armor|spike|twilight sparkle,frankilew
806470.jpeg,https://derpicdn.net/img/view/2015/1/14/806470.jpeg,0,0.9887444376945496,245,484,637,876,392,392,princess cadance|princess celestia|spike|twilight sparkle,humite-ubie
806470.jpeg,https://derpicdn.net/img/view/2015/1/14/806470.jpeg,1,0.981498122215271,759,79,1327,647,568,568,princess cadance|princess celestia|spike|twilight sparkle,humite-ubie
806859.jpeg,https://derpicdn.net/img/view/2015/1/15/806859.jpeg,0,0.9730641841888428,189,587,575,973,386,386,princess cadance|princess celestia|princess luna|twilight sparkle,theroyalprincesses
807615.jpeg,https://derpicdn.net/img/view/2015/1/16/807615.jpeg,0,0.9242308139801024,262,2808,1030,3576,768,768,apple bloom|applejack|cutie mark crusaders|discord|fluttershy|mane six|pinkie pie|princess cadance|princess celestia|princess luna|queen chrysalis|rainbow dash|rarity|scootaloo|shining armor|spike|sweetie belle|twilight sparkle,inkypsycho
808044.jpeg,https://derpicdn.net/img/view/2015/1/16/808044.jpeg,0,0.9372541904449464,0,0,764,658,764,658,trixie|twilight sparkle,sverre93
808058.jpeg,https://derpicdn.net/img/view/2015/1/16/808058.jpeg,0,0.979492723941803,1069,376,1259,566,190,190,princess luna|rarity|twilight sparkle,silfoe
808456.jpeg,https://derpicdn.net/img/view/2015/1/17/808456.jpeg,0,0.9730342626571656,145,1147,485,1487,340,340,discord|spike|twilight sparkle,mister-saugrenu
812741.jpeg,https://derpicdn.net/img/view/2015/1/23/812741.jpeg,0,0.9569802284240724,2270,904,2954,1588,684,684,princess celestia|princess luna|twilight sparkle,asimplerarity
816021.jpeg,https://derpicdn.net/img/view/2015/1/27/816021.jpeg,0,0.99113529920578,1823,370,3333,1880,1510,1510,princess luna|twilight sparkle,silfoe
816738.jpeg,https://derpicdn.net/img/view/2015/1/29/816738.jpeg,0,0.9960783123970032,696,0,1198,460,502,460,princess luna|twilight sparkle,japandragon
817026.jpeg,https://derpicdn.net/img/view/2015/1/29/817026.jpeg,0,0.9540658593177797,407,160,781,534,374,374,princess cadance|princess celestia|princess luna|twilight sparkle,kolshica
817218.jpeg,https://derpicdn.net/img/view/2015/1/29/817218.jpeg,0,0.9976110458374025,465,0,987,454,522,454,sunset shimmer|trixie|twilight sparkle,feather
817463.jpeg,https://derpicdn.net/img/view/2015/1/30/817463.jpeg,1,0.9739554524421692,654,1128,934,1408,280,280,applejack|fluttershy|mane six|pinkie pie|rainbow dash|rarity|spike|twilight sparkle,skecchiart
817463.jpeg,https://derpicdn.net/img/view/2015/1/30/817463.jpeg,2,0.9699226617813108,323,1129,669,1475,346,346,applejack|fluttershy|mane six|pinkie pie|rainbow dash|rarity|spike|twilight sparkle,skecchiart
820590.jpeg,https://derpicdn.net/img/view/2015/2/3/820590.jpeg,0,0.9928666949272156,0,209,307,517,307,308,princess cadance|princess celestia|princess luna|twilight sparkle,neko-ichigo
820590.jpeg,https://derpicdn.net/img/view/2015/2/3/820590.jpeg,1,0.9874948859214784,522,213,822,513,300,300,princess cadance|princess celestia|princess luna|twilight sparkle,neko-ichigo
820590.jpeg,https://derpicdn.net/img/view/2015/2/3/820590.jpeg,2,0.9508656859397888,237,189,497,449,260,260,princess cadance|princess celestia|princess luna|twilight sparkle,neko-ichigo
822320.jpeg,https://derpicdn.net/img/view/2015/2/5/822320.jpeg,0,0.966994285583496,206,5,538,337,332,332,trixie|twilight sparkle,radiantrealm
822858.jpeg,https://derpicdn.net/img/view/2015/2/6/822858.jpeg,0,0.9992895126342772,223,163,535,475,312,312,princess cadance|princess celestia|princess luna|shining armor|twilight sparkle,silfoe
822858.jpeg,https://derpicdn.net/img/view/2015/2/6/822858.jpeg,1,0.998366117477417,8,189,230,411,222,222,princess cadance|princess celestia|princess luna|shining armor|twilight sparkle,silfoe
822858.jpeg,https://derpicdn.net/img/view/2015/2/6/822858.jpeg,2,0.9922277927398682,802,98,1086,382,284,284,princess cadance|princess celestia|princess luna|shining armor|twilight sparkle,silfoe
823557.jpeg,https://derpicdn.net/img/view/2015/2/7/823557.jpeg,0,0.986864984035492,413,0,995,484,582,484,sunset shimmer|twilight sparkle,joycall6
825327.jpeg,https://derpicdn.net/img/view/2015/2/10/825327.jpeg,0,0.990869402885437,3803,148,4841,1186,1038,1038,discord|princess celestia|princess luna|twilight sparkle,magnaluna
825561.jpeg,https://derpicdn.net/img/view/2015/2/10/825561.jpeg,0,0.9980016350746156,688,187,1020,519,332,332,rarity|twilight sparkle,howxu
825561.jpeg,https://derpicdn.net/img/view/2015/2/10/825561.jpeg,1,0.9961601495742798,1738,1662,2108,2032,370,370,rarity|twilight sparkle,howxu
825561.jpeg,https://derpicdn.net/img/view/2015/2/10/825561.jpeg,4,0.9867735505104064,797,994,1117,1314,320,320,rarity|twilight sparkle,howxu
825701.jpeg,https://derpicdn.net/img/view/2015/2/10/825701.jpeg,0,0.9721779227256776,617,128,1203,714,586,586,princess luna|twilight sparkle,silfoe
827306.jpeg,https://derpicdn.net/img/view/2015/2/13/827306.jpeg,0,0.9896728992462158,535,27,1657,1149,1122,1122,sunset shimmer|twilight sparkle,cyanaeolin
827306.jpeg,https://derpicdn.net/img/view/2015/2/13/827306.jpeg,1,0.9688072204589844,1901,505,2683,1287,782,782,sunset shimmer|twilight sparkle,cyanaeolin
827989.jpeg,https://derpicdn.net/img/view/2015/2/14/827989.jpeg,0,0.9321308732032776,45,0,395,348,350,348,pinkie pie|rarity|twilight sparkle,arnne
829366.jpeg,https://derpicdn.net/img/view/2015/2/15/829366.jpeg,0,0.9670009613037108,1052,189,1816,953,764,764,rarity|twilight sparkle,jamesjackobgermany
831070.jpeg,https://derpicdn.net/img/view/2015/2/17/831070.jpeg,1,0.9439015388488772,803,2057,1237,2491,434,434,applejack|fluttershy|mane six|pinkie pie|rainbow dash|rarity|spike|sunset shimmer|twilight sparkle,jenndylyon
832599.jpeg,https://derpicdn.net/img/view/2015/2/19/832599.jpeg,0,0.9957175254821776,225,0,611,374,386,374,sunset shimmer|twilight sparkle,fallenangel5414
832610.jpeg,https://derpicdn.net/img/view/2015/2/19/832610.jpeg,0,0.9971472024917604,1576,394,2590,1269,1014,875,princess celestia|sunset shimmer|twilight sparkle,apilsinn
832610.jpeg,https://derpicdn.net/img/view/2015/2/19/832610.jpeg,1,0.9940596222877502,400,0,1596,952,1196,952,princess celestia|sunset shimmer|twilight sparkle,apilsinn
832610.jpeg,https://derpicdn.net/img/view/2015/2/19/832610.jpeg,2,0.9397264122962952,813,626,1301,1114,488,488,princess celestia|sunset shimmer|twilight sparkle,apilsinn
833948.jpeg,https://derpicdn.net/img/view/2015/2/21/833948.jpeg,0,0.9947389364242554,558,17,958,417,400,400,princess celestia|twilight sparkle,butterfingas|mrs89fluffy|kianamai
833948.jpeg,https://derpicdn.net/img/view/2015/2/21/833948.jpeg,1,0.950244963169098,148,221,474,547,326,326,princess celestia|twilight sparkle,butterfingas|mrs89fluffy|kianamai
836007.jpeg,https://derpicdn.net/img/view/2015/2/23/836007.jpeg,0,0.9930847883224488,192,0,806,611,614,611,fluttershy|twilight sparkle,spellboundcanvas
841603.jpeg,https://derpicdn.net/img/view/2015/3/3/841603.jpeg,0,0.9466667175292968,950,183,1790,1023,840,840,princess celestia|twilight sparkle,ncmares
842880.jpeg,https://derpicdn.net/img/view/2015/3/5/842880.jpeg,0,0.9932910799980164,572,276,756,460,184,184,applejack|fluttershy|mane six|pinkie pie|rainbow dash|rarity|twilight sparkle,
843164.jpeg,https://derpicdn.net/img/view/2015/3/5/843164.jpeg,0,0.9975410103797911,528,154,894,520,366,366,rainbow dash|rarity|twilight sparkle,maxressor
844095.jpeg,https://derpicdn.net/img/view/2015/3/6/844095.jpeg,0,0.9623453617095948,207,505,475,773,268,268,spike|twilight sparkle,drawing-heart
845488.jpeg,https://derpicdn.net/img/view/2015/3/8/845488.jpeg,0,0.9758903980255128,206,0,510,295,304,295,applejack|pinkie pie|rainbow dash|rarity|starlight glimmer|twilight sparkle,teammagix
846655.jpeg,https://derpicdn.net/img/view/2015/3/10/846655.jpeg,0,0.9340333342552184,0,23,350,459,350,436,pinkie pie|twilight sparkle,sip
846796.jpeg,https://derpicdn.net/img/view/2015/3/10/846796.jpeg,0,0.9975303411483764,1286,257,1830,801,544,544,applejack|fluttershy|mane six|pinkie pie|rainbow dash|rarity|twilight sparkle,ncmares
846796.jpeg,https://derpicdn.net/img/view/2015/3/10/846796.jpeg,1,0.9804273247718812,1683,708,2129,1154,446,446,applejack|fluttershy|mane six|pinkie pie|rainbow dash|rarity|twilight sparkle,ncmares
846796.jpeg,https://derpicdn.net/img/view/2015/3/10/846796.jpeg,3,0.961628258228302,1273,703,1711,1141,438,438,applejack|fluttershy|mane six|pinkie pie|rainbow dash|rarity|twilight sparkle,ncmares
847421.jpeg,https://derpicdn.net/img/view/2015/3/11/847421.jpeg,1,0.9567749500274658,260,623,546,909,286,286,spike|twilight sparkle,doretihome
847435.jpeg,https://derpicdn.net/img/view/2015/3/11/847435.jpeg,0,0.9967893362045288,164,10,1052,898,888,888,princess celestia|princess luna|twilight sparkle,ncmares
847435.jpeg,https://derpicdn.net/img/view/2015/3/11/847435.jpeg,2,0.9949846863746644,1812,412,2296,896,484,484,princess celestia|princess luna|twilight sparkle,ncmares
850813.jpeg,https://derpicdn.net/img/view/2015/3/16/850813.jpeg,1,0.9963481426239014,111,54,417,360,306,306,applejack|fluttershy|mane six|pinkie pie|rainbow dash|rarity|twilight sparkle,princrim
850813.jpeg,https://derpicdn.net/img/view/2015/3/16/850813.jpeg,2,0.9928662180900574,914,578,1196,860,282,282,applejack|fluttershy|mane six|pinkie pie|rainbow dash|rarity|twilight sparkle,princrim
850813.jpeg,https://derpicdn.net/img/view/2015/3/16/850813.jpeg,3,0.9890416860580444,463,595,871,1003,408,408,applejack|fluttershy|mane six|pinkie pie|rainbow dash|rarity|twilight sparkle,princrim
850813.jpeg,https://derpicdn.net/img/view/2015/3/16/850813.jpeg,4,0.9223424792289734,470,51,696,277,226,226,applejack|fluttershy|mane six|pinkie pie|rainbow dash|rarity|twilight sparkle,princrim
851773.jpeg,https://derpicdn.net/img/view/2015/3/17/851773.jpeg,0,0.9960720539093018,665,0,877,176,212,176,applejack|big macintosh|fluttershy|pinkie pie|rainbow dash|rarity|soarin'|sunset shimmer|trixie|twilight sparkle,islamilenaria
851773.jpeg,https://derpicdn.net/img/view/2015/3/17/851773.jpeg,1,0.962630033493042,591,460,813,682,222,222,applejack|big macintosh|fluttershy|pinkie pie|rainbow dash|rarity|soarin'|sunset shimmer|trixie|twilight sparkle,islamilenaria
851820.jpeg,https://derpicdn.net/img/view/2015/3/17/851820.jpeg,0,0.9530787467956544,667,56,1531,920,864,864,princess luna|twilight sparkle,silfoe
851820.jpeg,https://derpicdn.net/img/view/2015/3/17/851820.jpeg,1,0.9412080645561218,1668,0,2810,1039,1142,1039,princess luna|twilight sparkle,silfoe
854013.jpeg,https://derpicdn.net/img/view/2015/3/21/854013.jpeg,1,0.9932101964950562,849,713,1073,937,224,224,applejack|fluttershy|mane six|pinkie pie|rainbow dash|rarity|twilight sparkle,raikoh
854013.jpeg,https://derpicdn.net/img/view/2015/3/21/854013.jpeg,2,0.992056131362915,85,763,357,1035,272,272,applejack|fluttershy|mane six|pinkie pie|rainbow dash|rarity|twilight sparkle,raikoh
854013.jpeg,https://derpicdn.net/img/view/2015/3/21/854013.jpeg,3,0.9895718693733216,493,14,759,280,266,266,applejack|fluttershy|mane six|pinkie pie|rainbow dash|rarity|twilight sparkle,raikoh
854013.jpeg,https://derpicdn.net/img/view/2015/3/21/854013.jpeg,4,0.9423944354057312,491,745,735,989,244,244,applejack|fluttershy|mane six|pinkie pie|rainbow dash|rarity|twilight sparkle,raikoh
854013.jpeg,https://derpicdn.net/img/view/2015/3/21/854013.jpeg,5,0.9278635978698728,834,28,1116,310,282,282,applejack|fluttershy|mane six|pinkie pie|rainbow dash|rarity|twilight sparkle,raikoh
855639.jpeg,https://derpicdn.net/img/view/2015/3/23/855639.jpeg,1,0.9802292585372924,118,0,1142,910,1024,910,sunset shimmer|twilight sparkle,thegodoflazers
856606.jpeg,https://derpicdn.net/img/view/2015/3/25/856606.jpeg,0,0.9967186450958252,958,310,1652,1004,694,694,rarity|twilight sparkle,skecchiart
856606.jpeg,https://derpicdn.net/img/view/2015/3/25/856606.jpeg,1,0.9825631380081176,2012,297,2724,1009,712,712,rarity|twilight sparkle,skecchiart
856705.jpeg,https://derpicdn.net/img/view/2015/3/25/856705.jpeg,0,0.9955231547355652,213,897,801,1485,588,588,spike|twilight sparkle,gor1ck
856705.jpeg,https://derpicdn.net/img/view/2015/3/25/856705.jpeg,1,0.9901875257492064,774,359,1416,1001,642,642,spike|twilight sparkle,gor1ck
861071.jpeg,https://derpicdn.net/img/view/2015/3/31/861071.jpeg,0,0.9289824962615968,72,520,622,1070,550,550,princess cadance|princess celestia|princess luna|twilight sparkle,ncmares
861317.jpeg,https://derpicdn.net/img/view/2015/3/31/861317.jpeg,0,0.90660297870636,234,86,844,696,610,610,applejack|fluttershy|mane six|pinkie pie|rainbow dash|rarity|spike|twilight sparkle,unousaya
861586.jpeg,https://derpicdn.net/img/view/2015/3/31/861586.jpeg,0,0.963820219039917,317,422,595,700,278,278,discord|princess cadance|princess celestia|princess luna|twilight sparkle,slifertheskydragon
862114.jpeg,https://derpicdn.net/img/view/2015/4/1/862114.jpeg,0,0.9799123406410216,398,190,856,648,458,458,rainbow dash|twilight sparkle,nanoblade
863173.jpeg,https://derpicdn.net/img/view/2015/4/2/863173.jpeg,0,0.9898819327354432,673,600,1995,1922,1322,1322,discord|twilight sparkle,an-christiancomics
864445.jpeg,https://derpicdn.net/img/view/2015/4/4/864445.jpeg,0,0.9820317029953004,872,89,1472,689,600,600,princess cadance|princess celestia|princess luna|twilight sparkle,ncmares
864646.jpeg,https://derpicdn.net/img/view/2015/4/4/864646.jpeg,0,0.9980723857879642,223,47,619,443,396,396,princess cadance|princess celestia|princess luna|shining armor|spike|twilight sparkle,silfoe
867027.jpeg,https://derpicdn.net/img/view/2015/4/6/867027.jpeg,1,0.9965310096740724,35,172,283,420,248,248,applejack|fluttershy|mane six|pinkie pie|rainbow dash|rarity|starlight glimmer|twilight sparkle,tinacrazy29
867027.jpeg,https://derpicdn.net/img/view/2015/4/6/867027.jpeg,2,0.9905876517295836,324,0,600,221,276,221,applejack|fluttershy|mane six|pinkie pie|rainbow dash|rarity|starlight glimmer|twilight sparkle,tinacrazy29
867027.jpeg,https://derpicdn.net/img/view/2015/4/6/867027.jpeg,4,0.9821375608444214,153,17,381,245,228,228,applejack|fluttershy|mane six|pinkie pie|rainbow dash|rarity|starlight glimmer|twilight sparkle,tinacrazy29
868547.jpeg,https://derpicdn.net/img/view/2015/4/8/868547.jpeg,1,0.9952067136764526,471,477,681,687,210,210,applejack|fluttershy|mane six|pinkie pie|rainbow dash|rarity|starlight glimmer|twilight sparkle,acesential
868547.jpeg,https://derpicdn.net/img/view/2015/4/8/868547.jpeg,3,0.938713014125824,462,741,720,999,258,258,applejack|fluttershy|mane six|pinkie pie|rainbow dash|rarity|starlight glimmer|twilight sparkle,acesential
869719.jpeg,https://derpicdn.net/img/view/2015/4/9/869719.jpeg,1,0.9648274183273317,1668,0,1956,287,288,287,applejack|fluttershy|mane six|pinkie pie|rainbow dash|rarity|twilight sparkle,raptor007
869719.jpeg,https://derpicdn.net/img/view/2015/4/9/869719.jpeg,2,0.9207953214645386,2024,4,2336,316,312,312,applejack|fluttershy|mane six|pinkie pie|rainbow dash|rarity|twilight sparkle,raptor007
869719.jpeg,https://derpicdn.net/img/view/2015/4/9/869719.jpeg,3,0.9091994166374208,1111,0,1457,335,346,335,applejack|fluttershy|mane six|pinkie pie|rainbow dash|rarity|twilight sparkle,raptor007
872443.jpeg,https://derpicdn.net/img/view/2015/4/12/872443.jpeg,0,0.971451699733734,784,2180,1130,2520,346,340,applejack|rainbow dash|twilight sparkle,fred321123
872443.jpeg,https://derpicdn.net/img/view/2015/4/12/872443.jpeg,1,0.9613119959831238,2737,2190,2957,2410,220,220,applejack|rainbow dash|twilight sparkle,fred321123
872443.jpeg,https://derpicdn.net/img/view/2015/4/12/872443.jpeg,2,0.9558148980140686,699,1445,1129,1875,430,430,applejack|rainbow dash|twilight sparkle,fred321123
872443.jpeg,https://derpicdn.net/img/view/2015/4/12/872443.jpeg,3,0.9431650042533876,1340,0,1702,353,362,353,applejack|rainbow dash|twilight sparkle,fred321123
874320.jpeg,https://derpicdn.net/img/view/2015/4/15/874320.jpeg,0,0.9684478044509888,14,758,1116,1860,1102,1102,applejack|twilight sparkle,mkogwheel
874339.jpeg,https://derpicdn.net/img/view/2015/4/15/874339.jpeg,0,0.9881044030189514,1327,0,2093,753,766,753,pinkie pie|twilight sparkle,strebiskunk
876430.jpeg,https://derpicdn.net/img/view/2015/4/18/876430.jpeg,0,0.9737479090690612,598,461,790,653,192,192,applejack|fluttershy|mane six|pinkie pie|rainbow dash|rarity|twilight sparkle,polo-jasso
876484.jpeg,https://derpicdn.net/img/view/2015/4/18/876484.jpeg,0,0.9789674282073976,508,0,1280,810,772,810,rainbow dash|twilight sparkle,yanshiki
879386.jpeg,https://derpicdn.net/img/view/2015/4/21/879386.jpeg,1,0.995047926902771,591,0,1377,756,786,756,applejack|fluttershy|mane six|pinkie pie|rainbow dash|rarity|spike|twilight sparkle,franschesco
879386.jpeg,https://derpicdn.net/img/view/2015/4/21/879386.jpeg,2,0.9852708578109741,849,2023,1357,2480,508,457,applejack|fluttershy|mane six|pinkie pie|rainbow dash|rarity|spike|twilight sparkle,franschesco
879386.jpeg,https://derpicdn.net/img/view/2015/4/21/879386.jpeg,3,0.9747118353843688,1095,1336,1547,1788,452,452,applejack|fluttershy|mane six|pinkie pie|rainbow dash|rarity|spike|twilight sparkle,franschesco
879386.jpeg,https://derpicdn.net/img/view/2015/4/21/879386.jpeg,4,0.9327104091644288,10,12,852,854,842,842,applejack|fluttershy|mane six|pinkie pie|rainbow dash|rarity|spike|twilight sparkle,franschesco
879482.jpeg,https://derpicdn.net/img/view/2015/4/21/879482.jpeg,0,0.9958974719047546,545,1113,877,1445,332,332,apple bloom|applejack|big macintosh|pinkie pie|princess celestia|princess luna|shining armor|twilight sparkle,montyth
879482.jpeg,https://derpicdn.net/img/view/2015/4/21/879482.jpeg,1,0.9912012815475464,1388,1070,1674,1356,286,286,apple bloom|applejack|big macintosh|pinkie pie|princess celestia|princess luna|shining armor|twilight sparkle,montyth
879482.jpeg,https://derpicdn.net/img/view/2015/4/21/879482.jpeg,3,0.970012366771698,275,35,633,393,358,358,apple bloom|applejack|big macintosh|pinkie pie|princess celestia|princess luna|shining armor|twilight sparkle,montyth
879482.jpeg,https://derpicdn.net/img/view/2015/4/21/879482.jpeg,4,0.942792534828186,202,1094,528,1420,326,326,apple bloom|applejack|big macintosh|pinkie pie|princess celestia|princess luna|shining armor|twilight sparkle,montyth
880588.jpeg,https://derpicdn.net/img/view/2015/4/22/880588.jpeg,0,0.9981660842895508,893,64,1181,352,288,288,apple bloom|applejack|twilight sparkle,tsitra360
883377.jpeg,https://derpicdn.net/img/view/2015/4/26/883377.jpeg,0,0.9336310625076294,541,848,1007,1314,466,466,rainbow dash|twilight sparkle,otakuap
885127.jpeg,https://derpicdn.net/img/view/2015/4/29/885127.jpeg,0,0.9769498705863952,28,2085,516,2573,488,488,applejack|fluttershy|mane six|pinkie pie|rainbow dash|rarity|twilight sparkle,technicalwizard
885422.jpeg,https://derpicdn.net/img/view/2015/4/29/885422.jpeg,0,0.9910505414009094,375,445,767,837,392,392,applejack|fluttershy|mane six|pinkie pie|rainbow dash|rarity|spike|twilight sparkle,andypriceart
888146.jpeg,https://derpicdn.net/img/view/2015/5/3/888146.jpeg,0,0.9945838451385498,295,393,465,563,170,170,applejack|fluttershy|mane six|pinkie pie|queen chrysalis|rainbow dash|rarity|starlight glimmer|sunset shimmer|trixie|twilight sparkle,eljonek
888146.jpeg,https://derpicdn.net/img/view/2015/5/3/888146.jpeg,1,0.9150533080101012,478,355,702,579,224,224,applejack|fluttershy|mane six|pinkie pie|queen chrysalis|rainbow dash|rarity|starlight glimmer|sunset shimmer|trixie|twilight sparkle,eljonek
888465.jpeg,https://derpicdn.net/img/view/2015/5/3/888465.jpeg,0,0.941567361354828,761,0,2209,1431,1448,1431,rainbow dash|twilight sparkle,mistydash
888857.jpeg,https://derpicdn.net/img/view/2015/5/4/888857.jpeg,0,0.995272934436798,678,378,884,584,206,206,applejack|fluttershy|mane six|pinkie pie|rainbow dash|rarity|spike|twilight sparkle,thegamercolt
890279.jpeg,https://derpicdn.net/img/view/2015/5/6/890279.jpeg,0,0.9714418053627014,391,12,867,488,476,476,sunset shimmer|twilight sparkle,ameliacostanza
892255.jpeg,https://derpicdn.net/img/view/2015/5/9/892255.jpeg,0,0.9857876896858216,640,1730,1094,2184,454,454,princess celestia|princess luna|twilight sparkle,ardail
892255.jpeg,https://derpicdn.net/img/view/2015/5/9/892255.jpeg,1,0.9498648047447203,927,94,1650,820,723,726,princess celestia|princess luna|twilight sparkle,ardail
892305.jpeg,https://derpicdn.net/img/view/2015/5/9/892305.jpeg,0,0.9842836260795592,704,0,1560,706,856,706,rainbow dash|twilight sparkle,joycall6
892375.jpeg,https://derpicdn.net/img/view/2015/5/9/892375.jpeg,0,0.9980712532997132,757,94,1249,586,492,492,princess luna|twilight sparkle,silfoe
894007.jpeg,https://derpicdn.net/img/view/2015/5/11/894007.jpeg,0,0.9909731149673462,257,504,543,790,286,286,rarity|sunset shimmer|twilight sparkle,light262
894007.jpeg,https://derpicdn.net/img/view/2015/5/11/894007.jpeg,1,0.9099785685539246,840,476,1156,792,316,316,rarity|sunset shimmer|twilight sparkle,light262
896854.jpeg,https://derpicdn.net/img/view/2015/5/16/896854.jpeg,0,0.9974902868270874,1148,1327,2060,2239,912,912,princess celestia|princess luna|twilight sparkle,magnaluna
896854.jpeg,https://derpicdn.net/img/view/2015/5/16/896854.jpeg,2,0.9914670586586,2718,1736,3748,2766,1030,1030,princess celestia|princess luna|twilight sparkle,magnaluna
897746.jpeg,https://derpicdn.net/img/view/2015/5/17/897746.jpeg,0,0.9993904829025269,788,316,1382,910,594,594,applejack|fluttershy|mane six|pinkie pie|rainbow dash|rarity|spike|twilight sparkle,fur-what-loo
897746.jpeg,https://derpicdn.net/img/view/2015/5/17/897746.jpeg,2,0.9937134385108948,1830,388,2402,960,572,572,applejack|fluttershy|mane six|pinkie pie|rainbow dash|rarity|spike|twilight sparkle,fur-what-loo
897746.jpeg,https://derpicdn.net/img/view/2015/5/17/897746.jpeg,3,0.9906947016716005,2280,167,2974,861,694,694,applejack|fluttershy|mane six|pinkie pie|rainbow dash|rarity|spike|twilight sparkle,fur-what-loo
897746.jpeg,https://derpicdn.net/img/view/2015/5/17/897746.jpeg,4,0.9879604578018188,949,1230,1567,1848,618,618,applejack|fluttershy|mane six|pinkie pie|rainbow dash|rarity|spike|twilight sparkle,fur-what-loo
897746.jpeg,https://derpicdn.net/img/view/2015/5/17/897746.jpeg,5,0.9416787028312684,237,329,751,843,514,514,applejack|fluttershy|mane six|pinkie pie|rainbow dash|rarity|spike|twilight sparkle,fur-what-loo
899418.jpeg,https://derpicdn.net/img/view/2015/5/18/899418.jpeg,0,0.9921382069587708,554,40,1058,544,504,504,discord|twilight sparkle,ss2sonic
899418.jpeg,https://derpicdn.net/img/view/2015/5/18/899418.jpeg,1,0.9814228415489196,62,1277,350,1565,288,288,discord|twilight sparkle,ss2sonic
899899.jpeg,https://derpicdn.net/img/view/2015/5/19/899899.jpeg,0,0.9914591312408448,3280,848,4624,2192,1344,1344,applejack|rarity|twilight sparkle,vtruss1
900163.jpeg,https://derpicdn.net/img/view/2015/5/19/900163.jpeg,1,0.9690072536468506,418,505,890,977,472,472,applejack|twilight sparkle,superlucky13
902149.jpeg,https://derpicdn.net/img/view/2015/5/23/902149.jpeg,0,0.9810559749603271,541,269,907,635,366,366,princess celestia|twilight sparkle,santi-dleon
903688.jpeg,https://derpicdn.net/img/view/2015/5/25/903688.jpeg,0,0.9973948001861572,332,12,758,438,426,426,rainbow dash|twilight sparkle,mrscurlystyles|vest
904054.jpeg,https://derpicdn.net/img/view/2015/5/25/904054.jpeg,0,0.9990867376327516,528,1018,1642,2132,1114,1114,princess celestia|twilight sparkle,artisticwerks
904421.jpeg,https://derpicdn.net/img/view/2015/5/26/904421.jpeg,0,0.9938039779663086,776,2,940,166,164,164,applejack|fluttershy|mane six|pinkie pie|rainbow dash|rarity|twilight sparkle,wom-bat
904421.jpeg,https://derpicdn.net/img/view/2015/5/26/904421.jpeg,1,0.9678916335105896,465,0,665,175,200,175,applejack|fluttershy|mane six|pinkie pie|rainbow dash|rarity|twilight sparkle,wom-bat
904421.jpeg,https://derpicdn.net/img/view/2015/5/26/904421.jpeg,2,0.9118745923042296,253,7,479,233,226,226,applejack|fluttershy|mane six|pinkie pie|rainbow dash|rarity|twilight sparkle,wom-bat
904985.jpeg,https://derpicdn.net/img/view/2015/5/27/904985.jpeg,0,0.9763815999031068,401,597,1167,1350,766,753,princess celestia|princess luna|spike|twilight sparkle,latecustomer
904985.jpeg,https://derpicdn.net/img/view/2015/5/27/904985.jpeg,1,0.9497963190078736,965,46,1521,602,556,556,princess celestia|princess luna|spike|twilight sparkle,latecustomer
905710.jpeg,https://derpicdn.net/img/view/2015/5/28/905710.jpeg,0,0.9504933953285216,17,257,305,545,288,288,spike|twilight sparkle,silfoe
907498.jpeg,https://derpicdn.net/img/view/2015/5/31/907498.jpeg,0,0.9955737590789796,43,136,223,316,180,180,fluttershy|pinkie pie|princess celestia|rarity|spike|trixie|twilight sparkle,solar-slash
908649.jpeg,https://derpicdn.net/img/view/2015/6/2/908649.jpeg,0,0.9694768786430359,503,17,879,393,376,376,spike|twilight sparkle,twilite-sparkleplz
908888.jpeg,https://derpicdn.net/img/view/2015/6/2/908888.jpeg,1,0.9856112003326416,1823,676,2663,1516,840,840,princess celestia|princess luna|twilight sparkle,ncmares
909051.jpeg,https://derpicdn.net/img/view/2015/6/2/909051.jpeg,0,0.9684589505195618,507,0,1575,849,1068,849,fluttershy|twilight sparkle,sverre93
909582.jpeg,https://derpicdn.net/img/view/2015/6/3/909582.jpeg,0,0.9692327976226808,1546,42,4248,2744,2702,2702,princess celestia|twilight sparkle,magnaluna
910302.jpeg,https://derpicdn.net/img/view/2015/6/5/910302.jpeg,0,0.9886029362678528,462,96,742,376,280,280,princess celestia|twilight sparkle,mommashy
910624.jpeg,https://derpicdn.net/img/view/2015/6/5/910624.jpeg,0,0.9162750840187072,45,80,365,400,320,320,apple bloom|applejack|babs seed|big macintosh|braeburn|cutie mark crusaders|diamond tiara|discord|fluttershy|granny smith|lightning dust|mane six|pinkie pie|princess cadance|princess celestia|princess luna|queen chrysalis|rainbow dash|rarity|scootaloo|shining armor|silver spoon|spike|spitfire|sunset shimmer|sweetie belle|trixie|twilight sparkle,otaku-kun9
910777.jpeg,https://derpicdn.net/img/view/2015/6/5/910777.jpeg,1,0.9407699108123779,426,1017,934,1525,508,508,discord|rarity|twilight sparkle,skyshek
910777.jpeg,https://derpicdn.net/img/view/2015/6/5/910777.jpeg,2,0.9375985860824584,684,5,1710,1031,1026,1026,discord|rarity|twilight sparkle,skyshek
911714.jpeg,https://derpicdn.net/img/view/2015/6/6/911714.jpeg,0,0.9977312088012696,599,1909,1767,3077,1168,1168,applejack|fluttershy|mane six|pinkie pie|rainbow dash|rarity|twilight sparkle,elzzombie
911714.jpeg,https://derpicdn.net/img/view/2015/6/6/911714.jpeg,1,0.9976281523704528,2828,1793,3820,2785,992,992,applejack|fluttershy|mane six|pinkie pie|rainbow dash|rarity|twilight sparkle,elzzombie
911714.jpeg,https://derpicdn.net/img/view/2015/6/6/911714.jpeg,2,0.9926326274871826,1397,1671,2509,2783,1112,1112,applejack|fluttershy|mane six|pinkie pie|rainbow dash|rarity|twilight sparkle,elzzombie
911714.jpeg,https://derpicdn.net/img/view/2015/6/6/911714.jpeg,3,0.9572354555130004,3546,430,4724,1610,1178,1180,applejack|fluttershy|mane six|pinkie pie|rainbow dash|rarity|twilight sparkle,elzzombie
911881.jpeg,https://derpicdn.net/img/view/2015/6/6/911881.jpeg,0,0.9990749359130859,342,1129,1064,1851,722,722,applejack|fluttershy|mane six|pinkie pie|rainbow dash|rarity|twilight sparkle,elzzombie
911881.jpeg,https://derpicdn.net/img/view/2015/6/6/911881.jpeg,1,0.9986883401870728,1705,1083,2277,1655,572,572,applejack|fluttershy|mane six|pinkie pie|rainbow dash|rarity|twilight sparkle,elzzombie
911881.jpeg,https://derpicdn.net/img/view/2015/6/6/911881.jpeg,2,0.9976285099983216,831,997,1505,1671,674,674,applejack|fluttershy|mane six|pinkie pie|rainbow dash|rarity|twilight sparkle,elzzombie
911881.jpeg,https://derpicdn.net/img/view/2015/6/6/911881.jpeg,3,0.9511350393295288,2183,305,2797,919,614,614,applejack|fluttershy|mane six|pinkie pie|rainbow dash|rarity|twilight sparkle,elzzombie
911929.jpeg,https://derpicdn.net/img/view/2015/6/7/911929.jpeg,1,0.9951694011688232,869,266,1149,546,280,280,rarity|spike|sweetie belle|twilight sparkle,imsokyo
912061.jpeg,https://derpicdn.net/img/view/2015/6/7/912061.jpeg,0,0.9791213870048524,828,0,1196,313,368,313,apple bloom|applejack|cutie mark crusaders|fluttershy|mane six|pinkie pie|rainbow dash|rarity|scootaloo|spike|sweetie belle|twilight sparkle,ponygoddess
912061.jpeg,https://derpicdn.net/img/view/2015/6/7/912061.jpeg,1,0.9774616360664368,0,65,244,313,244,248,apple bloom|applejack|cutie mark crusaders|fluttershy|mane six|pinkie pie|rainbow dash|rarity|scootaloo|spike|sweetie belle|twilight sparkle,ponygoddess
912061.jpeg,https://derpicdn.net/img/view/2015/6/7/912061.jpeg,2,0.9408382177352904,388,0,770,348,382,348,apple bloom|applejack|cutie mark crusaders|fluttershy|mane six|pinkie pie|rainbow dash|rarity|scootaloo|spike|sweetie belle|twilight sparkle,ponygoddess
912297.jpeg,https://derpicdn.net/img/view/2015/6/7/912297.jpeg,0,0.9772973060607908,0,1224,739,2078,739,854,discord|rarity|twilight sparkle,skyshek
912297.jpeg,https://derpicdn.net/img/view/2015/6/7/912297.jpeg,1,0.9657936692237854,807,0,2171,1326,1364,1326,discord|rarity|twilight sparkle,skyshek
912297.jpeg,https://derpicdn.net/img/view/2015/6/7/912297.jpeg,2,0.9376142024993896,535,1259,1175,1899,640,640,discord|rarity|twilight sparkle,skyshek
916763.jpeg,https://derpicdn.net/img/view/2015/6/14/916763.jpeg,0,0.9573803544044496,980,0,2440,1418,1460,1418,spike|twilight sparkle,kuroi-wolf
918531.jpeg,https://derpicdn.net/img/view/2015/6/17/918531.jpeg,0,0.9806980490684508,122,832,662,1372,540,540,princess cadance|princess celestia|princess luna|twilight sparkle,andypriceart
920231.jpeg,https://derpicdn.net/img/view/2015/6/20/920231.jpeg,1,0.9841665029525756,1884,338,2222,676,338,338,applejack|fluttershy|mane six|pinkie pie|rainbow dash|rarity|twilight sparkle,tahublade7
920231.jpeg,https://derpicdn.net/img/view/2015/6/20/920231.jpeg,5,0.9593572616577148,139,94,577,532,438,438,applejack|fluttershy|mane six|pinkie pie|rainbow dash|rarity|twilight sparkle,tahublade7
920231.jpeg,https://derpicdn.net/img/view/2015/6/20/920231.jpeg,6,0.9263875484466552,1260,169,1682,591,422,422,applejack|fluttershy|mane six|pinkie pie|rainbow dash|rarity|twilight sparkle,tahublade7
920558.jpeg,https://derpicdn.net/img/view/2015/6/20/920558.jpeg,0,0.9679934978485109,773,0,1449,510,676,510,pinkie pie|sunset shimmer|twilight sparkle,bastbrushie
920571.jpeg,https://derpicdn.net/img/view/2015/6/20/920571.jpeg,0,0.9826688170433044,797,0,1233,391,436,391,princess cadance|spike|twilight sparkle,silfoe
920571.jpeg,https://derpicdn.net/img/view/2015/6/20/920571.jpeg,1,0.9549144506454468,144,0,464,278,320,278,princess cadance|spike|twilight sparkle,silfoe
921437.jpeg,https://derpicdn.net/img/view/2015/6/22/921437.jpeg,0,0.977615475654602,597,0,885,279,288,279,spike|twilight sparkle,kongyi
922475.jpeg,https://derpicdn.net/img/view/2015/6/23/922475.jpeg,0,0.9863851070404052,1485,613,1843,971,358,358,applejack|fluttershy|mane six|pinkie pie|rainbow dash|rarity|twilight sparkle,mingraine
922475.jpeg,https://derpicdn.net/img/view/2015/6/23/922475.jpeg,1,0.9782335758209229,994,864,1370,1240,376,376,applejack|fluttershy|mane six|pinkie pie|rainbow dash|rarity|twilight sparkle,mingraine
922574.jpeg,https://derpicdn.net/img/view/2015/6/23/922574.jpeg,1,0.9899395108222958,596,377,992,773,396,396,princess cadance|princess celestia|princess luna|twilight sparkle,staticdragon1
923053.jpeg,https://derpicdn.net/img/view/2015/6/24/923053.jpeg,0,0.9122382998466492,356,867,1042,1553,686,686,applejack|fluttershy|mane six|pinkie pie|rainbow dash|rarity|starlight glimmer|twilight sparkle,jowybean
923164.jpeg,https://derpicdn.net/img/view/2015/6/24/923164.jpeg,1,0.9421905875205994,470,443,1300,1273,830,830,princess cadance|twilight sparkle,ncmares
923165.jpeg,https://derpicdn.net/img/view/2015/6/24/923165.jpeg,0,0.9963527321815492,1096,66,2100,1070,1004,1004,princess cadance|twilight sparkle,ncmares
923722.jpeg,https://derpicdn.net/img/view/2015/6/25/923722.jpeg,1,0.99428790807724,496,1121,796,1421,300,300,princess cadance|princess celestia|princess luna|twilight sparkle,nancyksu
923783.jpeg,https://derpicdn.net/img/view/2015/6/25/923783.jpeg,0,0.9992069005966188,166,0,522,342,356,342,trixie|twilight sparkle,whale
923783.jpeg,https://derpicdn.net/img/view/2015/6/25/923783.jpeg,1,0.9984806776046752,763,34,1063,334,300,300,trixie|twilight sparkle,whale
924014.jpeg,https://derpicdn.net/img/view/2015/6/26/924014.jpeg,0,0.9579567909240724,417,10,1639,1232,1222,1222,pinkie pie|twilight sparkle,ryou14
924014.jpeg,https://derpicdn.net/img/view/2015/6/26/924014.jpeg,1,0.9319261312484741,1784,711,2918,1845,1134,1134,pinkie pie|twilight sparkle,ryou14
925097.jpeg,https://derpicdn.net/img/view/2015/6/27/925097.jpeg,0,0.9993156194686892,2147,596,3145,1594,998,998,princess celestia|princess luna|twilight sparkle,ncmares
925097.jpeg,https://derpicdn.net/img/view/2015/6/27/925097.jpeg,1,0.9961208701133728,1225,246,2219,1240,994,994,princess celestia|princess luna|twilight sparkle,ncmares
928232.jpeg,https://derpicdn.net/img/view/2015/7/2/928232.jpeg,0,0.9994931817054749,740,16,1500,782,760,766,rarity|spike|twilight sparkle,vavacung
929339.jpeg,https://derpicdn.net/img/view/2015/7/4/929339.jpeg,0,0.9824291467666626,211,137,375,301,164,164,applejack|fluttershy|mane six|pinkie pie|rainbow dash|rarity|spike|twilight sparkle,tonyfleecs
929551.jpeg,https://derpicdn.net/img/view/2015/7/4/929551.jpeg,0,0.9880132079124452,257,62,561,366,304,304,fluttershy|twilight sparkle,lampehannah
929551.jpeg,https://derpicdn.net/img/view/2015/7/4/929551.jpeg,1,0.9753963351249696,676,283,934,541,258,258,fluttershy|twilight sparkle,lampehannah
929966.jpeg,https://derpicdn.net/img/view/2015/7/4/929966.jpeg,0,0.9504486918449402,1654,233,2750,1329,1096,1096,applejack|twilight sparkle,ncmares
930593.jpeg,https://derpicdn.net/img/view/2015/7/5/930593.jpeg,0,0.9936332106590272,909,685,1161,937,252,252,apple bloom|applejack|big macintosh|cutie mark crusaders|fluttershy|mane six|pinkie pie|princess celestia|princess luna|rainbow dash|rarity|scootaloo|soarin'|spike|spitfire|sweetie belle|trixie|twilight sparkle,shutterflye
931513.jpeg,https://derpicdn.net/img/view/2015/7/6/931513.jpeg,0,0.9896173477172852,737,149,1219,631,482,482,princess celestia|twilight sparkle,magnaluna
934065.jpeg,https://derpicdn.net/img/view/2015/7/10/934065.jpeg,0,0.9990931153297424,1384,808,1838,1262,454,454,shining armor|twilight sparkle,jowybean
934372.jpeg,https://derpicdn.net/img/view/2015/7/10/934372.jpeg,0,0.9379482269287108,2410,2504,4248,4342,1838,1838,applejack|fluttershy|mane six|pinkie pie|rainbow dash|rarity|spike|twilight sparkle,zilvart
934729.jpeg,https://derpicdn.net/img/view/2015/7/11/934729.jpeg,0,0.9567738175392152,591,199,847,455,256,256,applejack|fluttershy|mane six|pinkie pie|rainbow dash|rarity|twilight sparkle,rovaa
934764.jpeg,https://derpicdn.net/img/view/2015/7/11/934764.jpeg,0,0.9914479851722716,0,55,438,557,438,502,spike|spitfire|trixie|twilight sparkle,cyrilunicorn
934764.jpeg,https://derpicdn.net/img/view/2015/7/11/934764.jpeg,1,0.9734506011009216,301,61,755,603,454,542,spike|spitfire|trixie|twilight sparkle,cyrilunicorn
936452.jpeg,https://derpicdn.net/img/view/2015/7/13/936452.jpeg,1,0.9883306622505188,615,473,1007,865,392,392,apple bloom|applejack|big macintosh|braeburn|cutie mark crusaders|diamond tiara|discord|fluttershy|granny smith|mane six|pinkie pie|princess cadance|princess celestia|princess luna|queen chrysalis|rainbow dash|rarity|scootaloo|shining armor|silver spoon|spike|sweetie belle|twilight sparkle,0ravensrequiem0
936672.jpeg,https://derpicdn.net/img/view/2015/7/14/936672.jpeg,0,0.9831428527832032,141,0,437,230,296,230,applejack|fluttershy|mane six|pinkie pie|rainbow dash|rarity|spike|twilight sparkle,ponygoddess
936672.jpeg,https://derpicdn.net/img/view/2015/7/14/936672.jpeg,1,0.9765822887420654,13,179,339,505,326,326,applejack|fluttershy|mane six|pinkie pie|rainbow dash|rarity|spike|twilight sparkle,ponygoddess
937493.jpeg,https://derpicdn.net/img/view/2015/7/15/937493.jpeg,1,0.97395259141922,334,0,676,339,342,339,applejack|rarity|spike|twilight sparkle,franschesco
943031.jpeg,https://derpicdn.net/img/view/2015/7/24/943031.jpeg,0,0.9770652651786804,1120,453,1642,975,522,522,applejack|fluttershy|mane six|pinkie pie|rainbow dash|rarity|spike|twilight sparkle,yula568
945074.jpeg,https://derpicdn.net/img/view/2015/7/27/945074.jpeg,0,0.9993558526039124,661,1476,989,1804,328,328,applejack|lightning dust|pinkie pie|rainbow dash|rarity|soarin'|spitfire|twilight sparkle,howxu
945074.jpeg,https://derpicdn.net/img/view/2015/7/27/945074.jpeg,1,0.990160584449768,528,203,810,485,282,282,applejack|lightning dust|pinkie pie|rainbow dash|rarity|soarin'|spitfire|twilight sparkle,howxu
945427.jpeg,https://derpicdn.net/img/view/2015/7/28/945427.jpeg,0,0.9776529669761658,624,1290,1408,2074,784,784,applejack|fluttershy|mane six|pinkie pie|rainbow dash|rarity|twilight sparkle,alixnight
945427.jpeg,https://derpicdn.net/img/view/2015/7/28/945427.jpeg,1,0.9750195741653442,1942,1001,2542,1601,600,600,applejack|fluttershy|mane six|pinkie pie|rainbow dash|rarity|twilight sparkle,alixnight
945489.jpeg,https://derpicdn.net/img/view/2015/7/28/945489.jpeg,0,0.9994999170303344,758,1025,1300,1567,542,542,applejack|fluttershy|pinkie pie|rainbow dash|rarity|twilight sparkle,ss2sonic
945489.jpeg,https://derpicdn.net/img/view/2015/7/28/945489.jpeg,1,0.9982476830482484,1217,418,1763,964,546,546,applejack|fluttershy|pinkie pie|rainbow dash|rarity|twilight sparkle,ss2sonic
945489.jpeg,https://derpicdn.net/img/view/2015/7/28/945489.jpeg,2,0.9969812035560608,1260,950,1872,1562,612,612,applejack|fluttershy|pinkie pie|rainbow dash|rarity|twilight sparkle,ss2sonic
945489.jpeg,https://derpicdn.net/img/view/2015/7/28/945489.jpeg,3,0.9730095267295836,784,161,1342,719,558,558,applejack|fluttershy|pinkie pie|rainbow dash|rarity|twilight sparkle,ss2sonic
945489.jpeg,https://derpicdn.net/img/view/2015/7/28/945489.jpeg,4,0.969195544719696,230,1044,782,1596,552,552,applejack|fluttershy|pinkie pie|rainbow dash|rarity|twilight sparkle,ss2sonic
945489.jpeg,https://derpicdn.net/img/view/2015/7/28/945489.jpeg,5,0.9676826596260072,359,424,889,954,530,530,applejack|fluttershy|pinkie pie|rainbow dash|rarity|twilight sparkle,ss2sonic
945997.jpeg,https://derpicdn.net/img/view/2015/7/28/945997.jpeg,0,0.9943234324455258,173,653,599,1079,426,426,princess luna|twilight sparkle,ncmares
946217.jpeg,https://derpicdn.net/img/view/2015/7/29/946217.jpeg,0,0.9278810024261476,767,450,1317,1000,550,550,rainbow dash|twilight sparkle,captainpudgemuffin
946529.jpeg,https://derpicdn.net/img/view/2015/7/29/946529.jpeg,1,0.971031665802002,986,88,1628,730,642,642,princess cadance|princess celestia|princess luna|twilight sparkle,ncmares
946595.jpeg,https://derpicdn.net/img/view/2015/7/29/946595.jpeg,0,0.99925297498703,1359,145,2143,929,784,784,princess celestia|trixie|twilight sparkle,ss2sonic
946595.jpeg,https://derpicdn.net/img/view/2015/7/29/946595.jpeg,1,0.993818461894989,610,20,1454,864,844,844,princess celestia|trixie|twilight sparkle,ss2sonic
946677.jpeg,https://derpicdn.net/img/view/2015/7/29/946677.jpeg,1,0.9982988834381104,1948,162,2586,800,638,638,applejack|discord|fluttershy|mane six|pinkie pie|rainbow dash|rarity|spike|twilight sparkle,ss2sonic
946677.jpeg,https://derpicdn.net/img/view/2015/7/29/946677.jpeg,2,0.992060661315918,122,1416,762,2056,640,640,applejack|discord|fluttershy|mane six|pinkie pie|rainbow dash|rarity|spike|twilight sparkle,ss2sonic
946677.jpeg,https://derpicdn.net/img/view/2015/7/29/946677.jpeg,3,0.9323546290397644,666,100,1372,806,706,706,applejack|discord|fluttershy|mane six|pinkie pie|rainbow dash|rarity|spike|twilight sparkle,ss2sonic
946677.jpeg,https://derpicdn.net/img/view/2015/7/29/946677.jpeg,4,0.9116332530975342,1469,189,1997,717,528,528,applejack|discord|fluttershy|mane six|pinkie pie|rainbow dash|rarity|spike|twilight sparkle,ss2sonic
949139.jpeg,https://derpicdn.net/img/view/2015/8/2/949139.jpeg,0,0.9959318041801452,66,39,594,567,528,528,discord|princess celestia|princess luna|spike|twilight sparkle,ss2sonic
949139.jpeg,https://derpicdn.net/img/view/2015/8/2/949139.jpeg,1,0.9908413887023926,1395,78,1853,536,458,458,discord|princess celestia|princess luna|spike|twilight sparkle,ss2sonic
949139.jpeg,https://derpicdn.net/img/view/2015/8/2/949139.jpeg,2,0.9902469515800476,1164,0,1464,300,300,300,discord|princess celestia|princess luna|spike|twilight sparkle,ss2sonic
949139.jpeg,https://derpicdn.net/img/view/2015/8/2/949139.jpeg,4,0.9510194063186646,0,655,753,1400,753,745,discord|princess celestia|princess luna|spike|twilight sparkle,ss2sonic
949265.jpeg,https://derpicdn.net/img/view/2015/8/2/949265.jpeg,0,0.9989405274391174,0,0,512,514,512,514,applejack|discord|fluttershy|mane six|pinkie pie|rainbow dash|rarity|spike|twilight sparkle,ss2sonic
949265.jpeg,https://derpicdn.net/img/view/2015/8/2/949265.jpeg,1,0.9934280514717102,973,605,1497,1129,524,524,applejack|discord|fluttershy|mane six|pinkie pie|rainbow dash|rarity|spike|twilight sparkle,ss2sonic
949265.jpeg,https://derpicdn.net/img/view/2015/8/2/949265.jpeg,2,0.9846119284629822,508,2062,1102,2656,594,594,applejack|discord|fluttershy|mane six|pinkie pie|rainbow dash|rarity|spike|twilight sparkle,ss2sonic
949265.jpeg,https://derpicdn.net/img/view/2015/8/2/949265.jpeg,3,0.96949702501297,900,2094,1474,2668,574,574,applejack|discord|fluttershy|mane six|pinkie pie|rainbow dash|rarity|spike|twilight sparkle,ss2sonic
949265.jpeg,https://derpicdn.net/img/view/2015/8/2/949265.jpeg,5,0.9549704790115356,483,56,1065,638,582,582,applejack|discord|fluttershy|mane six|pinkie pie|rainbow dash|rarity|spike|twilight sparkle,ss2sonic
949275.jpeg,https://derpicdn.net/img/view/2015/8/2/949275.jpeg,0,0.946374773979187,549,203,949,603,400,400,shining armor|twilight sparkle,ss2sonic
949869.jpeg,https://derpicdn.net/img/view/2015/8/3/949869.jpeg,0,0.9788139462471008,0,252,390,674,390,422,applejack|fluttershy|mane six|pinkie pie|rainbow dash|rarity|spike|twilight sparkle,mrs89fluffy|kianamai
949917.jpeg,https://derpicdn.net/img/view/2015/8/3/949917.jpeg,0,0.9890002012252808,207,997,705,1495,498,498,applejack|fluttershy|mane six|pinkie pie|rainbow dash|rarity|twilight sparkle,light262
949917.jpeg,https://derpicdn.net/img/view/2015/8/3/949917.jpeg,1,0.9276670217514038,128,171,530,573,402,402,applejack|fluttershy|mane six|pinkie pie|rainbow dash|rarity|twilight sparkle,light262
950085.jpeg,https://derpicdn.net/img/view/2015/8/3/950085.jpeg,0,0.9873729944229126,0,73,219,343,219,270,princess cadance|shining armor|twilight sparkle,johnjoseco
950085.jpeg,https://derpicdn.net/img/view/2015/8/3/950085.jpeg,1,0.958086371421814,143,0,593,403,450,403,princess cadance|shining armor|twilight sparkle,johnjoseco
950085.jpeg,https://derpicdn.net/img/view/2015/8/3/950085.jpeg,2,0.9517541527748108,608,85,990,467,382,382,princess cadance|shining armor|twilight sparkle,johnjoseco
950628.jpeg,https://derpicdn.net/img/view/2015/8/4/950628.jpeg,0,0.9592322707176208,347,1426,1151,2230,804,804,apple bloom|cutie mark crusaders|scootaloo|sweetie belle|twilight sparkle,horrormage
950926.jpeg,https://derpicdn.net/img/view/2015/8/5/950926.jpeg,1,0.9912648797035216,764,0,1196,429,432,429,sunset shimmer|trixie|twilight sparkle,nekocrispy
953472.jpeg,https://derpicdn.net/img/view/2015/8/8/953472.jpeg,0,0.9397866725921632,646,235,1178,767,532,532,applejack|fluttershy|mane six|pinkie pie|rainbow dash|rarity|spike|twilight sparkle,koodorshnik
954015.jpeg,https://derpicdn.net/img/view/2015/8/9/954015.jpeg,1,0.9989289641380308,256,298,644,686,388,388,applejack|fluttershy|mane six|pinkie pie|rainbow dash|rarity|twilight sparkle,hayley1432
956745.jpeg,https://derpicdn.net/img/view/2015/8/13/956745.jpeg,1,0.9927753806114196,88,2,304,218,216,216,applejack|fluttershy|mane six|pinkie pie|rainbow dash|rarity|twilight sparkle,kaemantis
956745.jpeg,https://derpicdn.net/img/view/2015/8/13/956745.jpeg,4,0.9835463166236876,50,891,328,1169,278,278,applejack|fluttershy|mane six|pinkie pie|rainbow dash|rarity|twilight sparkle,kaemantis
956745.jpeg,https://derpicdn.net/img/view/2015/8/13/956745.jpeg,7,0.9733676910400392,318,0,566,237,248,237,applejack|fluttershy|mane six|pinkie pie|rainbow dash|rarity|twilight sparkle,kaemantis
956745.jpeg,https://derpicdn.net/img/view/2015/8/13/956745.jpeg,8,0.954168438911438,47,1651,309,1913,262,262,applejack|fluttershy|mane six|pinkie pie|rainbow dash|rarity|twilight sparkle,kaemantis
957872.jpeg,https://derpicdn.net/img/view/2015/8/14/957872.jpeg,1,0.941133975982666,1107,842,1807,1542,700,700,applejack|fluttershy|mane six|pinkie pie|rainbow dash|rarity|twilight sparkle,sceathlet
959892.jpeg,https://derpicdn.net/img/view/2015/8/17/959892.jpeg,0,0.9648672342300416,3446,1550,4096,2200,650,650,applejack|fluttershy|mane six|pinkie pie|rainbow dash|rarity|spike|twilight sparkle,dari-draws
961160.jpeg,https://derpicdn.net/img/view/2015/8/19/961160.jpeg,0,0.9973271489143372,40,0,784,694,744,694,princess celestia|twilight sparkle,magnaluna
962649.jpeg,https://derpicdn.net/img/view/2015/8/21/962649.jpeg,0,0.9988160133361816,0,0,766,695,766,695,princess luna|twilight sparkle,silfoe
963512.jpeg,https://derpicdn.net/img/view/2015/8/22/963512.jpeg,0,0.9966214299201964,645,457,1175,987,530,530,applejack|princess celestia|princess luna|twilight sparkle,elyonblade|conicer
963781.jpeg,https://derpicdn.net/img/view/2015/8/23/963781.jpeg,0,0.9542790651321412,1180,278,2296,1394,1116,1116,applejack|twilight sparkle,misspolycysticovary
963781.jpeg,https://derpicdn.net/img/view/2015/8/23/963781.jpeg,1,0.9282942414283752,645,363,1603,1321,958,958,applejack|twilight sparkle,misspolycysticovary
965175.jpeg,https://derpicdn.net/img/view/2015/8/25/965175.jpeg,0,0.9932644367218018,103,0,515,381,412,381,applejack|fluttershy|mane six|pinkie pie|rainbow dash|rarity|twilight sparkle,fruitilupis
965210.jpeg,https://derpicdn.net/img/view/2015/8/25/965210.jpeg,0,0.973428189754486,26,112,496,582,470,470,rainbow dash|twilight sparkle,elzzombie
965438.jpeg,https://derpicdn.net/img/view/2015/8/25/965438.jpeg,0,0.9413908123970032,581,230,1280,1094,699,864,spike|twilight sparkle,exelzior
967348.jpeg,https://derpicdn.net/img/view/2015/8/28/967348.jpeg,0,0.99737811088562,353,0,793,410,440,410,applejack|twilight sparkle,jowybean
967348.jpeg,https://derpicdn.net/img/view/2015/8/28/967348.jpeg,1,0.9861988425254822,744,162,1100,518,356,356,applejack|twilight sparkle,jowybean
971766.jpeg,https://derpicdn.net/img/view/2015/9/3/971766.jpeg,1,0.9855456948280334,743,661,917,835,174,174,applejack|fluttershy|mane six|pinkie pie|rainbow dash|rarity|twilight sparkle,blackywolfer
971883.jpeg,https://derpicdn.net/img/view/2015/9/3/971883.jpeg,0,0.9652473330497742,475,0,889,388,414,388,spike|twilight sparkle,imalou
971883.jpeg,https://derpicdn.net/img/view/2015/9/3/971883.jpeg,1,0.9030959010124208,17,97,459,539,442,442,spike|twilight sparkle,imalou
972131.jpeg,https://derpicdn.net/img/view/2015/9/3/972131.jpeg,0,0.9933280348777772,311,109,1221,1019,910,910,rainbow dash|twilight sparkle,captainpudgemuffin
972461.jpeg,https://derpicdn.net/img/view/2015/9/4/972461.jpeg,0,0.9974234700202942,213,0,561,312,348,312,rarity|twilight sparkle,snibako
972461.jpeg,https://derpicdn.net/img/view/2015/9/4/972461.jpeg,1,0.992480218410492,451,0,837,342,386,342,rarity|twilight sparkle,snibako
972604.jpeg,https://derpicdn.net/img/view/2015/9/4/972604.jpeg,0,0.9687574505805968,147,134,405,392,258,258,discord|twilight sparkle,radiantrealm
972604.jpeg,https://derpicdn.net/img/view/2015/9/4/972604.jpeg,1,0.9593040347099304,352,30,584,262,232,232,discord|twilight sparkle,radiantrealm
973149.jpeg,https://derpicdn.net/img/view/2015/9/5/973149.jpeg,0,0.9902588725090028,7,0,311,235,304,235,applejack|fluttershy|mane six|pinkie pie|rainbow dash|rarity|twilight sparkle,yukandasama
976466.jpeg,https://derpicdn.net/img/view/2015/9/10/976466.jpeg,0,0.980017364025116,154,0,512,341,358,341,applejack|fluttershy|mane six|pinkie pie|rainbow dash|rarity|twilight sparkle,fruitilupis
981099.jpeg,https://derpicdn.net/img/view/2015/9/16/981099.jpeg,0,0.9030261039733888,402,1347,634,1579,232,232,applejack|fluttershy|mane six|pinkie pie|rainbow dash|rarity|spike|twilight sparkle,thelivingmachine02
983712.jpeg,https://derpicdn.net/img/view/2015/9/20/983712.jpeg,0,0.992555558681488,2114,25,3000,953,886,928,princess cadance|princess celestia|princess luna|shining armor|spike|twilight sparkle,silfoe
983712.jpeg,https://derpicdn.net/img/view/2015/9/20/983712.jpeg,2,0.9795985221862792,297,281,1205,1189,908,908,princess cadance|princess celestia|princess luna|shining armor|spike|twilight sparkle,silfoe
984388.jpeg,https://derpicdn.net/img/view/2015/9/21/984388.jpeg,0,0.9621281027793884,251,96,827,672,576,576,sunset shimmer|twilight sparkle,harwick
985448.jpeg,https://derpicdn.net/img/view/2015/9/22/985448.jpeg,0,0.9660707712173462,1371,222,1767,618,396,396,fluttershy|rainbow dash|twilight sparkle,miokomata
986636.jpeg,https://derpicdn.net/img/view/2015/9/24/986636.jpeg,0,0.9479773044586182,580,0,848,254,268,254,applejack|fluttershy|mane six|pinkie pie|rainbow dash|rarity|twilight sparkle,arrockansate
986922.jpeg,https://derpicdn.net/img/view/2015/9/24/986922.jpeg,0,0.9491077661514282,184,0,406,214,222,214,princess celestia|princess luna|sunset shimmer|trixie|twilight sparkle,konfettimayhem
988563.jpeg,https://derpicdn.net/img/view/2015/9/27/988563.jpeg,0,0.9776379466056824,12,0,656,533,644,533,sunset shimmer|twilight sparkle,dvixie
993579.jpeg,https://derpicdn.net/img/view/2015/10/3/993579.jpeg,0,0.9983091354370116,1744,653,2262,1171,518,518,applejack|princess cadance|princess celestia|princess luna|rainbow dash|twilight sparkle,ncmares
993579.jpeg,https://derpicdn.net/img/view/2015/10/3/993579.jpeg,3,0.9921252131462096,2309,606,3000,1314,691,708,applejack|princess cadance|princess celestia|princess luna|rainbow dash|twilight sparkle,ncmares
993580.jpeg,https://derpicdn.net/img/view/2015/10/3/993580.jpeg,0,0.9972794055938721,1784,692,2266,1174,482,482,princess cadance|princess celestia|princess luna|twilight sparkle,ncmares
998082.jpeg,https://derpicdn.net/img/view/2015/10/9/998082.jpeg,0,0.9528860449790956,26,272,432,678,406,406,applejack|fluttershy|mane six|pinkie pie|rainbow dash|rarity|spike|twilight sparkle,saturdaymorningproj
998303.jpeg,https://derpicdn.net/img/view/2015/10/10/998303.jpeg,0,0.9910590648651124,150,63,866,779,716,716,applejack|fluttershy|mane six|pinkie pie|rainbow dash|rarity|twilight sparkle,arareroll
998303.jpeg,https://derpicdn.net/img/view/2015/10/10/998303.jpeg,1,0.9843126535415648,1805,650,2447,1292,642,642,applejack|fluttershy|mane six|pinkie pie|rainbow dash|rarity|twilight sparkle,arareroll
998303.jpeg,https://derpicdn.net/img/view/2015/10/10/998303.jpeg,3,0.9552955627441406,1137,603,1771,1237,634,634,applejack|fluttershy|mane six|pinkie pie|rainbow dash|rarity|twilight sparkle,arareroll
998303.jpeg,https://derpicdn.net/img/view/2015/10/10/998303.jpeg,4,0.9480401873588562,1300,0,2480,1005,1180,1005,applejack|fluttershy|mane six|pinkie pie|rainbow dash|rarity|twilight sparkle,arareroll
