id,url,index,confidence,xmin,ymin,xmax,ymax,w,h,ponies,artists
1002895.png,https://derpicdn.net/img/view/2015/10/15/1002895.png,0,0.9965477585792542,47,7,415,375,368,368,twilight sparkle,cultmasteraranukon
1005256.png,https://derpicdn.net/img/view/2015/10/18/1005256.png,0,0.9985918402671814,493,223,791,521,298,298,twilight sparkle,thattagen
1005256.png,https://derpicdn.net/img/view/2015/10/18/1005256.png,0,0.9985918402671814,507,236,777,506,270,270,twilight sparkle,thattagen
1006491.png,https://derpicdn.net/img/view/2015/10/20/1006491.png,0,0.9558888673782348,132,0,698,495,566,495,twilight sparkle,
1006491.png,https://derpicdn.net/img/view/2015/10/20/1006491.png,0,0.9558888673782348,159,0,681,458,522,458,twilight sparkle,
1006945.png,https://derpicdn.net/img/view/2015/10/21/1006945.png,0,0.9394687414169312,0,50,433,530,433,480,twilight sparkle,yanshiki
1006945.png,https://derpicdn.net/img/view/2015/10/21/1006945.png,0,0.9394687414169312,0,72,411,508,411,436,twilight sparkle,yanshiki
1007039.png,https://derpicdn.net/img/view/2015/10/21/1007039.png,0,0.9677649140357972,347,0,835,452,488,452,twilight sparkle,spaerk
1007039.png,https://derpicdn.net/img/view/2015/10/21/1007039.png,0,0.9677649140357972,368,0,812,430,444,430,twilight sparkle,spaerk
1009635.png,https://derpicdn.net/img/view/2015/10/25/1009635.png,0,0.9941345453262328,1020,0,2600,1509,1580,1509,twilight sparkle,acharmingpony
1009635.png,https://derpicdn.net/img/view/2015/10/25/1009635.png,0,0.9941345453262328,1060,0,2560,1433,1500,1433,twilight sparkle,acharmingpony
1010471.png,https://derpicdn.net/img/view/2015/10/28/1010471.png,0,0.9327071905136108,784,296,1738,1250,954,954,twilight sparkle,mysticalpha
1010471.png,https://derpicdn.net/img/view/2015/10/28/1010471.png,0,0.9327071905136108,825,336,1697,1208,872,872,twilight sparkle,mysticalpha
1010557.png,https://derpicdn.net/img/view/2015/10/28/1010557.png,0,0.9983243346214294,1853,0,2893,1021,1040,1021,twilight sparkle,azure-doodle
1010557.png,https://derpicdn.net/img/view/2015/10/28/1010557.png,0,0.9983243346214294,1900,26,2844,970,944,944,twilight sparkle,azure-doodle
1013521.png,https://derpicdn.net/img/view/2015/10/31/1013521.png,0,0.9989238977432252,336,0,1130,849,794,849,twilight sparkle,badumsquish
1013521.png,https://derpicdn.net/img/view/2015/10/31/1013521.png,0,0.9989238977432252,380,0,1130,808,750,808,twilight sparkle,badumsquish
1014331.png,https://derpicdn.net/img/view/2015/11/1/1014331.png,0,0.9240755438804626,759,0,2491,1661,1732,1661,twilight sparkle,vector-brony
1014331.png,https://derpicdn.net/img/view/2015/11/1/1014331.png,0,0.9240755438804626,840,8,2414,1582,1574,1574,twilight sparkle,vector-brony
1018166.png,https://derpicdn.net/img/view/2015/11/7/1018166.png,0,0.9622467756271362,82,28,472,418,390,390,twilight sparkle,
1018166.png,https://derpicdn.net/img/view/2015/11/7/1018166.png,0,0.9622467756271362,35,0,504,464,469,464,twilight sparkle,
1018835.png,https://derpicdn.net/img/view/2015/11/8/1018835.png,0,0.984200954437256,36,3,512,479,476,476,twilight sparkle,discord|caramelbunnies
1018835.png,https://derpicdn.net/img/view/2015/11/8/1018835.png,0,0.984200954437256,9,0,528,505,519,505,twilight sparkle,discord|caramelbunnies
1019250.jpg,https://derpicdn.net/img/view/2015/11/8/1019250.jpg,0,0.9592788815498352,67,194,1300,1536,1233,1342,twilight sparkle,evehly
1019250.jpg,https://derpicdn.net/img/view/2015/11/8/1019250.jpg,0,0.9592788815498352,156,255,1300,1475,1144,1220,twilight sparkle,evehly
1019910.png,https://derpicdn.net/img/view/2015/11/9/1019910.png,0,0.9983999133110046,266,1017,510,1261,244,244,twilight sparkle,droll3
1019910.png,https://derpicdn.net/img/view/2015/11/9/1019910.png,3,0.9898048043251038,268,731,458,921,190,190,twilight sparkle,droll3
1019910.png,https://derpicdn.net/img/view/2015/11/9/1019910.png,5,0.9485403895378112,228,1319,452,1543,224,224,twilight sparkle,droll3
1019910.png,https://derpicdn.net/img/view/2015/11/9/1019910.png,6,0.9062179327011108,95,1866,289,2060,194,194,twilight sparkle,droll3
1019910.png,https://derpicdn.net/img/view/2015/11/9/1019910.png,0,0.9983999133110046,279,1030,499,1250,220,220,twilight sparkle,droll3
1019910.png,https://derpicdn.net/img/view/2015/11/9/1019910.png,3,0.9898048043251038,277,742,449,914,172,172,twilight sparkle,droll3
1019910.png,https://derpicdn.net/img/view/2015/11/9/1019910.png,5,0.9485403895378112,238,1331,442,1535,204,204,twilight sparkle,droll3
1019910.png,https://derpicdn.net/img/view/2015/11/9/1019910.png,6,0.9062179327011108,103,1875,279,2051,176,176,twilight sparkle,droll3
1020574.png,https://derpicdn.net/img/view/2015/11/10/1020574.png,0,0.9939272999763488,872,290,2066,1484,1194,1194,twilight sparkle,hoodie
1020574.png,https://derpicdn.net/img/view/2015/11/10/1020574.png,0,0.9939272999763488,926,345,2014,1433,1088,1088,twilight sparkle,hoodie
1020747.png,https://derpicdn.net/img/view/2015/11/11/1020747.png,0,0.9472588300704956,390,17,860,517,470,500,twilight sparkle,dm29
1020747.png,https://derpicdn.net/img/view/2015/11/11/1020747.png,0,0.9472588300704956,412,39,860,495,448,456,twilight sparkle,dm29
1021993.png,https://derpicdn.net/img/view/2015/11/13/1021993.png,0,0.9938892722129822,218,139,906,827,688,688,twilight sparkle,notenoughapples
1021993.png,https://derpicdn.net/img/view/2015/11/13/1021993.png,0,0.9938892722129822,248,171,874,797,626,626,twilight sparkle,notenoughapples
1022277.png,https://derpicdn.net/img/view/2015/11/13/1022277.png,0,0.9900429248809814,3,1063,2003,3063,2000,2000,twilight sparkle,mrscurlystyles
1022277.png,https://derpicdn.net/img/view/2015/11/13/1022277.png,0,0.9900429248809814,93,1153,1913,2973,1820,1820,twilight sparkle,mrscurlystyles
1023093.png,https://derpicdn.net/img/view/2015/11/15/1023093.png,0,0.9991447329521179,142,36,796,690,654,654,twilight sparkle,rune-blad3
1023093.png,https://derpicdn.net/img/view/2015/11/15/1023093.png,0,0.9991447329521179,172,66,766,660,594,594,twilight sparkle,rune-blad3
1023114.png,https://derpicdn.net/img/view/2015/11/15/1023114.png,0,0.9825865626335144,0,807,4295,5813,4295,5006,twilight sparkle,owlisun
1023114.png,https://derpicdn.net/img/view/2015/11/15/1023114.png,0,0.9825865626335144,0,234,4295,6376,4295,6142,twilight sparkle,owlisun
1023241.png,https://derpicdn.net/img/view/2015/11/15/1023241.png,0,0.9555101990699768,0,0,4884,5112,4884,5112,twilight sparkle,geometrymathalgebra
1023241.png,https://derpicdn.net/img/view/2015/11/15/1023241.png,0,0.9555101990699768,0,125,4638,4983,4638,4858,twilight sparkle,geometrymathalgebra
1023306.png,https://derpicdn.net/img/view/2015/11/15/1023306.png,0,0.9914168715476992,234,54,790,610,556,556,twilight sparkle,thattagen
1023306.png,https://derpicdn.net/img/view/2015/11/15/1023306.png,0,0.9914168715476992,259,79,765,585,506,506,twilight sparkle,thattagen
1024395.png,https://derpicdn.net/img/view/2015/11/17/1024395.png,0,0.9836075901985168,16,0,292,274,276,274,twilight sparkle,lulubell
1024395.png,https://derpicdn.net/img/view/2015/11/17/1024395.png,0,0.9836075901985168,29,10,279,260,250,250,twilight sparkle,lulubell
1024727.png,https://derpicdn.net/img/view/2015/11/17/1024727.png,0,0.9991883635520936,2064,3489,3000,4523,936,1034,twilight sparkle,silbersternenlicht
1024727.png,https://derpicdn.net/img/view/2015/11/17/1024727.png,1,0.9987494349479676,1342,2376,2400,3434,1058,1058,twilight sparkle,silbersternenlicht
1024727.png,https://derpicdn.net/img/view/2015/11/17/1024727.png,4,0.9967955946922302,2022,2374,3000,3464,978,1090,twilight sparkle,silbersternenlicht
1024727.png,https://derpicdn.net/img/view/2015/11/17/1024727.png,10,0.9915656447410583,2052,1259,3000,2369,948,1110,twilight sparkle,silbersternenlicht
1024727.png,https://derpicdn.net/img/view/2015/11/17/1024727.png,11,0.9861333966255188,0,2398,1008,3470,1008,1072,twilight sparkle,silbersternenlicht
1024727.png,https://derpicdn.net/img/view/2015/11/17/1024727.png,12,0.9855050444602966,585,1324,1669,2408,1084,1084,twilight sparkle,silbersternenlicht
1024727.png,https://derpicdn.net/img/view/2015/11/17/1024727.png,13,0.9546887874603271,1323,224,2387,1288,1064,1064,twilight sparkle,silbersternenlicht
1024727.png,https://derpicdn.net/img/view/2015/11/17/1024727.png,0,0.9991883635520936,2113,3540,3000,4472,887,932,twilight sparkle,silbersternenlicht
1024727.png,https://derpicdn.net/img/view/2015/11/17/1024727.png,1,0.9987494349479676,1388,2420,2358,3390,970,970,twilight sparkle,silbersternenlicht
1024727.png,https://derpicdn.net/img/view/2015/11/17/1024727.png,4,0.9967955946922302,2072,2424,3000,3414,928,990,twilight sparkle,silbersternenlicht
1024727.png,https://derpicdn.net/img/view/2015/11/17/1024727.png,10,0.9915656447410583,2103,1310,3000,2318,897,1008,twilight sparkle,silbersternenlicht
1024727.png,https://derpicdn.net/img/view/2015/11/17/1024727.png,11,0.9861333966255188,0,2449,957,3419,957,970,twilight sparkle,silbersternenlicht
1024727.png,https://derpicdn.net/img/view/2015/11/17/1024727.png,12,0.9855050444602966,630,1368,1620,2358,990,990,twilight sparkle,silbersternenlicht
1024727.png,https://derpicdn.net/img/view/2015/11/17/1024727.png,13,0.9546887874603271,1375,274,2339,1238,964,964,twilight sparkle,silbersternenlicht
1024874.png,https://derpicdn.net/img/view/2015/11/17/1024874.png,0,0.9987332224845886,338,0,1598,1138,1260,1138,twilight sparkle,srtagiuu
1024874.png,https://derpicdn.net/img/view/2015/11/17/1024874.png,0,0.9987332224845886,394,0,1540,1060,1146,1060,twilight sparkle,srtagiuu
1026111.png,https://derpicdn.net/img/view/2015/11/19/1026111.png,0,0.9869660139083862,135,0,640,531,505,531,twilight sparkle,loyaldis
1026111.png,https://derpicdn.net/img/view/2015/11/19/1026111.png,0,0.9869660139083862,169,0,640,506,471,506,twilight sparkle,loyaldis
1028775.png,https://derpicdn.net/img/view/2015/11/23/1028775.png,0,0.9946367740631104,0,69,719,935,719,866,twilight sparkle,piesarts
1028775.png,https://derpicdn.net/img/view/2015/11/23/1028775.png,0,0.9946367740631104,0,108,678,896,678,788,twilight sparkle,piesarts
1032994.png,https://derpicdn.net/img/view/2015/11/29/1032994.png,0,0.9862479567527772,426,487,964,1025,538,538,twilight sparkle,gashiboka
1034138.jpg,https://derpicdn.net/img/view/2015/11/30/1034138.jpg,0,0.957231342792511,60,0,1252,1112,1192,1112,twilight sparkle,mistydash
1035654.png,https://derpicdn.net/img/view/2015/12/3/1035654.png,0,0.9883857369422911,46,0,542,485,496,485,twilight sparkle,silfoe|lunapaws
1038072.png,https://derpicdn.net/img/view/2015/12/6/1038072.png,0,0.9985554814338684,4,25,378,399,374,374,twilight sparkle,theparagon
1040481.jpg,https://derpicdn.net/img/view/2015/12/9/1040481.jpg,0,0.9818724393844604,7,31,659,683,652,652,twilight sparkle,luciferamon
1041899.png,https://derpicdn.net/img/view/2015/12/11/1041899.png,0,0.9983159899711608,389,523,765,899,376,376,twilight sparkle,viwrastupr
1041958.png,https://derpicdn.net/img/view/2015/12/11/1041958.png,0,0.995924711227417,51,0,1883,1749,1832,1749,twilight sparkle,bugplayer
1042227.png,https://derpicdn.net/img/view/2015/12/11/1042227.png,0,0.9946346879005432,136,0,644,459,508,459,twilight sparkle,ruhisu
1042646.png,https://derpicdn.net/img/view/2015/12/12/1042646.png,0,0.9863467812538148,160,0,640,447,480,447,twilight sparkle,ruhisu
1042957.png,https://derpicdn.net/img/view/2015/12/12/1042957.png,0,0.964293897151947,825,75,1277,527,452,452,twilight sparkle,january3rd
104801.jpg,https://derpicdn.net/img/view/2012/9/23/104801.jpg,0,0.9954922199249268,248,15,600,367,352,352,twilight sparkle,shepherd0821
1048841.jpg,https://derpicdn.net/img/view/2015/12/20/1048841.jpg,0,0.9416513442993164,257,58,1061,862,804,804,twilight sparkle,girlsay
1051149.jpg,https://derpicdn.net/img/view/2015/12/23/1051149.jpg,0,0.9823300838470459,241,33,1269,1061,1028,1028,twilight sparkle,éclair
1051268.png,https://derpicdn.net/img/view/2015/12/23/1051268.png,0,0.9347753524780272,79,0,723,639,644,639,twilight sparkle,9seconds
1054761.jpg,https://derpicdn.net/img/view/2015/12/29/1054761.jpg,0,0.9815881252288818,22,32,380,390,358,358,twilight sparkle,conoghi
1055438.png,https://derpicdn.net/img/view/2015/12/30/1055438.png,0,0.9969719052314758,104,107,772,775,668,668,twilight sparkle,b-epon
1056697.png,https://derpicdn.net/img/view/2015/12/31/1056697.png,0,0.9140114188194276,15,168,325,478,310,310,twilight sparkle,metal-kitty
1057062.jpg,https://derpicdn.net/img/view/2016/1/1/1057062.jpg,0,0.9802506566047668,0,40,455,522,455,482,twilight sparkle,dalapony
1059057.png,https://derpicdn.net/img/view/2016/1/3/1059057.png,0,0.9974130392074584,65,0,1061,907,996,907,twilight sparkle,hawthornss
1059577.png,https://derpicdn.net/img/view/2016/1/4/1059577.png,0,0.9982439875602722,239,4,629,394,390,390,twilight sparkle,foxxy-arts
1060761.png,https://derpicdn.net/img/view/2016/1/6/1060761.png,0,0.9851136803627014,157,221,589,653,432,432,twilight sparkle,mysticalpha
1063004.png,https://derpicdn.net/img/view/2016/1/9/1063004.png,0,0.9977884888648988,180,0,516,305,336,305,twilight sparkle,lizombie
1065604.png,https://derpicdn.net/img/view/2016/1/13/1065604.png,0,0.9895440340042114,13,48,355,390,342,342,twilight sparkle,nobody
1066323.png,https://derpicdn.net/img/view/2016/1/14/1066323.png,0,0.925627052783966,0,74,159,246,159,172,twilight sparkle,invisibleone11
1066467.png,https://derpicdn.net/img/view/2016/1/14/1066467.png,0,0.9923732876777648,550,0,1462,817,912,817,twilight sparkle,bugplayer
1067029.png,https://derpicdn.net/img/view/2016/1/15/1067029.png,0,0.9809688925743104,432,340,814,722,382,382,twilight sparkle,reuniclus
1068195.png,https://derpicdn.net/img/view/2016/1/17/1068195.png,0,0.9984514713287354,370,0,1148,717,778,717,twilight sparkle,notenoughapples
1068335.png,https://derpicdn.net/img/view/2016/1/17/1068335.png,0,0.9929266571998596,477,321,983,827,506,506,twilight sparkle,novabytes
1069409.jpg,https://derpicdn.net/img/view/2016/1/19/1069409.jpg,0,0.9993818998336792,111,0,501,366,390,366,twilight sparkle,drbdnv
1070374.png,https://derpicdn.net/img/view/2016/1/20/1070374.png,0,0.9983691573143004,214,59,1232,1077,1018,1018,twilight sparkle,bugplayer
1076058.png,https://derpicdn.net/img/view/2016/1/29/1076058.png,0,0.982096254825592,1202,0,2648,1381,1446,1381,twilight sparkle,souladdicted
1078793.png,https://derpicdn.net/img/view/2016/2/2/1078793.png,0,0.9986394643783568,234,0,1302,1067,1068,1067,twilight sparkle,inlucidreverie
1082657.jpg,https://derpicdn.net/img/view/2016/2/7/1082657.jpg,0,0.9934253692626952,828,5,1408,585,580,580,twilight sparkle,magnaluna
1085765.png,https://derpicdn.net/img/view/2016/2/11/1085765.png,0,0.995593011379242,873,163,2091,1381,1218,1218,twilight sparkle,bugplayer
1085868.jpg,https://derpicdn.net/img/view/2016/2/12/1085868.jpg,0,0.9934715628623962,302,0,836,526,534,526,twilight sparkle,ninjaham
1086119.png,https://derpicdn.net/img/view/2016/2/12/1086119.png,0,0.998137891292572,503,1524,1259,2280,756,756,twilight sparkle,fromamida
1086119.png,https://derpicdn.net/img/view/2016/2/12/1086119.png,1,0.99777489900589,1821,0,2603,782,782,782,twilight sparkle,fromamida
1086119.png,https://derpicdn.net/img/view/2016/2/12/1086119.png,2,0.9410305023193359,146,25,720,599,574,574,twilight sparkle,fromamida
1086831.png,https://derpicdn.net/img/view/2016/2/13/1086831.png,0,0.9968725442886353,1629,314,2239,924,610,610,twilight sparkle,wynnchi
1086831.png,https://derpicdn.net/img/view/2016/2/13/1086831.png,2,0.9846348762512208,0,439,485,939,485,500,twilight sparkle,wynnchi
1086831.png,https://derpicdn.net/img/view/2016/2/13/1086831.png,3,0.9422656893730164,942,0,1714,720,772,720,twilight sparkle,wynnchi
1088145.png,https://derpicdn.net/img/view/2016/2/14/1088145.png,0,0.9965113401412964,301,90,859,648,558,558,twilight sparkle,neoncel
1089845.jpg,https://derpicdn.net/img/view/2016/2/16/1089845.jpg,0,0.9941715002059937,37,33,699,695,662,662,twilight sparkle,bof|bgf
1090000.png,https://derpicdn.net/img/view/2016/2/16/1090000.png,0,0.9374939799308776,525,130,911,516,386,386,twilight sparkle,meekcheep
1091202.jpg,https://derpicdn.net/img/view/2016/2/18/1091202.jpg,0,0.9977114200592041,372,13,1058,699,686,686,twilight sparkle,mrs1989
1093007.png,https://derpicdn.net/img/view/2016/2/20/1093007.png,0,0.9983795285224916,222,1,644,423,422,422,twilight sparkle,thebrokencog
1093026.png,https://derpicdn.net/img/view/2016/2/20/1093026.png,0,0.998373806476593,222,1,644,423,422,422,twilight sparkle,thebrokencog
1101114.png,https://derpicdn.net/img/view/2016/3/3/1101114.png,0,0.976832389831543,183,153,2400,2627,2217,2474,twilight sparkle,drawponies|stellarsynthesis
1102615.png,https://derpicdn.net/img/view/2016/3/5/1102615.png,0,0.926936149597168,0,0,1024,1157,1024,1157,twilight sparkle,chromaskunk|stoic5
1104702.png,https://derpicdn.net/img/view/2016/3/8/1104702.png,0,0.9176180362701416,94,0,548,417,454,417,twilight sparkle,ehfa
1105619.png,https://derpicdn.net/img/view/2016/3/9/1105619.png,0,0.9892515540122986,11,24,575,588,564,564,twilight sparkle,umejiru
1106339.jpg,https://derpicdn.net/img/view/2016/3/11/1106339.jpg,0,0.9860399961471558,300,0,1524,1183,1224,1183,twilight sparkle,captainpudgemuffin
1107294.jpg,https://derpicdn.net/img/view/2016/3/12/1107294.jpg,0,0.9978549480438232,74,16,526,468,452,452,twilight sparkle,umehachi|doubt|91o42|ume89s
1107294.jpg,https://derpicdn.net/img/view/2016/3/12/1107294.jpg,1,0.99091899394989,514,12,1024,524,510,512,twilight sparkle,umehachi|doubt|91o42|ume89s
1107747.png,https://derpicdn.net/img/view/2016/3/13/1107747.png,0,0.9156468510627748,681,0,1169,398,488,398,twilight sparkle,shydale edits
1110939.png,https://derpicdn.net/img/view/2016/3/17/1110939.png,0,0.995675265789032,646,80,1492,926,846,846,twilight sparkle,bugplayer
1112115.png,https://derpicdn.net/img/view/2016/3/19/1112115.png,0,0.984908401966095,255,0,673,417,418,417,twilight sparkle,king-kakapo
1116869.png,https://derpicdn.net/img/view/2016/3/26/1116869.png,0,0.99436616897583,186,0,616,412,430,412,twilight sparkle,king-kakapo
1117591.png,https://derpicdn.net/img/view/2016/3/26/1117591.png,0,0.9892054200172424,403,59,887,543,484,484,twilight sparkle,bluntwhiskey
1118620.png,https://derpicdn.net/img/view/2016/3/28/1118620.png,0,0.9931505918502808,145,0,2777,2406,2632,2406,twilight sparkle,fluffyxai
1118901.png,https://derpicdn.net/img/view/2016/3/28/1118901.png,0,0.997868001461029,82,0,656,539,574,539,twilight sparkle,supermare
1119734.png,https://derpicdn.net/img/view/2016/3/29/1119734.png,0,0.978086233139038,2,23,1100,1133,1098,1110,twilight sparkle,theroyalprincesses
1120643.png,https://derpicdn.net/img/view/2016/3/30/1120643.png,0,0.9992876052856444,114,1,326,213,212,212,twilight sparkle,tuxisthename
1123771.png,https://derpicdn.net/img/view/2016/4/3/1123771.png,0,0.995176076889038,248,0,650,372,402,372,twilight sparkle,thebrokencog
1125303.png,https://derpicdn.net/img/view/2016/4/5/1125303.png,0,0.962739109992981,10,0,584,559,574,559,twilight sparkle,audrarius
1126262.jpg,https://derpicdn.net/img/view/2016/4/6/1126262.jpg,0,0.9913358092308044,619,0,3625,2528,3006,2528,twilight sparkle,magnaluna
1127321.png,https://derpicdn.net/img/view/2016/4/8/1127321.png,0,0.9982473254203796,459,13,1737,1291,1278,1278,twilight sparkle,slavedemorto
1127321.png,https://derpicdn.net/img/view/2016/4/8/1127321.png,1,0.9955613017082214,1918,161,2898,1141,980,980,twilight sparkle,slavedemorto
1128781.png,https://derpicdn.net/img/view/2016/4/10/1128781.png,0,0.9759461879730223,337,50,800,560,463,510,twilight sparkle,theparagon
1132639.png,https://derpicdn.net/img/view/2016/4/15/1132639.png,0,0.990010142326355,0,73,614,825,614,752,twilight sparkle,3xlneet|reiduran
1135424.png,https://derpicdn.net/img/view/2016/4/19/1135424.png,0,0.9733583331108092,91,1,641,551,550,550,twilight sparkle,tsitra360
1136455.png,https://derpicdn.net/img/view/2016/4/20/1136455.png,0,0.9764940142631532,47,0,919,794,872,794,twilight sparkle,june34rd
1136781.jpg,https://derpicdn.net/img/view/2016/4/20/1136781.jpg,0,0.999040186405182,992,322,1828,1158,836,836,twilight sparkle,tonyfleecs
1137624.png,https://derpicdn.net/img/view/2016/4/22/1137624.png,0,0.9978975057601928,270,104,772,606,502,502,twilight sparkle,victoreach
1139926.png,https://derpicdn.net/img/view/2016/4/25/1139926.png,0,0.9988721609115601,86,0,510,421,424,421,twilight sparkle,dfectivedvice|longren
1140906.png,https://derpicdn.net/img/view/2016/4/27/1140906.png,0,0.9923546314239502,96,3,640,547,544,544,twilight sparkle,lopoddity
1141953.png,https://derpicdn.net/img/view/2016/4/28/1141953.png,0,0.9800378680229188,138,33,726,653,588,620,twilight sparkle,tjpones
1146516.png,https://derpicdn.net/img/view/2016/5/4/1146516.png,0,0.9951747059822084,552,0,1676,1016,1124,1016,twilight sparkle,ponyecho
1147592.jpg,https://derpicdn.net/img/view/2016/5/6/1147592.jpg,0,0.9522860646247864,47,0,343,268,296,268,twilight sparkle,bluse
1147593.jpg,https://derpicdn.net/img/view/2016/5/6/1147593.jpg,0,0.9806250929832458,40,0,474,408,434,408,twilight sparkle,bluse
1151120.png,https://derpicdn.net/img/view/2016/5/10/1151120.png,0,0.9173198938369752,390,0,1764,1282,1374,1282,twilight sparkle,january3rd
1156277.png,https://derpicdn.net/img/view/2016/5/17/1156277.png,0,0.9961212277412416,822,0,4946,3937,4124,3937,twilight sparkle,dfectivedvice|mactavish1996
1156826.png,https://derpicdn.net/img/view/2016/5/18/1156826.png,0,0.9647117853164672,372,13,720,361,348,348,twilight sparkle,graphenescloset
1159279.png,https://derpicdn.net/img/view/2016/5/21/1159279.png,0,0.9408524036407472,143,52,1041,950,898,898,twilight sparkle,
1159833.png,https://derpicdn.net/img/view/2016/5/21/1159833.png,0,0.958781361579895,394,3,1302,911,908,908,twilight sparkle,novaspark
1159869.png,https://derpicdn.net/img/view/2016/5/21/1159869.png,0,0.9402752518653872,0,26,3901,4318,3901,4292,twilight sparkle,theevafreak
1160603.png,https://derpicdn.net/img/view/2016/5/22/1160603.png,0,0.9491541385650636,227,0,831,543,604,543,twilight sparkle,datte-before-dawn
1161687.png,https://derpicdn.net/img/view/2016/5/24/1161687.png,0,0.9879262447357178,207,25,1600,1531,1393,1506,twilight sparkle,sourspot
1162951.jpg,https://derpicdn.net/img/view/2016/5/25/1162951.jpg,0,0.996912956237793,784,0,1710,821,926,821,twilight sparkle,ncmares
1163540.png,https://derpicdn.net/img/view/2016/5/26/1163540.png,0,0.9954472184181212,48,0,748,669,700,669,twilight sparkle,bhawk
1168432.jpg,https://derpicdn.net/img/view/2016/6/2/1168432.jpg,0,0.9164003729820251,223,0,929,676,706,676,twilight sparkle,acrylic-stroke
1168442.png,https://derpicdn.net/img/view/2016/6/2/1168442.png,0,0.9801065921783448,531,497,1727,1693,1196,1196,twilight sparkle,fluttershy-wins
1169709.png,https://derpicdn.net/img/view/2016/6/4/1169709.png,0,0.9911466240882874,176,117,772,713,596,596,twilight sparkle,tamyarts
1171248.png,https://derpicdn.net/img/view/2016/6/5/1171248.png,0,0.968115508556366,168,103,416,351,248,248,twilight sparkle,buttersprinkle
1172376.png,https://derpicdn.net/img/view/2016/6/7/1172376.png,0,0.9686581492424012,67,0,819,719,752,719,twilight sparkle,purple-yoshi-draws|graphenescloset
1172377.png,https://derpicdn.net/img/view/2016/6/7/1172377.png,0,0.9955626130104064,346,0,1254,868,908,868,twilight sparkle,graphenescloset|purple-yoshi-draws
1173415.png,https://derpicdn.net/img/view/2016/6/8/1173415.png,0,0.9933264255523682,96,0,598,496,502,496,twilight sparkle,dm29
1175033.png,https://derpicdn.net/img/view/2016/6/10/1175033.png,0,0.9678598642349244,152,64,500,412,348,348,twilight sparkle,pepooni
1177649.png,https://derpicdn.net/img/view/2016/6/13/1177649.png,0,0.9969031810760498,874,0,1780,902,906,902,twilight sparkle,ambris
1179393.png,https://derpicdn.net/img/view/2016/6/16/1179393.png,0,0.997627854347229,41,0,515,438,474,438,twilight sparkle,slugbox
1180301.jpg,https://derpicdn.net/img/view/2016/6/17/1180301.jpg,0,0.98655503988266,649,314,985,650,336,336,twilight sparkle,dstears
1181773.png,https://derpicdn.net/img/view/2016/6/19/1181773.png,0,0.9682425856590272,0,35,584,683,584,648,twilight sparkle,assasinmonkey
1183719.jpg,https://derpicdn.net/img/view/2016/6/21/1183719.jpg,0,0.9993877410888672,493,44,1063,614,570,570,twilight sparkle,marcus todjel|ambris
1184290.png,https://derpicdn.net/img/view/2016/6/22/1184290.png,0,0.9824137091636658,161,100,415,354,254,254,twilight sparkle,buttersprinkle
1184890.png,https://derpicdn.net/img/view/2016/6/23/1184890.png,0,0.9646764397621156,78,168,504,594,426,426,twilight sparkle,acesential
1186742.png,https://derpicdn.net/img/view/2016/6/25/1186742.png,0,0.9955169558525084,379,0,1025,572,646,572,twilight sparkle,php92
1186976.png,https://derpicdn.net/img/view/2016/6/26/1186976.png,0,0.9812992215156556,375,54,887,566,512,512,twilight sparkle,pabbley
1187018.png,https://derpicdn.net/img/view/2016/6/26/1187018.png,0,0.9941467046737672,666,207,1188,729,522,522,twilight sparkle,pikachumask
1188047.jpg,https://derpicdn.net/img/view/2016/6/27/1188047.jpg,0,0.9964882135391236,9,38,839,868,830,830,twilight sparkle,elzzombie
11899.jpg,https://derpicdn.net/img/view/2012/6/20/11899.jpg,0,0.9945487380027772,274,0,652,359,378,359,twilight sparkle,oze
1191445.png,https://derpicdn.net/img/view/2016/7/2/1191445.png,0,0.9928589463233948,243,209,653,619,410,410,twilight sparkle,tjpones
1191445.png,https://derpicdn.net/img/view/2016/7/2/1191445.png,1,0.9843618869781494,610,53,1052,495,442,442,twilight sparkle,tjpones
1191730.png,https://derpicdn.net/img/view/2016/7/2/1191730.png,0,0.981408953666687,297,0,743,445,446,445,twilight sparkle,audrarius
1191781.png,https://derpicdn.net/img/view/2016/7/2/1191781.png,0,0.9773931503295898,121,48,467,394,346,346,twilight sparkle,sockl
1192078.png,https://derpicdn.net/img/view/2016/7/2/1192078.png,0,0.9889447689056396,317,49,837,569,520,520,twilight sparkle,hashioaryut
1194719.png,https://derpicdn.net/img/view/2016/7/6/1194719.png,2,0.9423249363899232,178,160,558,540,380,380,twilight sparkle,pika-chany
1195872.png,https://derpicdn.net/img/view/2016/7/8/1195872.png,0,0.9905797839164734,207,134,915,842,708,708,twilight sparkle,mlpanon
1196491.png,https://derpicdn.net/img/view/2016/7/8/1196491.png,0,0.9918233752250672,947,0,1303,310,356,310,twilight sparkle,php41
1197954.png,https://derpicdn.net/img/view/2016/7/10/1197954.png,0,0.9765651822090148,359,0,2599,2114,2240,2114,twilight sparkle,badumsquish
1199249.png,https://derpicdn.net/img/view/2016/7/12/1199249.png,0,0.9981082677841188,297,0,1141,826,844,826,twilight sparkle,silbersternenlicht
1199806.png,https://derpicdn.net/img/view/2016/7/13/1199806.png,0,0.9983264803886414,49,23,383,357,334,334,twilight sparkle,30clock
1201219.png,https://derpicdn.net/img/view/2016/7/15/1201219.png,0,0.9923904538154602,70,0,1160,1041,1090,1041,twilight sparkle,dshou
1206400.png,https://derpicdn.net/img/view/2016/7/22/1206400.png,0,0.9023673534393308,959,131,2171,1343,1212,1212,twilight sparkle,flutterthrash
1206484.png,https://derpicdn.net/img/view/2016/7/22/1206484.png,0,0.9778845310211182,0,228,1024,1333,1024,1105,twilight sparkle,northernsprint
1207302.png,https://derpicdn.net/img/view/2016/7/23/1207302.png,0,0.9852294921875,5,3,391,389,386,386,twilight sparkle,phyllismi
1208205.png,https://derpicdn.net/img/view/2016/7/24/1208205.png,0,0.9685195088386536,50,0,758,663,708,663,twilight sparkle,umejiru
1209964.png,https://derpicdn.net/img/view/2016/7/26/1209964.png,0,0.9993469715118408,586,0,2090,1480,1504,1480,twilight sparkle,ambris
1212783.png,https://derpicdn.net/img/view/2016/7/30/1212783.png,0,0.998753547668457,504,108,1324,928,820,820,twilight sparkle,noctilucent-arts
1214471.png,https://derpicdn.net/img/view/2016/8/1/1214471.png,0,0.9831380844116212,13,0,613,558,600,558,twilight sparkle,nekubi
1217615.png,https://derpicdn.net/img/view/2016/8/5/1217615.png,0,0.951150357723236,0,150,1782,1964,1782,1814,twilight sparkle,audrarius
1218138.png,https://derpicdn.net/img/view/2016/8/6/1218138.png,0,0.9612630605697632,213,0,631,414,418,414,twilight sparkle,reiduran
1218334.png,https://derpicdn.net/img/view/2016/8/6/1218334.png,0,0.967019259929657,215,0,629,414,414,414,twilight sparkle,reiduran
1218725.png,https://derpicdn.net/img/view/2016/8/6/1218725.png,0,0.9951320886611938,698,0,2098,1370,1400,1370,twilight sparkle,danmakuman
1219888.png,https://derpicdn.net/img/view/2016/8/8/1219888.png,0,0.9936100840568542,650,0,1404,616,754,616,twilight sparkle,ncmares
1219932.png,https://derpicdn.net/img/view/2016/8/8/1219932.png,0,0.99666428565979,656,159,1472,975,816,816,twilight sparkle,zapplebow
1220790.png,https://derpicdn.net/img/view/2016/8/9/1220790.png,0,0.9815887212753296,67,0,1699,1249,1632,1249,twilight sparkle,theparagon
1221306.png,https://derpicdn.net/img/view/2016/8/9/1221306.png,0,0.9661239385604858,378,21,1460,1103,1082,1082,twilight sparkle,bugplayer
1223004.png,https://derpicdn.net/img/view/2016/8/12/1223004.png,0,0.9052469730377196,185,0,775,549,590,549,twilight sparkle,thebrokencog
1225954.png,https://derpicdn.net/img/view/2016/8/15/1225954.png,0,0.999215006828308,985,1174,1815,2004,830,830,twilight sparkle,mrscroup
1226155.png,https://derpicdn.net/img/view/2016/8/15/1226155.png,0,0.9964691996574402,193,0,539,314,346,314,twilight sparkle,buttersprinkle
1226229.png,https://derpicdn.net/img/view/2016/8/16/1226229.png,0,0.9702796339988708,520,113,1132,725,612,612,twilight sparkle,flutterthrash
1226304.png,https://derpicdn.net/img/view/2016/8/16/1226304.png,0,0.9869934916496276,41,0,619,544,578,544,twilight sparkle,nekubi
1229631.png,https://derpicdn.net/img/view/2016/8/20/1229631.png,0,0.9966919422149658,835,299,1357,821,522,522,twilight sparkle,alasou
1232179.png,https://derpicdn.net/img/view/2016/8/23/1232179.png,0,0.9747825860977172,230,332,838,940,608,608,twilight sparkle,alasou
1232179.png,https://derpicdn.net/img/view/2016/8/23/1232179.png,1,0.964659571647644,1025,357,1577,909,552,552,twilight sparkle,alasou
1233023.png,https://derpicdn.net/img/view/2016/8/24/1233023.png,0,0.9886363744735718,712,0,2464,1641,1752,1641,twilight sparkle,haidiannotes
1233239.png,https://derpicdn.net/img/view/2016/8/25/1233239.png,0,0.9912877678871156,230,0,1558,1274,1328,1274,twilight sparkle,captainpudgemuffin
1234396.png,https://derpicdn.net/img/view/2016/8/26/1234396.png,0,0.9369327425956726,0,16,340,362,340,346,twilight sparkle,prince-lionel
1235628.png,https://derpicdn.net/img/view/2016/8/28/1235628.png,0,0.9962021708488464,6,27,370,391,364,364,twilight sparkle,wookylee
1237203.png,https://derpicdn.net/img/view/2016/8/30/1237203.png,0,0.9926006197929382,381,0,991,601,610,601,twilight sparkle,evehly
1237711.png,https://derpicdn.net/img/view/2016/8/30/1237711.png,0,0.9944092035293579,1587,0,3967,2377,2380,2377,twilight sparkle,evehly|tyler611
1238026.png,https://derpicdn.net/img/view/2016/8/30/1238026.png,0,0.9985851049423218,293,42,1017,766,724,724,twilight sparkle,otakuap
12402.jpg,https://derpicdn.net/img/view/2012/6/20/12402.jpg,0,0.9612591862678528,123,0,753,503,630,503,twilight sparkle,raikoh
1240622.png,https://derpicdn.net/img/view/2016/9/3/1240622.png,0,0.9585542678833008,0,34,3116,4720,3116,4686,twilight sparkle,dashiesparkle
1241567.png,https://derpicdn.net/img/view/2016/9/4/1241567.png,0,0.9978306889533995,36,1,326,291,290,290,twilight sparkle,heilos
1244448.png,https://derpicdn.net/img/view/2016/9/8/1244448.png,0,0.9928943514823914,96,0,524,414,428,414,twilight sparkle,hioshiru
1244764.png,https://derpicdn.net/img/view/2016/9/8/1244764.png,0,0.9995177984237672,488,90,990,592,502,502,twilight sparkle,skorpionletun
1246403.png,https://derpicdn.net/img/view/2016/9/11/1246403.png,0,0.9767789840698242,156,13,1646,1503,1490,1490,twilight sparkle,maren
1249700.png,https://derpicdn.net/img/view/2016/9/15/1249700.png,0,0.933050572872162,423,6,2031,1614,1608,1608,twilight sparkle,scarlet-spectrum
1249709.png,https://derpicdn.net/img/view/2016/9/15/1249709.png,0,0.998261570930481,323,215,653,545,330,330,twilight sparkle,dstears
1250740.png,https://derpicdn.net/img/view/2016/9/16/1250740.png,0,0.9294106364250184,0,5,180,193,180,188,twilight sparkle,stoic5
1255830.png,https://derpicdn.net/img/view/2016/9/22/1255830.png,0,0.9979166388511658,556,0,1570,982,1014,982,twilight sparkle,pabbley
1259739.png,https://derpicdn.net/img/view/2016/9/27/1259739.png,0,0.989659309387207,1054,31,1816,793,762,762,twilight sparkle,flutterthrash
1260027.png,https://derpicdn.net/img/view/2016/9/28/1260027.png,0,0.9950756430625916,646,0,1280,587,634,587,twilight sparkle,pandramodo
1260388.png,https://derpicdn.net/img/view/2016/9/28/1260388.png,0,0.9424819946289062,904,298,1898,1292,994,994,twilight sparkle,badumsquish
1263674.png,https://derpicdn.net/img/view/2016/10/2/1263674.png,0,0.9494253396987916,747,0,1723,821,976,821,twilight sparkle,ncmares
1265872.png,https://derpicdn.net/img/view/2016/10/6/1265872.png,0,0.9807370901107788,176,0,974,750,798,750,twilight sparkle,pencils
1266569.png,https://derpicdn.net/img/view/2016/10/6/1266569.png,0,0.9983943700790404,541,21,1185,665,644,644,twilight sparkle,chowdie
1268035.png,https://derpicdn.net/img/view/2016/10/8/1268035.png,0,0.9370231628417968,403,164,1521,1282,1118,1118,twilight sparkle,mirapony
1269029.png,https://derpicdn.net/img/view/2016/10/9/1269029.png,0,0.9906613230705258,221,73,1601,1453,1380,1380,twilight sparkle,bugplayer
1271874.png,https://derpicdn.net/img/view/2016/10/13/1271874.png,0,0.9090949296951294,0,96,1517,1836,1517,1740,twilight sparkle,arifproject
1272737.png,https://derpicdn.net/img/view/2016/10/14/1272737.png,0,0.993430197238922,505,235,1003,733,498,498,twilight sparkle,alasou
1276262.png,https://derpicdn.net/img/view/2016/10/18/1276262.png,0,0.9089580178260804,505,0,2321,1723,1816,1723,twilight sparkle,bugplayer
127643.jpg,https://derpicdn.net/img/view/2012/10/20/127643.jpg,0,0.979602873325348,434,0,792,328,358,328,twilight sparkle,hobbes-maxwell
1276568.png,https://derpicdn.net/img/view/2016/10/19/1276568.png,0,0.9892687797546388,408,0,1280,833,872,833,twilight sparkle,fluffymaiden
1280530.png,https://derpicdn.net/img/view/2016/10/24/1280530.png,0,0.9979162216186525,357,63,1323,1029,966,966,twilight sparkle,pabbley
1281853.png,https://derpicdn.net/img/view/2016/10/26/1281853.png,0,0.9186537265777588,828,49,1402,623,574,574,twilight sparkle,haden-2375
1283988.png,https://derpicdn.net/img/view/2016/10/29/1283988.png,0,0.9645909667015076,1218,0,4099,2972,2881,2972,twilight sparkle,skitter|slb94
1285292.png,https://derpicdn.net/img/view/2016/10/31/1285292.png,0,0.9916378855705258,127,126,645,644,518,518,twilight sparkle,sorcerushorserus
1289098.png,https://derpicdn.net/img/view/2016/11/5/1289098.png,0,0.9857403039932252,225,0,1200,906,975,906,twilight sparkle,captainpudgemuffin
1296504.png,https://derpicdn.net/img/view/2016/11/15/1296504.png,0,0.9846320152282716,94,0,830,684,736,684,twilight sparkle,alasou
1297814.png,https://derpicdn.net/img/view/2016/11/17/1297814.png,0,0.9993606209754944,763,85,1287,609,524,524,twilight sparkle,alasou
1297907.png,https://derpicdn.net/img/view/2016/11/17/1297907.png,0,0.9891073703765868,118,0,1006,876,888,876,twilight sparkle,taneysha
1298855.png,https://derpicdn.net/img/view/2016/11/19/1298855.png,0,0.9981716871261596,302,0,3298,2861,2996,2861,twilight sparkle,bloodatius
1300579.png,https://derpicdn.net/img/view/2016/11/21/1300579.png,0,0.9844760298728944,77,104,392,413,315,309,twilight sparkle,lumineko
1302355.png,https://derpicdn.net/img/view/2016/11/24/1302355.png,0,0.9949674606323242,1676,124,4492,2940,2816,2816,twilight sparkle,slb94
1304494.png,https://derpicdn.net/img/view/2016/11/27/1304494.png,0,0.9781391024589542,61,0,477,387,416,387,twilight sparkle,neuro
1306949.png,https://derpicdn.net/img/view/2016/11/30/1306949.png,0,0.9707928299903872,314,16,918,620,604,604,twilight sparkle,trollie trollenberg|wolfnanaki
1311205.png,https://derpicdn.net/img/view/2016/12/6/1311205.png,0,0.996448576450348,295,6,747,458,452,452,twilight sparkle,xenchiiru
1313645.png,https://derpicdn.net/img/view/2016/12/10/1313645.png,0,0.9894640445709229,184,0,792,587,608,587,twilight sparkle,xwhitedreamsx
1318889.png,https://derpicdn.net/img/view/2016/12/16/1318889.png,0,0.9905261993408204,1484,84,2492,1092,1008,1008,twilight sparkle,bugplayer
1321034.png,https://derpicdn.net/img/view/2016/12/19/1321034.png,0,0.9968937039375304,162,0,582,364,420,364,twilight sparkle,graphenescloset
1321316.png,https://derpicdn.net/img/view/2016/12/20/1321316.png,0,0.9602819681167604,150,0,444,289,294,289,twilight sparkle,thebrokencog
1323782.png,https://derpicdn.net/img/view/2016/12/24/1323782.png,0,0.9962624907493592,139,0,421,276,282,276,twilight sparkle,comaofsouls
1327300.png,https://derpicdn.net/img/view/2016/12/28/1327300.png,0,0.9985742568969728,346,51,664,369,318,318,twilight sparkle,king-kakapo
1329069.png,https://derpicdn.net/img/view/2016/12/31/1329069.png,0,0.9984723925590516,3667,0,7631,3579,3964,3579,twilight sparkle,justisanimation
1329265.png,https://derpicdn.net/img/view/2016/12/31/1329265.png,0,0.924657702445984,340,137,1496,1266,1156,1129,twilight sparkle,yakovlev-vad
1331603.png,https://derpicdn.net/img/view/2017/1/3/1331603.png,0,0.912349820137024,1423,395,2341,1313,918,918,twilight sparkle,badumsquish
1332732.png,https://derpicdn.net/img/view/2017/1/5/1332732.png,0,0.9622745513916016,111,45,955,889,844,844,twilight sparkle,orchidpony
1333140.png,https://derpicdn.net/img/view/2017/1/6/1333140.png,0,0.998958170413971,13,0,887,862,874,862,twilight sparkle,windymils
1333418.png,https://derpicdn.net/img/view/2017/1/6/1333418.png,0,0.999038815498352,231,1004,1929,2702,1698,1698,twilight sparkle,docwario
1335821.png,https://derpicdn.net/img/view/2017/1/9/1335821.png,0,0.9965001344680786,4020,375,8090,4567,4070,4192,twilight sparkle,pink1ejack
1336620.png,https://derpicdn.net/img/view/2017/1/10/1336620.png,0,0.9970085620880128,56,0,458,364,402,364,twilight sparkle,foxinshadow
1336620.png,https://derpicdn.net/img/view/2017/1/10/1336620.png,1,0.9530680179595948,625,0,961,336,336,336,twilight sparkle,foxinshadow
1340739.png,https://derpicdn.net/img/view/2017/1/16/1340739.png,0,0.961676836013794,0,0,1868,2009,1868,2009,twilight sparkle,lilfunkman
1340883.png,https://derpicdn.net/img/view/2017/1/16/1340883.png,0,0.9970353841781616,317,0,981,600,664,600,twilight sparkle,hiccupsdoesart
1341112.png,https://derpicdn.net/img/view/2017/1/17/1341112.png,0,0.9982746243476868,436,4,894,462,458,458,twilight sparkle,evehly
1342552.png,https://derpicdn.net/img/view/2017/1/19/1342552.png,0,0.996395707130432,464,45,684,265,220,220,twilight sparkle,thebrokencog
1342552.png,https://derpicdn.net/img/view/2017/1/19/1342552.png,1,0.9926192760467528,94,18,332,256,238,238,twilight sparkle,thebrokencog
1349361.png,https://derpicdn.net/img/view/2017/1/27/1349361.png,0,0.9931864738464355,273,174,2127,2028,1854,1854,twilight sparkle,bloodatius
1349770.png,https://derpicdn.net/img/view/2017/1/28/1349770.png,0,0.9799527525901794,432,130,956,654,524,524,twilight sparkle,1jaz
1351134.png,https://derpicdn.net/img/view/2017/1/30/1351134.png,0,0.9246644973754884,0,243,1588,1887,1588,1644,twilight sparkle,fensu-san
1354331.png,https://derpicdn.net/img/view/2017/2/3/1354331.png,0,0.9989683032035828,333,0,883,523,550,523,twilight sparkle,vavacung
1355052.png,https://derpicdn.net/img/view/2017/2/4/1355052.png,0,0.9913265705108644,0,0,371,364,371,364,twilight sparkle,haden-2375
1355703.png,https://derpicdn.net/img/view/2017/2/5/1355703.png,0,0.9888238906860352,112,0,644,521,532,521,twilight sparkle,haden-2375
1357816.png,https://derpicdn.net/img/view/2017/2/8/1357816.png,0,0.9612755179405212,1155,0,2339,1082,1184,1082,twilight sparkle,pabbley|slb94
1358315.png,https://derpicdn.net/img/view/2017/2/8/1358315.png,0,0.9946935772895812,511,113,1211,813,700,700,twilight sparkle,buttersprinkle
1358503.png,https://derpicdn.net/img/view/2017/2/9/1358503.png,0,0.9954590797424316,93,0,485,391,392,391,twilight sparkle,riouku
1358516.png,https://derpicdn.net/img/view/2017/2/9/1358516.png,0,0.9940586686134338,18,0,442,408,424,408,twilight sparkle,ravensunart
1360840.png,https://derpicdn.net/img/view/2017/2/12/1360840.png,0,0.9830069541931152,104,0,758,645,654,645,twilight sparkle,hiccupsdoesart
1361875.png,https://derpicdn.net/img/view/2017/2/13/1361875.png,0,0.9883381128311156,477,0,1299,786,822,786,twilight sparkle,haden-2375
1361950.png,https://derpicdn.net/img/view/2017/2/13/1361950.png,0,0.994597315788269,1675,479,2659,1463,984,984,twilight sparkle,noctilucent-arts
1362664.png,https://derpicdn.net/img/view/2017/2/14/1362664.png,0,0.9909009337425232,580,1103,984,1507,404,404,twilight sparkle,the-butch-x
1363368.png,https://derpicdn.net/img/view/2017/2/15/1363368.png,0,0.9868688583374025,173,85,493,405,320,320,twilight sparkle,mlpanon
1364186.png,https://derpicdn.net/img/view/2017/2/16/1364186.png,0,0.9823461771011353,352,0,1226,762,874,762,twilight sparkle,ncmares
1365780.png,https://derpicdn.net/img/view/2017/2/17/1365780.png,0,0.9947138428688048,392,0,1378,957,986,957,twilight sparkle,discorded
1365837.png,https://derpicdn.net/img/view/2017/2/18/1365837.png,0,0.97983717918396,84,8,716,640,632,632,twilight sparkle,transgressors-reworks|pabbley
1366206.png,https://derpicdn.net/img/view/2017/2/18/1366206.png,0,0.97705739736557,264,1,1692,1467,1428,1466,twilight sparkle,deltauraart
1367718.png,https://derpicdn.net/img/view/2017/2/19/1367718.png,0,0.9744279980659484,162,454,1818,2110,1656,1656,twilight sparkle,pucksterv
1368373.png,https://derpicdn.net/img/view/2017/2/20/1368373.png,0,0.9658989906311036,61,0,903,840,842,840,twilight sparkle,vetallie
1368497.png,https://derpicdn.net/img/view/2017/2/20/1368497.png,0,0.9728211164474488,73,7,893,827,820,820,twilight sparkle,vetallie
1370130.png,https://derpicdn.net/img/view/2017/2/22/1370130.png,0,0.9981075525283812,1030,0,1574,532,544,532,twilight sparkle,evehly
1370130.png,https://derpicdn.net/img/view/2017/2/22/1370130.png,1,0.9683955907821656,212,186,1050,1024,838,838,twilight sparkle,evehly
1375535.png,https://derpicdn.net/img/view/2017/2/28/1375535.png,0,0.9971605539321899,122,0,760,609,638,609,twilight sparkle,toroitimu
1380327.png,https://derpicdn.net/img/view/2017/3/5/1380327.png,0,0.981417953968048,68,0,540,437,472,437,twilight sparkle,twiren
1380349.png,https://derpicdn.net/img/view/2017/3/5/1380349.png,0,0.9799358248710632,597,597,1131,1131,534,534,twilight sparkle,sammy-upvotes
1380487.png,https://derpicdn.net/img/view/2017/3/6/1380487.png,0,0.9778122901916504,176,0,938,621,762,621,twilight sparkle,sammy-upvotes
1381035.png,https://derpicdn.net/img/view/2017/3/6/1381035.png,0,0.9985544681549072,0,149,792,969,792,820,twilight sparkle,habijob
1381035.png,https://derpicdn.net/img/view/2017/3/6/1381035.png,1,0.9722663164138794,513,82,1335,932,822,850,twilight sparkle,habijob
1382923.png,https://derpicdn.net/img/view/2017/3/9/1382923.png,0,0.9663109183311462,249,28,663,442,414,414,twilight sparkle,king-kakapo
1382925.png,https://derpicdn.net/img/view/2017/3/9/1382925.png,0,0.9712011218070984,254,32,658,436,404,404,twilight sparkle,king-kakapo
1383191.png,https://derpicdn.net/img/view/2017/3/9/1383191.png,0,0.9890836477279664,333,54,689,410,356,356,twilight sparkle,king-kakapo
1385537.png,https://derpicdn.net/img/view/2017/3/12/1385537.png,0,0.9989621639251708,513,245,1071,803,558,558,twilight sparkle,earthsong9405|turnipberry
1385798.png,https://derpicdn.net/img/view/2017/3/13/1385798.png,0,0.9987143278121948,266,62,684,480,418,418,twilight sparkle,king-kakapo
1387395.png,https://derpicdn.net/img/view/2017/3/15/1387395.png,0,0.9957648515701294,0,0,477,499,477,499,twilight sparkle,braeburned
1389541.png,https://derpicdn.net/img/view/2017/3/17/1389541.png,0,0.9976999163627625,2239,1414,2815,1990,576,576,twilight sparkle,1trick
1391135.png,https://derpicdn.net/img/view/2017/3/19/1391135.png,0,0.9915714859962464,1568,0,2708,1005,1140,1005,twilight sparkle,raps|cabrony
1392541.png,https://derpicdn.net/img/view/2017/3/20/1392541.png,0,0.991452932357788,150,0,802,629,652,629,twilight sparkle,sugarlesspaints
1394005.png,https://derpicdn.net/img/view/2017/3/22/1394005.png,0,0.9951105117797852,583,0,1543,957,960,957,twilight sparkle,nexcoyotlgt
1394070.png,https://derpicdn.net/img/view/2017/3/22/1394070.png,0,0.9270566701889038,293,0,681,347,388,347,twilight sparkle,lewdmanakitty
1394183.png,https://derpicdn.net/img/view/2017/3/23/1394183.png,0,0.9958056211471558,583,1,1539,957,956,956,twilight sparkle,nexcoyotlgt
1394184.png,https://derpicdn.net/img/view/2017/3/23/1394184.png,0,0.995760142803192,583,1,1539,957,956,956,twilight sparkle,nexcoyotlgt
1394394.png,https://derpicdn.net/img/view/2017/3/23/1394394.png,0,0.9993885159492492,563,0,1865,1261,1302,1261,twilight sparkle,mp-printer
1394520.png,https://derpicdn.net/img/view/2017/3/23/1394520.png,0,0.9145769476890564,0,21,766,835,766,814,twilight sparkle,galawaille
1397402.png,https://derpicdn.net/img/view/2017/3/27/1397402.png,0,0.9957522749900818,1522,0,4114,2522,2592,2522,twilight sparkle,thebrokencog
1400279.png,https://derpicdn.net/img/view/2017/3/31/1400279.png,0,0.9579158425331116,158,13,929,785,771,772,twilight sparkle,badumsquish
1403790.png,https://derpicdn.net/img/view/2017/4/4/1403790.png,0,0.9612482786178588,176,63,880,767,704,704,twilight sparkle,freeedon|longren
1403794.png,https://derpicdn.net/img/view/2017/4/4/1403794.png,0,0.9992296695709229,407,18,753,364,346,346,twilight sparkle,pettankochanv
1405530.png,https://derpicdn.net/img/view/2017/4/6/1405530.png,0,0.9548996686935424,242,0,504,256,262,256,twilight sparkle,graphenescloset
1405646.png,https://derpicdn.net/img/view/2017/4/6/1405646.png,0,0.95157128572464,251,160,1677,1586,1426,1426,twilight sparkle,duop-qoub
1406089.png,https://derpicdn.net/img/view/2017/4/7/1406089.png,0,0.9986394047737122,111,76,1023,988,912,912,twilight sparkle,tjpones
1407140.png,https://derpicdn.net/img/view/2017/4/8/1407140.png,0,0.9849091172218324,1028,731,1264,1035,236,304,twilight sparkle,
1407140.png,https://derpicdn.net/img/view/2017/4/8/1407140.png,1,0.9582149386405944,114,67,354,307,240,240,twilight sparkle,
1407482.png,https://derpicdn.net/img/view/2017/4/9/1407482.png,0,0.966091811656952,0,0,1890,2182,1890,2182,twilight sparkle,zilvart
1408285.png,https://derpicdn.net/img/view/2017/4/10/1408285.png,0,0.9005804657936096,103,0,2005,1881,1902,1881,twilight sparkle,bloodatius
1415505.png,https://derpicdn.net/img/view/2017/4/18/1415505.png,0,0.9560881853103638,408,51,828,471,420,420,twilight sparkle,ramiras
1415798.png,https://derpicdn.net/img/view/2017/4/19/1415798.png,0,0.9120841026306152,29,2,157,136,128,134,twilight sparkle,shydale
1420232.png,https://derpicdn.net/img/view/2017/4/24/1420232.png,0,0.9874881505966188,593,0,1573,969,980,969,twilight sparkle,jetwave
1420337.png,https://derpicdn.net/img/view/2017/4/24/1420337.png,0,0.9953334331512452,230,37,920,727,690,690,twilight sparkle,tsitra360|vest
1422868.png,https://derpicdn.net/img/view/2017/4/27/1422868.png,0,0.9782809019088744,522,0,1872,1153,1350,1153,twilight sparkle,hawthornss
1423457.png,https://derpicdn.net/img/view/2017/4/28/1423457.png,0,0.9380884766578674,272,328,1842,1898,1570,1570,twilight sparkle,sourspot|lilfunkman
1425122.png,https://derpicdn.net/img/view/2017/4/30/1425122.png,0,0.9965663552284241,376,557,752,933,376,376,twilight sparkle,thenornonthego
1426976.png,https://derpicdn.net/img/view/2017/5/2/1426976.png,0,0.9254218339920044,178,0,1136,930,958,930,twilight sparkle,underpable
1430866.png,https://derpicdn.net/img/view/2017/5/7/1430866.png,0,0.9798911809921264,319,444,1091,1216,772,772,twilight sparkle,ghst-qn|sokolas
1432280.png,https://derpicdn.net/img/view/2017/5/9/1432280.png,0,0.9325913190841676,601,0,1397,705,796,705,twilight sparkle,graphene
1432731.png,https://derpicdn.net/img/view/2017/5/9/1432731.png,0,0.9806100130081176,4,0,775,785,771,785,twilight sparkle,sorcerushorserus
1433757.png,https://derpicdn.net/img/view/2017/5/11/1433757.png,0,0.9355524182319641,76,0,1134,1048,1058,1048,twilight sparkle,pabbley
1434024.png,https://derpicdn.net/img/view/2017/5/11/1434024.png,0,0.9786199331283568,0,0,1066,972,1066,972,twilight sparkle,soshyqqq
1435576.png,https://derpicdn.net/img/view/2017/5/13/1435576.png,0,0.975605309009552,1239,143,3091,1995,1852,1852,twilight sparkle,sollace
1435954.png,https://derpicdn.net/img/view/2017/5/14/1435954.png,0,0.9864493608474731,199,58,851,710,652,652,twilight sparkle,andelai
1437832.png,https://derpicdn.net/img/view/2017/5/16/1437832.png,0,0.9985991716384888,57,0,1389,1292,1332,1292,twilight sparkle,madacon
1438070.png,https://derpicdn.net/img/view/2017/5/16/1438070.png,0,0.9686130285263062,220,0,1214,919,994,919,twilight sparkle,bluecoffeedog
1438145.png,https://derpicdn.net/img/view/2017/5/16/1438145.png,0,0.997380256652832,253,83,1461,1291,1208,1208,twilight sparkle,yakovlev-vad
1441743.png,https://derpicdn.net/img/view/2017/5/21/1441743.png,0,0.9370357394218444,775,0,1619,824,844,824,twilight sparkle,remcmaximus
1442147.png,https://derpicdn.net/img/view/2017/5/21/1442147.png,0,0.9949497580528259,217,5,867,655,650,650,twilight sparkle,haden-2375
1445478.png,https://derpicdn.net/img/view/2017/5/25/1445478.png,0,0.948112726211548,0,27,459,495,459,468,twilight sparkle,matimus91
1445644.png,https://derpicdn.net/img/view/2017/5/25/1445644.png,0,0.9966454505920408,710,63,3096,2449,2386,2386,twilight sparkle,bloodatius
1446367.png,https://derpicdn.net/img/view/2017/5/26/1446367.png,0,0.9986516237258912,487,30,1261,804,774,774,twilight sparkle,okusheny
1450943.png,https://derpicdn.net/img/view/2017/5/31/1450943.png,0,0.9998631477355956,0,63,705,809,705,746,twilight sparkle,doekitty
1450943.png,https://derpicdn.net/img/view/2017/5/31/1450943.png,1,0.9686275124549866,728,110,1424,806,696,696,twilight sparkle,doekitty
1452226.png,https://derpicdn.net/img/view/2017/6/2/1452226.png,0,0.9975923895835876,29,17,505,493,476,476,twilight sparkle,setharu
1452911.png,https://derpicdn.net/img/view/2017/6/3/1452911.png,0,0.9934649467468262,391,0,1419,985,1028,985,twilight sparkle,mykegreywolf
1456645.png,https://derpicdn.net/img/view/2017/6/8/1456645.png,0,0.9948982000350952,430,11,1388,969,958,958,twilight sparkle,mykegreywolf
1457359.png,https://derpicdn.net/img/view/2017/6/9/1457359.png,0,0.9852009415626526,302,102,632,432,330,330,twilight sparkle,vanillaghosties
1458343.png,https://derpicdn.net/img/view/2017/6/10/1458343.png,0,0.9535560011863708,348,46,658,356,310,310,twilight sparkle,ta-na
1458491.png,https://derpicdn.net/img/view/2017/6/10/1458491.png,0,0.9957380294799804,826,585,1432,1191,606,606,twilight sparkle,dawnfire
1460793.png,https://derpicdn.net/img/view/2017/6/13/1460793.png,0,0.9500808119773864,679,0,2789,2004,2110,2004,twilight sparkle,shutterflyeqd
1465921.png,https://derpicdn.net/img/view/2017/6/19/1465921.png,0,0.9963347315788268,186,41,694,549,508,508,twilight sparkle,raikoh
1468576.png,https://derpicdn.net/img/view/2017/6/22/1468576.png,0,0.9856526851654052,1673,70,5475,3872,3802,3802,twilight sparkle,pabbley
1470794.png,https://derpicdn.net/img/view/2017/6/24/1470794.png,0,0.9969241619110109,279,72,793,586,514,514,twilight sparkle,unousaya
1475507.png,https://derpicdn.net/img/view/2017/6/30/1475507.png,0,0.9778903126716614,1093,0,2959,1863,1866,1863,twilight sparkle,duop-qoub
1477827.png,https://derpicdn.net/img/view/2017/7/3/1477827.png,0,0.9854193925857544,37,107,359,429,322,322,twilight sparkle,duop-qoub
1478364.png,https://derpicdn.net/img/view/2017/7/4/1478364.png,0,0.9675560593605042,146,8,336,198,190,190,twilight sparkle,pia-sama
1481903.png,https://derpicdn.net/img/view/2017/7/8/1481903.png,0,0.9869815707206726,861,151,1911,1201,1050,1050,twilight sparkle,nexcoyotlgt
1481909.png,https://derpicdn.net/img/view/2017/7/8/1481909.png,0,0.9713395833969116,523,117,1177,771,654,654,twilight sparkle,unousaya
1483920.png,https://derpicdn.net/img/view/2017/7/11/1483920.png,0,0.9568131566047668,205,0,1401,1143,1196,1143,twilight sparkle,nightskrill
1485699.png,https://derpicdn.net/img/view/2017/7/14/1485699.png,0,0.9946383833885192,0,83,1148,1285,1148,1202,twilight sparkle,pirill
1485699.png,https://derpicdn.net/img/view/2017/7/14/1485699.png,1,0.9724143743515016,2807,138,3840,1276,1033,1138,twilight sparkle,pirill
1485718.png,https://derpicdn.net/img/view/2017/7/14/1485718.png,0,0.955642819404602,410,0,1020,543,610,543,twilight sparkle,ncmares
1486863.png,https://derpicdn.net/img/view/2017/7/15/1486863.png,0,0.9758416414260864,1026,83,1596,653,570,570,twilight sparkle,marauder6272|hyperstorm_h
1487121.png,https://derpicdn.net/img/view/2017/7/15/1487121.png,0,0.9870477318763732,341,0,2753,1957,2412,1957,twilight sparkle,balloons504
1487248.png,https://derpicdn.net/img/view/2017/7/16/1487248.png,0,0.9965969324111938,837,42,1375,606,538,564,twilight sparkle,si1vr
1489116.png,https://derpicdn.net/img/view/2017/7/18/1489116.png,0,0.944571852684021,64,93,902,931,838,838,twilight sparkle,mewball
1491222.png,https://derpicdn.net/img/view/2017/7/21/1491222.png,0,0.9739471077919006,1,0,585,468,584,468,twilight sparkle,1trick
1498046.png,https://derpicdn.net/img/view/2017/7/30/1498046.png,0,0.9937047362327576,248,0,1570,1130,1322,1130,twilight sparkle,pucksterv
1499446.png,https://derpicdn.net/img/view/2017/7/31/1499446.png,0,0.9901794195175172,278,336,920,978,642,642,twilight sparkle,sea-maas
1500428.png,https://derpicdn.net/img/view/2017/8/1/1500428.png,0,0.9653066992759703,685,0,2213,1367,1528,1367,twilight sparkle,alcor
1500428.png,https://derpicdn.net/img/view/2017/8/1/1500428.png,1,0.9092303514480592,2135,343,2995,1203,860,860,twilight sparkle,alcor
1503088.png,https://derpicdn.net/img/view/2017/8/5/1503088.png,0,0.9027523398399352,249,0,855,601,606,601,twilight sparkle,flutterthrash
1503950.png,https://derpicdn.net/img/view/2017/8/6/1503950.png,0,0.9544621706008912,770,32,1702,964,932,932,twilight sparkle,bugplayer
1504928.png,https://derpicdn.net/img/view/2017/8/7/1504928.png,0,0.962588667869568,83,118,1089,1124,1006,1006,twilight sparkle,orang111
150656.png,https://derpicdn.net/img/view/2012/11/13/150656.png,0,0.9054915308952332,989,1000,2087,2098,1098,1098,twilight sparkle,zelc-face
1507534.png,https://derpicdn.net/img/view/2017/8/10/1507534.png,0,0.9863630533218384,0,0,2165,2295,2165,2295,twilight sparkle,duop-qoub
1507692.png,https://derpicdn.net/img/view/2017/8/11/1507692.png,0,0.9958622455596924,1102,10,4718,3626,3616,3616,twilight sparkle,pabbley
1510207.png,https://derpicdn.net/img/view/2017/8/14/1510207.png,0,0.9477440118789672,61,12,855,806,794,794,twilight sparkle,noctilucent-arts
1510697.png,https://derpicdn.net/img/view/2017/8/14/1510697.png,0,0.9786803126335144,366,138,710,482,344,344,twilight sparkle,vanillaghosties
1512.jpg,https://derpicdn.net/img/view/2012/1/22/1512.jpg,0,0.9907962083816528,106,18,420,332,314,314,twilight sparkle,mysticalpha
1515650.png,https://derpicdn.net/img/view/2017/8/20/1515650.png,0,0.991019070148468,192,128,1326,1262,1134,1134,twilight sparkle,anonbelle
1516868.png,https://derpicdn.net/img/view/2017/8/22/1516868.png,0,0.9509398341178894,498,1048,1162,1712,664,664,twilight sparkle,discorded
1517372.png,https://derpicdn.net/img/view/2017/8/22/1517372.png,0,0.9002519845962524,836,140,1760,1064,924,924,twilight sparkle,sourspot|lilfunkman
1518526.png,https://derpicdn.net/img/view/2017/8/24/1518526.png,0,0.999146580696106,925,0,2787,1814,1862,1814,twilight sparkle,pabbley
1519179.png,https://derpicdn.net/img/view/2017/8/25/1519179.png,0,0.9958512783050536,449,13,1809,1373,1360,1360,twilight sparkle,yukomaussi
1519230.png,https://derpicdn.net/img/view/2017/8/25/1519230.png,0,0.9887776970863342,1038,138,2444,1544,1406,1406,twilight sparkle,danmakuman
1519751.png,https://derpicdn.net/img/view/2017/8/26/1519751.png,0,0.990943729877472,471,0,2995,2300,2524,2300,twilight sparkle,silverhopexiii
1522016.png,https://derpicdn.net/img/view/2017/8/28/1522016.png,0,0.954466700553894,109,26,807,724,698,698,twilight sparkle,pabbley|certificate
1523155.png,https://derpicdn.net/img/view/2017/8/30/1523155.png,0,0.9907313585281372,1347,4,2949,1606,1602,1602,twilight sparkle,docwario
1523600.png,https://derpicdn.net/img/view/2017/8/30/1523600.png,0,0.9791977405548096,148,61,866,779,718,718,twilight sparkle,certificate|pabbley
1524491.png,https://derpicdn.net/img/view/2017/8/31/1524491.png,0,0.9952840805053712,205,0,697,460,492,460,twilight sparkle,9seconds
1524795.png,https://derpicdn.net/img/view/2017/9/1/1524795.png,0,0.998915433883667,64,40,500,476,436,436,twilight sparkle,setharu
1525734.png,https://derpicdn.net/img/view/2017/9/2/1525734.png,0,0.9590367078781128,0,0,361,415,361,415,twilight sparkle,n_thing
1527401.png,https://derpicdn.net/img/view/2017/9/4/1527401.png,0,0.9634645581245422,1074,0,2826,1747,1752,1747,twilight sparkle,pabbley
1527937.png,https://derpicdn.net/img/view/2017/9/4/1527937.png,0,0.9968951344490052,719,89,2293,1663,1574,1574,twilight sparkle,duop-qoub
1528814.png,https://derpicdn.net/img/view/2017/9/5/1528814.png,0,0.9968691468238832,719,88,2295,1664,1576,1576,twilight sparkle,duop-qoub
1529057.png,https://derpicdn.net/img/view/2017/9/6/1529057.png,0,0.9939299225807192,817,395,2623,2201,1806,1806,twilight sparkle,aleximusprime
1531523.png,https://derpicdn.net/img/view/2017/9/9/1531523.png,0,0.9704753756523132,276,280,1330,1334,1054,1054,twilight sparkle,duop-qoub
1531593.png,https://derpicdn.net/img/view/2017/9/9/1531593.png,0,0.9739769697189332,263,272,1373,1382,1110,1110,twilight sparkle,duop-qoub
1531820.png,https://derpicdn.net/img/view/2017/9/10/1531820.png,0,0.929470419883728,892,307,1742,1157,850,850,twilight sparkle,laszlvfx|aleximusprime
1532220.png,https://derpicdn.net/img/view/2017/9/10/1532220.png,0,0.929392397403717,142,716,2442,3016,2300,2300,twilight sparkle,bloodatius
1534435.png,https://derpicdn.net/img/view/2017/9/13/1534435.png,0,0.9813499450683594,12,0,2604,2489,2592,2489,twilight sparkle,setharu
1534625.png,https://derpicdn.net/img/view/2017/9/13/1534625.png,0,0.9724835157394408,329,103,733,507,404,404,twilight sparkle,stasysolitude
1536258.png,https://derpicdn.net/img/view/2017/9/15/1536258.png,0,0.9861871004104614,606,0,1782,1142,1176,1142,twilight sparkle,check3256
1537588.png,https://derpicdn.net/img/view/2017/9/17/1537588.png,0,0.9846253395080566,771,3,1400,689,629,686,twilight sparkle,cakewasgood
1539623.png,https://derpicdn.net/img/view/2017/9/19/1539623.png,0,0.9858783483505248,40,0,2346,2005,2306,2005,twilight sparkle,badumsquish
1540832.png,https://derpicdn.net/img/view/2017/9/21/1540832.png,0,0.9902421832084656,102,0,880,639,778,639,twilight sparkle,noctilucent-arts
1542560.png,https://derpicdn.net/img/view/2017/9/23/1542560.png,0,0.9753473997116088,104,152,1424,1472,1320,1320,twilight sparkle,misukitty
1542806.png,https://derpicdn.net/img/view/2017/9/23/1542806.png,0,0.9422782063484192,137,0,909,743,772,743,twilight sparkle,
1542946.png,https://derpicdn.net/img/view/2017/9/23/1542946.png,0,0.9271484613418579,313,12,1829,1558,1516,1546,twilight sparkle,badumsquish
1543270.png,https://derpicdn.net/img/view/2017/9/24/1543270.png,0,0.9880542159080504,8,0,252,226,244,226,twilight sparkle,aureai-sketches
1544783.png,https://derpicdn.net/img/view/2017/9/25/1544783.png,0,0.994954526424408,85,0,1145,1013,1060,1013,twilight sparkle,piesarts
1545394.png,https://derpicdn.net/img/view/2017/9/26/1545394.png,0,0.9408941268920898,338,43,1829,1535,1491,1492,twilight sparkle,badumsquish
1545828.png,https://derpicdn.net/img/view/2017/9/27/1545828.png,0,0.9182825088500975,193,0,685,451,492,451,twilight sparkle,dm29
1548948.png,https://derpicdn.net/img/view/2017/10/1/1548948.png,0,0.9067553877830504,80,0,610,506,530,506,twilight sparkle,
1550077.png,https://derpicdn.net/img/view/2017/10/2/1550077.png,0,0.9956672191619872,164,0,602,426,438,426,twilight sparkle,toroitimu
1553668.png,https://derpicdn.net/img/view/2017/10/6/1553668.png,0,0.9620330929756165,237,0,897,644,660,644,twilight sparkle,redcrow32|duop-qoub
1553803.png,https://derpicdn.net/img/view/2017/10/6/1553803.png,0,0.9577503800392152,0,6,3741,3770,3741,3764,twilight sparkle,shutterflyeqd
1554682.png,https://derpicdn.net/img/view/2017/10/7/1554682.png,0,0.9963839054107666,391,0,1161,765,770,765,twilight sparkle,huckser
1554733.png,https://derpicdn.net/img/view/2017/10/7/1554733.png,0,0.9987909197807312,426,23,770,367,344,344,twilight sparkle,
1554856.png,https://derpicdn.net/img/view/2017/10/8/1554856.png,0,0.9919273257255554,1255,205,2701,1651,1446,1446,twilight sparkle,maxiima
1557701.png,https://derpicdn.net/img/view/2017/10/10/1557701.png,0,0.9992059469223022,89,51,591,553,502,502,twilight sparkle,tsitra360
1558656.png,https://derpicdn.net/img/view/2017/10/11/1558656.png,0,0.9870973229408264,54,0,1800,1080,1746,1080,twilight sparkle,
1559400.png,https://derpicdn.net/img/view/2017/10/12/1559400.png,0,0.9983243346214294,776,1511,1170,1905,394,394,twilight sparkle,ramiras
1561483.png,https://derpicdn.net/img/view/2017/10/15/1561483.png,0,0.9882223010063172,155,0,1024,1087,869,1087,twilight sparkle,crecious
1563892.png,https://derpicdn.net/img/view/2017/10/17/1563892.png,0,0.9986573457717896,330,1546,1122,2338,792,792,twilight sparkle,mr.smile
1563892.png,https://derpicdn.net/img/view/2017/10/17/1563892.png,1,0.9896908402442932,2165,112,3427,1374,1262,1262,twilight sparkle,mr.smile
1563899.png,https://derpicdn.net/img/view/2017/10/17/1563899.png,0,0.993981659412384,1394,0,5821,4369,4427,4369,twilight sparkle,jhayarr23
1564568.png,https://derpicdn.net/img/view/2017/10/18/1564568.png,0,0.9728997349739076,1061,681,1681,1301,620,620,twilight sparkle,noctilucent-arts
1566306.png,https://derpicdn.net/img/view/2017/10/21/1566306.png,0,0.9904966354370116,0,0,809,766,809,766,twilight sparkle,pastelhorses|duop-qoub
1567509.png,https://derpicdn.net/img/view/2017/10/22/1567509.png,0,0.9594694972038268,124,0,1092,844,968,844,twilight sparkle,sion
1567670.png,https://derpicdn.net/img/view/2017/10/22/1567670.png,0,0.998026967048645,95,0,1263,1153,1168,1153,twilight sparkle,moondreamer16
1568525.png,https://derpicdn.net/img/view/2017/10/23/1568525.png,0,0.948697566986084,0,7,304,323,304,316,twilight sparkle,calicopikachu
1569880.png,https://derpicdn.net/img/view/2017/10/25/1569880.png,0,0.9816601872444152,60,0,754,665,694,665,twilight sparkle,dstears
1573567.png,https://derpicdn.net/img/view/2017/10/30/1573567.png,0,0.9940021634101868,441,0,1317,844,876,844,twilight sparkle,unousaya
1576102.png,https://derpicdn.net/img/view/2017/11/2/1576102.png,0,0.9998270273208618,4,9,326,331,322,322,twilight sparkle,xenon
1576272.png,https://derpicdn.net/img/view/2017/11/2/1576272.png,0,0.9910302758216858,794,0,2344,1483,1550,1483,twilight sparkle,applec1234
1578303.png,https://derpicdn.net/img/view/2017/11/5/1578303.png,0,0.9602712392807008,0,0,799,798,799,798,twilight sparkle,talimingi
1578505.png,https://derpicdn.net/img/view/2017/11/5/1578505.png,0,0.9321463108062744,501,0,2287,1719,1786,1719,twilight sparkle,greyscaleart
1579721.png,https://derpicdn.net/img/view/2017/11/6/1579721.png,0,0.9905857443809508,252,0,854,584,602,584,twilight sparkle,king-kakapo
1582175.png,https://derpicdn.net/img/view/2017/11/9/1582175.png,0,0.959288477897644,653,177,1311,835,658,658,twilight sparkle,hiccupsdoesart
1582175.png,https://derpicdn.net/img/view/2017/11/9/1582175.png,1,0.9589638113975524,31,91,665,725,634,634,twilight sparkle,hiccupsdoesart
1582175.png,https://derpicdn.net/img/view/2017/11/9/1582175.png,2,0.9394028782844543,1096,0,1918,786,822,786,twilight sparkle,hiccupsdoesart
1583386.png,https://derpicdn.net/img/view/2017/11/11/1583386.png,0,0.9968404173851012,632,0,2244,1587,1612,1587,twilight sparkle,bloodatius
15844.jpg,https://derpicdn.net/img/view/2012/6/22/15844.jpg,0,0.9663055539131165,863,93,1491,721,628,628,twilight sparkle,whitmaverick
1585112.png,https://derpicdn.net/img/view/2017/11/13/1585112.png,0,0.9972948431968688,490,21,926,457,436,436,twilight sparkle,pabbley
15879.jpg,https://derpicdn.net/img/view/2012/6/22/15879.jpg,0,0.9625492095947266,162,28,604,470,442,442,twilight sparkle,doxy
1588080.png,https://derpicdn.net/img/view/2017/11/17/1588080.png,0,0.9796038866043092,578,188,1246,856,668,668,twilight sparkle,
1588639.png,https://derpicdn.net/img/view/2017/11/17/1588639.png,0,0.9995172023773192,2061,0,2885,736,824,736,twilight sparkle,bluecoffeedog
1588639.png,https://derpicdn.net/img/view/2017/11/17/1588639.png,1,0.9966907501220704,329,359,1121,1151,792,792,twilight sparkle,bluecoffeedog
1594968.png,https://derpicdn.net/img/view/2017/11/26/1594968.png,0,0.9915233254432678,88,36,624,572,536,536,twilight sparkle,pabbley
1595055.png,https://derpicdn.net/img/view/2017/11/26/1595055.png,0,0.9737318754196168,128,181,988,1041,860,860,twilight sparkle,skorpionletun
1595268.png,https://derpicdn.net/img/view/2017/11/27/1595268.png,0,0.9416912794113159,649,56,1185,592,536,536,twilight sparkle,andelai
1597373.png,https://derpicdn.net/img/view/2017/11/30/1597373.png,0,0.9654428362846376,132,6,606,480,474,474,twilight sparkle,toroitimu
1597853.png,https://derpicdn.net/img/view/2017/12/1/1597853.png,0,0.9982700943946838,73,43,1821,1791,1748,1748,twilight sparkle,lispp
1598021.png,https://derpicdn.net/img/view/2017/12/1/1598021.png,0,0.9810259938240052,309,0,741,406,432,406,twilight sparkle,sevedie
1599246.png,https://derpicdn.net/img/view/2017/12/3/1599246.png,0,0.9723618626594543,0,0,531,529,531,529,twilight sparkle,talimingi
1603736.png,https://derpicdn.net/img/view/2017/12/9/1603736.png,0,0.9029921293258668,807,97,2163,1453,1356,1356,twilight sparkle,kitana762|brisineo
1605704.png,https://derpicdn.net/img/view/2017/12/12/1605704.png,0,0.9924710392951964,43,0,729,656,686,656,twilight sparkle,clockworkquartet
1606113.png,https://derpicdn.net/img/view/2017/12/12/1606113.png,0,0.9021502733230592,274,0,1132,942,858,942,twilight sparkle,pastelhorses|dilarus
1610007.png,https://derpicdn.net/img/view/2017/12/17/1610007.png,0,0.9288060069084167,342,228,1112,998,770,770,twilight sparkle,pastelhorses|duop-qoub
1610711.png,https://derpicdn.net/img/view/2017/12/18/1610711.png,0,0.9877928495407104,1,353,401,753,400,400,twilight sparkle,pixelkitties
16113.png,https://derpicdn.net/img/view/2012/6/23/16113.png,0,0.9648705720901488,719,731,1485,1497,766,766,twilight sparkle,skutchi|somepony
1611698.png,https://derpicdn.net/img/view/2017/12/20/1611698.png,0,0.9800440073013306,0,0,506,545,506,545,twilight sparkle,aymint
1612231.png,https://derpicdn.net/img/view/2017/12/20/1612231.png,0,0.995061457157135,929,122,2441,1634,1512,1512,twilight sparkle,duop-qoub
1612293.png,https://derpicdn.net/img/view/2017/12/20/1612293.png,0,0.9804113507270812,315,219,1413,1317,1098,1098,twilight sparkle,andelai
1613201.png,https://derpicdn.net/img/view/2017/12/22/1613201.png,0,0.9816975593566896,0,0,751,752,751,752,twilight sparkle,lilboulder
1613735.png,https://derpicdn.net/img/view/2017/12/23/1613735.png,0,0.9583866596221924,1148,346,1772,970,624,624,twilight sparkle,batonya12561
1613853.png,https://derpicdn.net/img/view/2017/12/23/1613853.png,0,0.9898404479026794,865,0,3783,2789,2918,2789,twilight sparkle,omegaozone|slb94
1614046.png,https://derpicdn.net/img/view/2017/12/23/1614046.png,0,0.998132586479187,16,0,856,808,840,808,twilight sparkle,sirzi
1614990.png,https://derpicdn.net/img/view/2017/12/24/1614990.png,0,0.928548276424408,767,367,1619,1219,852,852,twilight sparkle,rainihorn
1614990.png,https://derpicdn.net/img/view/2017/12/24/1614990.png,1,0.90610671043396,1315,448,2091,1224,776,776,twilight sparkle,rainihorn
1615612.png,https://derpicdn.net/img/view/2017/12/25/1615612.png,0,0.9956004619598388,286,0,1954,1617,1668,1617,twilight sparkle,pridark
1619975.png,https://derpicdn.net/img/view/2017/12/30/1619975.png,0,0.9754516482353208,12,0,1142,1089,1130,1089,twilight sparkle,mewball
1620358.png,https://derpicdn.net/img/view/2017/12/31/1620358.png,0,0.9996272325515748,249,0,891,621,642,621,twilight sparkle,kaliner123
1620840.png,https://derpicdn.net/img/view/2017/12/31/1620840.png,0,0.9025543332099916,242,96,602,456,360,360,twilight sparkle,xenon
1621867.png,https://derpicdn.net/img/view/2018/1/1/1621867.png,0,0.9972075819969176,757,0,2427,1642,1670,1642,twilight sparkle,bloodatius
1622954.png,https://derpicdn.net/img/view/2018/1/3/1622954.png,0,0.9229584336280824,320,0,1162,821,842,821,twilight sparkle,deltauraart
1624358.png,https://derpicdn.net/img/view/2018/1/5/1624358.png,0,0.9972785711288452,737,0,1519,759,782,759,twilight sparkle,koveliana
1624718.png,https://derpicdn.net/img/view/2018/1/5/1624718.png,0,0.9761542081832886,520,572,950,1002,430,430,twilight sparkle,reiduran
1626438.png,https://derpicdn.net/img/view/2018/1/7/1626438.png,0,0.985531449317932,161,9,387,235,226,226,twilight sparkle,pervynamek02|marauder6272
1630957.png,https://derpicdn.net/img/view/2018/1/13/1630957.png,0,0.9958056211471558,309,11,649,351,340,340,twilight sparkle,ashiji|sugaryrainbow
1631460.png,https://derpicdn.net/img/view/2018/1/13/1631460.png,0,0.9992297887802124,182,0,690,485,508,485,twilight sparkle,higgly-chan
1631843.png,https://derpicdn.net/img/view/2018/1/14/1631843.png,0,0.9887043237686156,625,102,1843,1320,1218,1218,twilight sparkle,flamevulture17
1632310.png,https://derpicdn.net/img/view/2018/1/14/1632310.png,0,0.9807989001274108,352,128,1328,1104,976,976,twilight sparkle,bloodatius|pastelhorses
1633395.png,https://derpicdn.net/img/view/2018/1/16/1633395.png,0,0.996110200881958,980,0,1972,953,992,953,twilight sparkle,andelai
1633631.png,https://derpicdn.net/img/view/2018/1/16/1633631.png,0,0.9906867742538452,428,22,906,500,478,478,twilight sparkle,king-kakapo
1636642.png,https://derpicdn.net/img/view/2018/1/20/1636642.png,0,0.9920592308044434,1588,0,3153,1663,1565,1663,twilight sparkle,sunibee|lyracorn
1639541.png,https://derpicdn.net/img/view/2018/1/24/1639541.png,0,0.9328352808952332,282,137,582,437,300,300,twilight sparkle,napstamuse
1640714.png,https://derpicdn.net/img/view/2018/1/25/1640714.png,0,0.9947199821472168,789,110,1739,1060,950,950,twilight sparkle,bugplayer
1641652.png,https://derpicdn.net/img/view/2018/1/26/1641652.png,0,0.9392164349555968,573,84,1171,682,598,598,twilight sparkle,mrscurlystyles
1642823.png,https://derpicdn.net/img/view/2018/1/28/1642823.png,0,0.9976443648338318,0,71,633,761,633,690,twilight sparkle,dsp2003
1642825.png,https://derpicdn.net/img/view/2018/1/28/1642825.png,0,0.996725618839264,0,71,635,763,635,692,twilight sparkle,dsp2003
1645894.png,https://derpicdn.net/img/view/2018/2/1/1645894.png,0,0.9938346743583679,123,34,479,390,356,356,twilight sparkle,bantha
1647091.png,https://derpicdn.net/img/view/2018/2/3/1647091.png,0,0.9668486714363098,476,116,1372,1012,896,896,twilight sparkle,andelai
1647214.png,https://derpicdn.net/img/view/2018/2/3/1647214.png,0,0.9806562662124634,39,0,350,316,311,316,twilight sparkle,cold-blooded-twilight
1648615.png,https://derpicdn.net/img/view/2018/2/4/1648615.png,0,0.9968851804733276,157,450,381,674,224,224,twilight sparkle,king-kakapo
1648616.png,https://derpicdn.net/img/view/2018/2/4/1648616.png,0,0.9959962368011476,162,456,378,672,216,216,twilight sparkle,king-kakapo
1648687.png,https://derpicdn.net/img/view/2018/2/5/1648687.png,0,0.9883155226707458,1341,0,3321,1952,1980,1952,twilight sparkle,artiks
1650858.png,https://derpicdn.net/img/view/2018/2/8/1650858.png,0,0.9853281378746032,693,39,1951,1297,1258,1258,twilight sparkle,shutterflyeqd
1650866.png,https://derpicdn.net/img/view/2018/2/8/1650866.png,0,0.9853281378746032,693,39,1951,1297,1258,1258,twilight sparkle,shutterflyeqd
1651197.png,https://derpicdn.net/img/view/2018/2/8/1651197.png,0,0.9533878564834596,354,81,568,295,214,214,twilight sparkle,kevinsano
1652811.png,https://derpicdn.net/img/view/2018/2/10/1652811.png,0,0.9980320334434508,398,0,2224,1753,1826,1753,twilight sparkle,pabbley|pastelhorses
1653660.png,https://derpicdn.net/img/view/2018/2/11/1653660.png,0,0.9782962799072266,684,12,1770,1098,1086,1086,twilight sparkle,sourspot
1653660.png,https://derpicdn.net/img/view/2018/2/11/1653660.png,1,0.958954930305481,379,1150,1281,2052,902,902,twilight sparkle,sourspot
1653660.png,https://derpicdn.net/img/view/2018/2/11/1653660.png,2,0.9369320273399352,0,42,866,914,866,872,twilight sparkle,sourspot
1655803.png,https://derpicdn.net/img/view/2018/2/14/1655803.png,0,0.9958500862121582,89,135,423,469,334,334,twilight sparkle,scarlet-spectrum
1656985.png,https://derpicdn.net/img/view/2018/2/15/1656985.png,0,0.9547542929649352,425,389,1381,1345,956,956,twilight sparkle,itsalwayspony
1659310.png,https://derpicdn.net/img/view/2018/2/18/1659310.png,0,0.9708154797554016,0,0,2812,2685,2812,2685,twilight sparkle,fluffyxai
1660294.png,https://derpicdn.net/img/view/2018/2/19/1660294.png,0,0.9941195249557496,477,398,2209,2130,1732,1732,twilight sparkle,lilfunkman
1660689.png,https://derpicdn.net/img/view/2018/2/19/1660689.png,0,0.9830910563468932,553,0,1079,464,526,464,twilight sparkle,scheadar
1662703.png,https://derpicdn.net/img/view/2018/2/22/1662703.png,0,0.9453983902931212,435,0,1103,589,668,589,twilight sparkle,foldeath
16638.png,https://derpicdn.net/img/view/2012/6/23/16638.png,0,0.995052695274353,263,99,1627,1463,1364,1364,twilight sparkle,zev
1666391.png,https://derpicdn.net/img/view/2018/2/26/1666391.png,0,0.9203351736068726,82,4,274,196,192,192,twilight sparkle,pabbley
1667569.png,https://derpicdn.net/img/view/2018/2/27/1667569.png,0,0.9953765869140624,264,61,542,339,278,278,twilight sparkle,longtailshort
1668919.png,https://derpicdn.net/img/view/2018/3/1/1668919.png,0,0.9494509696960448,89,0,701,585,612,585,twilight sparkle,spectre-z
1671775.png,https://derpicdn.net/img/view/2018/3/4/1671775.png,0,0.99599027633667,612,326,1922,1636,1310,1310,twilight sparkle,andelai
1672040.png,https://derpicdn.net/img/view/2018/3/5/1672040.png,0,0.9894810914993286,395,177,709,491,314,314,twilight sparkle,lumineko
1673736.png,https://derpicdn.net/img/view/2018/3/7/1673736.png,0,0.9815537333488464,4,0,492,442,488,442,twilight sparkle,toroitimu
1677560.png,https://derpicdn.net/img/view/2018/3/11/1677560.png,0,0.9840868711471558,19,0,357,336,338,336,twilight sparkle,dusthiel
1679060.png,https://derpicdn.net/img/view/2018/3/13/1679060.png,0,0.9132298231124878,146,4,424,282,278,278,twilight sparkle,king-kakapo
1685685.png,https://derpicdn.net/img/view/2018/3/20/1685685.png,0,0.9844664335250854,194,0,434,230,240,230,twilight sparkle,tre
1686749.png,https://derpicdn.net/img/view/2018/3/21/1686749.png,0,0.991983950138092,30,0,564,521,534,521,twilight sparkle,umejiru
1686981.png,https://derpicdn.net/img/view/2018/3/21/1686981.png,0,0.965621054172516,415,0,837,398,422,398,twilight sparkle,heir-of-rick
1687594.png,https://derpicdn.net/img/view/2018/3/22/1687594.png,0,0.9759461283683776,381,0,1439,1049,1058,1049,twilight sparkle,bugplayer
1688501.png,https://derpicdn.net/img/view/2018/3/23/1688501.png,0,0.9485517740249634,0,16,963,1000,963,984,twilight sparkle,duop-qoub
1688625.png,https://derpicdn.net/img/view/2018/3/24/1688625.png,0,0.9183352589607242,19,0,551,486,532,486,twilight sparkle,kingjnar
1689751.png,https://derpicdn.net/img/view/2018/3/25/1689751.png,0,0.9826371669769288,0,57,731,885,731,828,twilight sparkle,duop-qoub
1689957.png,https://derpicdn.net/img/view/2018/3/25/1689957.png,0,0.98844712972641,124,122,1702,1700,1578,1578,twilight sparkle,zelc-face
1690402.png,https://derpicdn.net/img/view/2018/3/25/1690402.png,0,0.9725892543792723,55,27,950,965,895,938,twilight sparkle,duop-qoub
1691421.png,https://derpicdn.net/img/view/2018/3/26/1691421.png,0,0.9976882338523864,743,86,1379,722,636,636,twilight sparkle,inowiseei
1691562.png,https://derpicdn.net/img/view/2018/3/26/1691562.png,0,0.9991711378097534,1009,0,2417,1252,1408,1252,twilight sparkle,twistedscarlett60
1693038.png,https://derpicdn.net/img/view/2018/3/28/1693038.png,0,0.9750357270240784,0,0,527,471,527,471,twilight sparkle,ehfa
1694087.png,https://derpicdn.net/img/view/2018/3/29/1694087.png,0,0.994149386882782,373,2,1169,798,796,796,twilight sparkle,higgly-chan
1694380.png,https://derpicdn.net/img/view/2018/3/30/1694380.png,0,0.9902684092521667,0,0,774,812,774,812,twilight sparkle,bae-mon
1697382.png,https://derpicdn.net/img/view/2018/4/2/1697382.png,0,0.999478816986084,224,90,586,452,362,362,twilight sparkle,anthroponiessfm
1702303.png,https://derpicdn.net/img/view/2018/4/8/1702303.png,0,0.9992395043373108,829,75,2031,1277,1202,1202,twilight sparkle,aleriastarlight
1704685.png,https://derpicdn.net/img/view/2018/4/11/1704685.png,0,0.9649195075035096,889,132,2339,1582,1450,1450,twilight sparkle,shutterflyeqd
1705334.png,https://derpicdn.net/img/view/2018/4/11/1705334.png,0,0.9670277237892152,137,190,1044,1286,907,1096,twilight sparkle,duop-qoub
1706056.png,https://derpicdn.net/img/view/2018/4/12/1706056.png,0,0.9367031455039978,54,0,598,517,544,517,twilight sparkle,askaniz|johnjoseco
1706733.png,https://derpicdn.net/img/view/2018/4/13/1706733.png,0,0.9662590622901917,121,0,1079,826,958,826,twilight sparkle,yanamosuda
170723.jpg,https://derpicdn.net/img/view/2012/12/2/170723.jpg,0,0.9686102867126464,758,80,1106,428,348,348,twilight sparkle,ruhje
1707666.png,https://derpicdn.net/img/view/2018/4/14/1707666.png,0,0.9856753945350648,856,41,1762,947,906,906,twilight sparkle,yakovlev-vad
1709288.png,https://derpicdn.net/img/view/2018/4/16/1709288.png,0,0.9855238795280457,14,0,360,340,346,340,twilight sparkle,dusthiel
1709777.png,https://derpicdn.net/img/view/2018/4/16/1709777.png,0,0.9857261776924132,396,304,2054,1962,1658,1658,twilight sparkle,andelai
1710633.png,https://derpicdn.net/img/view/2018/4/18/1710633.png,0,0.9934763908386228,345,190,943,788,598,598,twilight sparkle,thefloatingtree
1710918.png,https://derpicdn.net/img/view/2018/4/18/1710918.png,0,0.9910582900047302,711,124,1413,826,702,702,twilight sparkle,dawnfire
1718831.png,https://derpicdn.net/img/view/2018/4/28/1718831.png,0,0.919649302959442,126,17,858,749,732,732,twilight sparkle,orang111
1719634.png,https://derpicdn.net/img/view/2018/4/29/1719634.png,0,0.9982784390449524,1065,1187,2047,2169,982,982,twilight sparkle,ravensunart
1719732.png,https://derpicdn.net/img/view/2018/4/29/1719732.png,0,0.9937005639076232,0,536,872,1434,872,898,twilight sparkle,laptop-pone
1722307.png,https://derpicdn.net/img/view/2018/5/2/1722307.png,0,0.9990450143814088,1004,186,2220,1402,1216,1216,twilight sparkle,kurozu
1723312.png,https://derpicdn.net/img/view/2018/5/3/1723312.png,0,0.957269251346588,507,0,1841,1240,1334,1240,twilight sparkle,badumsquish
1723429.png,https://derpicdn.net/img/view/2018/5/3/1723429.png,0,0.9777167439460754,92,0,600,529,508,529,twilight sparkle,amarynceus
1725014.png,https://derpicdn.net/img/view/2018/5/5/1725014.png,0,0.9847790002822876,110,0,2128,1883,2018,1883,twilight sparkle,mirroredsea
1725033.png,https://derpicdn.net/img/view/2018/5/5/1725033.png,0,0.96136736869812,553,172,1197,816,644,644,twilight sparkle,mirroredsea
1725044.png,https://derpicdn.net/img/view/2018/5/5/1725044.png,0,0.9695281982421876,1636,1496,2124,1984,488,488,twilight sparkle,mirroredsea
1725046.png,https://derpicdn.net/img/view/2018/5/5/1725046.png,0,0.9917285442352296,745,0,2457,1636,1712,1636,twilight sparkle,mirroredsea
1725052.png,https://derpicdn.net/img/view/2018/5/5/1725052.png,0,0.9986805319786072,854,0,2000,1114,1146,1114,twilight sparkle,mirroredsea
1726311.png,https://derpicdn.net/img/view/2018/5/6/1726311.png,0,0.9844756722450256,968,436,2368,1836,1400,1400,twilight sparkle,mirroredsea
1727015.png,https://derpicdn.net/img/view/2018/5/7/1727015.png,0,0.9838370084762572,354,8,818,472,464,464,twilight sparkle,rodrigues404
1727867.png,https://derpicdn.net/img/view/2018/5/8/1727867.png,0,0.992310643196106,715,318,1667,1270,952,952,twilight sparkle,andelai
1728768.png,https://derpicdn.net/img/view/2018/5/10/1728768.png,0,0.9438647031784058,1352,687,2202,1537,850,850,twilight sparkle,mirroredsea
1730769.png,https://derpicdn.net/img/view/2018/5/12/1730769.png,0,0.9860855937004088,201,242,729,770,528,528,twilight sparkle,rossignolet
1731023.png,https://derpicdn.net/img/view/2018/5/12/1731023.png,0,0.9977028369903564,51,0,507,388,456,388,twilight sparkle,fensu-san
1735946.png,https://derpicdn.net/img/view/2018/5/18/1735946.png,0,0.99467670917511,320,106,600,386,280,280,twilight sparkle,inuhoshi-to-darkpen
1735946.png,https://derpicdn.net/img/view/2018/5/18/1735946.png,1,0.9527392983436584,70,52,386,368,316,316,twilight sparkle,inuhoshi-to-darkpen
1736187.png,https://derpicdn.net/img/view/2018/5/19/1736187.png,0,0.9599021077156068,228,24,690,486,462,462,twilight sparkle,king-kakapo
1736188.png,https://derpicdn.net/img/view/2018/5/19/1736188.png,0,0.9136499762535096,214,0,690,474,476,474,twilight sparkle,king-kakapo
1737754.png,https://derpicdn.net/img/view/2018/5/20/1737754.png,0,0.9467928409576416,0,34,835,998,835,964,twilight sparkle,duop-qoub
1739138.png,https://derpicdn.net/img/view/2018/5/22/1739138.png,0,0.9962199926376344,220,38,500,318,280,280,twilight sparkle,zakro
1739154.png,https://derpicdn.net/img/view/2018/5/22/1739154.png,0,0.9982068538665771,498,0,1022,487,524,487,twilight sparkle,clopician
1739969.png,https://derpicdn.net/img/view/2018/5/24/1739969.png,0,0.9757693409919742,154,0,1172,982,1018,982,twilight sparkle,heir-of-rick
1741803.png,https://derpicdn.net/img/view/2018/5/26/1741803.png,0,0.9878031611442566,246,0,1438,1029,1192,1029,twilight sparkle,heir-of-rick
1742104.png,https://derpicdn.net/img/view/2018/5/26/1742104.png,0,0.9987472295761108,1143,176,1985,1018,842,842,twilight sparkle,09hankris|badgerben
1742238.png,https://derpicdn.net/img/view/2018/5/26/1742238.png,0,0.9838640689849854,44,0,2250,2192,2206,2192,twilight sparkle,moozua
1743177.png,https://derpicdn.net/img/view/2018/5/27/1743177.png,0,0.9996017217636108,135,0,887,696,752,696,twilight sparkle,pegacornss
1746114.png,https://derpicdn.net/img/view/2018/5/31/1746114.png,0,0.9971474409103394,43,0,1035,973,992,973,twilight sparkle,jovalic
1747046.png,https://derpicdn.net/img/view/2018/6/1/1747046.png,0,0.9798638820648192,83,0,1691,1591,1608,1591,twilight sparkle,bloodatius
1748930.png,https://derpicdn.net/img/view/2018/6/3/1748930.png,0,0.9429329037666321,85,3,751,669,666,666,twilight sparkle,verawitch
1749854.png,https://derpicdn.net/img/view/2018/6/4/1749854.png,0,0.9545720815658568,215,0,1095,865,880,865,twilight sparkle,vistamage
1751038.png,https://derpicdn.net/img/view/2018/6/6/1751038.png,0,0.9719228744506836,67,0,393,289,326,289,twilight sparkle,tohupo
1751376.png,https://derpicdn.net/img/view/2018/6/6/1751376.png,0,0.9967269301414492,354,120,1690,1456,1336,1336,twilight sparkle,fensu-san
1752482.png,https://derpicdn.net/img/view/2018/6/8/1752482.png,0,0.9922740459442142,55,0,627,495,572,495,twilight sparkle,9seconds
1752716.png,https://derpicdn.net/img/view/2018/6/8/1752716.png,1,0.9457375407218932,1126,1028,1594,1496,468,468,twilight sparkle,light262
1757320.png,https://derpicdn.net/img/view/2018/6/14/1757320.png,0,0.9800661206245422,362,214,758,610,396,396,twilight sparkle,dawnallies
1758153.png,https://derpicdn.net/img/view/2018/6/15/1758153.png,0,0.9966076016426086,908,141,1676,909,768,768,twilight sparkle,pony-way
1758901.png,https://derpicdn.net/img/view/2018/6/16/1758901.png,0,0.9922778606414796,0,0,1149,1104,1149,1104,twilight sparkle,ohno
1760804.png,https://derpicdn.net/img/view/2018/6/18/1760804.png,0,0.9690382480621338,265,0,689,421,424,421,twilight sparkle,king-kakapo
1760807.png,https://derpicdn.net/img/view/2018/6/18/1760807.png,0,0.9889625906944276,266,0,688,420,422,420,twilight sparkle,king-kakapo
1760882.png,https://derpicdn.net/img/view/2018/6/18/1760882.png,0,0.9865050315856934,231,0,925,691,694,691,twilight sparkle,pastelhorses
1760912.png,https://derpicdn.net/img/view/2018/6/18/1760912.png,0,0.9964253902435304,524,0,3948,3090,3424,3090,twilight sparkle,fluffyxai
1761219.png,https://derpicdn.net/img/view/2018/6/19/1761219.png,0,0.9935033321380616,120,0,794,593,674,593,twilight sparkle,toroitimu
1762174.png,https://derpicdn.net/img/view/2018/6/20/1762174.png,0,0.986698567867279,86,2,560,476,474,474,twilight sparkle,hua
1762626.png,https://derpicdn.net/img/view/2018/6/21/1762626.png,0,0.9925830960273744,143,0,579,404,436,404,twilight sparkle,lulubell
1762874.png,https://derpicdn.net/img/view/2018/6/21/1762874.png,0,0.9948347806930542,380,28,760,408,380,380,twilight sparkle,aurora-sparkle
1763234.png,https://derpicdn.net/img/view/2018/6/22/1763234.png,0,0.9981086254119872,311,8,539,236,228,228,twilight sparkle,culu-bluebeaver
1765038.png,https://derpicdn.net/img/view/2018/6/24/1765038.png,0,0.9801433682441713,273,0,833,456,560,456,twilight sparkle,dezmondvulpin
1765103.png,https://derpicdn.net/img/view/2018/6/24/1765103.png,0,0.9843310713768004,727,184,2455,1912,1728,1728,twilight sparkle,nevobaster
1766589.png,https://derpicdn.net/img/view/2018/6/26/1766589.png,0,0.9355365633964542,48,103,998,1053,950,950,twilight sparkle,ncmares
1768009.png,https://derpicdn.net/img/view/2018/6/28/1768009.png,0,0.9694241881370544,106,6,422,322,316,316,twilight sparkle,skipsy
1770174.png,https://derpicdn.net/img/view/2018/7/1/1770174.png,0,0.9966975450515748,568,41,1494,967,926,926,twilight sparkle,andelai
1777677.png,https://derpicdn.net/img/view/2018/7/10/1777677.png,0,0.9686393737792968,893,0,1825,931,932,931,twilight sparkle,chaosangeldesu
1777894.png,https://derpicdn.net/img/view/2018/7/10/1777894.png,0,0.9991532564163208,580,31,1980,1431,1400,1400,twilight sparkle,bloodatius
1780591.png,https://derpicdn.net/img/view/2018/7/14/1780591.png,0,0.9983894228935242,339,353,721,735,382,382,twilight sparkle,silfoe|prince-cobalt
1781661.png,https://derpicdn.net/img/view/2018/7/15/1781661.png,0,0.9836720824241638,0,0,644,710,644,710,twilight sparkle,slavedemorto
1781939.png,https://derpicdn.net/img/view/2018/7/16/1781939.png,0,0.9413967132568359,0,51,724,809,724,758,twilight sparkle,heir-of-rick
1782510.png,https://derpicdn.net/img/view/2018/7/16/1782510.png,0,0.9378578066825868,665,91,1747,1173,1082,1082,twilight sparkle,andelai
1782878.png,https://derpicdn.net/img/view/2018/7/17/1782878.png,0,0.9625008702278136,790,162,1220,592,430,430,twilight sparkle,blackkaries
1783138.png,https://derpicdn.net/img/view/2018/7/17/1783138.png,0,0.973796844482422,139,9,609,479,470,470,twilight sparkle,toroitimu
1783411.png,https://derpicdn.net/img/view/2018/7/17/1783411.png,0,0.9933129549026488,24,15,690,681,666,666,twilight sparkle,cloud-fly
1788603.png,https://derpicdn.net/img/view/2018/7/24/1788603.png,0,0.9979019761085508,1050,0,1716,558,666,558,twilight sparkle,star-lightstarbright
1795189.png,https://derpicdn.net/img/view/2018/8/1/1795189.png,0,0.9673919677734376,0,0,2186,2118,2186,2118,twilight sparkle,pesty_skillengton
1796.png,https://derpicdn.net/img/view/2012/1/23/1796.png,0,0.999172568321228,79,0,477,369,398,369,twilight sparkle,johnjoseco
1797029.png,https://derpicdn.net/img/view/2018/8/3/1797029.png,0,0.923650324344635,0,239,748,1057,748,818,twilight sparkle,raps
1797115.png,https://derpicdn.net/img/view/2018/8/3/1797115.png,0,0.9982762336730956,446,0,1948,1476,1502,1476,twilight sparkle,amberpendant
1800332.png,https://derpicdn.net/img/view/2018/8/7/1800332.png,0,0.9848788380622864,1713,0,3600,1815,1887,1815,twilight sparkle,vanillaghosties
1800952.png,https://derpicdn.net/img/view/2018/8/7/1800952.png,0,0.996851086616516,196,19,626,449,430,430,twilight sparkle,coffeecloud
1801705.png,https://derpicdn.net/img/view/2018/8/8/1801705.png,0,0.93845796585083,296,210,1134,1048,838,838,twilight sparkle,yakovlev-vad
1802344.png,https://derpicdn.net/img/view/2018/8/9/1802344.png,0,0.9817140102386476,460,44,694,278,234,234,twilight sparkle,kevinsano
1802675.png,https://derpicdn.net/img/view/2018/8/9/1802675.png,0,0.969989538192749,1323,88,2205,970,882,882,twilight sparkle,iuth
1803370.png,https://derpicdn.net/img/view/2018/8/10/1803370.png,0,0.9693110585212708,718,51,1476,809,758,758,twilight sparkle,hierozaki
1804584.png,https://derpicdn.net/img/view/2018/8/12/1804584.png,0,0.9891616106033324,1209,293,3431,2515,2222,2222,twilight sparkle,jetwave
1805867.png,https://derpicdn.net/img/view/2018/8/13/1805867.png,0,0.9274991154670716,619,366,2317,2064,1698,1698,twilight sparkle,pridark
1806072.png,https://derpicdn.net/img/view/2018/8/13/1806072.png,0,0.9649240970611572,71,140,1523,1592,1452,1452,twilight sparkle,aer0 zer0
1807241.png,https://derpicdn.net/img/view/2018/8/15/1807241.png,0,0.9663296937942504,78,94,832,848,754,754,twilight sparkle,light262|lummh
1809399.png,https://derpicdn.net/img/view/2018/8/17/1809399.png,0,0.979827880859375,87,0,1833,1668,1746,1668,twilight sparkle,imbirgiana
1816177.png,https://derpicdn.net/img/view/2018/8/25/1816177.png,0,0.9981787800788879,1,0,569,542,568,542,twilight sparkle,duop-qoub|barhandar
1818016.png,https://derpicdn.net/img/view/2018/8/27/1818016.png,0,0.9949610829353333,1121,0,2961,1792,1840,1792,twilight sparkle,kaleido-art
1819320.png,https://derpicdn.net/img/view/2018/8/29/1819320.png,0,0.9949147701263428,116,0,906,771,790,771,twilight sparkle,klaudy
1820669.png,https://derpicdn.net/img/view/2018/8/30/1820669.png,0,0.9700745344161988,21,0,1596,1600,1575,1600,twilight sparkle,lilfunkman
1821674.png,https://derpicdn.net/img/view/2018/9/1/1821674.png,0,0.9988387227058412,0,0,389,387,389,387,twilight sparkle,haden-2375
1823039.png,https://derpicdn.net/img/view/2018/9/2/1823039.png,0,0.9583479762077332,181,138,571,528,390,390,twilight sparkle,posionjoke
1830581.png,https://derpicdn.net/img/view/2018/9/11/1830581.png,0,0.9930136203765868,81,9,579,507,498,498,twilight sparkle,imalou
1830620.png,https://derpicdn.net/img/view/2018/9/12/1830620.png,0,0.9931237101554872,96,17,428,349,332,332,twilight sparkle,anibaruthecat
1830923.png,https://derpicdn.net/img/view/2018/9/12/1830923.png,0,0.9905396699905396,42,0,594,512,552,512,twilight sparkle,hioshiru
1831422.png,https://derpicdn.net/img/view/2018/9/13/1831422.png,0,0.9694854021072388,389,39,1409,1059,1020,1020,twilight sparkle,andelai
1832349.png,https://derpicdn.net/img/view/2018/9/14/1832349.png,0,0.9529494643211364,204,151,528,475,324,324,twilight sparkle,mrrowboat
1832458.png,https://derpicdn.net/img/view/2018/9/14/1832458.png,0,0.9529494643211364,204,151,528,475,324,324,twilight sparkle,mrrowboat
1833534.png,https://derpicdn.net/img/view/2018/9/15/1833534.png,0,0.9730655550956726,95,0,1065,931,970,931,twilight sparkle,baigak
1835889.png,https://derpicdn.net/img/view/2018/9/18/1835889.png,0,0.9916153550148008,273,647,823,1197,550,550,twilight sparkle,johnjoseco
1835890.png,https://derpicdn.net/img/view/2018/9/18/1835890.png,0,0.991375207901001,279,654,819,1194,540,540,twilight sparkle,johnjoseco
1836879.png,https://derpicdn.net/img/view/2018/9/20/1836879.png,0,0.931157648563385,48,24,486,462,438,438,twilight sparkle,paperbagpony
1837903.png,https://derpicdn.net/img/view/2018/9/21/1837903.png,0,0.9984151124954224,879,250,2797,2168,1918,1918,twilight sparkle,imafutureguitarhero
1838625.png,https://derpicdn.net/img/view/2018/9/22/1838625.png,0,0.9939683079719543,98,85,518,505,420,420,twilight sparkle,iloota
1838639.png,https://derpicdn.net/img/view/2018/9/22/1838639.png,0,0.9955664873123168,98,85,518,505,420,420,twilight sparkle,iloota
1839849.png,https://derpicdn.net/img/view/2018/9/23/1839849.png,0,0.982593297958374,551,89,1549,1087,998,998,twilight sparkle,andelai
1840835.png,https://derpicdn.net/img/view/2018/9/25/1840835.png,0,0.9940820336341858,98,85,518,505,420,420,twilight sparkle,iloota
1840839.png,https://derpicdn.net/img/view/2018/9/25/1840839.png,0,0.9940820336341858,98,85,518,505,420,420,twilight sparkle,iloota
1841275.png,https://derpicdn.net/img/view/2018/9/25/1841275.png,0,0.9771252870559692,252,92,480,320,228,228,twilight sparkle,
1842190.png,https://derpicdn.net/img/view/2018/9/27/1842190.png,0,0.9649920463562012,249,312,781,844,532,532,twilight sparkle,bae-mon
1846581.png,https://derpicdn.net/img/view/2018/10/2/1846581.png,0,0.9879305958747864,0,0,480,480,480,480,twilight sparkle,duop-qoub
1847179.png,https://derpicdn.net/img/view/2018/10/3/1847179.png,0,0.9874302744865416,52,2,484,434,432,432,twilight sparkle,sion
1848228.png,https://derpicdn.net/img/view/2018/10/4/1848228.png,0,0.9860326647758484,422,473,898,949,476,476,twilight sparkle,tjpones
1852746.png,https://derpicdn.net/img/view/2018/10/10/1852746.png,1,0.9909809827804564,357,174,793,610,436,436,twilight sparkle,thebrokencog
1853348.png,https://derpicdn.net/img/view/2018/10/10/1853348.png,0,0.9922225475311279,661,0,1345,619,684,619,twilight sparkle,baigak
1854104.png,https://derpicdn.net/img/view/2018/10/11/1854104.png,0,0.9942461252212524,489,0,1215,685,726,685,twilight sparkle,meow|iuth
1855513.png,https://derpicdn.net/img/view/2018/10/13/1855513.png,0,0.9860972762107848,0,0,1260,1232,1260,1232,twilight sparkle,esfelt
1855638.png,https://derpicdn.net/img/view/2018/10/13/1855638.png,0,0.98765629529953,385,51,745,411,360,360,twilight sparkle,alicesmitt31
1857627.png,https://derpicdn.net/img/view/2018/10/15/1857627.png,0,0.9408103227615356,753,0,1953,1093,1200,1093,twilight sparkle,baigak
1858240.png,https://derpicdn.net/img/view/2018/10/16/1858240.png,0,0.9883849620819092,309,0,1183,835,874,835,twilight sparkle,alcor
1858575.png,https://derpicdn.net/img/view/2018/10/17/1858575.png,0,0.9990028142929076,1773,0,3035,1164,1262,1164,twilight sparkle,badgerben
1858892.png,https://derpicdn.net/img/view/2018/10/17/1858892.png,0,0.9953765869140624,151,0,459,297,308,297,twilight sparkle,king-kakapo
1858892.png,https://derpicdn.net/img/view/2018/10/17/1858892.png,1,0.9931043386459352,860,0,1158,292,298,292,twilight sparkle,king-kakapo
1858897.png,https://derpicdn.net/img/view/2018/10/17/1858897.png,0,0.999660849571228,279,0,691,409,412,409,twilight sparkle,king-kakapo
1858897.png,https://derpicdn.net/img/view/2018/10/17/1858897.png,1,0.9996498823165894,1203,0,1615,412,412,412,twilight sparkle,king-kakapo
1862667.png,https://derpicdn.net/img/view/2018/10/21/1862667.png,0,0.9252996444702148,199,24,1718,1782,1519,1758,twilight sparkle,draconidsmxz
1862915.png,https://derpicdn.net/img/view/2018/10/22/1862915.png,0,0.9656259417533876,493,111,1005,637,512,526,twilight sparkle,techycutie
1863739.png,https://derpicdn.net/img/view/2018/10/23/1863739.png,0,0.9901639819145204,642,0,2450,1731,1808,1731,twilight sparkle,kaleido-art
1863817.png,https://derpicdn.net/img/view/2018/10/23/1863817.png,0,0.9474358558654784,124,19,642,537,518,518,twilight sparkle,
1864948.png,https://derpicdn.net/img/view/2018/10/24/1864948.png,0,0.9874126315116882,174,36,548,410,374,374,twilight sparkle,rutkotka
1865786.png,https://derpicdn.net/img/view/2018/10/25/1865786.png,0,0.965194046497345,108,0,468,314,360,314,twilight sparkle,iloota
1865950.png,https://derpicdn.net/img/view/2018/10/25/1865950.png,0,0.9967649579048156,0,0,2386,2015,2386,2015,twilight sparkle,bonoramo
1865950.png,https://derpicdn.net/img/view/2018/10/25/1865950.png,1,0.9928281903266908,1449,321,4093,2894,2644,2573,twilight sparkle,bonoramo
1870005.png,https://derpicdn.net/img/view/2018/10/30/1870005.png,0,0.9913535714149476,20,0,1824,1080,1804,1080,twilight sparkle,
1871295.png,https://derpicdn.net/img/view/2018/10/31/1871295.png,0,0.9934467673301696,455,71,959,575,504,504,twilight sparkle,plainoasis
1873666.png,https://derpicdn.net/img/view/2018/11/3/1873666.png,0,0.9920907616615297,7,0,1077,869,1070,869,twilight sparkle,artiks
1874829.png,https://derpicdn.net/img/view/2018/11/4/1874829.png,0,0.9650628566741944,203,36,663,496,460,460,twilight sparkle,haden-2375
187484.png,https://derpicdn.net/img/view/2012/12/19/187484.png,0,0.9911861419677734,0,0,665,614,665,614,twilight sparkle,sirmasterdufel
1875153.png,https://derpicdn.net/img/view/2018/11/4/1875153.png,0,0.999148726463318,598,0,994,388,396,388,twilight sparkle,pekou
1876036.png,https://derpicdn.net/img/view/2018/11/6/1876036.png,0,0.9637582898139954,160,300,2088,2228,1928,1928,twilight sparkle,andelai
1876037.png,https://derpicdn.net/img/view/2018/11/6/1876037.png,0,0.9638074636459352,160,300,2088,2228,1928,1928,twilight sparkle,andelai
1876038.png,https://derpicdn.net/img/view/2018/11/6/1876038.png,0,0.973035216331482,174,315,2072,2213,1898,1898,twilight sparkle,andelai
1877247.png,https://derpicdn.net/img/view/2018/11/7/1877247.png,0,0.9977522492408752,1868,0,3850,2086,1982,2086,twilight sparkle,neekophobia
1880177.png,https://derpicdn.net/img/view/2018/11/11/1880177.png,0,0.9872976541519164,0,0,878,954,878,954,twilight sparkle,duop-qoub
188728.png,https://derpicdn.net/img/view/2012/12/20/188728.png,0,0.992976725101471,277,0,485,201,208,201,twilight sparkle,alasou
1889569.png,https://derpicdn.net/img/view/2018/11/24/1889569.png,0,0.9948036670684814,223,181,1441,1399,1218,1218,twilight sparkle,shutterflyeqd
1890092.png,https://derpicdn.net/img/view/2018/11/24/1890092.png,0,0.961297333240509,0,7,1004,1079,1004,1072,twilight sparkle,theroyalprincesses
1893668.png,https://derpicdn.net/img/view/2018/11/29/1893668.png,1,0.9523657560348512,1237,0,1909,608,672,608,twilight sparkle,king-kakapo
1895206.png,https://derpicdn.net/img/view/2018/12/1/1895206.png,0,0.9809126257896424,339,59,1433,1153,1094,1094,twilight sparkle,hiccupsdoesart
1895678.png,https://derpicdn.net/img/view/2018/12/1/1895678.png,0,0.9530913829803468,153,45,617,509,464,464,twilight sparkle,ambris
1895888.png,https://derpicdn.net/img/view/2018/12/2/1895888.png,0,0.9854718446731568,886,45,1832,991,946,946,twilight sparkle,tatara94
1897795.png,https://derpicdn.net/img/view/2018/12/4/1897795.png,0,0.9976518750190736,175,36,639,500,464,464,twilight sparkle,darkestmbongo
1903696.png,https://derpicdn.net/img/view/2018/12/9/1903696.png,0,0.992518424987793,420,0,1320,861,900,861,twilight sparkle,yakovlev-vad
1904560.png,https://derpicdn.net/img/view/2018/12/10/1904560.png,0,0.9967346787452698,700,90,1036,426,336,336,twilight sparkle,fromamida
1904560.png,https://derpicdn.net/img/view/2018/12/10/1904560.png,1,0.9914522767066956,903,362,1235,694,332,332,twilight sparkle,fromamida
1904560.png,https://derpicdn.net/img/view/2018/12/10/1904560.png,2,0.9822869896888732,361,100,769,508,408,408,twilight sparkle,fromamida
1904694.png,https://derpicdn.net/img/view/2018/12/10/1904694.png,0,0.9937771558761596,851,429,1281,859,430,430,twilight sparkle,28gooddays
1908438.png,https://derpicdn.net/img/view/2018/12/14/1908438.png,0,0.9238892793655396,569,337,1957,1725,1388,1388,twilight sparkle,sourspot
1908994.png,https://derpicdn.net/img/view/2018/12/15/1908994.png,0,0.999711573123932,16,0,858,807,842,807,twilight sparkle,yunlongchen
1911782.png,https://derpicdn.net/img/view/2018/12/18/1911782.png,0,0.9871367812156676,123,30,1139,1046,1016,1016,twilight sparkle,greyscaleart
1912829.png,https://derpicdn.net/img/view/2018/12/19/1912829.png,0,0.9988293647766112,200,39,428,267,228,228,twilight sparkle,iloota
1912842.png,https://derpicdn.net/img/view/2018/12/19/1912842.png,0,0.9913075566291808,32,0,1728,1783,1696,1783,twilight sparkle,neira|ashleyjaneworld
1913108.png,https://derpicdn.net/img/view/2018/12/19/1913108.png,0,0.9236364960670472,0,0,1045,1076,1045,1076,twilight sparkle,bigshot232
1913385.png,https://derpicdn.net/img/view/2018/12/20/1913385.png,0,0.9912133216857908,2764,212,3612,1060,848,848,twilight sparkle,graphenescloset
1914815.png,https://derpicdn.net/img/view/2018/12/21/1914815.png,0,0.994638204574585,326,0,1422,1035,1096,1035,twilight sparkle,duop-qoub
1917305.png,https://derpicdn.net/img/view/2018/12/24/1917305.png,0,0.999136745929718,0,1445,310,1859,310,414,twilight sparkle,loveslove
1917412.png,https://derpicdn.net/img/view/2018/12/24/1917412.png,0,0.993066906929016,1002,927,1600,1525,598,598,twilight sparkle,ramiras
1917412.png,https://derpicdn.net/img/view/2018/12/24/1917412.png,2,0.9362345933914183,1433,242,1913,722,480,480,twilight sparkle,ramiras
1917791.png,https://derpicdn.net/img/view/2018/12/24/1917791.png,0,0.9443308711051941,1410,163,3830,2583,2420,2420,twilight sparkle,taneysha
1919254.png,https://derpicdn.net/img/view/2018/12/26/1919254.png,0,0.9990468621253968,121,0,459,318,338,318,twilight sparkle,iloota
1923076.png,https://derpicdn.net/img/view/2018/12/31/1923076.png,0,0.9940406680107116,1013,0,2671,1326,1658,1326,twilight sparkle,awalex
1925307.png,https://derpicdn.net/img/view/2019/1/3/1925307.png,0,0.979692280292511,0,0,642,540,642,540,twilight sparkle,hattsy-nsfw
1925353.png,https://derpicdn.net/img/view/2019/1/3/1925353.png,0,0.9986709356307985,73,0,593,470,520,470,twilight sparkle,colorfulcolor233|deserter
1925353.png,https://derpicdn.net/img/view/2019/1/3/1925353.png,1,0.9971564412117004,706,0,1236,494,530,494,twilight sparkle,colorfulcolor233|deserter
1927313.png,https://derpicdn.net/img/view/2019/1/5/1927313.png,0,0.99793803691864,730,0,1874,1030,1144,1030,twilight sparkle,renokim
1931410.png,https://derpicdn.net/img/view/2019/1/10/1931410.png,0,0.9927753806114196,50,0,2500,2340,2450,2340,twilight sparkle,smoldix
1931596.png,https://derpicdn.net/img/view/2019/1/10/1931596.png,0,0.9656312465667723,679,0,1609,787,930,787,twilight sparkle,kaikururu
1932563.png,https://derpicdn.net/img/view/2019/1/11/1932563.png,0,0.998217225074768,123,0,911,758,788,758,twilight sparkle,pearlyiridescence
1932793.png,https://derpicdn.net/img/view/2019/1/12/1932793.png,0,0.9984569549560548,318,0,716,386,398,386,twilight sparkle,luciferamon
1934007.png,https://derpicdn.net/img/view/2019/1/13/1934007.png,0,0.9014943838119508,19,122,979,1082,960,960,twilight sparkle,kaliner123
1936134.png,https://derpicdn.net/img/view/2019/1/15/1936134.png,0,0.9983052015304564,549,0,2039,1327,1490,1327,twilight sparkle,shad0w-galaxy
1936286.png,https://derpicdn.net/img/view/2019/1/15/1936286.png,0,0.9976925253868104,209,10,745,546,536,536,twilight sparkle,rossignolet
1937145.png,https://derpicdn.net/img/view/2019/1/16/1937145.png,0,0.953692615032196,19,34,1507,1522,1488,1488,twilight sparkle,duop-qoub
1937742.png,https://derpicdn.net/img/view/2019/1/17/1937742.png,1,0.9498679637908936,294,31,1114,851,820,820,twilight sparkle,yakovlev-vad
1940205.png,https://derpicdn.net/img/view/2019/1/20/1940205.png,0,0.9973976612091064,590,116,1918,1444,1328,1328,twilight sparkle,ask-colorsound
1943410.png,https://derpicdn.net/img/view/2019/1/24/1943410.png,0,0.9827665090560912,511,61,1679,1229,1168,1168,twilight sparkle,autumnvoyage
1945167.png,https://derpicdn.net/img/view/2019/1/26/1945167.png,0,0.9457376599311828,2019,0,5915,3525,3896,3525,twilight sparkle,aureai-sketches|cyanlightning
1947877.png,https://derpicdn.net/img/view/2019/1/29/1947877.png,0,0.9943313598632812,56,0,1300,1152,1244,1152,twilight sparkle,saxopi
1949492.png,https://derpicdn.net/img/view/2019/1/31/1949492.png,0,0.998002290725708,73,32,711,670,638,638,twilight sparkle,php97
1951237.png,https://derpicdn.net/img/view/2019/2/2/1951237.png,0,0.9995287656784058,1738,133,2456,851,718,718,twilight sparkle,tatemil
1951237.png,https://derpicdn.net/img/view/2019/2/2/1951237.png,1,0.9990026950836182,656,17,1434,795,778,778,twilight sparkle,tatemil
1951243.png,https://derpicdn.net/img/view/2019/2/2/1951243.png,0,0.9995288848876952,1738,133,2456,851,718,718,twilight sparkle,tatemil
1951243.png,https://derpicdn.net/img/view/2019/2/2/1951243.png,1,0.9990024566650392,656,17,1434,795,778,778,twilight sparkle,tatemil
1952560.png,https://derpicdn.net/img/view/2019/2/3/1952560.png,0,0.9990243315696716,173,24,729,580,556,556,twilight sparkle,elzzombie
1952561.png,https://derpicdn.net/img/view/2019/2/3/1952561.png,0,0.9989643692970276,174,24,728,578,554,554,twilight sparkle,elzzombie
1955213.png,https://derpicdn.net/img/view/2019/2/6/1955213.png,0,0.9867042899131776,306,0,2130,1794,1824,1794,twilight sparkle,hiccupsdoesart
1960514.png,https://derpicdn.net/img/view/2019/2/13/1960514.png,0,0.9743098020553588,145,1182,971,2008,826,826,twilight sparkle,viwrastupr
1962762.png,https://derpicdn.net/img/view/2019/2/15/1962762.png,0,0.9950420260429382,99,53,1149,1103,1050,1050,twilight sparkle,vanillaghosties
1962762.png,https://derpicdn.net/img/view/2019/2/15/1962762.png,1,0.9302697777748108,889,629,1985,1725,1096,1096,twilight sparkle,vanillaghosties
1964657.png,https://derpicdn.net/img/view/2019/2/17/1964657.png,0,0.9152421355247498,308,83,1272,1047,964,964,twilight sparkle,php97
1965360.png,https://derpicdn.net/img/view/2019/2/18/1965360.png,0,0.9266763925552368,302,0,2706,2192,2404,2192,twilight sparkle,adostume
1965767.png,https://derpicdn.net/img/view/2019/2/19/1965767.png,0,0.98370361328125,105,0,741,614,636,614,twilight sparkle,toroitimu
1967572.png,https://derpicdn.net/img/view/2019/2/21/1967572.png,0,0.9925093650817872,289,99,1031,841,742,742,twilight sparkle,pabbley
1969007.png,https://derpicdn.net/img/view/2019/2/22/1969007.png,0,0.9537352919578552,145,54,645,554,500,500,twilight sparkle,kirionek
1969372.png,https://derpicdn.net/img/view/2019/2/23/1969372.png,0,0.9629202485084534,386,0,1026,627,640,627,twilight sparkle,aureai
1970122.png,https://derpicdn.net/img/view/2019/2/24/1970122.png,0,0.9140850305557252,274,67,1012,805,738,738,twilight sparkle,magnaluna
1970973.png,https://derpicdn.net/img/view/2019/2/24/1970973.png,0,0.9170919060707092,886,103,1868,1085,982,982,twilight sparkle,andelai
1971169.png,https://derpicdn.net/img/view/2019/2/25/1971169.png,0,0.9612228274345398,257,0,821,573,564,573,twilight sparkle,puetsua
1971575.png,https://derpicdn.net/img/view/2019/2/25/1971575.png,0,0.9538564682006836,301,0,3625,3307,3324,3307,twilight sparkle,cyanlightning
1974438.png,https://derpicdn.net/img/view/2019/3/1/1974438.png,0,0.9964228868484496,185,0,757,543,572,543,twilight sparkle,pink-pinktooth
1974514.png,https://derpicdn.net/img/view/2019/3/1/1974514.png,0,0.9815956354141236,43,99,793,849,750,750,twilight sparkle,puetsua
1976192.png,https://derpicdn.net/img/view/2019/3/3/1976192.png,0,0.9360467195510864,181,126,495,440,314,314,twilight sparkle,lilfunkman
1976567.png,https://derpicdn.net/img/view/2019/3/3/1976567.png,0,0.9972641468048096,681,731,2831,2881,2150,2150,twilight sparkle,pink1ejack
1978644.png,https://derpicdn.net/img/view/2019/3/6/1978644.png,0,0.988986611366272,232,0,1792,1493,1560,1493,twilight sparkle,vird-gi
1979892.png,https://derpicdn.net/img/view/2019/3/7/1979892.png,0,0.9646013379096984,491,465,1157,1131,666,666,twilight sparkle,roaert
1983143.png,https://derpicdn.net/img/view/2019/3/11/1983143.png,0,0.993951141834259,832,62,2242,1472,1410,1410,twilight sparkle,ziemniax
1986144.png,https://derpicdn.net/img/view/2019/3/15/1986144.png,0,0.9049394130706788,196,0,574,368,378,368,twilight sparkle,joenobody
1986580.png,https://derpicdn.net/img/view/2019/3/16/1986580.png,0,0.9962331056594848,1332,14,2728,1410,1396,1396,twilight sparkle,greyscaleart
1989972.png,https://derpicdn.net/img/view/2019/3/19/1989972.png,0,0.9954631328582764,857,0,1941,1064,1084,1064,twilight sparkle,nana-yuka
1990218.png,https://derpicdn.net/img/view/2019/3/19/1990218.png,0,0.986832559108734,172,0,628,428,456,428,twilight sparkle,sunibee
1992024.png,https://derpicdn.net/img/view/2019/3/22/1992024.png,0,0.9967516660690308,49,14,399,364,350,350,twilight sparkle,hoodie
1992024.png,https://derpicdn.net/img/view/2019/3/22/1992024.png,1,0.9964399933815002,376,11,752,387,376,376,twilight sparkle,hoodie
1992963.png,https://derpicdn.net/img/view/2019/3/23/1992963.png,0,0.9203037619590759,0,75,1036,1257,1036,1182,twilight sparkle,tomness
1993749.png,https://derpicdn.net/img/view/2019/3/24/1993749.png,0,0.9382694959640504,1478,716,2736,1974,1258,1258,twilight sparkle,yinglongfujun
1995100.png,https://derpicdn.net/img/view/2019/3/26/1995100.png,0,0.97977614402771,65,0,517,376,452,376,twilight sparkle,
1997990.png,https://derpicdn.net/img/view/2019/3/30/1997990.png,0,0.9833942651748656,47,0,4201,3777,4154,3777,twilight sparkle,cyanlightning|aureai-sketches
1998855.png,https://derpicdn.net/img/view/2019/3/31/1998855.png,0,0.9782894849777222,2480,309,3238,1067,758,758,twilight sparkle,secretgoombaman12345
1999268.png,https://derpicdn.net/img/view/2019/3/31/1999268.png,0,0.9464521408081056,417,86,877,546,460,460,twilight sparkle,discordthege
1999268.png,https://derpicdn.net/img/view/2019/3/31/1999268.png,1,0.9448803067207336,781,21,1263,503,482,482,twilight sparkle,discordthege
2003213.png,https://derpicdn.net/img/view/2019/4/5/2003213.png,0,0.9503982067108154,166,0,432,244,266,244,twilight sparkle,longtailshort
2003286.png,https://derpicdn.net/img/view/2019/4/5/2003286.png,0,0.927784264087677,384,459,1510,1585,1126,1126,twilight sparkle,ifmsoul
2009124.png,https://derpicdn.net/img/view/2019/4/11/2009124.png,0,0.9273999929428101,495,459,3385,3349,2890,2890,twilight sparkle,maneingreen
2009866.png,https://derpicdn.net/img/view/2019/4/12/2009866.png,0,0.9672397375106812,822,1218,1472,1868,650,650,twilight sparkle,tingsan
2010224.png,https://derpicdn.net/img/view/2019/4/12/2010224.png,0,0.9291574358940125,0,0,1000,1000,1000,1000,twilight sparkle,puetsua
2010699.png,https://derpicdn.net/img/view/2019/4/13/2010699.png,0,0.9767950177192688,0,0,2327,2348,2327,2348,twilight sparkle,arcane-thunder
20146.jpg,https://derpicdn.net/img/view/2012/6/25/20146.jpg,0,0.9894649982452391,122,97,378,353,256,256,twilight sparkle,don-ko
2015014.png,https://derpicdn.net/img/view/2019/4/17/2015014.png,0,0.9776073098182678,0,193,821,1087,821,894,twilight sparkle,iridescentadopt
2015134.png,https://derpicdn.net/img/view/2019/4/17/2015134.png,0,0.9357569217681884,0,72,625,708,625,636,twilight sparkle,shydale
2015173.png,https://derpicdn.net/img/view/2019/4/17/2015173.png,0,0.9866560101509094,582,170,1514,1102,932,932,twilight sparkle,basilloon
2015325.png,https://derpicdn.net/img/view/2019/4/17/2015325.png,0,0.9899328351020812,0,0,604,615,604,615,twilight sparkle,puetsua
2015499.png,https://derpicdn.net/img/view/2019/4/18/2015499.png,0,0.9982083439826964,30,0,604,553,574,553,twilight sparkle,pekou
2016569.png,https://derpicdn.net/img/view/2019/4/19/2016569.png,0,0.9756274223327636,24,0,474,407,450,407,twilight sparkle,crystalmagic6|liaaqila
2022362.png,https://derpicdn.net/img/view/2019/4/25/2022362.png,0,0.9989221096038818,49,35,605,591,556,556,twilight sparkle,ratofdrawn
2022362.png,https://derpicdn.net/img/view/2019/4/25/2022362.png,1,0.9856277108192444,602,40,1112,550,510,510,twilight sparkle,ratofdrawn
2022920.png,https://derpicdn.net/img/view/2019/4/25/2022920.png,0,0.9987317323684692,497,0,1089,544,592,544,twilight sparkle,deraniel
2023289.png,https://derpicdn.net/img/view/2019/4/26/2023289.png,0,0.9511927962303162,1179,124,1987,932,808,808,twilight sparkle,setharu
2023663.png,https://derpicdn.net/img/view/2019/4/26/2023663.png,0,0.9575314521789552,183,281,2265,2363,2082,2082,twilight sparkle,selenophile
2028045.png,https://derpicdn.net/img/view/2019/5/1/2028045.png,0,0.930691421031952,104,499,414,809,310,310,twilight sparkle,hioshiru
2028287.png,https://derpicdn.net/img/view/2019/5/1/2028287.png,0,0.984165370464325,366,0,1306,898,940,898,twilight sparkle,luxrayss|leche
202840.png,https://derpicdn.net/img/view/2013/1/5/202840.png,0,0.9929540753364564,0,608,269,898,269,290,twilight sparkle,trollie trollenberg
202840.png,https://derpicdn.net/img/view/2013/1/5/202840.png,1,0.9861260652542114,258,0,756,453,498,453,twilight sparkle,trollie trollenberg
2028803.png,https://derpicdn.net/img/view/2019/5/2/2028803.png,0,0.995447039604187,557,0,1017,443,460,443,twilight sparkle,hitbass
2032024.png,https://derpicdn.net/img/view/2019/5/6/2032024.png,0,0.9952211976051332,750,42,1914,1206,1164,1164,twilight sparkle,pabbley
2033633.png,https://derpicdn.net/img/view/2019/5/8/2033633.png,0,0.9988946914672852,137,0,795,627,658,627,twilight sparkle,mega-bugsly|incubugs
2033633.png,https://derpicdn.net/img/view/2019/5/8/2033633.png,1,0.9908053874969482,769,0,1554,754,785,754,twilight sparkle,mega-bugsly|incubugs
2033869.png,https://derpicdn.net/img/view/2019/5/8/2033869.png,0,0.9155360460281372,197,0,2480,2321,2283,2321,twilight sparkle,underpable
2040318.png,https://derpicdn.net/img/view/2019/5/16/2040318.png,0,0.9614962339401244,91,0,573,475,482,475,twilight sparkle,snow angel
2044040.png,https://derpicdn.net/img/view/2019/5/20/2044040.png,0,0.989440381526947,0,3,1926,1983,1926,1980,twilight sparkle,xsatanielx
2044966.png,https://derpicdn.net/img/view/2019/5/21/2044966.png,0,0.9958605766296388,152,0,706,546,554,546,twilight sparkle,jacky-bunny
2045646.png,https://derpicdn.net/img/view/2019/5/22/2045646.png,0,0.9778518676757812,185,0,1413,1146,1228,1146,twilight sparkle,katputze
2047798.png,https://derpicdn.net/img/view/2019/5/24/2047798.png,0,0.9250726699829102,67,60,1200,1252,1133,1192,twilight sparkle,yakovlev-vad
2051925.png,https://derpicdn.net/img/view/2019/5/28/2051925.png,0,0.9847534894943236,1104,0,1832,705,728,705,twilight sparkle,loveslove
2059226.png,https://derpicdn.net/img/view/2019/6/6/2059226.png,0,0.9717827439308168,522,224,1898,1600,1376,1376,twilight sparkle,empress-twilight
2059660.png,https://derpicdn.net/img/view/2019/6/7/2059660.png,0,0.9987142086029052,1022,375,1654,1007,632,632,twilight sparkle,empress-twilight
2062245.png,https://derpicdn.net/img/view/2019/6/10/2062245.png,0,0.9975168108940125,586,647,1016,1077,430,430,twilight sparkle,king-kakapo
2062245.png,https://derpicdn.net/img/view/2019/6/10/2062245.png,2,0.993036687374115,1002,651,1332,981,330,330,twilight sparkle,king-kakapo
2062245.png,https://derpicdn.net/img/view/2019/6/10/2062245.png,3,0.9549527168273926,1529,204,1893,568,364,364,twilight sparkle,king-kakapo
2062245.png,https://derpicdn.net/img/view/2019/6/10/2062245.png,4,0.9429376125335692,500,212,820,532,320,320,twilight sparkle,king-kakapo
2065918.png,https://derpicdn.net/img/view/2019/6/15/2065918.png,0,0.9716030955314636,370,18,1152,800,782,782,twilight sparkle,mirroredsea
2066857.png,https://derpicdn.net/img/view/2019/6/16/2066857.png,0,0.9848089218139648,164,0,1368,1144,1204,1144,twilight sparkle,vird-gi
2068626.png,https://derpicdn.net/img/view/2019/6/18/2068626.png,1,0.927333414554596,0,2672,946,3618,946,946,twilight sparkle,chango-tan
2068629.png,https://derpicdn.net/img/view/2019/6/18/2068629.png,1,0.9323158860206604,0,2542,1012,3612,1012,1070,twilight sparkle,chango-tan
2072128.png,https://derpicdn.net/img/view/2019/6/22/2072128.png,0,0.9994648694992064,347,0,795,426,448,426,twilight sparkle,joenobody
2073204.png,https://derpicdn.net/img/view/2019/6/23/2073204.png,0,0.9890331029891968,53,161,361,469,308,308,twilight sparkle,xjenn9
2073207.png,https://derpicdn.net/img/view/2019/6/23/2073207.png,0,0.9869273900985718,53,161,361,469,308,308,twilight sparkle,xjenn9
2076652.png,https://derpicdn.net/img/view/2019/6/27/2076652.png,0,0.9745996594429016,172,0,1262,820,1090,820,twilight sparkle,topicranger
2076707.png,https://derpicdn.net/img/view/2019/6/27/2076707.png,0,0.9917093515396118,190,0,756,541,566,541,twilight sparkle,dvixie
2077225.png,https://derpicdn.net/img/view/2019/6/28/2077225.png,0,0.9890036582946776,662,5,1060,403,398,398,twilight sparkle,howxu
2083572.png,https://derpicdn.net/img/view/2019/7/5/2083572.png,0,0.9760470986366272,211,0,873,624,662,624,twilight sparkle,770nanao15
2084785.png,https://derpicdn.net/img/view/2019/7/6/2084785.png,0,0.9882689118385316,965,0,2500,1394,1535,1394,twilight sparkle,taneysha
2084792.png,https://derpicdn.net/img/view/2019/7/6/2084792.png,0,0.9730550050735474,921,0,2632,1628,1711,1628,twilight sparkle,taneysha
2085639.png,https://derpicdn.net/img/view/2019/7/7/2085639.png,0,0.9390837550163268,296,134,2200,2038,1904,1904,twilight sparkle,graphene
2086382.png,https://derpicdn.net/img/view/2019/7/8/2086382.png,0,0.9725821614265442,676,60,1896,1280,1220,1220,twilight sparkle,huckser
2087665.png,https://derpicdn.net/img/view/2019/7/10/2087665.png,0,0.9603896737098694,785,26,1343,584,558,558,twilight sparkle,sunibee
2089246.png,https://derpicdn.net/img/view/2019/7/11/2089246.png,0,0.9350571632385254,0,0,1084,1052,1084,1052,twilight sparkle,duop-qoub
2089447.png,https://derpicdn.net/img/view/2019/7/12/2089447.png,0,0.9966104030609132,54,65,410,421,356,356,twilight sparkle,andelai
2089447.png,https://derpicdn.net/img/view/2019/7/12/2089447.png,1,0.9901277422904968,404,0,834,425,430,425,twilight sparkle,andelai
2090284.png,https://derpicdn.net/img/view/2019/7/13/2090284.png,0,0.9995922446250916,420,13,926,519,506,506,twilight sparkle,king-kakapo
2090929.png,https://derpicdn.net/img/view/2019/7/13/2090929.png,0,0.9965426325798036,53,0,631,575,578,575,twilight sparkle,sunibee
2090929.png,https://derpicdn.net/img/view/2019/7/13/2090929.png,1,0.9939934611320496,655,27,1171,543,516,516,twilight sparkle,sunibee
20910.png,https://derpicdn.net/img/view/2012/6/25/20910.png,0,0.992993712425232,18,0,314,289,296,289,twilight sparkle,brianblackberry
2092648.png,https://derpicdn.net/img/view/2019/7/15/2092648.png,0,0.9847053289413452,652,1,1368,717,716,716,twilight sparkle,light262
2093271.png,https://derpicdn.net/img/view/2019/7/16/2093271.png,0,0.953878939151764,363,65,1069,771,706,706,twilight sparkle,kingjnar
2093272.png,https://derpicdn.net/img/view/2019/7/16/2093272.png,0,0.9065404534339904,458,109,1068,719,610,610,twilight sparkle,kingjnar
2094913.png,https://derpicdn.net/img/view/2019/7/18/2094913.png,0,0.9839509129524232,0,0,719,649,719,649,twilight sparkle,duop-qoub
2095789.png,https://derpicdn.net/img/view/2019/7/19/2095789.png,0,0.9906347393989564,167,17,519,369,352,352,twilight sparkle,silfoe|vasillium
2099061.png,https://derpicdn.net/img/view/2019/7/23/2099061.png,0,0.9191415309906006,396,0,820,421,424,421,twilight sparkle,flutterthrash
2099460.png,https://derpicdn.net/img/view/2019/7/23/2099460.png,0,0.9935710430145264,175,52,727,604,552,552,twilight sparkle,casualcolt
2105841.png,https://derpicdn.net/img/view/2019/7/31/2105841.png,0,0.9480186104774476,533,0,2439,1828,1906,1828,twilight sparkle,underpable
2106248.png,https://derpicdn.net/img/view/2019/8/1/2106248.png,0,0.9560375809669496,34,1,1200,1261,1166,1260,twilight sparkle,yakovlev-vad
2108941.png,https://derpicdn.net/img/view/2019/8/4/2108941.png,0,0.9661136865615844,1009,216,1685,892,676,676,twilight sparkle,yakovlev-vad
2112920.png,https://derpicdn.net/img/view/2019/8/9/2112920.png,0,0.9898269176483154,317,43,5293,4961,4976,4918,twilight sparkle,freeedon
2113120.png,https://derpicdn.net/img/view/2019/8/9/2113120.png,0,0.9439823627471924,821,159,1601,939,780,780,twilight sparkle,php97
2114111.png,https://derpicdn.net/img/view/2019/8/10/2114111.png,0,0.9893319010734558,474,448,966,940,492,492,twilight sparkle,yakovlev-vad
2114440.png,https://derpicdn.net/img/view/2019/8/10/2114440.png,0,0.9998152852058412,473,14,783,324,310,310,twilight sparkle,pinkkoffin
2114881.png,https://derpicdn.net/img/view/2019/8/11/2114881.png,0,0.9993472695350648,54,0,716,644,662,644,twilight sparkle,kinnachan456
2115427.png,https://derpicdn.net/img/view/2019/8/11/2115427.png,0,0.9870520234107972,141,1,573,433,432,432,twilight sparkle,hitbass
2117140.png,https://derpicdn.net/img/view/2019/8/13/2117140.png,0,0.9313555359840392,288,0,1112,802,824,802,twilight sparkle,marsminer
2119748.png,https://derpicdn.net/img/view/2019/8/16/2119748.png,0,0.988815188407898,459,0,2127,1702,1668,1702,twilight sparkle,danli69
2121093.png,https://derpicdn.net/img/view/2019/8/18/2121093.png,0,0.9904218912124634,0,8,613,680,613,672,twilight sparkle,assasinmonkey
2121655.png,https://derpicdn.net/img/view/2019/8/18/2121655.png,0,0.9427506923675536,251,0,1297,981,1046,981,twilight sparkle,kimmyartmlp
2121799.png,https://derpicdn.net/img/view/2019/8/18/2121799.png,0,0.9914581775665284,886,0,1198,262,312,262,twilight sparkle,pia-sama
2124706.png,https://derpicdn.net/img/view/2019/8/22/2124706.png,0,0.9831400513648988,0,0,631,622,631,622,twilight sparkle,ncmares
2125069.png,https://derpicdn.net/img/view/2019/8/23/2125069.png,0,0.997719407081604,91,41,451,401,360,360,twilight sparkle,twistedcarrot
2126851.png,https://derpicdn.net/img/view/2019/8/25/2126851.png,0,0.9946312904357908,101,0,817,694,716,694,twilight sparkle,silentwolf-oficial
2129364.png,https://derpicdn.net/img/view/2019/8/27/2129364.png,0,0.9674226641654968,103,0,935,816,832,816,twilight sparkle,sugar morning
2130211.png,https://derpicdn.net/img/view/2019/8/28/2130211.png,0,0.999713122844696,921,1781,2343,3203,1422,1422,twilight sparkle,witchtaunter
2133443.png,https://derpicdn.net/img/view/2019/9/1/2133443.png,0,0.9426307082176208,279,85,709,515,430,430,twilight sparkle,ladychimaera
2134715.png,https://derpicdn.net/img/view/2019/9/2/2134715.png,0,0.9919304251670836,357,0,673,294,316,294,twilight sparkle,hioshiru
2137097.png,https://derpicdn.net/img/view/2019/9/5/2137097.png,0,0.9994998574256896,0,0,378,353,378,353,twilight sparkle,tf-sential
2137198.png,https://derpicdn.net/img/view/2019/9/5/2137198.png,0,0.9990450143814088,685,148,1485,948,800,800,twilight sparkle,magnalunansfw|magnaluna
2139913.png,https://derpicdn.net/img/view/2019/9/9/2139913.png,0,0.9993633031845092,160,48,1296,1184,1136,1136,twilight sparkle,modularpon|themodpony
2140403.png,https://derpicdn.net/img/view/2019/9/9/2140403.png,0,0.9989519119262696,1474,0,3184,1623,1710,1623,twilight sparkle,celsian
2141305.png,https://derpicdn.net/img/view/2019/9/11/2141305.png,0,0.9787726402282716,23,20,299,296,276,276,twilight sparkle,
2141436.png,https://derpicdn.net/img/view/2019/9/11/2141436.png,0,0.9090819358825684,1167,0,4763,3508,3596,3508,twilight sparkle,cyanlightning
2141787.png,https://derpicdn.net/img/view/2019/9/11/2141787.png,0,0.9952508211135864,377,0,991,526,614,526,twilight sparkle,twistedscarlett60
2141788.png,https://derpicdn.net/img/view/2019/9/11/2141788.png,0,0.9989321231842041,387,0,977,513,590,513,twilight sparkle,twistedscarlett60
2145039.png,https://derpicdn.net/img/view/2019/9/15/2145039.png,0,0.9675487875938416,0,0,1416,974,1416,974,twilight sparkle,artiks
2145045.png,https://derpicdn.net/img/view/2019/9/15/2145045.png,0,0.9370031952857972,868,88,1402,622,534,534,twilight sparkle,hentaired
2147673.png,https://derpicdn.net/img/view/2019/9/19/2147673.png,0,0.9937658905982972,99,0,865,760,766,760,twilight sparkle,threetwotwo32232
2147831.png,https://derpicdn.net/img/view/2019/9/19/2147831.png,0,0.9950974583625792,44,0,1938,1694,1894,1694,twilight sparkle,heavymetalbronyyeah
2152067.png,https://derpicdn.net/img/view/2019/9/24/2152067.png,0,0.9545883536338806,2577,280,5285,2988,2708,2708,twilight sparkle,starbolt-81
2156763.png,https://derpicdn.net/img/view/2019/9/30/2156763.png,0,0.9975119233131408,20,0,258,232,238,232,twilight sparkle,dvixie
2158107.png,https://derpicdn.net/img/view/2019/10/2/2158107.png,0,0.9905837178230286,151,0,957,749,806,749,twilight sparkle,evehly
2160817.png,https://derpicdn.net/img/view/2019/10/5/2160817.png,0,0.9448373913764954,499,157,1669,1327,1170,1170,twilight sparkle,detectiveneko
216533.png,https://derpicdn.net/img/view/2013/1/18/216533.png,0,0.9954495429992676,1382,128,2354,1100,972,972,twilight sparkle,danmakuman
2165574.png,https://derpicdn.net/img/view/2019/10/11/2165574.png,0,0.9936109185218812,0,0,1133,1097,1133,1097,twilight sparkle,mirroredsea
2166130.png,https://derpicdn.net/img/view/2019/10/12/2166130.png,0,0.9842168688774108,66,0,666,534,600,534,twilight sparkle,thefloatingtree
2167980.png,https://derpicdn.net/img/view/2019/10/13/2167980.png,0,0.9374785423278807,547,395,825,673,278,278,twilight sparkle,motger-mor
2168637.png,https://derpicdn.net/img/view/2019/10/14/2168637.png,0,0.9349204301834106,75,49,1029,1003,954,954,twilight sparkle,tohupo
2168836.png,https://derpicdn.net/img/view/2019/10/14/2168836.png,0,0.951671063899994,136,7,800,671,664,664,twilight sparkle,anthroponiessfm
2170028.png,https://derpicdn.net/img/view/2019/10/15/2170028.png,0,0.9841083884239196,1036,0,2798,1755,1762,1755,twilight sparkle,celsian
2170273.png,https://derpicdn.net/img/view/2019/10/16/2170273.png,0,0.9780193567276,891,404,2419,1932,1528,1528,twilight sparkle,ljdamz1119
2174873.png,https://derpicdn.net/img/view/2019/10/20/2174873.png,0,0.9706586003303528,895,203,1577,885,682,682,twilight sparkle,andelai
2175730.png,https://derpicdn.net/img/view/2019/10/21/2175730.png,0,0.938724398612976,387,33,879,525,492,492,twilight sparkle,discordthege
2176290.png,https://derpicdn.net/img/view/2019/10/22/2176290.png,0,0.9107921719551086,322,0,2860,2473,2538,2473,twilight sparkle,shad0w-galaxy
2177976.png,https://derpicdn.net/img/view/2019/10/24/2177976.png,0,0.937772274017334,228,0,2550,2464,2322,2464,twilight sparkle,skoon
2178379.png,https://derpicdn.net/img/view/2019/10/25/2178379.png,0,0.9828281998634338,654,0,1575,1024,921,1024,twilight sparkle,gluemakers
2182006.png,https://derpicdn.net/img/view/2019/10/29/2182006.png,0,0.996025025844574,347,0,981,609,634,609,twilight sparkle,pabbley
2183261.png,https://derpicdn.net/img/view/2019/10/30/2183261.png,0,0.9000059962272644,669,70,2137,1538,1468,1468,twilight sparkle,andelai
2185605.png,https://derpicdn.net/img/view/2019/11/2/2185605.png,0,0.9913559556007384,129,15,305,191,176,176,twilight sparkle,pabbley
2186404.png,https://derpicdn.net/img/view/2019/11/3/2186404.png,0,0.9790951013565063,4,52,708,756,704,704,twilight sparkle,assasinmonkey
2186536.png,https://derpicdn.net/img/view/2019/11/3/2186536.png,0,0.9964568614959716,136,61,1010,935,874,874,twilight sparkle,lonelycross
2188292.png,https://derpicdn.net/img/view/2019/11/5/2188292.png,0,0.9989973306655884,283,10,609,336,326,326,twilight sparkle,longtailshort
218897.png,https://derpicdn.net/img/view/2013/1/20/218897.png,0,0.9517486095428468,145,595,981,1431,836,836,twilight sparkle,feli
2189332.png,https://derpicdn.net/img/view/2019/11/7/2189332.png,0,0.9143214225769044,0,0,1277,1318,1277,1318,twilight sparkle,aer0 zer0
2191348.png,https://derpicdn.net/img/view/2019/11/9/2191348.png,0,0.9733481407165528,847,270,1838,1298,991,1028,twilight sparkle,lrusu
2191845.png,https://derpicdn.net/img/view/2019/11/10/2191845.png,0,0.9983891844749452,783,147,1515,879,732,732,twilight sparkle,thebrokencog
2197725.png,https://derpicdn.net/img/view/2019/11/16/2197725.png,0,0.9957079887390136,84,0,1692,1575,1608,1575,twilight sparkle,luciferamon
2199021.png,https://derpicdn.net/img/view/2019/11/17/2199021.png,0,0.993825376033783,638,0,1282,544,644,544,twilight sparkle,inuhoshi-to-darkpen
2199021.png,https://derpicdn.net/img/view/2019/11/17/2199021.png,1,0.9686035513877868,203,453,659,909,456,456,twilight sparkle,inuhoshi-to-darkpen
2200721.png,https://derpicdn.net/img/view/2019/11/20/2200721.png,0,0.9789268970489502,827,174,3000,2706,2173,2532,twilight sparkle,annakitsun3
2201435.png,https://derpicdn.net/img/view/2019/11/21/2201435.png,0,0.97480970621109,326,0,1080,881,754,881,twilight sparkle,xenia-amata|nyxie-nsfw
2204522.png,https://derpicdn.net/img/view/2019/11/24/2204522.png,0,0.9951099753379822,73,0,399,291,326,291,twilight sparkle,d.w.h.cn
2205348.png,https://derpicdn.net/img/view/2019/11/25/2205348.png,0,0.9914976358413696,225,0,637,379,412,379,twilight sparkle,chaosangeldesu
2207303.png,https://derpicdn.net/img/view/2019/11/27/2207303.png,0,0.9695277810096741,285,99,989,803,704,704,twilight sparkle,magnaluna
2210106.png,https://derpicdn.net/img/view/2019/12/1/2210106.png,0,0.9940809607505798,952,105,1682,835,730,730,twilight sparkle,tsitra360
2210650.png,https://derpicdn.net/img/view/2019/12/2/2210650.png,0,0.9940445423126221,1596,881,2304,1589,708,708,twilight sparkle,yinglongfujun
2210650.png,https://derpicdn.net/img/view/2019/12/2/2210650.png,1,0.9820474982261658,526,23,1716,1213,1190,1190,twilight sparkle,yinglongfujun
2210823.png,https://derpicdn.net/img/view/2019/12/2/2210823.png,0,0.9947488903999328,97,0,1139,945,1042,945,twilight sparkle,avrameow
2211657.png,https://derpicdn.net/img/view/2019/12/3/2211657.png,0,0.9940819144248962,555,132,1449,1026,894,894,twilight sparkle,wolfythewolf555
2213227.png,https://derpicdn.net/img/view/2019/12/5/2213227.png,0,0.9399351477622986,325,0,2027,1700,1702,1700,twilight sparkle,danmakuman
2216038.png,https://derpicdn.net/img/view/2019/12/8/2216038.png,0,0.953350305557251,318,0,1248,741,930,741,twilight sparkle,hierozaki
2216184.png,https://derpicdn.net/img/view/2019/12/8/2216184.png,0,0.9818413257598876,327,0,991,656,664,656,twilight sparkle,toroitimu
2216185.png,https://derpicdn.net/img/view/2019/12/8/2216185.png,0,0.996553122997284,602,172,1042,612,440,440,twilight sparkle,toroitimu
2217071.png,https://derpicdn.net/img/view/2019/12/10/2217071.png,0,0.995513081550598,353,43,1127,817,774,774,twilight sparkle,meotashie
2217378.png,https://derpicdn.net/img/view/2019/12/10/2217378.png,0,0.9851309657096864,75,23,367,315,292,292,twilight sparkle,twistedcarrot
2217410.png,https://derpicdn.net/img/view/2019/12/10/2217410.png,0,0.9980986714363098,318,0,1280,837,962,837,twilight sparkle,reterica
2217737.png,https://derpicdn.net/img/view/2019/12/10/2217737.png,0,0.9498096704483032,257,33,793,595,536,562,twilight sparkle,jargon scott
2221270.png,https://derpicdn.net/img/view/2019/12/15/2221270.png,0,0.926725208759308,717,740,1537,1560,820,820,twilight sparkle,miokomata
2221461.png,https://derpicdn.net/img/view/2019/12/15/2221461.png,0,0.9616819024086,201,0,511,305,310,305,twilight sparkle,ipun
2223504.png,https://derpicdn.net/img/view/2019/12/18/2223504.png,0,0.968066155910492,379,260,1851,1732,1472,1472,twilight sparkle,light-of-inirida
2225583.png,https://derpicdn.net/img/view/2019/12/21/2225583.png,0,0.9629029631614684,496,53,1300,857,804,804,twilight sparkle,vito
2226113.png,https://derpicdn.net/img/view/2019/12/21/2226113.png,0,0.9391627311706544,0,0,2005,1798,2005,1798,twilight sparkle,underpable
2226167.png,https://derpicdn.net/img/view/2019/12/21/2226167.png,0,0.9900091886520386,2018,583,2730,1295,712,712,twilight sparkle,underpable
2226880.png,https://derpicdn.net/img/view/2019/12/22/2226880.png,0,0.9953271150588988,1720,161,2912,1353,1192,1192,twilight sparkle,wenni
2227028.png,https://derpicdn.net/img/view/2019/12/22/2227028.png,0,0.9330631494522096,751,0,3165,1921,2414,1921,twilight sparkle,cloud-drawings
2228439.jpg,https://derpicdn.net/img/view/2019/12/24/2228439.jpg,0,0.9288588166236876,614,0,1984,1125,1370,1125,twilight sparkle,fidzfox
2228440.jpg,https://derpicdn.net/img/view/2019/12/24/2228440.jpg,0,0.9987475275993348,382,0,1084,658,702,658,twilight sparkle,fidzfox
2228845.png,https://derpicdn.net/img/view/2019/12/24/2228845.png,0,0.9997882246971128,660,56,1908,1304,1248,1248,twilight sparkle,yutakira92
2230649.png,https://derpicdn.net/img/view/2019/12/26/2230649.png,0,0.9879865050315856,0,0,1328,1331,1328,1331,twilight sparkle,vird-gi
2234959.png,https://derpicdn.net/img/view/2019/12/31/2234959.png,0,0.9978160262107848,903,177,2283,1557,1380,1380,twilight sparkle,paskanaakka
2234959.png,https://derpicdn.net/img/view/2019/12/31/2234959.png,1,0.9807652235031128,0,2007,1944,4083,1944,2076,twilight sparkle,paskanaakka
2237187.jpg,https://derpicdn.net/img/view/2020/1/3/2237187.jpg,0,0.9579508304595948,61,162,1073,1174,1012,1012,twilight sparkle,themodpony|modularpon
2238329.png,https://derpicdn.net/img/view/2020/1/4/2238329.png,0,0.9959960579872132,32,13,594,575,562,562,twilight sparkle,ch-chau
2239240.png,https://derpicdn.net/img/view/2020/1/5/2239240.png,0,0.9996924996376038,840,0,1560,711,720,711,twilight sparkle,siggie740
2239767.png,https://derpicdn.net/img/view/2020/1/5/2239767.png,0,0.9916353821754456,484,263,806,585,322,322,twilight sparkle,smg11-on-ddjrb
2241700.png,https://derpicdn.net/img/view/2020/1/8/2241700.png,0,0.9519441723823548,2105,0,3861,1695,1756,1695,twilight sparkle,dawnfire
2243607.png,https://derpicdn.net/img/view/2020/1/10/2243607.png,0,0.9788132905960084,64,0,632,553,568,553,twilight sparkle,ch-chau
2245381.png,https://derpicdn.net/img/view/2020/1/12/2245381.png,0,0.9956702589988708,195,0,1151,895,956,895,twilight sparkle,avrameow
2245572.png,https://derpicdn.net/img/view/2020/1/12/2245572.png,0,0.9546777606010436,1995,54,4250,2372,2255,2318,twilight sparkle,cencerberon
2245759.jpg,https://derpicdn.net/img/view/2020/1/12/2245759.jpg,0,0.9854986071586608,41,0,1185,1060,1144,1060,twilight sparkle,reterica
2247245.png,https://derpicdn.net/img/view/2020/1/14/2247245.png,0,0.9987879991531372,811,1103,1713,2005,902,902,twilight sparkle,saturdaymorningproj
2252552.png,https://derpicdn.net/img/view/2020/1/20/2252552.png,0,0.9848535656929016,71,0,957,866,886,866,twilight sparkle,anthroponiessfm
2254423.jpg,https://derpicdn.net/img/view/2020/1/23/2254423.jpg,0,0.9988096356391908,0,8,566,584,566,576,twilight sparkle,ch-chau
2254966.png,https://derpicdn.net/img/view/2020/1/23/2254966.png,0,0.9787121415138244,376,0,764,369,388,369,twilight sparkle,anthroponiessfm
2254967.png,https://derpicdn.net/img/view/2020/1/23/2254967.png,0,0.9787121415138244,376,0,764,369,388,369,twilight sparkle,anthroponiessfm
2255275.jpg,https://derpicdn.net/img/view/2020/1/24/2255275.jpg,0,0.9704310894012452,47,0,889,820,842,820,twilight sparkle,tjpones
2256115.jpg,https://derpicdn.net/img/view/2020/1/25/2256115.jpg,0,0.9967440366744996,449,386,785,722,336,336,twilight sparkle,lilfunkman
2257348.jpg,https://derpicdn.net/img/view/2020/1/26/2257348.jpg,0,0.9979308843612672,295,28,987,720,692,692,twilight sparkle,princesslunka10
2257913.png,https://derpicdn.net/img/view/2020/1/26/2257913.png,0,0.958556056022644,279,0,583,259,304,259,twilight sparkle,jargon scott
2259891.png,https://derpicdn.net/img/view/2020/1/29/2259891.png,0,0.9003586173057556,188,232,588,632,400,400,twilight sparkle,jargon scott
2260838.jpg,https://derpicdn.net/img/view/2020/1/30/2260838.jpg,0,0.9982420802116394,19,0,673,536,654,536,twilight sparkle,shibaroll
2261645.jpg,https://derpicdn.net/img/view/2020/1/31/2261645.jpg,1,0.9489327073097228,222,1072,1386,2236,1164,1164,twilight sparkle,harwick
2262200.png,https://derpicdn.net/img/view/2020/1/31/2262200.png,0,0.9984645843505859,1091,0,2429,1300,1338,1300,twilight sparkle,share dast
2264032.png,https://derpicdn.net/img/view/2020/2/2/2264032.png,0,0.9987178444862366,519,51,1053,585,534,534,twilight sparkle,kayav_art
2264365.jpg,https://derpicdn.net/img/view/2020/2/3/2264365.jpg,0,0.9950684309005736,295,536,921,1162,626,626,twilight sparkle,joakaha
2264557.jpg,https://derpicdn.net/img/view/2020/2/3/2264557.jpg,0,0.9942421317100524,395,53,819,477,424,424,twilight sparkle,lollipony
2264813.jpg,https://derpicdn.net/img/view/2020/2/3/2264813.jpg,0,0.9703734517097472,1251,885,2583,2217,1332,1332,twilight sparkle,anticular
2265380.png,https://derpicdn.net/img/view/2020/2/4/2265380.png,0,0.9723259806632996,42,6,1000,1164,958,1158,twilight sparkle,loyaldis
2265733.png,https://derpicdn.net/img/view/2020/2/4/2265733.png,0,0.9545162320137024,309,0,1861,1516,1552,1516,twilight sparkle,empress-twilight
2265913.png,https://derpicdn.net/img/view/2020/2/4/2265913.png,0,0.9088585376739502,130,0,912,718,782,718,twilight sparkle,vird-gi
2266697.jpg,https://derpicdn.net/img/view/2020/2/5/2266697.jpg,0,0.9161307215690612,21,64,645,688,624,624,twilight sparkle,joakaha
2267526.png,https://derpicdn.net/img/view/2020/2/7/2267526.png,0,0.9823890924453736,423,123,1161,861,738,738,twilight sparkle,andelai
2267948.jpg,https://derpicdn.net/img/view/2020/2/7/2267948.jpg,0,0.9370789527893066,318,42,1378,1102,1060,1060,twilight sparkle,traupa
2268093.jpg,https://derpicdn.net/img/view/2020/2/7/2268093.jpg,0,0.9906607270240784,315,75,1077,837,762,762,twilight sparkle,limebreaker
2268474.jpg,https://derpicdn.net/img/view/2020/2/8/2268474.jpg,0,0.9779619574546814,468,214,984,730,516,516,twilight sparkle,shore2020
2269843.png,https://derpicdn.net/img/view/2020/2/9/2269843.png,0,0.95405113697052,895,197,1637,939,742,742,twilight sparkle,tjpones|adequality
2269844.png,https://derpicdn.net/img/view/2020/2/9/2269844.png,0,0.9828550219535828,576,0,1424,844,848,844,twilight sparkle,melloncollie-chan
2270756.png,https://derpicdn.net/img/view/2020/2/10/2270756.png,0,0.999267578125,115,0,679,534,564,534,twilight sparkle,iloota
2271553.png,https://derpicdn.net/img/view/2020/2/11/2271553.png,0,0.99635910987854,633,114,1071,552,438,438,twilight sparkle,tklninja
2271668.png,https://derpicdn.net/img/view/2020/2/11/2271668.png,0,0.9057542085647584,37,7,425,395,388,388,twilight sparkle,pencils
2272815.png,https://derpicdn.net/img/view/2020/2/13/2272815.png,0,0.9617609977722168,188,0,558,347,370,347,twilight sparkle,furdynamo
2274009.jpg,https://derpicdn.net/img/view/2020/2/14/2274009.jpg,0,0.9591533541679382,113,142,627,656,514,514,twilight sparkle,nekosnicker
227505.png,https://derpicdn.net/img/view/2013/1/29/227505.png,0,0.9478678107261658,0,110,534,652,534,542,twilight sparkle,sambragg
2276366.png,https://derpicdn.net/img/view/2020/2/17/2276366.png,0,0.9972872734069824,30,0,730,595,700,595,twilight sparkle,kebchach
2277759.jpg,https://derpicdn.net/img/view/2020/2/18/2277759.jpg,1,0.9754299521446228,193,29,1047,883,854,854,twilight sparkle,shadowreindeer
2278192.jpg,https://derpicdn.net/img/view/2020/2/19/2278192.jpg,0,0.9896551966667176,724,114,1022,412,298,298,twilight sparkle,thecreamyowl
2279119.png,https://derpicdn.net/img/view/2020/2/20/2279119.png,0,0.9473879933357242,368,87,1178,897,810,810,twilight sparkle,tohupo
2279256.jpg,https://derpicdn.net/img/view/2020/2/20/2279256.jpg,0,0.9599581360816956,17,0,513,447,496,447,twilight sparkle,handgunboi
2279430.png,https://derpicdn.net/img/view/2020/2/20/2279430.png,0,0.995517373085022,1113,0,3145,1872,2032,1872,twilight sparkle,cyanlightning|slb94
2281383.jpg,https://derpicdn.net/img/view/2020/2/23/2281383.jpg,0,0.9896131753921508,243,11,773,541,530,530,twilight sparkle,luciferamon
2282284.png,https://derpicdn.net/img/view/2020/2/23/2282284.png,0,0.9727444052696228,1437,201,4157,2921,2720,2720,twilight sparkle,luciferamon|pink1ejack
2283063.jpg,https://derpicdn.net/img/view/2020/2/25/2283063.jpg,0,0.9914631843566896,328,0,1000,655,672,655,twilight sparkle,pillowsword
2284810.jpg,https://derpicdn.net/img/view/2020/2/27/2284810.jpg,0,0.9614092707633972,165,0,1015,847,850,847,twilight sparkle,shadowreindeer
2285098.jpg,https://derpicdn.net/img/view/2020/2/28/2285098.jpg,0,0.991807222366333,140,0,756,586,616,586,twilight sparkle,hosikawa
2286555.png,https://derpicdn.net/img/view/2020/2/29/2286555.png,0,0.9739492535591124,0,15,346,377,346,362,twilight sparkle,sugar morning
2288209.png,https://derpicdn.net/img/view/2020/3/2/2288209.png,0,0.9894739389419556,108,0,438,327,330,327,twilight sparkle,iloota
2289529.jpg,https://derpicdn.net/img/view/2020/3/4/2289529.jpg,0,0.9783686995506288,1304,947,2300,1943,996,996,twilight sparkle,xbi
2293207.png,https://derpicdn.net/img/view/2020/3/9/2293207.png,0,0.9929038882255554,650,71,1390,811,740,740,twilight sparkle,anticular
2293853.jpg,https://derpicdn.net/img/view/2020/3/9/2293853.jpg,0,0.9953193068504332,98,0,1506,1231,1408,1231,twilight sparkle,reterica
2295142.png,https://derpicdn.net/img/view/2020/3/11/2295142.png,0,0.962722659111023,222,89,502,369,280,280,twilight sparkle,cold-blooded-twilight
2296723.png,https://derpicdn.net/img/view/2020/3/13/2296723.png,0,0.9928783178329468,673,160,1895,1382,1222,1222,twilight sparkle,ifmsoul
2296799.png,https://derpicdn.net/img/view/2020/3/13/2296799.png,0,0.9910563826560974,188,0,1636,1314,1448,1314,twilight sparkle,underpable
2301551.png,https://derpicdn.net/img/view/2020/3/20/2301551.png,0,0.9986255764961244,1010,1792,1944,2726,934,934,twilight sparkle,viwrastupr
2301965.png,https://derpicdn.net/img/view/2020/3/20/2301965.png,0,0.9964528083801272,1632,196,3280,1868,1648,1672,twilight sparkle,teaflower300
2302220.jpg,https://derpicdn.net/img/view/2020/3/20/2302220.jpg,0,0.9969714283943176,168,153,858,843,690,690,twilight sparkle,andelai
2302762.png,https://derpicdn.net/img/view/2020/3/21/2302762.png,0,0.9998495578765868,505,0,1289,738,784,738,twilight sparkle,loxy
2302854.jpg,https://derpicdn.net/img/view/2020/3/21/2302854.jpg,0,0.9712933301925659,505,0,1663,1103,1158,1103,twilight sparkle,025aki
2308796.png,https://derpicdn.net/img/view/2020/3/29/2308796.png,0,0.9914999008178712,901,116,1403,618,502,502,twilight sparkle,serenepony
2309867.png,https://derpicdn.net/img/view/2020/3/30/2309867.png,0,0.9628872275352478,108,4,970,866,862,862,twilight sparkle,renarde-louve
2309923.png,https://derpicdn.net/img/view/2020/3/30/2309923.png,0,0.9971402883529664,328,91,1462,1225,1134,1134,twilight sparkle,cinnamontee
2310923.jpg,https://derpicdn.net/img/view/2020/3/31/2310923.jpg,0,0.999127984046936,316,247,1014,945,698,698,twilight sparkle,scarlet-spectrum
2311394.png,https://derpicdn.net/img/view/2020/4/1/2311394.png,0,0.936991810798645,403,164,1521,1282,1118,1118,twilight sparkle,mirapony
2311982.png,https://derpicdn.net/img/view/2020/4/2/2311982.png,0,0.9703991413116456,0,0,1216,1258,1216,1258,twilight sparkle,vird-gi
2312483.jpg,https://derpicdn.net/img/view/2020/4/2/2312483.jpg,0,0.9611181020736694,68,3,832,767,764,764,twilight sparkle,vanillaghosties
2313099.jpg,https://derpicdn.net/img/view/2020/4/3/2313099.jpg,0,0.9803082942962646,0,0,878,849,878,849,twilight sparkle,lostdreamm
2313440.jpg,https://derpicdn.net/img/view/2020/4/3/2313440.jpg,0,0.9949979782104492,54,0,1620,1430,1566,1430,twilight sparkle,reterica
2313469.png,https://derpicdn.net/img/view/2020/4/4/2313469.png,0,0.9651387929916382,228,0,1330,1075,1102,1075,twilight sparkle,sadtrooper
2314166.jpg,https://derpicdn.net/img/view/2020/4/4/2314166.jpg,0,0.9976741075515748,691,52,2379,1740,1688,1688,twilight sparkle,magnaluna
2317925.jpg,https://derpicdn.net/img/view/2020/4/9/2317925.jpg,0,0.957463800907135,1322,99,2136,913,814,814,twilight sparkle,martazap3
2320524.jpg,https://derpicdn.net/img/view/2020/4/12/2320524.jpg,0,0.9905608296394348,96,0,620,507,524,507,twilight sparkle,spectre-z
2324674.jpg,https://derpicdn.net/img/view/2020/4/17/2324674.jpg,0,0.9880387783050536,0,0,1192,1196,1192,1196,twilight sparkle,musicfirewind
2325359.png,https://derpicdn.net/img/view/2020/4/18/2325359.png,0,0.9714285135269164,219,9,1309,1099,1090,1090,twilight sparkle,draw3|3-gon
2325673.png,https://derpicdn.net/img/view/2020/4/18/2325673.png,0,0.9911515712738036,1477,0,2791,1039,1314,1039,twilight sparkle,loveslove
2326014.png,https://derpicdn.net/img/view/2020/4/19/2326014.png,0,0.9885498881340028,1518,127,2996,1605,1478,1478,twilight sparkle,auroriia
2326137.jpg,https://derpicdn.net/img/view/2020/4/19/2326137.jpg,0,0.9929441213607788,118,0,826,643,708,643,twilight sparkle,tyuubatu
2326700.jpg,https://derpicdn.net/img/view/2020/4/20/2326700.jpg,0,0.9944098591804504,612,0,1438,768,826,768,twilight sparkle,reterica
2327363.jpg,https://derpicdn.net/img/view/2020/4/20/2327363.jpg,0,0.9996474981307985,639,0,1569,909,930,909,twilight sparkle,adagiostring
2331437.png,https://derpicdn.net/img/view/2020/4/25/2331437.png,0,0.9451426863670348,1259,0,2823,1436,1564,1436,twilight sparkle,nevobaster
233354.jpg,https://derpicdn.net/img/view/2013/2/4/233354.jpg,0,0.967271089553833,97,73,1105,1081,1008,1008,twilight sparkle,freedomthai
2333804.jpg,https://derpicdn.net/img/view/2020/4/28/2333804.jpg,0,0.9937487840652466,216,18,944,746,728,728,twilight sparkle,musicfirewind
2335173.jpg,https://derpicdn.net/img/view/2020/4/30/2335173.jpg,0,0.9994850158691406,2373,872,4053,2552,1680,1680,twilight sparkle,chub-wub
2335173.jpg,https://derpicdn.net/img/view/2020/4/30/2335173.jpg,1,0.901290774345398,1648,1677,2610,2639,962,962,twilight sparkle,chub-wub
2335962.png,https://derpicdn.net/img/view/2020/4/30/2335962.png,0,0.9933183193206788,501,263,859,621,358,358,twilight sparkle,inuhoshi-to-darkpen
2337470.jpg,https://derpicdn.net/img/view/2020/5/2/2337470.jpg,0,0.9808996319770812,85,0,791,677,706,677,twilight sparkle,shadowreindeer
2337574.jpg,https://derpicdn.net/img/view/2020/5/2/2337574.jpg,0,0.9806245565414428,91,7,595,511,504,504,twilight sparkle,zokkili
2338432.jpg,https://derpicdn.net/img/view/2020/5/3/2338432.jpg,0,0.9951422214508056,488,83,1186,781,698,698,twilight sparkle,chillyfish
2340805.png,https://derpicdn.net/img/view/2020/5/6/2340805.png,0,0.9668447971343994,548,0,1684,1073,1136,1073,twilight sparkle,dashie116
2346240.png,https://derpicdn.net/img/view/2020/5/12/2346240.png,0,0.9333998560905457,2109,0,3299,1079,1190,1079,twilight sparkle,danmakuman
2347512.png,https://derpicdn.net/img/view/2020/5/13/2347512.png,0,0.9242437481880188,1672,0,3312,1614,1640,1614,twilight sparkle,cottonaime|chickenbrony
2348566.jpg,https://derpicdn.net/img/view/2020/5/14/2348566.jpg,0,0.9654930233955384,1724,94,3136,1506,1412,1412,twilight sparkle,miokomata
2349121.png,https://derpicdn.net/img/view/2020/5/15/2349121.png,0,0.977169394493103,0,0,2083,2113,2083,2113,twilight sparkle,heavymetalbronyyeah
2349172.png,https://derpicdn.net/img/view/2020/5/15/2349172.png,0,0.9630736112594604,121,0,473,342,352,342,twilight sparkle,
2349833.png,https://derpicdn.net/img/view/2020/5/16/2349833.png,0,0.9898419976234436,133,107,517,491,384,384,twilight sparkle,
235044.png,https://derpicdn.net/img/view/2013/2/6/235044.png,0,0.9769971966743468,312,397,1000,1085,688,688,twilight sparkle,1jaz
2351204.jpg,https://derpicdn.net/img/view/2020/5/17/2351204.jpg,0,0.9995738863945008,460,207,838,585,378,378,twilight sparkle,asimos
2352540.png,https://derpicdn.net/img/view/2020/5/19/2352540.png,0,0.9994685649871826,444,0,1220,734,776,734,twilight sparkle,xbi
2354648.png,https://derpicdn.net/img/view/2020/5/21/2354648.png,0,0.9874053001403807,166,0,1318,895,1152,895,twilight sparkle,mite-lime
2354844.png,https://derpicdn.net/img/view/2020/5/22/2354844.png,0,0.9940940737724304,265,0,1109,832,844,832,twilight sparkle,higgly-chan
242027.png,https://derpicdn.net/img/view/2013/2/13/242027.png,0,0.9734062552452089,0,48,517,626,517,578,twilight sparkle,loyaldis
242027.png,https://derpicdn.net/img/view/2013/2/13/242027.png,1,0.9195813536643982,71,0,565,537,494,537,twilight sparkle,loyaldis
261410.jpg,https://derpicdn.net/img/view/2013/3/3/261410.jpg,0,0.9990305900573728,88,24,388,324,300,300,twilight sparkle,muzz
261552.png,https://derpicdn.net/img/view/2013/3/3/261552.png,0,0.996753454208374,208,25,460,277,252,252,twilight sparkle,stupjam
27469.png,https://derpicdn.net/img/view/2012/7/1/27469.png,0,0.9851243495941162,72,104,864,860,792,756,twilight sparkle,doxy
275562.png,https://derpicdn.net/img/view/2013/3/21/275562.png,0,0.9946699738502502,191,193,629,631,438,438,twilight sparkle,alasou
275562.png,https://derpicdn.net/img/view/2013/3/21/275562.png,1,0.972938358783722,558,292,964,698,406,406,twilight sparkle,alasou
283686.png,https://derpicdn.net/img/view/2013/3/30/283686.png,0,0.993893027305603,922,108,1556,742,634,634,twilight sparkle,zaphy1415926
283887.jpg,https://derpicdn.net/img/view/2013/3/31/283887.jpg,0,0.9960168600082396,156,177,454,475,298,298,twilight sparkle,foxenawolf
285489.png,https://derpicdn.net/img/view/2013/4/1/285489.png,0,0.998926281929016,53,0,509,425,456,425,twilight sparkle,moyamoya kuroi
291638.png,https://derpicdn.net/img/view/2013/4/8/291638.png,0,0.9830598831176758,71,36,281,246,210,210,twilight sparkle,foxinshadow
293943.jpg,https://derpicdn.net/img/view/2013/4/10/293943.jpg,0,0.9913682341575624,160,71,406,317,246,246,twilight sparkle,audrarius
295195.png,https://derpicdn.net/img/view/2013/4/12/295195.png,0,0.9162150621414183,233,0,581,321,348,321,twilight sparkle,the weaver
29622.jpg,https://derpicdn.net/img/view/2012/7/3/29622.jpg,0,0.9950544834136964,34,52,942,960,908,908,twilight sparkle,skipsy
298209.png,https://derpicdn.net/img/view/2013/4/14/298209.png,0,0.9942365884780884,15,0,471,449,456,449,twilight sparkle,glancojusticar
303661.png,https://derpicdn.net/img/view/2013/4/20/303661.png,0,0.992936074733734,665,970,1277,1582,612,612,twilight sparkle,santafer
308178.jpg,https://derpicdn.net/img/view/2013/4/25/308178.jpg,0,0.9967725872993468,390,0,950,553,560,553,twilight sparkle,kejifox
315404.png,https://derpicdn.net/img/view/2013/5/3/315404.png,0,0.9855912327766418,341,0,913,536,572,536,twilight sparkle,sokolas|kas92
315448.png,https://derpicdn.net/img/view/2013/5/3/315448.png,0,0.9983524680137634,704,54,1160,510,456,456,twilight sparkle,otakuap
317646.jpg,https://derpicdn.net/img/view/2013/5/5/317646.jpg,0,0.9878867864608764,1856,0,2224,315,368,315,twilight sparkle,mirakurunaito|scorpiordinance|foxinshadow|ninjaham|glancojusticar|kprovido|the-orator|theartrix|atryl|carthegian|fajeh|arucardpl|gomigomipomi|kevinsano|innerd|zoe-productions|yanabau|aeolus06|johnjoseco|karzahnii|sallymon|mrw32|derpiihooves|ddhew|angriestangryartist
317646.jpg,https://derpicdn.net/img/view/2013/5/5/317646.jpg,3,0.9701072573661804,30,889,502,1361,472,472,twilight sparkle,mirakurunaito|scorpiordinance|foxinshadow|ninjaham|glancojusticar|kprovido|the-orator|theartrix|atryl|carthegian|fajeh|arucardpl|gomigomipomi|kevinsano|innerd|zoe-productions|yanabau|aeolus06|johnjoseco|karzahnii|sallymon|mrw32|derpiihooves|ddhew|angriestangryartist
317646.jpg,https://derpicdn.net/img/view/2013/5/5/317646.jpg,6,0.9267591238021852,2501,1481,2823,1803,322,322,twilight sparkle,mirakurunaito|scorpiordinance|foxinshadow|ninjaham|glancojusticar|kprovido|the-orator|theartrix|atryl|carthegian|fajeh|arucardpl|gomigomipomi|kevinsano|innerd|zoe-productions|yanabau|aeolus06|johnjoseco|karzahnii|sallymon|mrw32|derpiihooves|ddhew|angriestangryartist
319244.png,https://derpicdn.net/img/view/2013/5/7/319244.png,0,0.9985793828964232,262,0,684,396,422,396,twilight sparkle,foxinshadow
323611.png,https://derpicdn.net/img/view/2013/5/13/323611.png,0,0.9983770251274108,613,170,797,354,184,184,twilight sparkle,shepherd0821
324788.jpg,https://derpicdn.net/img/view/2013/5/14/324788.jpg,0,0.9894561171531676,420,0,1104,670,684,670,twilight sparkle,hobbes-maxwell
339042.png,https://derpicdn.net/img/view/2013/6/2/339042.png,0,0.9983962774276732,665,0,1225,555,560,555,twilight sparkle,spittfireart
343425.jpg,https://derpicdn.net/img/view/2013/6/8/343425.jpg,0,0.9713162779808044,436,113,884,561,448,448,twilight sparkle,garam
344993.png,https://derpicdn.net/img/view/2013/6/10/344993.png,0,0.9634803533554076,12,0,454,423,442,423,twilight sparkle,trinity-fate62
346463.png,https://derpicdn.net/img/view/2013/6/12/346463.png,0,0.9793717265129088,75,0,685,567,610,567,twilight sparkle,xieril
349651.png,https://derpicdn.net/img/view/2013/6/16/349651.png,0,0.966102421283722,38,26,590,578,552,552,twilight sparkle,frogbians
354280.jpg,https://derpicdn.net/img/view/2013/6/22/354280.jpg,0,0.9914029240608216,64,0,408,339,344,339,twilight sparkle,soukitsubasa
359286.png,https://derpicdn.net/img/view/2013/6/28/359286.png,0,0.9390581846237184,0,0,1727,1959,1727,1959,twilight sparkle,killryde
360116.png,https://derpicdn.net/img/view/2013/6/29/360116.png,0,0.97624009847641,0,0,4820,4550,4820,4550,twilight sparkle,masem
362538.png,https://derpicdn.net/img/view/2013/7/2/362538.png,0,0.9983738660812378,358,79,776,497,418,418,twilight sparkle,pijinpyon
363978.png,https://derpicdn.net/img/view/2013/7/4/363978.png,0,0.9927427172660828,328,0,759,415,431,415,twilight sparkle,fizzy-dog
365049.png,https://derpicdn.net/img/view/2013/7/5/365049.png,0,0.9959208369255066,517,29,959,471,442,442,twilight sparkle,chromaskunk|kevinsano
368867.jpg,https://derpicdn.net/img/view/2013/7/9/368867.jpg,0,0.9880892634391784,225,0,777,547,552,547,twilight sparkle,europamaxima
369748.png,https://derpicdn.net/img/view/2013/7/10/369748.png,0,0.9878785014152528,31,0,993,880,962,880,twilight sparkle,dimwitdog
372829.png,https://derpicdn.net/img/view/2013/7/13/372829.png,0,0.9962517023086548,2381,272,3781,1672,1400,1400,twilight sparkle,gashiboka
381434.png,https://derpicdn.net/img/view/2013/7/22/381434.png,0,0.9634131789207458,131,0,1279,1108,1148,1108,twilight sparkle,aymint
382632.png,https://derpicdn.net/img/view/2013/7/24/382632.png,0,0.9987369179725648,668,9,1756,1097,1088,1088,twilight sparkle,killryde
382760.png,https://derpicdn.net/img/view/2013/7/24/382760.png,0,0.9692922234535216,5,0,517,489,512,489,twilight sparkle,suikuzu
388197.png,https://derpicdn.net/img/view/2013/8/1/388197.png,0,0.9976947903633118,568,220,974,626,406,406,twilight sparkle,cigarscigarettes
390953.png,https://derpicdn.net/img/view/2013/8/4/390953.png,0,0.9979196786880492,349,20,945,616,596,596,twilight sparkle,mlp-scribbles
393768.png,https://derpicdn.net/img/view/2013/8/7/393768.png,0,0.9705141186714172,553,0,897,341,344,341,twilight sparkle,hivelordlusa|kloudmutt
395557.png,https://derpicdn.net/img/view/2013/8/9/395557.png,0,0.9355353116989136,83,39,331,287,248,248,twilight sparkle,skykain
407491.png,https://derpicdn.net/img/view/2013/8/22/407491.png,0,0.9963799118995668,81,54,445,418,364,364,twilight sparkle,atryl
410675.png,https://derpicdn.net/img/view/2013/8/26/410675.png,0,0.9906406998634338,0,0,500,465,500,465,twilight sparkle,zev
411419.png,https://derpicdn.net/img/view/2013/8/26/411419.png,0,0.9806304574012756,427,84,981,638,554,554,twilight sparkle,furreon
411530.png,https://derpicdn.net/img/view/2013/8/26/411530.png,0,0.9976384043693542,216,14,494,292,278,278,twilight sparkle,sugarcup
413372.png,https://derpicdn.net/img/view/2013/8/29/413372.png,0,0.9939578771591188,517,576,805,864,288,288,twilight sparkle,dm29
413372.png,https://derpicdn.net/img/view/2013/8/29/413372.png,1,0.9701048731803894,235,18,545,328,310,310,twilight sparkle,dm29
413818.jpg,https://derpicdn.net/img/view/2013/8/29/413818.jpg,0,0.9817906022071838,723,193,1629,1099,906,906,twilight sparkle,bluntwhiskey
415424.png,https://derpicdn.net/img/view/2013/8/31/415424.png,0,0.997852861881256,1319,457,2559,1697,1240,1240,twilight sparkle,gashiboka
416369.png,https://derpicdn.net/img/view/2013/9/1/416369.png,0,0.9646484255790708,434,39,1240,845,806,806,twilight sparkle,mirapony
418174.png,https://derpicdn.net/img/view/2013/9/3/418174.png,0,0.9938161969184875,392,0,1620,1098,1228,1098,twilight sparkle,equestria-prevails
419890.png,https://derpicdn.net/img/view/2013/9/5/419890.png,0,0.9985702037811279,1139,0,2405,1131,1266,1131,twilight sparkle,jcosneverexisted
420414.png,https://derpicdn.net/img/view/2013/9/6/420414.png,0,0.9920582771301272,120,0,724,589,604,589,twilight sparkle,atryl
4240.png,https://derpicdn.net/img/view/2012/6/3/4240.png,0,0.9177443385124208,19,41,341,363,322,322,twilight sparkle,brianblackberry
4247.png,https://derpicdn.net/img/view/2012/6/3/4247.png,0,0.99507474899292,128,27,492,391,364,364,twilight sparkle,brianblackberry
429322.png,https://derpicdn.net/img/view/2013/9/17/429322.png,0,0.9132886528968812,2377,610,4677,2910,2300,2300,twilight sparkle,matimus91
429527.jpg,https://derpicdn.net/img/view/2013/9/17/429527.jpg,0,0.9953163862228394,188,6,606,424,418,418,twilight sparkle,amy30535
430503.jpg,https://derpicdn.net/img/view/2013/9/19/430503.jpg,0,0.9750860333442688,245,14,1163,932,918,918,twilight sparkle,doublewbrothers
430680.png,https://derpicdn.net/img/view/2013/9/19/430680.png,0,0.9708092212677002,0,0,864,902,864,902,twilight sparkle,zacatron94
431779.png,https://derpicdn.net/img/view/2013/9/21/431779.png,0,0.902519464492798,2350,581,4704,2935,2354,2354,twilight sparkle,matimus91
4323.png,https://derpicdn.net/img/view/2012/6/5/4323.png,0,0.931048572063446,1407,0,2397,885,990,885,twilight sparkle,illuminatiums
4331.png,https://derpicdn.net/img/view/2012/6/5/4331.png,0,0.9941000938415528,83,0,1349,985,1266,985,twilight sparkle,illuminatiums
437067.png,https://derpicdn.net/img/view/2013/9/28/437067.png,0,0.9979830384254456,0,0,356,359,356,359,twilight sparkle,30clock
437711.png,https://derpicdn.net/img/view/2013/9/29/437711.png,0,0.9840495586395264,587,0,1677,1074,1090,1074,twilight sparkle,danmakuman
442823.png,https://derpicdn.net/img/view/2013/10/6/442823.png,0,0.9583284854888916,285,21,943,719,658,698,twilight sparkle,aymint
444976.png,https://derpicdn.net/img/view/2013/10/9/444976.png,0,0.9984919428825378,2260,0,4000,1564,1740,1564,twilight sparkle,discorded
446361.jpg,https://derpicdn.net/img/view/2013/10/11/446361.jpg,0,0.9688492417335508,118,7,500,389,382,382,twilight sparkle,onnanoko
455846.jpg,https://derpicdn.net/img/view/2013/10/25/455846.jpg,0,0.9992727041244508,327,23,1405,1101,1078,1078,twilight sparkle,bluntwhiskey
458514.png,https://derpicdn.net/img/view/2013/10/28/458514.png,0,0.9978907704353333,238,31,530,323,292,292,twilight sparkle,atryl
467679.png,https://derpicdn.net/img/view/2013/11/9/467679.png,0,0.9936811923980712,488,0,5450,4356,4962,4356,twilight sparkle,godoffury
467995.jpg,https://derpicdn.net/img/view/2013/11/9/467995.jpg,0,0.991954267024994,692,142,1602,1052,910,910,twilight sparkle,pitchyy
468088.png,https://derpicdn.net/img/view/2013/11/9/468088.png,0,0.9939481616020204,330,0,986,627,656,627,twilight sparkle,cakewasgood
4717.png,https://derpicdn.net/img/view/2012/6/17/4717.png,0,0.9987075328826904,1237,384,1721,868,484,484,twilight sparkle,countcarbon
472085.png,https://derpicdn.net/img/view/2013/11/13/472085.png,0,0.9974766373634338,559,0,1029,458,470,458,twilight sparkle,eagle1division|starshinecelestalis
473090.png,https://derpicdn.net/img/view/2013/11/15/473090.png,0,0.9893262982368468,2521,625,5477,3581,2956,2956,twilight sparkle,fluffyxai
473483.png,https://derpicdn.net/img/view/2013/11/16/473483.png,0,0.949550449848175,75,0,521,420,446,420,twilight sparkle,hikariviny
480075.png,https://derpicdn.net/img/view/2013/11/24/480075.png,0,0.9847845435142516,447,22,845,420,398,398,twilight sparkle,jopiter
480470.jpg,https://derpicdn.net/img/view/2013/11/24/480470.jpg,0,0.9839777946472168,0,5,517,607,517,602,twilight sparkle,hua
480915.png,https://derpicdn.net/img/view/2013/11/25/480915.png,0,0.9828646183013916,638,0,2050,1301,1412,1301,twilight sparkle,
481348.png,https://derpicdn.net/img/view/2013/11/25/481348.png,0,0.948333740234375,0,415,308,737,308,322,twilight sparkle,
486200.jpg,https://derpicdn.net/img/view/2013/11/30/486200.jpg,0,0.990790069103241,21,0,417,379,396,379,twilight sparkle,scorpdk
488570.jpg,https://derpicdn.net/img/view/2013/12/3/488570.jpg,0,0.9987627267837524,41,0,409,344,368,344,twilight sparkle,pimmy
488570.jpg,https://derpicdn.net/img/view/2013/12/3/488570.jpg,1,0.9961090683937072,623,0,911,262,288,262,twilight sparkle,pimmy
488570.jpg,https://derpicdn.net/img/view/2013/12/3/488570.jpg,2,0.9807281494140624,1215,0,1567,336,352,336,twilight sparkle,pimmy
488570.jpg,https://derpicdn.net/img/view/2013/12/3/488570.jpg,3,0.9013086557388306,438,265,946,773,508,508,twilight sparkle,pimmy
493890.png,https://derpicdn.net/img/view/2013/12/10/493890.png,0,0.9922558665275574,108,0,532,386,424,386,twilight sparkle,latios69|stradivarius
493894.png,https://derpicdn.net/img/view/2013/12/10/493894.png,0,0.9861371517181396,132,0,542,380,410,380,twilight sparkle,stradivarius|latios69
501597.png,https://derpicdn.net/img/view/2013/12/20/501597.png,0,0.9966846108436584,58,0,404,344,346,344,twilight sparkle,pia-sama
501776.png,https://derpicdn.net/img/view/2013/12/20/501776.png,0,0.9852932095527648,350,42,816,508,466,466,twilight sparkle,ss2sonic
512172.png,https://derpicdn.net/img/view/2014/1/1/512172.png,0,0.9235703945159912,0,0,1904,1804,1904,1804,twilight sparkle,ambris
513847.png,https://derpicdn.net/img/view/2014/1/3/513847.png,0,0.9027990102767944,25,271,545,791,520,520,twilight sparkle,king-kakapo
514190.png,https://derpicdn.net/img/view/2014/1/3/514190.png,0,0.9762044548988342,554,0,1026,441,472,441,twilight sparkle,arnachy
517137.png,https://derpicdn.net/img/view/2014/1/6/517137.png,0,0.9902637600898744,772,322,1810,1360,1038,1038,twilight sparkle,danmakuman
518577.png,https://derpicdn.net/img/view/2014/1/8/518577.png,0,0.99932599067688,75,0,393,308,318,308,twilight sparkle,jessy
519430.png,https://derpicdn.net/img/view/2014/1/9/519430.png,0,0.9457545280456544,514,562,1332,1380,818,818,twilight sparkle,frogbians
520201.png,https://derpicdn.net/img/view/2014/1/10/520201.png,0,0.9932430386543274,758,811,1730,1783,972,972,twilight sparkle,jittery-the-dragon
521592.png,https://derpicdn.net/img/view/2014/1/11/521592.png,0,0.9867384433746338,66,65,502,501,436,436,twilight sparkle,zat
524591.png,https://derpicdn.net/img/view/2014/1/14/524591.png,0,0.9439828991889954,234,250,466,482,232,232,twilight sparkle,jopiter
527169.png,https://derpicdn.net/img/view/2014/1/18/527169.png,0,0.9871296882629396,322,139,800,627,478,488,twilight sparkle,xioade
528769.jpg,https://derpicdn.net/img/view/2014/1/19/528769.jpg,0,0.9983727931976318,284,256,862,834,578,578,twilight sparkle,newyorkx3
530754.png,https://derpicdn.net/img/view/2014/1/21/530754.png,0,0.9075040221214294,0,11,789,863,789,852,twilight sparkle,maren
534138.png,https://derpicdn.net/img/view/2014/1/25/534138.png,0,0.9732431769371032,7,27,249,250,242,223,twilight sparkle,
535218.png,https://derpicdn.net/img/view/2014/1/26/535218.png,0,0.9966974258422852,2613,155,5367,2909,2754,2754,twilight sparkle,masem
540766.png,https://derpicdn.net/img/view/2014/2/1/540766.png,0,0.9897341728210448,357,0,1087,698,730,698,twilight sparkle,ambris
544780.png,https://derpicdn.net/img/view/2014/2/6/544780.png,0,0.9526615142822266,0,30,462,550,462,520,twilight sparkle,greyradian
557289.png,https://derpicdn.net/img/view/2014/2/20/557289.png,0,0.9959616661071776,449,463,763,777,314,314,twilight sparkle,king-kakapo
559061.png,https://derpicdn.net/img/view/2014/2/22/559061.png,0,0.9271823167800904,1391,728,2705,2042,1314,1314,twilight sparkle,europamaxima
559539.png,https://derpicdn.net/img/view/2014/2/23/559539.png,0,0.9952058792114258,0,180,206,446,206,266,twilight sparkle,karpet-shark
559957.png,https://derpicdn.net/img/view/2014/2/23/559957.png,0,0.9970810413360596,386,12,1370,996,984,984,twilight sparkle,kyodashiro
563316.jpg,https://derpicdn.net/img/view/2014/2/28/563316.jpg,0,0.9906187057495116,30,0,800,764,770,764,twilight sparkle,macheteponies
563507.png,https://derpicdn.net/img/view/2014/2/28/563507.png,0,0.9594605565071106,403,905,983,1485,580,580,twilight sparkle,subjectnumber2394
567070.png,https://derpicdn.net/img/view/2014/3/5/567070.png,0,0.9740221500396729,0,0,393,504,393,504,twilight sparkle,
569051.png,https://derpicdn.net/img/view/2014/3/8/569051.png,0,0.9933056831359864,0,0,390,376,390,376,twilight sparkle,atryl
572912.png,https://derpicdn.net/img/view/2014/3/12/572912.png,0,0.9693912267684937,0,0,427,555,427,555,twilight sparkle,
573289.jpg,https://derpicdn.net/img/view/2014/3/12/573289.jpg,0,0.9710529446601868,98,4,658,564,560,560,twilight sparkle,dtkraus
5746.png,https://derpicdn.net/img/view/2012/6/18/5746.png,0,0.9859884977340698,149,0,1257,1047,1108,1047,twilight sparkle,grumblepluck
576380.png,https://derpicdn.net/img/view/2014/3/16/576380.png,0,0.980795681476593,431,0,899,417,468,417,twilight sparkle,red-poni
578972.png,https://derpicdn.net/img/view/2014/3/18/578972.png,0,0.9772365689277648,36,15,292,271,256,256,twilight sparkle,stoic5
580541.png,https://derpicdn.net/img/view/2014/3/20/580541.png,0,0.9947038888931274,652,296,942,586,290,290,twilight sparkle,berrypawnch
580541.png,https://derpicdn.net/img/view/2014/3/20/580541.png,1,0.9866827726364136,239,0,647,377,408,377,twilight sparkle,berrypawnch
581109.png,https://derpicdn.net/img/view/2014/3/21/581109.png,0,0.99037504196167,256,197,520,461,264,264,twilight sparkle,heilos
584308.png,https://derpicdn.net/img/view/2014/3/24/584308.png,0,0.9538300037384032,2626,705,5038,3117,2412,2412,twilight sparkle,magister39
585228.png,https://derpicdn.net/img/view/2014/3/26/585228.png,0,0.9455070495605468,130,18,544,432,414,414,twilight sparkle,alasou
589340.png,https://derpicdn.net/img/view/2014/3/31/589340.png,0,0.9848829507827759,37,0,343,306,306,306,twilight sparkle,idrawweeklypony
593634.png,https://derpicdn.net/img/view/2014/4/5/593634.png,0,0.9995602369308472,0,0,428,453,428,453,twilight sparkle,theparagon
593634.png,https://derpicdn.net/img/view/2014/4/5/593634.png,1,0.9944246411323548,396,18,800,440,404,422,twilight sparkle,theparagon
598166.jpg,https://derpicdn.net/img/view/2014/4/11/598166.jpg,0,0.9442934393882751,81,0,417,333,336,333,twilight sparkle,yulyeen
599099.png,https://derpicdn.net/img/view/2014/4/13/599099.png,0,0.998676300048828,603,13,1533,943,930,930,twilight sparkle,devs-iratvs
601045.png,https://derpicdn.net/img/view/2014/4/15/601045.png,0,0.9584193229675292,235,37,737,539,502,502,twilight sparkle,maren
603466.png,https://derpicdn.net/img/view/2014/4/18/603466.png,0,0.9987823963165284,828,112,2406,1690,1578,1578,twilight sparkle,ambris
605272.png,https://derpicdn.net/img/view/2014/4/20/605272.png,0,0.9961971640586852,356,243,928,815,572,572,twilight sparkle,kloudmutt
606925.png,https://derpicdn.net/img/view/2014/4/22/606925.png,0,0.9892017841339112,594,0,1036,405,442,405,twilight sparkle,sandwich-anomaly
612684.png,https://derpicdn.net/img/view/2014/4/29/612684.png,0,0.9957778453826904,252,0,630,362,378,362,twilight sparkle,dm29
614134.png,https://derpicdn.net/img/view/2014/4/30/614134.png,0,0.9820566773414612,23,11,299,287,276,276,twilight sparkle,lopoddity
614492.png,https://derpicdn.net/img/view/2014/5/1/614492.png,0,0.980870246887207,75,0,695,615,620,615,twilight sparkle,mcponyponypony|silver1kunai
61770.png,https://derpicdn.net/img/view/2012/7/30/61770.png,0,0.9105823040008544,241,34,619,412,378,378,twilight sparkle,blackkaries
623293.png,https://derpicdn.net/img/view/2014/5/11/623293.png,0,0.9590219855308532,253,16,900,700,647,684,twilight sparkle,pegacornss
623345.png,https://derpicdn.net/img/view/2014/5/11/623345.png,0,0.9238991141319276,352,163,818,629,466,466,twilight sparkle,alasou
623750.png,https://derpicdn.net/img/view/2014/5/11/623750.png,0,0.997258722782135,0,11,438,457,438,446,twilight sparkle,thenationmaker|ambris
624839.png,https://derpicdn.net/img/view/2014/5/12/624839.png,0,0.9077641367912292,169,20,633,484,464,464,twilight sparkle,revadiehard
628116.png,https://derpicdn.net/img/view/2014/5/16/628116.png,0,0.9969002604484558,1011,401,1893,1283,882,882,twilight sparkle,nadnerbd
631115.png,https://derpicdn.net/img/view/2014/5/19/631115.png,0,0.990728795528412,370,109,800,539,430,430,twilight sparkle,tomtornados
639137.png,https://derpicdn.net/img/view/2014/5/28/639137.png,0,0.9915429353713988,824,379,1024,599,200,220,twilight sparkle,umeguru
639137.png,https://derpicdn.net/img/view/2014/5/28/639137.png,1,0.9703399538993835,241,341,519,619,278,278,twilight sparkle,umeguru
639137.png,https://derpicdn.net/img/view/2014/5/28/639137.png,2,0.9610100984573364,70,0,346,247,276,247,twilight sparkle,umeguru
639483.jpg,https://derpicdn.net/img/view/2014/5/28/639483.jpg,0,0.9734230637550354,1423,296,2151,1024,728,728,twilight sparkle,my-magic-dream
640593.png,https://derpicdn.net/img/view/2014/5/30/640593.png,0,0.9895777702331544,1328,5,3258,1935,1930,1930,twilight sparkle,evilfrenzy
644460.jpg,https://derpicdn.net/img/view/2014/6/4/644460.jpg,0,0.9971692562103271,39,0,1007,905,968,905,twilight sparkle,canvymamamoo
652005.jpg,https://derpicdn.net/img/view/2014/6/13/652005.jpg,0,0.9916120171546936,72,0,322,239,250,239,twilight sparkle,buxbi
654697.png,https://derpicdn.net/img/view/2014/6/16/654697.png,0,0.9986935257911682,222,0,534,299,312,299,twilight sparkle,probablyfakeblonde
654798.png,https://derpicdn.net/img/view/2014/6/16/654798.png,0,0.9212729334831238,477,190,1041,754,564,564,twilight sparkle,yakovlev-vad
657302.png,https://derpicdn.net/img/view/2014/6/20/657302.png,0,0.9976638555526732,1759,0,3225,1395,1466,1395,twilight sparkle,theshadowstone
657836.png,https://derpicdn.net/img/view/2014/6/20/657836.png,0,0.9967249035835266,251,0,499,240,248,240,twilight sparkle,red-poni
659437.png,https://derpicdn.net/img/view/2014/6/23/659437.png,0,0.9985085129737854,163,0,985,809,822,809,twilight sparkle,alasou
664036.png,https://derpicdn.net/img/view/2014/6/29/664036.png,0,0.9636038541793824,368,62,912,606,544,544,twilight sparkle,dawnfire
665991.png,https://derpicdn.net/img/view/2014/7/2/665991.png,1,0.9393599033355712,777,1058,2281,2562,1504,1504,twilight sparkle,pirill
666840.png,https://derpicdn.net/img/view/2014/7/3/666840.png,0,0.9961429834365844,781,113,1731,1063,950,950,twilight sparkle,reimon-master-ii|ponyguy67
670870.png,https://derpicdn.net/img/view/2014/7/9/670870.png,0,0.9978212714195251,274,272,736,734,462,462,twilight sparkle,dfectivedvice|chromaskunk
672373.jpg,https://derpicdn.net/img/view/2014/7/11/672373.jpg,0,0.9866884350776672,620,0,1604,881,984,881,twilight sparkle,mysticalpha
680479.jpg,https://derpicdn.net/img/view/2014/7/21/680479.jpg,0,0.9508299827575684,140,0,378,236,238,236,twilight sparkle,glacierclear
685105.png,https://derpicdn.net/img/view/2014/7/28/685105.png,0,0.9880361557006836,0,4,438,472,438,468,twilight sparkle,stoic5
691032.png,https://derpicdn.net/img/view/2014/8/4/691032.png,0,0.998062789440155,90,0,518,424,428,424,twilight sparkle,dfectivedvice|shawnyall
692637.png,https://derpicdn.net/img/view/2014/8/6/692637.png,0,0.9717750549316406,235,6,1007,778,772,772,twilight sparkle,strangerdanger
693635.png,https://derpicdn.net/img/view/2014/8/7/693635.png,0,0.9128671288490297,0,0,1108,1115,1108,1115,twilight sparkle,madacon
694003.png,https://derpicdn.net/img/view/2014/8/7/694003.png,0,0.9991415143013,867,0,1893,809,1026,809,twilight sparkle,dshou
696690.png,https://derpicdn.net/img/view/2014/8/10/696690.png,0,0.9013735055923462,924,276,1636,988,712,712,twilight sparkle,navitaserussirus
696868.png,https://derpicdn.net/img/view/2014/8/11/696868.png,0,0.9823988676071168,75,12,475,412,400,400,twilight sparkle,ninjapony
699329.jpg,https://derpicdn.net/img/view/2014/8/14/699329.jpg,0,0.9983105659484864,753,663,1493,1403,740,740,twilight sparkle,audrarius
702384.png,https://derpicdn.net/img/view/2014/8/18/702384.png,0,0.9907625913619996,0,0,833,881,833,881,twilight sparkle,january3rd
706146.jpg,https://derpicdn.net/img/view/2014/8/23/706146.jpg,0,0.9912829399108888,166,1,520,355,354,354,twilight sparkle,bansan
706478.png,https://derpicdn.net/img/view/2014/8/23/706478.png,0,0.9993923902511596,90,0,514,418,424,418,twilight sparkle,anime-apothecary|dfectivedvice
707538.png,https://derpicdn.net/img/view/2014/8/25/707538.png,1,0.9804143905639648,315,0,685,367,370,367,twilight sparkle,ravenpuff
707538.png,https://derpicdn.net/img/view/2014/8/25/707538.png,2,0.9427025318145752,850,81,1210,441,360,360,twilight sparkle,ravenpuff
707884.png,https://derpicdn.net/img/view/2014/8/25/707884.png,0,0.9732866287231444,231,27,739,535,508,508,twilight sparkle,hobbsmeerkat
708878.jpg,https://derpicdn.net/img/view/2014/8/26/708878.jpg,0,0.9933831095695496,0,0,557,509,557,509,twilight sparkle,bansan
709269.png,https://derpicdn.net/img/view/2014/8/27/709269.png,0,0.9800769686698914,613,0,1223,573,610,573,twilight sparkle,lustrous-dreams
710734.png,https://derpicdn.net/img/view/2014/8/30/710734.png,0,0.9768778681755066,718,0,1436,673,718,673,twilight sparkle,lustrous-dreams
712044.png,https://derpicdn.net/img/view/2014/8/31/712044.png,0,0.9899664521217346,510,20,1030,540,520,520,twilight sparkle,hawthornss
713079.png,https://derpicdn.net/img/view/2014/9/1/713079.png,0,0.9239975810050964,262,21,582,341,320,320,twilight sparkle,pepooni
713220.png,https://derpicdn.net/img/view/2014/9/1/713220.png,0,0.9756564497947692,160,92,590,522,430,430,twilight sparkle,mlpanon
714422.png,https://derpicdn.net/img/view/2014/9/4/714422.png,0,0.9028143882751464,0,0,1207,1231,1207,1231,twilight sparkle,katputze
715644.png,https://derpicdn.net/img/view/2014/9/5/715644.png,0,0.9971907734870912,686,116,1386,816,700,700,twilight sparkle,bluntwhiskey
720113.png,https://derpicdn.net/img/view/2014/9/11/720113.png,0,0.9830756783485411,290,25,736,471,446,446,twilight sparkle,ninidoodles
721845.png,https://derpicdn.net/img/view/2014/9/14/721845.png,0,0.9641025066375732,2,0,588,543,586,543,twilight sparkle,sion-ara
726279.png,https://derpicdn.net/img/view/2014/9/21/726279.png,0,0.9874980449676514,278,193,588,503,310,310,twilight sparkle,ctb-36
726685.png,https://derpicdn.net/img/view/2014/9/21/726685.png,0,0.9960566163063048,418,339,786,707,368,368,twilight sparkle,i am nude
733783.png,https://derpicdn.net/img/view/2014/10/2/733783.png,0,0.9964777827262878,214,0,1032,738,818,738,twilight sparkle,atryl
733843.png,https://derpicdn.net/img/view/2014/10/2/733843.png,0,0.9909144043922424,404,0,1972,1376,1568,1376,twilight sparkle,galekz
735052.png,https://derpicdn.net/img/view/2014/10/3/735052.png,0,0.9879468679428101,45,92,2337,2402,2292,2310,twilight sparkle,fluffyxai
736321.png,https://derpicdn.net/img/view/2014/10/5/736321.png,0,0.9999402761459352,21,1002,543,1524,522,522,twilight sparkle,nobody
739386.png,https://derpicdn.net/img/view/2014/10/9/739386.png,0,0.996293604373932,136,30,346,240,210,210,twilight sparkle,mastergodai
741089.png,https://derpicdn.net/img/view/2014/10/12/741089.png,0,0.9590113162994384,205,97,521,413,316,316,twilight sparkle,empyu
744559.jpg,https://derpicdn.net/img/view/2014/10/17/744559.jpg,0,0.9018750190734864,65,7,427,369,362,362,twilight sparkle,duskyamore
745607.png,https://derpicdn.net/img/view/2014/10/18/745607.png,0,0.966094970703125,0,0,540,707,540,707,twilight sparkle,underpable
746.png,https://derpicdn.net/img/view/2012/1/17/746.png,0,0.9291337728500366,132,0,668,530,536,530,twilight sparkle,johnjoseco
747436.jpg,https://derpicdn.net/img/view/2014/10/21/747436.jpg,0,0.9938752055168152,189,0,1539,1089,1350,1089,twilight sparkle,bluedrg19
747443.png,https://derpicdn.net/img/view/2014/10/21/747443.png,0,0.9970714449882508,768,179,1400,811,632,632,twilight sparkle,hoyeechun
747490.png,https://derpicdn.net/img/view/2014/10/21/747490.png,0,0.9757363200187684,0,0,1335,1249,1335,1249,twilight sparkle,sion
749015.png,https://derpicdn.net/img/view/2014/10/23/749015.png,0,0.9870949983596802,0,0,1130,1251,1130,1251,twilight sparkle,kyodashiro
749036.png,https://derpicdn.net/img/view/2014/10/23/749036.png,0,0.9816579222679138,0,0,1168,1217,1168,1217,twilight sparkle,kyodashiro
751708.png,https://derpicdn.net/img/view/2014/10/27/751708.png,0,0.9987934231758118,302,23,1002,723,700,700,twilight sparkle,fladdykin
753643.png,https://derpicdn.net/img/view/2014/10/30/753643.png,0,0.9719091653823853,481,191,1509,1219,1028,1028,twilight sparkle,captainpudgemuffin
755627.png,https://derpicdn.net/img/view/2014/11/1/755627.png,0,0.918749749660492,186,0,884,619,698,619,twilight sparkle,atryl
755876.png,https://derpicdn.net/img/view/2014/11/2/755876.png,0,0.984244465827942,702,321,1356,975,654,654,twilight sparkle,graphenescloset
760039.png,https://derpicdn.net/img/view/2014/11/7/760039.png,0,0.9858320951461792,501,0,823,311,322,311,twilight sparkle,php41
760623.png,https://derpicdn.net/img/view/2014/11/8/760623.png,0,0.970327615737915,270,0,628,350,358,350,twilight sparkle,arnachy
763034.png,https://derpicdn.net/img/view/2014/11/12/763034.png,0,0.998519778251648,226,29,600,403,374,374,twilight sparkle,kucchi
770899.png,https://derpicdn.net/img/view/2014/11/24/770899.png,0,0.9809658527374268,44,0,422,363,378,363,twilight sparkle,alasou
770972.png,https://derpicdn.net/img/view/2014/11/24/770972.png,0,0.982011079788208,221,15,789,583,568,568,twilight sparkle,atane27
773882.png,https://derpicdn.net/img/view/2014/11/29/773882.png,0,0.9744635224342346,217,0,737,458,520,458,twilight sparkle,lopoddity
776347.png,https://derpicdn.net/img/view/2014/12/2/776347.png,0,0.987252414226532,333,313,1161,1141,828,828,twilight sparkle,lopoddity
777499.png,https://derpicdn.net/img/view/2014/12/4/777499.png,0,0.9405279159545898,0,128,418,550,418,422,twilight sparkle,lumineko
779849.png,https://derpicdn.net/img/view/2014/12/7/779849.png,0,0.9908325672149658,112,138,752,778,640,640,twilight sparkle,starshinebeast
781331.png,https://derpicdn.net/img/view/2014/12/9/781331.png,0,0.977482795715332,332,8,656,332,324,324,twilight sparkle,lamia
784293.png,https://derpicdn.net/img/view/2014/12/13/784293.png,0,0.9993727207183838,3060,0,5868,2717,2808,2717,twilight sparkle,slb94
784583.png,https://derpicdn.net/img/view/2014/12/14/784583.png,0,0.9871453642845154,93,90,2177,2174,2084,2084,twilight sparkle,captainpudgemuffin
784880.png,https://derpicdn.net/img/view/2014/12/14/784880.png,0,0.9749698042869568,191,20,1105,934,914,914,twilight sparkle,chingilin
78824.jpg,https://derpicdn.net/img/view/2012/8/20/78824.jpg,0,0.9818424582481384,422,69,776,423,354,354,twilight sparkle,otakuap
790063.png,https://derpicdn.net/img/view/2014/12/22/790063.png,0,0.9873464107513428,905,183,1379,657,474,474,twilight sparkle,jcosneverexisted
790630.png,https://derpicdn.net/img/view/2014/12/22/790630.png,0,0.96937757730484,0,0,427,556,427,556,twilight sparkle,
797572.jpg,https://derpicdn.net/img/view/2015/1/1/797572.jpg,0,0.9916095733642578,323,30,867,574,544,544,twilight sparkle,mad'n evil
797845.png,https://derpicdn.net/img/view/2015/1/2/797845.png,0,0.9901390671730042,624,0,1254,609,630,609,twilight sparkle,ambris
798946.png,https://derpicdn.net/img/view/2015/1/3/798946.png,0,0.9915058016777042,339,0,769,411,430,411,twilight sparkle,phurie
800412.png,https://derpicdn.net/img/view/2015/1/6/800412.png,0,0.9992255568504332,138,0,854,711,716,711,twilight sparkle,ambris
800414.png,https://derpicdn.net/img/view/2015/1/6/800414.png,0,0.997502326965332,119,0,875,729,756,729,twilight sparkle,ambris
800415.png,https://derpicdn.net/img/view/2015/1/6/800415.png,0,0.9989718794822692,142,2,842,702,700,700,twilight sparkle,ambris
80167.jpg,https://derpicdn.net/img/view/2012/8/22/80167.jpg,0,0.9983286261558532,231,0,445,207,214,207,twilight sparkle,miu
802337.jpg,https://derpicdn.net/img/view/2015/1/8/802337.jpg,0,0.988349974155426,825,0,1477,534,652,534,twilight sparkle,arareroll
803454.jpg,https://derpicdn.net/img/view/2015/1/10/803454.jpg,0,0.975189745426178,85,0,675,567,590,567,twilight sparkle,kejifox
803972.png,https://derpicdn.net/img/view/2015/1/11/803972.png,0,0.9754908680915833,44,0,524,450,480,450,twilight sparkle,nekubi
809149.jpg,https://derpicdn.net/img/view/2015/1/18/809149.jpg,0,0.939149022102356,129,0,795,668,666,668,twilight sparkle,yakovlev-vad
810949.png,https://derpicdn.net/img/view/2015/1/20/810949.png,0,0.987606406211853,440,58,1036,654,596,596,twilight sparkle,hidden-cat
814476.png,https://derpicdn.net/img/view/2015/1/25/814476.png,0,0.9806273579597472,254,39,930,715,676,676,twilight sparkle,sion-ara
814673.png,https://derpicdn.net/img/view/2015/1/25/814673.png,0,0.9495838284492492,244,0,608,352,364,352,twilight sparkle,danmakuman|ponyguy67
815955.png,https://derpicdn.net/img/view/2015/1/27/815955.png,0,0.9802995324134828,4,0,440,435,436,435,twilight sparkle,ponut_joe
815958.png,https://derpicdn.net/img/view/2015/1/27/815958.png,0,0.9989601969718932,659,0,1277,600,618,600,twilight sparkle,ponut_joe
818283.png,https://derpicdn.net/img/view/2015/1/31/818283.png,0,0.9267745018005372,223,0,1595,1033,1372,1033,twilight sparkle,xwhitedreamsx
819754.png,https://derpicdn.net/img/view/2015/2/2/819754.png,0,0.916528046131134,130,0,278,141,148,141,twilight sparkle,vdru7
822115.png,https://derpicdn.net/img/view/2015/2/5/822115.png,0,0.9909285902976992,46,0,464,374,418,374,twilight sparkle,suzuii
823139.png,https://derpicdn.net/img/view/2015/2/7/823139.png,0,0.999737560749054,429,0,885,378,456,378,twilight sparkle,lopoddity
823879.png,https://derpicdn.net/img/view/2015/2/8/823879.png,0,0.9934069514274596,696,0,1348,640,652,640,twilight sparkle,xenosaga428|adequality
824793.png,https://derpicdn.net/img/view/2015/2/9/824793.png,0,0.9996613264083862,68,1013,476,1421,408,408,twilight sparkle,cold-blooded-twilight
824793.png,https://derpicdn.net/img/view/2015/2/9/824793.png,2,0.9019657969474792,742,789,1266,1313,524,524,twilight sparkle,cold-blooded-twilight
825284.png,https://derpicdn.net/img/view/2015/2/10/825284.png,0,0.9935775399208068,19,0,900,1004,881,1004,twilight sparkle,tsitra360
825378.png,https://derpicdn.net/img/view/2015/2/10/825378.png,0,0.9903049468994141,119,6,1355,1242,1236,1236,twilight sparkle,lumineko
826847.png,https://derpicdn.net/img/view/2015/2/12/826847.png,0,0.9702461361885072,278,0,800,529,522,529,twilight sparkle,dattebayo681
828323.png,https://derpicdn.net/img/view/2015/2/14/828323.png,0,0.9779970645904541,352,224,628,500,276,276,twilight sparkle,arnachy
828374.png,https://derpicdn.net/img/view/2015/2/14/828374.png,0,0.9851754903793336,228,117,590,479,362,362,twilight sparkle,adequality|trickydick
83036.png,https://derpicdn.net/img/view/2012/8/26/83036.png,0,0.9822879433631896,149,251,907,1009,758,758,twilight sparkle,rubypm
832434.png,https://derpicdn.net/img/view/2015/2/19/832434.png,0,0.9264047145843506,325,0,999,670,674,670,twilight sparkle,madacon
833751.png,https://derpicdn.net/img/view/2015/2/21/833751.png,0,0.9965159893035888,336,0,778,417,442,417,twilight sparkle,phurie edits
834057.jpg,https://derpicdn.net/img/view/2015/2/21/834057.jpg,0,0.9773898720741272,19,16,457,454,438,438,twilight sparkle,jirousan
834306.png,https://derpicdn.net/img/view/2015/2/21/834306.png,0,0.9979021549224854,167,0,703,488,536,488,twilight sparkle,thebridgebuilder
836978.png,https://derpicdn.net/img/view/2015/2/25/836978.png,0,0.9195104837417604,532,118,730,316,198,198,twilight sparkle,sonicrocksmysocks
837040.png,https://derpicdn.net/img/view/2015/2/25/837040.png,0,0.97608745098114,187,0,828,624,641,624,twilight sparkle,rileyav
837626.png,https://derpicdn.net/img/view/2015/2/26/837626.png,0,0.9975181221961976,649,33,939,323,290,290,twilight sparkle,yoditax
837795.png,https://derpicdn.net/img/view/2015/2/26/837795.png,0,0.9939268827438354,144,22,652,530,508,508,twilight sparkle,kp-shadowsquirrel
839976.png,https://derpicdn.net/img/view/2015/3/1/839976.png,0,0.986769437789917,21,0,299,273,278,273,twilight sparkle,baekgup
8400.png,https://derpicdn.net/img/view/2012/6/18/8400.png,0,0.9914501309394836,359,55,889,585,530,530,twilight sparkle,rainbow
841256.png,https://derpicdn.net/img/view/2015/3/3/841256.png,1,0.975025475025177,4,0,394,375,390,375,twilight sparkle,cold-blooded-twilight
842069.png,https://derpicdn.net/img/view/2015/3/4/842069.png,0,0.9906046390533448,263,4,793,534,530,530,twilight sparkle,piesarts
842092.png,https://derpicdn.net/img/view/2015/3/4/842092.png,0,0.9777458310127258,0,78,1077,1260,1077,1182,twilight sparkle,sion-ara
842099.png,https://derpicdn.net/img/view/2015/3/4/842099.png,0,0.977194368839264,10,112,868,970,858,858,twilight sparkle,the1xeno1
848814.png,https://derpicdn.net/img/view/2015/3/13/848814.png,0,0.9766266345977784,1014,0,3144,1950,2130,1950,twilight sparkle,bri-sta|wodahseht
853347.png,https://derpicdn.net/img/view/2015/3/20/853347.png,0,0.9972380995750428,437,26,729,318,292,292,twilight sparkle,underpable
853347.png,https://derpicdn.net/img/view/2015/3/20/853347.png,1,0.9780645370483398,58,0,384,302,326,302,twilight sparkle,underpable
855513.png,https://derpicdn.net/img/view/2015/3/23/855513.png,0,0.9970886707305908,379,78,991,690,612,612,twilight sparkle,poisindoodles
857376.png,https://derpicdn.net/img/view/2015/3/26/857376.png,0,0.9965339899063108,242,0,1492,1205,1250,1205,twilight sparkle,captainpudgemuffin
858028.png,https://derpicdn.net/img/view/2015/3/27/858028.png,1,0.9672214388847352,901,86,1153,338,252,252,twilight sparkle,king-kakapo
860003.png,https://derpicdn.net/img/view/2015/3/29/860003.png,0,0.987593948841095,123,444,625,946,502,502,twilight sparkle,ambris
860434.png,https://derpicdn.net/img/view/2015/3/30/860434.png,0,0.9865143299102784,87,0,479,381,392,381,twilight sparkle,mewball
862250.png,https://derpicdn.net/img/view/2015/4/1/862250.png,0,0.9813787341117859,115,0,1000,912,885,912,twilight sparkle,m@k
863790.png,https://derpicdn.net/img/view/2015/4/3/863790.png,0,0.9721885323524476,225,0,1913,1622,1688,1622,twilight sparkle,skatalapu
864039.png,https://derpicdn.net/img/view/2015/4/3/864039.png,0,0.9639013409614564,126,52,414,340,288,288,twilight sparkle,toycake
865763.png,https://derpicdn.net/img/view/2015/4/5/865763.png,0,0.9677318930625916,159,0,800,654,641,654,twilight sparkle,mastgrr
868603.png,https://derpicdn.net/img/view/2015/4/8/868603.png,0,0.9317126274108888,531,134,1703,1306,1172,1172,twilight sparkle,heavymetalbronyyeah
871123.png,https://derpicdn.net/img/view/2015/4/11/871123.png,0,0.9786764979362488,654,1466,1174,1986,520,520,twilight sparkle,ncmares
871123.png,https://derpicdn.net/img/view/2015/4/11/871123.png,1,0.9685190320014954,480,869,962,1351,482,482,twilight sparkle,ncmares
871441.png,https://derpicdn.net/img/view/2015/4/11/871441.png,0,0.9223536252975464,0,0,2112,1963,2112,1963,twilight sparkle,xebck
871443.jpg,https://derpicdn.net/img/view/2015/4/11/871443.jpg,0,0.9969580769538879,10,0,600,540,590,540,twilight sparkle,moronsonofboron
871479.png,https://derpicdn.net/img/view/2015/4/11/871479.png,0,0.9800525307655334,0,19,678,707,678,688,twilight sparkle,raikoh
871490.png,https://derpicdn.net/img/view/2015/4/11/871490.png,0,0.9806090593338012,104,7,926,829,822,822,twilight sparkle,nekubi
871595.png,https://derpicdn.net/img/view/2015/4/11/871595.png,0,0.9982826113700868,399,1657,833,2091,434,434,twilight sparkle,esuka
871664.png,https://derpicdn.net/img/view/2015/4/11/871664.png,0,0.9949806928634644,1330,36,2152,858,822,822,twilight sparkle,10art1
871701.png,https://derpicdn.net/img/view/2015/4/11/871701.png,0,0.9821421504020692,377,32,759,414,382,382,twilight sparkle,novaspark
871731.png,https://derpicdn.net/img/view/2015/4/11/871731.png,0,0.9208836555480956,0,0,972,720,972,720,twilight sparkle,
871865.png,https://derpicdn.net/img/view/2015/4/11/871865.png,0,0.9920556545257568,0,0,2219,2284,2219,2284,twilight sparkle,dimfann
871914.png,https://derpicdn.net/img/view/2015/4/11/871914.png,0,0.9325786828994752,603,489,4806,4937,4203,4448,twilight sparkle,dashiesparkle
872000.png,https://derpicdn.net/img/view/2015/4/12/872000.png,0,0.985733687877655,865,909,5500,5717,4635,4808,twilight sparkle,gabrielwoj
872039.png,https://derpicdn.net/img/view/2015/4/12/872039.png,0,0.9962095022201538,1081,0,3139,2022,2058,2022,twilight sparkle,jetwave
872060.png,https://derpicdn.net/img/view/2015/4/12/872060.png,0,0.9362300634384156,124,0,730,591,606,591,twilight sparkle,lumelya
872500.png,https://derpicdn.net/img/view/2015/4/12/872500.png,0,0.9674981832504272,92,86,1223,1222,1131,1136,twilight sparkle,bymotika
872788.png,https://derpicdn.net/img/view/2015/4/12/872788.png,0,0.9980961084365844,51,75,469,493,418,418,twilight sparkle,taneysha
872890.png,https://derpicdn.net/img/view/2015/4/13/872890.png,0,0.9758408665657043,250,390,2840,2980,2590,2590,twilight sparkle,shedence
873291.png,https://derpicdn.net/img/view/2015/4/13/873291.png,0,0.9100956916809082,112,60,636,584,524,524,twilight sparkle,lance
873474.png,https://derpicdn.net/img/view/2015/4/13/873474.png,0,0.9829360246658324,0,45,1297,1413,1297,1368,twilight sparkle,london13ridges
873510.png,https://derpicdn.net/img/view/2015/4/13/873510.png,0,0.9754800796508788,1363,877,4806,4591,3443,3714,twilight sparkle,mrcbleck
873714.png,https://derpicdn.net/img/view/2015/4/14/873714.png,0,0.9620464444160458,1099,0,1701,533,602,533,twilight sparkle,lamia
873821.png,https://derpicdn.net/img/view/2015/4/14/873821.png,0,0.9865314960479736,0,0,961,957,961,957,twilight sparkle,alterhouse
873848.png,https://derpicdn.net/img/view/2015/4/14/873848.png,0,0.9718175530433656,0,0,409,340,409,340,twilight sparkle,baekgup
874011.png,https://derpicdn.net/img/view/2015/4/14/874011.png,0,0.9783178567886353,100,99,850,849,750,750,twilight sparkle,turtlefarminguy
875232.png,https://derpicdn.net/img/view/2015/4/16/875232.png,0,0.9956064820289612,544,499,768,723,224,224,twilight sparkle,30clock
875232.png,https://derpicdn.net/img/view/2015/4/16/875232.png,1,0.9945128560066224,111,0,371,256,260,256,twilight sparkle,30clock
875232.png,https://derpicdn.net/img/view/2015/4/16/875232.png,2,0.9611328244209292,407,70,777,440,370,370,twilight sparkle,30clock
876291.png,https://derpicdn.net/img/view/2015/4/17/876291.png,0,0.958159327507019,584,214,962,592,378,378,twilight sparkle,scootiebloom
876472.png,https://derpicdn.net/img/view/2015/4/18/876472.png,0,0.983281135559082,223,0,1441,1169,1218,1169,twilight sparkle,chickhawk96
876540.png,https://derpicdn.net/img/view/2015/4/18/876540.png,0,0.9918667674064636,1,0,827,755,826,755,twilight sparkle,3d thread|creatorofpony|borickrut
879621.png,https://derpicdn.net/img/view/2015/4/21/879621.png,0,0.9197223782539368,449,135,2543,2229,2094,2094,twilight sparkle,danmakuman
880720.png,https://derpicdn.net/img/view/2015/4/23/880720.png,0,0.9809076189994812,451,0,847,389,396,389,twilight sparkle,danmakuman|ponyguy67
881305.jpg,https://derpicdn.net/img/view/2015/4/24/881305.jpg,0,0.9976158738136292,459,0,1167,689,708,689,twilight sparkle,koveliana
882000.png,https://derpicdn.net/img/view/2015/4/25/882000.png,0,0.9974846839904784,506,63,896,453,390,390,twilight sparkle,ponut_joe
883624.png,https://derpicdn.net/img/view/2015/4/26/883624.png,0,0.9889389872550964,601,370,1463,1232,862,862,twilight sparkle,i-am-knot
885709.png,https://derpicdn.net/img/view/2015/4/30/885709.png,0,0.9866650104522704,270,34,614,378,344,344,twilight sparkle,lizombie
886275.png,https://derpicdn.net/img/view/2015/4/30/886275.png,0,0.9216466546058656,64,12,456,404,392,392,twilight sparkle,awesomecoolwhip
889268.png,https://derpicdn.net/img/view/2015/5/4/889268.png,0,0.9759206771850586,50,0,1110,1040,1060,1040,twilight sparkle,b-epon
891462.png,https://derpicdn.net/img/view/2015/5/8/891462.png,1,0.9899161458015442,222,21,752,551,530,530,twilight sparkle,lopoddity
891763.png,https://derpicdn.net/img/view/2015/5/8/891763.png,0,0.9948514103889464,223,50,791,618,568,568,twilight sparkle,rivibaes
892612.png,https://derpicdn.net/img/view/2015/5/10/892612.png,0,0.9978017210960388,236,0,700,513,464,513,twilight sparkle,fizzy-dog
892613.png,https://derpicdn.net/img/view/2015/5/10/892613.png,0,0.997660756111145,232,0,700,518,468,518,twilight sparkle,fizzy-dog
898230.png,https://derpicdn.net/img/view/2015/5/17/898230.png,0,0.9778699278831482,142,10,482,350,340,340,twilight sparkle,aymint
898578.png,https://derpicdn.net/img/view/2015/5/17/898578.png,0,0.9962791204452516,91,0,745,635,654,635,twilight sparkle,atryl
899110.png,https://derpicdn.net/img/view/2015/5/18/899110.png,0,0.9840009808540344,0,0,295,292,295,292,twilight sparkle,baekgup
900095.png,https://derpicdn.net/img/view/2015/5/19/900095.png,0,0.9766539931297302,0,0,1682,1668,1682,1668,twilight sparkle,rainbowscreen
903065.png,https://derpicdn.net/img/view/2015/5/24/903065.png,0,0.9846923351287842,107,0,1121,720,1014,720,twilight sparkle,ponut_joe
903775.png,https://derpicdn.net/img/view/2015/5/25/903775.png,0,0.9860457777976992,872,0,1856,974,984,974,twilight sparkle,nookturn|badgerben
904512.png,https://derpicdn.net/img/view/2015/5/26/904512.png,0,0.9336684346199036,37,0,405,326,368,326,twilight sparkle,youhoujou
905081.png,https://derpicdn.net/img/view/2015/5/27/905081.png,0,0.9950569868087769,55,99,529,573,474,474,twilight sparkle,ushiro no kukan
910084.png,https://derpicdn.net/img/view/2015/6/4/910084.png,0,0.9986901879310608,655,157,1247,749,592,592,twilight sparkle,kp-shadowsquirrel
91174.png,https://derpicdn.net/img/view/2012/9/6/91174.png,0,0.9766358137130736,34,429,244,639,210,210,twilight sparkle,kturtle
913013.png,https://derpicdn.net/img/view/2015/6/8/913013.png,0,0.9262043237686156,214,79,754,619,540,540,twilight sparkle,shadowhulk
913302.png,https://derpicdn.net/img/view/2015/6/8/913302.png,0,0.987266719341278,129,0,1944,1823,1815,1823,twilight sparkle,mistydash
914003.png,https://derpicdn.net/img/view/2015/6/10/914003.png,0,0.9981396794319152,219,15,485,281,266,266,twilight sparkle,kevinsano
914991.png,https://derpicdn.net/img/view/2015/6/11/914991.png,0,0.9723524451255798,281,16,903,638,622,622,twilight sparkle,glacierclear
915003.png,https://derpicdn.net/img/view/2015/6/11/915003.png,0,0.9991840720176696,1282,24,1980,722,698,698,twilight sparkle,lavalord50
915474.png,https://derpicdn.net/img/view/2015/6/12/915474.png,0,0.9593902230262756,110,4,528,422,418,418,twilight sparkle,oneofyouare
916787.png,https://derpicdn.net/img/view/2015/6/14/916787.png,0,0.911814272403717,140,492,970,1322,830,830,twilight sparkle,sion
919758.png,https://derpicdn.net/img/view/2015/6/19/919758.png,0,0.9777523279190063,111,477,717,1083,606,606,twilight sparkle,darkflame75
920237.png,https://derpicdn.net/img/view/2015/6/20/920237.png,0,0.9936392307281494,1235,45,2849,1659,1614,1614,twilight sparkle,heavymetalbronyyeah
920699.png,https://derpicdn.net/img/view/2015/6/21/920699.png,0,0.969646453857422,227,36,733,542,506,506,twilight sparkle,1trick
921583.png,https://derpicdn.net/img/view/2015/6/22/921583.png,0,0.9694315195083618,61,13,845,797,784,784,twilight sparkle,elzielai
922194.png,https://derpicdn.net/img/view/2015/6/23/922194.png,0,0.9992679953575134,303,64,615,376,312,312,twilight sparkle,chickhawk96
922960.png,https://derpicdn.net/img/view/2015/6/24/922960.png,0,0.9553128480911256,189,126,885,822,696,696,twilight sparkle,bobdude0
924457.png,https://derpicdn.net/img/view/2015/6/27/924457.png,0,0.9954655170440674,215,257,545,587,330,330,twilight sparkle,northernsprint
924832.jpg,https://derpicdn.net/img/view/2015/6/27/924832.jpg,0,0.9910612702369692,7,0,981,917,974,917,twilight sparkle,
924899.png,https://derpicdn.net/img/view/2015/6/27/924899.png,0,0.9473084807395936,157,0,1393,1017,1236,1017,twilight sparkle,
925210.png,https://derpicdn.net/img/view/2015/6/28/925210.png,0,0.9963802695274352,141,50,483,392,342,342,twilight sparkle,atteez
925661.png,https://derpicdn.net/img/view/2015/6/28/925661.png,0,0.9955295920372008,230,0,878,635,648,635,twilight sparkle,silverromance|raver1357
926292.jpg,https://derpicdn.net/img/view/2015/6/29/926292.jpg,0,0.9912091493606568,1436,415,2048,1043,612,628,twilight sparkle,snapai
927785.png,https://derpicdn.net/img/view/2015/7/1/927785.png,0,0.9934530258178712,0,0,1675,1742,1675,1742,twilight sparkle,discorded
927789.png,https://derpicdn.net/img/view/2015/7/1/927789.png,0,0.9653033018112184,48,57,1412,1421,1364,1364,twilight sparkle,discorded
929898.png,https://derpicdn.net/img/view/2015/7/4/929898.png,0,0.9951505064964294,1,31,471,501,470,470,twilight sparkle,luciferamon
929898.png,https://derpicdn.net/img/view/2015/7/4/929898.png,1,0.9666067957878112,302,37,790,525,488,488,twilight sparkle,luciferamon
929905.png,https://derpicdn.net/img/view/2015/7/4/929905.png,1,0.9617738723754884,732,584,1064,916,332,332,twilight sparkle,esuka
930351.png,https://derpicdn.net/img/view/2015/7/5/930351.png,0,0.9977248907089232,1021,85,1745,809,724,724,twilight sparkle,gsphere
931132.png,https://derpicdn.net/img/view/2015/7/6/931132.png,0,0.9574942588806152,109,213,645,749,536,536,twilight sparkle,thattagen
932590.png,https://derpicdn.net/img/view/2015/7/8/932590.png,0,0.970148503780365,0,0,1880,1690,1880,1690,twilight sparkle,mistydash
932604.png,https://derpicdn.net/img/view/2015/7/8/932604.png,1,0.957840859889984,85,157,553,625,468,468,twilight sparkle,sion-ara
932679.png,https://derpicdn.net/img/view/2015/7/8/932679.png,0,0.9935097098350524,0,0,504,512,504,512,twilight sparkle,jovalic
932792.png,https://derpicdn.net/img/view/2015/7/8/932792.png,0,0.9822742938995358,4,0,460,441,456,441,twilight sparkle,danmakuman
933505.png,https://derpicdn.net/img/view/2015/7/9/933505.png,0,0.9851771593093872,228,117,590,479,362,362,twilight sparkle,trickydick|adequality
9337.png,https://derpicdn.net/img/view/2012/6/19/9337.png,0,0.9696531891822816,103,0,429,291,326,291,twilight sparkle,rainbow
934155.png,https://derpicdn.net/img/view/2015/7/10/934155.png,0,0.969626247882843,169,61,655,547,486,486,twilight sparkle,k-nattoh
934260.jpg,https://derpicdn.net/img/view/2015/7/10/934260.jpg,0,0.9816927313804626,600,133,1014,547,414,414,twilight sparkle,shimizu
937184.png,https://derpicdn.net/img/view/2015/7/15/937184.png,0,0.9912258386611938,88,0,708,570,620,570,twilight sparkle,ihara
938066.jpg,https://derpicdn.net/img/view/2015/7/16/938066.jpg,0,0.9781042337417604,40,4,390,354,350,350,twilight sparkle,hobbes-maxwell
939454.png,https://derpicdn.net/img/view/2015/7/18/939454.png,0,0.9701785445213318,2,0,733,729,731,729,twilight sparkle,ratofdrawn
939978.png,https://derpicdn.net/img/view/2015/7/19/939978.png,0,0.9944692254066468,31,0,659,579,628,579,twilight sparkle,danli69
943084.jpg,https://derpicdn.net/img/view/2015/7/24/943084.jpg,0,0.9842554330825806,744,0,2226,1353,1482,1353,twilight sparkle,alcor
943243.jpg,https://derpicdn.net/img/view/2015/7/25/943243.jpg,0,0.9911589026451112,250,433,646,829,396,396,twilight sparkle,sweetsound
943305.png,https://derpicdn.net/img/view/2015/7/25/943305.png,0,0.9918777346611024,270,18,1474,1222,1204,1204,twilight sparkle,php16|scobionicle99
947661.jpg,https://derpicdn.net/img/view/2015/7/31/947661.jpg,0,0.9820538759231568,0,0,2021,1831,2021,1831,twilight sparkle,captainpudgemuffin
947954.png,https://derpicdn.net/img/view/2015/7/31/947954.png,0,0.9976141452789308,405,48,735,378,330,330,twilight sparkle,lopoddity
949549.png,https://derpicdn.net/img/view/2015/8/3/949549.png,0,0.9982708096504213,225,0,775,525,550,525,twilight sparkle,fladdykin
950618.png,https://derpicdn.net/img/view/2015/8/4/950618.png,0,0.933483064174652,16,0,3000,3031,2984,3031,twilight sparkle,bugplayer
952054.png,https://derpicdn.net/img/view/2015/8/6/952054.png,0,0.9669522643089294,294,15,632,353,338,338,twilight sparkle,lillayfran
952217.jpg,https://derpicdn.net/img/view/2015/8/6/952217.jpg,0,0.999375820159912,940,24,1930,1014,990,990,twilight sparkle,nikoh
952948.png,https://derpicdn.net/img/view/2015/8/7/952948.png,0,0.9921401739120485,220,0,728,476,508,476,twilight sparkle,ushiro no kukan
953235.png,https://derpicdn.net/img/view/2015/8/7/953235.png,0,0.9029033184051514,30,75,496,541,466,466,twilight sparkle,underpable
954815.png,https://derpicdn.net/img/view/2015/8/10/954815.png,0,0.9832062125205994,534,146,1258,870,724,724,twilight sparkle,danli69
955971.png,https://derpicdn.net/img/view/2015/8/12/955971.png,0,0.9914233684539796,431,0,861,400,430,400,twilight sparkle,akeahi
959795.png,https://derpicdn.net/img/view/2015/8/17/959795.png,0,0.9400885701179504,100,13,694,607,594,594,twilight sparkle,baffleddingo
962042.jpg,https://derpicdn.net/img/view/2015/8/20/962042.jpg,0,0.9770454168319702,180,0,1732,1503,1552,1503,twilight sparkle,rain-gear
962286.png,https://derpicdn.net/img/view/2015/8/21/962286.png,0,0.9488772749900818,356,86,886,616,530,530,twilight sparkle,poisindoodles
963047.png,https://derpicdn.net/img/view/2015/8/22/963047.png,0,0.9671982526779176,622,67,892,337,270,270,twilight sparkle,suirano
963617.png,https://derpicdn.net/img/view/2015/8/23/963617.png,0,0.9809024930000304,0,0,1240,1236,1240,1236,twilight sparkle,acleps
963768.png,https://derpicdn.net/img/view/2015/8/23/963768.png,0,0.9807365536689758,4,0,734,689,730,689,twilight sparkle,mlpfwb
964446.jpg,https://derpicdn.net/img/view/2015/8/24/964446.jpg,0,0.9890370965003968,436,82,1244,890,808,808,twilight sparkle,captainpudgemuffin
965304.png,https://derpicdn.net/img/view/2015/8/25/965304.png,0,0.998685359954834,443,61,1339,957,896,896,twilight sparkle,mailinya
965304.png,https://derpicdn.net/img/view/2015/8/25/965304.png,1,0.9921912550926208,1200,78,2162,1040,962,962,twilight sparkle,mailinya
966332.png,https://derpicdn.net/img/view/2015/8/26/966332.png,0,0.9880222678184508,171,32,891,752,720,720,twilight sparkle,alasou
966624.png,https://derpicdn.net/img/view/2015/8/27/966624.png,0,0.9572157859802246,477,67,1451,1041,974,974,twilight sparkle,sheandog
967844.png,https://derpicdn.net/img/view/2015/8/29/967844.png,0,0.9982603788375854,539,0,1161,582,622,582,twilight sparkle,ambris
967886.png,https://derpicdn.net/img/view/2015/8/29/967886.png,0,0.98379784822464,1493,0,2883,1378,1390,1378,twilight sparkle,leafbunny
968014.png,https://derpicdn.net/img/view/2015/8/29/968014.png,0,0.9302000999450684,367,31,829,493,462,462,twilight sparkle,kkuyo
971275.png,https://derpicdn.net/img/view/2015/9/2/971275.png,0,0.9953181147575378,318,73,1278,1033,960,960,twilight sparkle,skipsy
974586.jpg,https://derpicdn.net/img/view/2015/9/7/974586.jpg,0,0.9969662427902222,275,0,2495,1801,2220,1801,twilight sparkle,captainpudgemuffin
975696.png,https://derpicdn.net/img/view/2015/9/9/975696.png,0,0.9799071550369264,163,45,663,545,500,500,twilight sparkle,voraire
976076.png,https://derpicdn.net/img/view/2015/9/9/976076.png,0,0.9917782545089722,127,0,593,423,466,423,twilight sparkle,hioshiru
976732.png,https://derpicdn.net/img/view/2015/9/10/976732.png,0,0.9025879502296448,692,246,1358,912,666,666,twilight sparkle,thegreatrouge
977781.png,https://derpicdn.net/img/view/2015/9/12/977781.png,0,0.9985222220420836,739,10,1525,796,786,786,twilight sparkle,sourspot
978125.png,https://derpicdn.net/img/view/2015/9/12/978125.png,0,0.9828941226005554,266,357,912,1003,646,646,twilight sparkle,discorded
978125.png,https://derpicdn.net/img/view/2015/9/12/978125.png,1,0.969209849834442,1967,621,2489,1143,522,522,twilight sparkle,discorded
978125.png,https://derpicdn.net/img/view/2015/9/12/978125.png,2,0.9628140926361084,1045,593,1543,1091,498,498,twilight sparkle,discorded
978231.png,https://derpicdn.net/img/view/2015/9/12/978231.png,0,0.9908269047737122,154,70,434,350,280,280,twilight sparkle,lumineko
978279.png,https://derpicdn.net/img/view/2015/9/12/978279.png,0,0.9407601356506348,392,0,794,400,402,400,twilight sparkle,d-lowell
984749.png,https://derpicdn.net/img/view/2015/9/21/984749.png,0,0.9417381286621094,0,92,2049,2272,2049,2180,twilight sparkle,nxyde
986058.png,https://derpicdn.net/img/view/2015/9/23/986058.png,0,0.9942765831947328,110,0,864,676,754,676,twilight sparkle,lattynskit|dripponi
987092.png,https://derpicdn.net/img/view/2015/9/24/987092.png,0,0.9892513155937196,181,4,467,290,286,286,twilight sparkle,weasselk
991331.png,https://derpicdn.net/img/view/2015/9/30/991331.png,0,0.9804581999778748,70,0,790,627,720,627,twilight sparkle,lunarmarshmallow
992826.png,https://derpicdn.net/img/view/2015/10/2/992826.png,0,0.992786705493927,435,85,806,495,371,410,twilight sparkle,tjpones
993619.jpg,https://derpicdn.net/img/view/2015/10/3/993619.jpg,0,0.9802985191345216,157,88,613,544,456,456,twilight sparkle,caibaoreturn
993619.jpg,https://derpicdn.net/img/view/2015/10/3/993619.jpg,1,0.9756087064743042,618,74,1058,514,440,440,twilight sparkle,caibaoreturn
994691.png,https://derpicdn.net/img/view/2015/10/4/994691.png,0,0.9887550473213196,270,0,604,320,334,320,twilight sparkle,zwitterkitsune
994969.png,https://derpicdn.net/img/view/2015/10/5/994969.png,0,0.9576252698898317,297,0,1233,896,936,896,twilight sparkle,mricantdraw
998040.png,https://derpicdn.net/img/view/2015/10/9/998040.png,0,0.9682614803314208,315,24,799,508,484,484,twilight sparkle,3mangos
998226.jpg,https://derpicdn.net/img/view/2015/10/10/998226.jpg,0,0.917760968208313,79,0,403,296,324,296,twilight sparkle,yukandasama
999524.png,https://derpicdn.net/img/view/2015/10/11/999524.png,0,0.9894328713417052,1,16,693,708,692,692,twilight sparkle,maggwai
1001995.jpg,https://derpicdn.net/img/view/2015/10/14/1001995.jpg,0,0.9669668674468994,187,0,1151,856,964,856,twilight sparkle,acesential
1003822.png,https://derpicdn.net/img/view/2015/10/17/1003822.png,0,0.9957581162452698,19,28,505,514,486,486,twilight sparkle,glacierclear edits|happygnarwal
1006385.jpg,https://derpicdn.net/img/view/2015/10/20/1006385.jpg,0,0.9657216668128968,91,24,1187,1120,1096,1096,twilight sparkle,unousaya
1006888.png,https://derpicdn.net/img/view/2015/10/21/1006888.png,0,0.9768983125686646,542,875,1800,2133,1258,1258,twilight sparkle,stinkehund
1008628.png,https://derpicdn.net/img/view/2015/10/24/1008628.png,0,0.992218554019928,114,60,518,464,404,404,twilight sparkle,9seconds
1009718.png,https://derpicdn.net/img/view/2015/10/25/1009718.png,0,0.9851978421211244,36,0,484,428,448,428,twilight sparkle,persikstuff|vernumis
1010511.png,https://derpicdn.net/img/view/2015/10/28/1010511.png,0,0.9415900707244872,1013,125,1571,683,558,558,twilight sparkle,gign-3208
1010624.png,https://derpicdn.net/img/view/2015/10/28/1010624.png,0,0.9358902573585508,257,0,647,375,390,375,twilight sparkle,tjpones
1011620.png,https://derpicdn.net/img/view/2015/10/29/1011620.png,0,0.9612826704978944,545,347,1257,1059,712,712,twilight sparkle,b00mt00b
1011652.jpg,https://derpicdn.net/img/view/2015/10/29/1011652.jpg,0,0.9852902293205258,79,8,297,226,218,218,twilight sparkle,moonagvaze
1012054.png,https://derpicdn.net/img/view/2015/10/29/1012054.png,0,0.9682266116142272,325,53,967,695,642,642,twilight sparkle,alasou
1012423.png,https://derpicdn.net/img/view/2015/10/30/1012423.png,0,0.996639847755432,471,0,1753,1097,1282,1097,twilight sparkle,sketchmcreations
1012879.jpg,https://derpicdn.net/img/view/2015/10/31/1012879.jpg,0,0.980592966079712,36,102,416,482,380,380,twilight sparkle,braffy
1013064.png,https://derpicdn.net/img/view/2015/10/31/1013064.png,0,0.9961966872215272,4615,0,6863,2008,2248,2008,twilight sparkle,eagle1division|krusiu42
1013520.png,https://derpicdn.net/img/view/2015/10/31/1013520.png,0,0.9943915605545044,2682,369,3156,869,474,500,twilight sparkle,badumsquish
1013558.png,https://derpicdn.net/img/view/2015/10/31/1013558.png,0,0.9231996536254884,512,204,1222,914,710,710,twilight sparkle,eosphorite
1014423.png,https://derpicdn.net/img/view/2015/11/1/1014423.png,0,0.9914996027946472,0,11,269,293,269,282,twilight sparkle,deusexequus
1015562.png,https://derpicdn.net/img/view/2015/11/3/1015562.png,0,0.9931459426879884,1685,0,4693,2852,3008,2852,twilight sparkle,itv-canterlot
1018217.png,https://derpicdn.net/img/view/2015/11/7/1018217.png,0,0.9062854051589966,21,20,443,442,422,422,twilight sparkle,
1020673.png,https://derpicdn.net/img/view/2015/11/11/1020673.png,0,0.9817575216293336,573,101,1467,995,894,894,twilight sparkle,sourspot
1022069.jpg,https://derpicdn.net/img/view/2015/11/13/1022069.jpg,0,0.9992098808288574,0,3,354,361,354,358,twilight sparkle,mad'n evil
1022238.png,https://derpicdn.net/img/view/2015/11/13/1022238.png,0,0.9645147323608398,0,252,1837,2752,1837,2500,twilight sparkle,shutterflyeqd
1023314.png,https://derpicdn.net/img/view/2015/11/15/1023314.png,0,0.9830815196037292,0,84,2357,2686,2357,2602,twilight sparkle,xebck
1023513.png,https://derpicdn.net/img/view/2015/11/15/1023513.png,0,0.9945080280303956,103,0,705,519,602,519,twilight sparkle,perinia
1023522.png,https://derpicdn.net/img/view/2015/11/15/1023522.png,0,0.9728060960769652,0,43,3283,3543,3283,3500,twilight sparkle,speedox12
1023593.png,https://derpicdn.net/img/view/2015/11/15/1023593.png,0,0.9959051609039308,0,0,828,821,828,821,twilight sparkle,the1xeno1
1024781.png,https://derpicdn.net/img/view/2015/11/17/1024781.png,0,0.9304869771003724,0,0,2638,2614,2638,2614,twilight sparkle,vaderpl
1025381.png,https://derpicdn.net/img/view/2015/11/18/1025381.png,0,0.99334454536438,3471,274,7000,3982,3529,3708,twilight sparkle,luckreza8
1028882.png,https://derpicdn.net/img/view/2015/11/23/1028882.png,0,0.9914430975914,397,116,633,352,236,236,twilight sparkle,icebergi
1029318.png,https://derpicdn.net/img/view/2015/11/24/1029318.png,0,0.9980419874191284,0,0,1377,1359,1377,1359,twilight sparkle,bjorn-bi
1033846.png,https://derpicdn.net/img/view/2015/11/30/1033846.png,0,0.9946208000183104,463,820,4699,5000,4236,4180,twilight sparkle,lunahazacookie
1033847.png,https://derpicdn.net/img/view/2015/11/30/1033847.png,0,0.9919416904449464,19,0,395,339,376,339,twilight sparkle,momogatari
1035007.png,https://derpicdn.net/img/view/2015/12/2/1035007.png,0,0.9229731559753418,1042,1573,3930,4987,2888,3414,twilight sparkle,bluethunder66
1036160.png,https://derpicdn.net/img/view/2015/12/3/1036160.png,0,0.9979898929595948,235,173,737,675,502,502,twilight sparkle,alasou
1040332.png,https://derpicdn.net/img/view/2015/12/9/1040332.png,0,0.9176781177520752,588,17,984,413,396,396,twilight sparkle,dm29
1050403.png,https://derpicdn.net/img/view/2015/12/22/1050403.png,0,0.9870205521583556,2949,0,5963,2757,3014,2757,twilight sparkle,slb94
1050985.png,https://derpicdn.net/img/view/2015/12/23/1050985.png,0,0.9990845322608948,397,0,947,535,550,535,twilight sparkle,cherivinca
1052130.png,https://derpicdn.net/img/view/2015/12/25/1052130.png,0,0.98729807138443,789,0,1683,888,894,888,twilight sparkle,arcuswind
1053171.png,https://derpicdn.net/img/view/2015/12/26/1053171.png,0,0.990522027015686,478,908,1000,1430,522,522,twilight sparkle,silbersternenlicht
1054039.jpg,https://derpicdn.net/img/view/2015/12/28/1054039.jpg,0,0.9777109622955322,39,5,447,413,408,408,twilight sparkle,conoghi
1057155.png,https://derpicdn.net/img/view/2016/1/1/1057155.png,0,0.9556978344917296,70,0,460,365,390,365,twilight sparkle,mt
1057386.png,https://derpicdn.net/img/view/2016/1/1/1057386.png,0,0.9754549264907836,1295,405,1959,1069,664,664,twilight sparkle,loukaina
1057404.png,https://derpicdn.net/img/view/2016/1/1/1057404.png,0,0.9994056224822998,518,34,1104,620,586,586,twilight sparkle,miss-cats
1059137.png,https://derpicdn.net/img/view/2016/1/4/1059137.png,1,0.9916943907737732,374,341,770,737,396,396,twilight sparkle,wizardski
1059281.png,https://derpicdn.net/img/view/2016/1/4/1059281.png,0,0.9605975151062012,289,40,819,572,530,532,twilight sparkle,varemia
1059718.png,https://derpicdn.net/img/view/2016/1/4/1059718.png,0,0.9969735741615297,158,0,1230,1020,1072,1020,twilight sparkle,davidsfire
1060138.png,https://derpicdn.net/img/view/2016/1/5/1060138.png,0,0.9877256751060486,299,0,4980,4834,4681,4834,twilight sparkle,estrill|slb94
1060167.png,https://derpicdn.net/img/view/2016/1/5/1060167.png,0,0.9954797625541688,1896,0,3500,1582,1604,1582,twilight sparkle,xebck
1060401.png,https://derpicdn.net/img/view/2016/1/5/1060401.png,0,0.9923969507217408,216,0,628,412,412,412,twilight sparkle,fizzy-dog
1064070.png,https://derpicdn.net/img/view/2016/1/11/1064070.png,0,0.994412899017334,412,0,1354,884,942,884,twilight sparkle,ariot
106409.jpg,https://derpicdn.net/img/view/2012/9/25/106409.jpg,0,0.9669291973114014,122,67,574,519,452,452,twilight sparkle,freedomthai
1064395.png,https://derpicdn.net/img/view/2016/1/11/1064395.png,0,0.9947274923324584,308,161,518,371,210,210,twilight sparkle,n3moni
1064859.png,https://derpicdn.net/img/view/2016/1/12/1064859.png,0,0.991908609867096,283,0,833,523,550,523,twilight sparkle,dragonfoxgirl
1065066.png,https://derpicdn.net/img/view/2016/1/12/1065066.png,0,0.9891964197158812,413,0,1231,781,818,781,twilight sparkle,camo-pony
1065410.png,https://derpicdn.net/img/view/2016/1/12/1065410.png,0,0.996643602848053,3568,0,5874,2209,2306,2209,twilight sparkle,lil miss jay|slb94
1065503.png,https://derpicdn.net/img/view/2016/1/13/1065503.png,0,0.9889766573905944,188,145,570,527,382,382,twilight sparkle,rwl
1066852.jpg,https://derpicdn.net/img/view/2016/1/15/1066852.jpg,0,0.9992664456367492,200,76,498,374,298,298,twilight sparkle,sibashen
1068371.png,https://derpicdn.net/img/view/2016/1/17/1068371.png,0,0.9976248741149902,172,33,456,317,284,284,twilight sparkle,sonork91
1069468.png,https://derpicdn.net/img/view/2016/1/19/1069468.png,0,0.9521384835243224,2498,169,4546,2217,2048,2048,twilight sparkle,aureai
1071868.png,https://derpicdn.net/img/view/2016/1/23/1071868.png,0,0.9848936200141908,8,0,900,851,892,851,twilight sparkle,
1074460.png,https://derpicdn.net/img/view/2016/1/27/1074460.png,0,0.9898292422294616,124,82,436,394,312,312,twilight sparkle,its-gloomy
1077219.png,https://derpicdn.net/img/view/2016/1/31/1077219.png,0,0.934867799282074,308,0,1218,946,910,946,twilight sparkle,furrgroup
1078063.png,https://derpicdn.net/img/view/2016/2/1/1078063.png,0,0.9958472251892092,463,29,2367,1933,1904,1904,twilight sparkle,10art1
1078121.png,https://derpicdn.net/img/view/2016/2/1/1078121.png,0,0.9171507358551024,449,0,1159,684,710,684,twilight sparkle,cherivinca
1080020.png,https://derpicdn.net/img/view/2016/2/4/1080020.png,0,0.968028962612152,48,75,580,607,532,532,twilight sparkle,tjpones
1082393.png,https://derpicdn.net/img/view/2016/2/7/1082393.png,0,0.9962313175201416,417,219,895,697,478,478,twilight sparkle,turtlefarminguy
1083335.png,https://derpicdn.net/img/view/2016/2/8/1083335.png,0,0.9981167912483216,0,26,2957,3302,2957,3276,twilight sparkle,byteslice
1084689.png,https://derpicdn.net/img/view/2016/2/10/1084689.png,0,0.9707592129707336,0,915,2906,4175,2906,3260,twilight sparkle,midnightfunny
1086984.png,https://derpicdn.net/img/view/2016/2/13/1086984.png,0,0.9725895524024964,445,0,1465,990,1020,990,twilight sparkle,mili-kat
1089834.png,https://derpicdn.net/img/view/2016/2/16/1089834.png,0,0.99784255027771,275,0,1087,700,812,700,twilight sparkle,geraritydevillefort
1089892.jpg,https://derpicdn.net/img/view/2016/2/16/1089892.jpg,0,0.9832056164741516,169,28,973,832,804,804,twilight sparkle,bgf
1089991.png,https://derpicdn.net/img/view/2016/2/16/1089991.png,0,0.9862030744552612,1133,0,2007,828,874,828,twilight sparkle,sirzi
1094510.jpg,https://derpicdn.net/img/view/2016/2/22/1094510.jpg,0,0.965861976146698,48,61,488,501,440,440,twilight sparkle,weirdandweirder
1098915.png,https://derpicdn.net/img/view/2016/2/28/1098915.png,0,0.9773749113082886,1,0,501,441,500,441,twilight sparkle,dusthiel
1100403.png,https://derpicdn.net/img/view/2016/3/2/1100403.png,0,0.9900150299072266,9,69,379,405,370,336,twilight sparkle,
1100403.png,https://derpicdn.net/img/view/2016/3/2/1100403.png,1,0.9197847247123718,87,1,405,355,318,354,twilight sparkle,
1101104.png,https://derpicdn.net/img/view/2016/3/3/1101104.png,0,0.990627646446228,279,71,593,385,314,314,twilight sparkle,pon-ee
1103544.jpg,https://derpicdn.net/img/view/2016/3/7/1103544.jpg,0,0.9299123287200928,254,14,564,324,310,310,twilight sparkle,carnifex
1103547.jpg,https://derpicdn.net/img/view/2016/3/7/1103547.jpg,0,0.9320875406265259,250,7,568,325,318,318,twilight sparkle,carnifex
1103550.jpg,https://derpicdn.net/img/view/2016/3/7/1103550.jpg,0,0.9940770268440248,264,6,566,308,302,302,twilight sparkle,carnifex
1103929.png,https://derpicdn.net/img/view/2016/3/7/1103929.png,0,0.9890632033348083,2860,312,4260,1712,1400,1400,twilight sparkle,ampgamer|lunebat
1103930.png,https://derpicdn.net/img/view/2016/3/7/1103930.png,0,0.9768701791763306,0,42,1014,1108,1014,1066,twilight sparkle,joakaha
1105442.png,https://derpicdn.net/img/view/2016/3/9/1105442.png,0,0.9533127546310424,2210,0,5000,2859,2790,2859,twilight sparkle,aureai
1105982.jpg,https://derpicdn.net/img/view/2016/3/10/1105982.jpg,0,0.9938762187957764,952,0,1546,563,594,563,twilight sparkle,kawaiipony2
1106651.jpg,https://derpicdn.net/img/view/2016/3/11/1106651.jpg,0,0.9878369569778442,426,0,1894,1429,1468,1429,twilight sparkle,unousaya
1108021.png,https://derpicdn.net/img/view/2016/3/13/1108021.png,0,0.9287036657333374,0,67,1184,1369,1184,1302,twilight sparkle,virtue147
1109146.png,https://derpicdn.net/img/view/2016/3/15/1109146.png,0,0.9988079071044922,26,0,2066,1948,2040,1948,twilight sparkle,slb94|fromamida
1109610.png,https://derpicdn.net/img/view/2016/3/15/1109610.png,0,0.984481692314148,119,41,715,637,596,596,twilight sparkle,turtlefarminguy
1112333.png,https://derpicdn.net/img/view/2016/3/19/1112333.png,0,0.996979594230652,3583,0,5851,2166,2268,2166,twilight sparkle,lil miss jay|slb94
1113074.png,https://derpicdn.net/img/view/2016/3/20/1113074.png,0,0.9038121700286864,472,198,1260,986,788,788,twilight sparkle,vincher
1115512.jpg,https://derpicdn.net/img/view/2016/3/24/1115512.jpg,0,0.9982965588569641,150,22,558,430,408,408,twilight sparkle,lya
1115643.png,https://derpicdn.net/img/view/2016/3/24/1115643.png,0,0.9976162314414978,571,52,895,376,324,324,twilight sparkle,ctb-36
1116866.png,https://derpicdn.net/img/view/2016/3/26/1116866.png,0,0.9905434846878052,190,0,612,408,422,408,twilight sparkle,king-kakapo
1116867.png,https://derpicdn.net/img/view/2016/3/26/1116867.png,0,0.9926453828811646,224,21,576,373,352,352,twilight sparkle,king-kakapo
1116868.png,https://derpicdn.net/img/view/2016/3/26/1116868.png,0,0.9906007051467896,189,0,609,406,420,406,twilight sparkle,king-kakapo
1116870.png,https://derpicdn.net/img/view/2016/3/26/1116870.png,0,0.9889631271362304,334,0,1920,1545,1586,1545,twilight sparkle,sourspot
1116978.png,https://derpicdn.net/img/view/2016/3/26/1116978.png,0,0.9978171586990356,439,42,989,592,550,550,twilight sparkle,superix
1123487.png,https://derpicdn.net/img/view/2016/4/3/1123487.png,0,0.9508590698242188,634,284,982,632,348,348,twilight sparkle,shamanguli
1125304.png,https://derpicdn.net/img/view/2016/4/5/1125304.png,0,0.9950699210166932,33,0,601,512,568,512,twilight sparkle,fanaticpanda
1128991.png,https://derpicdn.net/img/view/2016/4/10/1128991.png,0,0.9847130179405212,23,0,1131,1061,1108,1061,twilight sparkle,vidersan
113126.jpg,https://derpicdn.net/img/view/2012/10/4/113126.jpg,0,0.985059916973114,94,46,544,496,450,450,twilight sparkle,innocenttazlet
1132934.jpg,https://derpicdn.net/img/view/2016/4/16/1132934.jpg,0,0.9108303189277648,0,31,1020,1119,1020,1088,twilight sparkle,abbystarling
1137211.png,https://derpicdn.net/img/view/2016/4/21/1137211.png,0,0.9563138484954834,0,9,294,339,294,330,twilight sparkle,sky
1138031.jpg,https://derpicdn.net/img/view/2016/4/22/1138031.jpg,0,0.9864461421966552,363,0,1261,889,898,889,twilight sparkle,project-fallen-angel
1138158.png,https://derpicdn.net/img/view/2016/4/23/1138158.png,0,0.9618152976036072,0,111,784,915,784,804,twilight sparkle,pigzfairy
1138158.png,https://derpicdn.net/img/view/2016/4/23/1138158.png,1,0.9518555998802184,395,15,1300,959,905,944,twilight sparkle,pigzfairy
1138829.png,https://derpicdn.net/img/view/2016/4/24/1138829.png,0,0.9896300435066224,1349,0,3395,2020,2046,2020,twilight sparkle,whazzam95
1139047.png,https://derpicdn.net/img/view/2016/4/24/1139047.png,0,0.9968758821487428,122,0,354,221,232,221,twilight sparkle,gummigator|brsajo
1139368.png,https://derpicdn.net/img/view/2016/4/24/1139368.png,0,0.9977887868881226,366,61,800,525,434,464,twilight sparkle,silentwulv
1139887.png,https://derpicdn.net/img/view/2016/4/25/1139887.png,0,0.9971420168876648,606,52,1168,614,562,562,twilight sparkle,sevenowait
1140344.png,https://derpicdn.net/img/view/2016/4/26/1140344.png,0,0.9658862352371216,515,62,759,306,244,244,twilight sparkle,dusthiel
1141607.png,https://derpicdn.net/img/view/2016/4/28/1141607.png,0,0.9689776301383972,13,0,1080,1088,1067,1088,twilight sparkle,alcohors
1142304.jpg,https://derpicdn.net/img/view/2016/4/29/1142304.jpg,0,0.9763973951339722,277,0,855,545,578,545,twilight sparkle,shikimaakemi
1142859.png,https://derpicdn.net/img/view/2016/4/30/1142859.png,0,0.9734136462211608,63,0,523,499,460,499,twilight sparkle,php104
1143784.png,https://derpicdn.net/img/view/2016/5/1/1143784.png,0,0.9974269270896912,141,72,501,432,360,360,twilight sparkle,hikariviny
1144014.png,https://derpicdn.net/img/view/2016/5/1/1144014.png,0,0.9893532991409302,138,9,1254,1125,1116,1116,twilight sparkle,scarlet-spectrum
1144767.png,https://derpicdn.net/img/view/2016/5/2/1144767.png,0,0.9909958839416504,119,0,405,281,286,281,twilight sparkle,mococo
1144854.png,https://derpicdn.net/img/view/2016/5/2/1144854.png,0,0.9820178747177124,369,104,815,550,446,446,twilight sparkle,pwnagespartan
1145705.png,https://derpicdn.net/img/view/2016/5/3/1145705.png,0,0.9691779613494872,262,363,3000,3137,2738,2774,twilight sparkle,sollace
1148342.png,https://derpicdn.net/img/view/2016/5/7/1148342.png,0,0.9987515807151794,280,0,700,410,420,410,twilight sparkle,kanaowo
1148478.png,https://derpicdn.net/img/view/2016/5/7/1148478.png,0,0.9890313744544984,164,0,790,611,626,611,twilight sparkle,vavacung
1148478.png,https://derpicdn.net/img/view/2016/5/7/1148478.png,1,0.9413673281669616,517,475,815,773,298,298,twilight sparkle,vavacung
1149454.png,https://derpicdn.net/img/view/2016/5/8/1149454.png,0,0.998850405216217,126,71,562,507,436,436,twilight sparkle,tentinythimbles
1149962.png,https://derpicdn.net/img/view/2016/5/9/1149962.png,0,0.9823105335235596,255,57,535,337,280,280,twilight sparkle,caroo
115087.png,https://derpicdn.net/img/view/2012/10/6/115087.png,0,0.9626923203468324,283,0,3981,3656,3698,3656,twilight sparkle,xniclord789x
1155551.png,https://derpicdn.net/img/view/2016/5/16/1155551.png,0,0.9960922598838806,1044,160,2258,1374,1214,1214,twilight sparkle,jurill
1155571.jpg,https://derpicdn.net/img/view/2016/5/16/1155571.jpg,0,0.9798081517219543,39,0,569,490,530,490,twilight sparkle,doodlepaintdraws
1157921.png,https://derpicdn.net/img/view/2016/5/19/1157921.png,0,0.9955785870552064,362,0,1478,924,1116,924,twilight sparkle,xwhitedreamsx
1158560.png,https://derpicdn.net/img/view/2016/5/20/1158560.png,0,0.9896747469902042,302,0,768,460,466,460,twilight sparkle,rubbermage
1159086.png,https://derpicdn.net/img/view/2016/5/21/1159086.png,0,0.9703002572059632,27,0,1743,1591,1716,1591,twilight sparkle,haydee
1160365.png,https://derpicdn.net/img/view/2016/5/22/1160365.png,0,0.9263867139816284,0,86,4697,5606,4697,5520,twilight sparkle,lahirien
1160419.png,https://derpicdn.net/img/view/2016/5/22/1160419.png,0,0.9870581626892092,0,0,2441,2620,2441,2620,twilight sparkle,osipush
1161063.png,https://derpicdn.net/img/view/2016/5/23/1161063.png,0,0.9860804677009584,193,13,653,473,460,460,twilight sparkle,crponies
1161626.png,https://derpicdn.net/img/view/2016/5/24/1161626.png,0,0.9529621005058287,246,111,980,845,734,734,twilight sparkle,tallaferroxiv
1162549.png,https://derpicdn.net/img/view/2016/5/25/1162549.png,0,0.9775912761688232,715,117,1207,609,492,492,twilight sparkle,silverfox057
1164967.png,https://derpicdn.net/img/view/2016/5/28/1164967.png,0,0.9967710971832277,134,120,2000,1986,1866,1866,twilight sparkle,ogre
1165303.jpg,https://derpicdn.net/img/view/2016/5/29/1165303.jpg,0,0.9860804080963136,36,0,718,655,682,655,twilight sparkle,timelordomega
1167378.png,https://derpicdn.net/img/view/2016/5/31/1167378.png,0,0.9950517416000366,309,0,725,415,416,415,twilight sparkle,ultrard
1169246.png,https://derpicdn.net/img/view/2016/6/3/1169246.png,0,0.9748640060424804,9,0,627,561,618,561,twilight sparkle,wandeh
1170365.png,https://derpicdn.net/img/view/2016/6/4/1170365.png,0,0.9801121354103088,14,51,894,931,880,880,twilight sparkle,alasou
1171504.png,https://derpicdn.net/img/view/2016/6/6/1171504.png,0,0.9443515539169312,114,77,1214,1177,1100,1100,twilight sparkle,kawaiipony2
1175616.png,https://derpicdn.net/img/view/2016/6/11/1175616.png,0,0.996011197566986,126,35,600,509,474,474,twilight sparkle,dusthiel
1176390.jpg,https://derpicdn.net/img/view/2016/6/12/1176390.jpg,0,0.9501864314079284,247,143,525,421,278,278,twilight sparkle,kianamai
1177450.png,https://derpicdn.net/img/view/2016/6/13/1177450.png,0,0.9022590517997742,231,0,713,466,482,466,twilight sparkle,dm29
1178451.png,https://derpicdn.net/img/view/2016/6/14/1178451.png,0,0.9949183464050292,44,0,2180,2058,2136,2058,twilight sparkle,meganlovesangrybirds
1178958.png,https://derpicdn.net/img/view/2016/6/15/1178958.png,0,0.9930607080459596,0,0,893,880,893,880,twilight sparkle,cloudyglow
1179654.png,https://derpicdn.net/img/view/2016/6/16/1179654.png,0,0.9909128546714784,0,0,2682,2515,2682,2515,twilight sparkle,magister39
1180979.png,https://derpicdn.net/img/view/2016/6/18/1180979.png,0,0.9507851600646972,139,45,559,465,420,420,twilight sparkle,renaifoxi
1183436.png,https://derpicdn.net/img/view/2016/6/21/1183436.png,0,0.9933342933654784,3272,653,4946,2327,1674,1674,twilight sparkle,strachattack
1187240.png,https://derpicdn.net/img/view/2016/6/26/1187240.png,0,0.9953336119651794,58,38,724,657,666,619,twilight sparkle,jinyaranda
1187949.png,https://derpicdn.net/img/view/2016/6/27/1187949.png,0,0.9925174117088318,164,0,892,692,728,692,twilight sparkle,starlet8228
1191077.png,https://derpicdn.net/img/view/2016/7/1/1191077.png,0,0.9937492609024048,549,0,1113,549,564,549,twilight sparkle,rapidstrike
1191359.png,https://derpicdn.net/img/view/2016/7/2/1191359.png,0,0.9760332703590392,149,0,965,808,816,808,twilight sparkle,hungrysohma
1196203.png,https://derpicdn.net/img/view/2016/7/8/1196203.png,0,0.9710511565208436,537,0,2039,1470,1502,1470,twilight sparkle,stupchek
1199171.png,https://derpicdn.net/img/view/2016/7/12/1199171.png,0,0.9972495436668396,321,225,713,617,392,392,twilight sparkle,glacierponi
1200430.png,https://derpicdn.net/img/view/2016/7/14/1200430.png,0,0.9883501529693604,192,55,918,781,726,726,twilight sparkle,bluntwhiskey
1200556.png,https://derpicdn.net/img/view/2016/7/14/1200556.png,0,0.9807624220848083,2140,82,4176,2118,2036,2036,twilight sparkle,dashiesparkle
1202022.png,https://derpicdn.net/img/view/2016/7/16/1202022.png,0,0.9335825443267822,559,431,1069,941,510,510,twilight sparkle,nihithebrony
1203049.png,https://derpicdn.net/img/view/2016/7/17/1203049.png,0,0.92677241563797,266,211,710,655,444,444,twilight sparkle,calorie
1205476.png,https://derpicdn.net/img/view/2016/7/20/1205476.png,0,0.9784530401229858,554,593,1040,1079,486,486,twilight sparkle,gianghanz
1206024.png,https://derpicdn.net/img/view/2016/7/21/1206024.png,0,0.9841921329498292,253,0,523,259,270,259,twilight sparkle,graphene
1207314.png,https://derpicdn.net/img/view/2016/7/23/1207314.png,0,0.9611867666244508,180,34,538,392,358,358,twilight sparkle,fj-c
1208108.png,https://derpicdn.net/img/view/2016/7/24/1208108.png,0,0.9148503541946412,536,198,814,476,278,278,twilight sparkle,kidkaizer
1211306.png,https://derpicdn.net/img/view/2016/7/28/1211306.png,0,0.9946419000625608,422,128,1102,808,680,680,twilight sparkle,dipfanken
1211966.png,https://derpicdn.net/img/view/2016/7/29/1211966.png,0,0.9906286597251892,291,0,747,420,456,420,twilight sparkle,ultrard
1214629.png,https://derpicdn.net/img/view/2016/8/1/1214629.png,0,0.9802258014678956,42,17,436,411,394,394,twilight sparkle,ramott
1217281.png,https://derpicdn.net/img/view/2016/8/5/1217281.png,0,0.9946178793907166,350,0,760,388,410,388,twilight sparkle,tabrony23
1217701.png,https://derpicdn.net/img/view/2016/8/5/1217701.png,0,0.9955265522003174,1240,12,2418,1312,1178,1300,twilight sparkle,jittery-the-dragon
1218504.png,https://derpicdn.net/img/view/2016/8/6/1218504.png,0,0.997409462928772,24,0,802,722,778,722,twilight sparkle,dipfanken
1225587.png,https://derpicdn.net/img/view/2016/8/15/1225587.png,0,0.9991523623466492,1457,1,2829,1373,1372,1372,twilight sparkle,ruinedomega
1225886.png,https://derpicdn.net/img/view/2016/8/15/1225886.png,0,0.9764836430549622,286,120,524,358,238,238,twilight sparkle,28gooddays
1227034.png,https://derpicdn.net/img/view/2016/8/17/1227034.png,0,0.9963374137878418,856,146,1772,1062,916,916,twilight sparkle,slb94
1233372.png,https://derpicdn.net/img/view/2016/8/25/1233372.png,0,0.9988358020782472,707,36,995,324,288,288,twilight sparkle,patty-plmh
1233372.png,https://derpicdn.net/img/view/2016/8/25/1233372.png,1,0.9951843023300172,468,6,688,226,220,220,twilight sparkle,patty-plmh
1236723.png,https://derpicdn.net/img/view/2016/8/29/1236723.png,0,0.9233533143997192,0,148,620,820,620,672,twilight sparkle,dm29
1240928.png,https://derpicdn.net/img/view/2016/9/3/1240928.png,0,0.9914370179176332,879,254,1749,1124,870,870,twilight sparkle,dullpoint
1241599.png,https://derpicdn.net/img/view/2016/9/4/1241599.png,0,0.990184247493744,324,7,798,481,474,474,twilight sparkle,omegasunburst
1242750.png,https://derpicdn.net/img/view/2016/9/5/1242750.png,0,0.963754415512085,511,0,1533,810,1022,810,twilight sparkle,the4thhomunculus
1242768.png,https://derpicdn.net/img/view/2016/9/5/1242768.png,0,0.9863179326057434,355,0,10071,9469,9716,9469,twilight sparkle,cyanlightning
1244147.png,https://derpicdn.net/img/view/2016/9/7/1244147.png,0,0.9860824346542358,412,117,1140,845,728,728,twilight sparkle,drawntildawn
1245303.png,https://derpicdn.net/img/view/2016/9/9/1245303.png,0,0.9891790151596068,0,0,10131,9963,10131,9963,twilight sparkle,cyanlightning
1245423.png,https://derpicdn.net/img/view/2016/9/9/1245423.png,0,0.9955719113349916,85,0,577,482,492,482,twilight sparkle,dopeedit
1247901.png,https://derpicdn.net/img/view/2016/9/12/1247901.png,0,0.988147795200348,229,0,4257,3953,4028,3953,twilight sparkle,pink1ejack
1250371.png,https://derpicdn.net/img/view/2016/9/16/1250371.png,0,0.9915990829467772,269,97,715,543,446,446,twilight sparkle,thattagen
1252821.png,https://derpicdn.net/img/view/2016/9/18/1252821.png,0,0.9956589937210084,135,210,619,694,484,484,twilight sparkle,jeki
1255619.png,https://derpicdn.net/img/view/2016/9/22/1255619.png,0,0.9750716686248779,97,19,587,509,490,490,twilight sparkle,tsitra360
1255741.png,https://derpicdn.net/img/view/2016/9/22/1255741.png,0,0.9813576340675354,175,0,645,437,470,437,twilight sparkle,king-kakapo
1255743.png,https://derpicdn.net/img/view/2016/9/22/1255743.png,0,0.9912043809890748,173,0,647,441,474,441,twilight sparkle,king-kakapo
1258665.png,https://derpicdn.net/img/view/2016/9/26/1258665.png,0,0.9267846345901488,55,3,529,477,474,474,twilight sparkle,ultrard
1261102.png,https://derpicdn.net/img/view/2016/9/29/1261102.png,0,0.9475786089897156,617,968,6959,7310,6342,6342,twilight sparkle,pink1ejack
1261169.png,https://derpicdn.net/img/view/2016/9/29/1261169.png,0,0.9981962442398072,54,53,1180,1179,1126,1126,twilight sparkle,snapshot1994
1263236.png,https://derpicdn.net/img/view/2016/10/2/1263236.png,0,0.9955468773841858,0,49,1507,1621,1507,1572,twilight sparkle,eagle1division
1264021.png,https://derpicdn.net/img/view/2016/10/3/1264021.png,0,0.9968631267547609,0,0,1685,1744,1685,1744,twilight sparkle,eagle1division
1266358.png,https://derpicdn.net/img/view/2016/10/6/1266358.png,0,0.9860383868217468,34,29,409,457,375,428,twilight sparkle,
1266358.png,https://derpicdn.net/img/view/2016/10/6/1266358.png,1,0.9158226847648621,0,0,328,382,328,382,twilight sparkle,
1269954.png,https://derpicdn.net/img/view/2016/10/10/1269954.png,0,0.9891756772994996,10,0,552,467,542,467,twilight sparkle,
1272249.png,https://derpicdn.net/img/view/2016/10/14/1272249.png,0,0.9956405162811279,419,47,915,543,496,496,twilight sparkle,variant
1280397.png,https://derpicdn.net/img/view/2016/10/24/1280397.png,0,0.9957165122032166,1061,0,3000,2049,1939,2049,twilight sparkle,sollace
1282119.png,https://derpicdn.net/img/view/2016/10/26/1282119.png,0,0.99257093667984,610,56,1128,574,518,518,twilight sparkle,turtlefarminguy
1283306.png,https://derpicdn.net/img/view/2016/10/28/1283306.png,0,0.9554938077926636,210,36,998,824,788,788,twilight sparkle,leadhooves
1284000.png,https://derpicdn.net/img/view/2016/10/29/1284000.png,0,0.992293655872345,1080,706,1988,1614,908,908,twilight sparkle,lifesharbinger
1286366.png,https://derpicdn.net/img/view/2016/11/1/1286366.png,0,0.9932620525360109,479,95,991,607,512,512,twilight sparkle,soft-arthropod
1286929.png,https://derpicdn.net/img/view/2016/11/2/1286929.png,0,0.999072015285492,553,0,1511,915,958,915,twilight sparkle,arifproject
1287306.png,https://derpicdn.net/img/view/2016/11/2/1287306.png,0,0.9578790664672852,914,0,1998,1007,1084,1007,twilight sparkle,jp
1289584.png,https://derpicdn.net/img/view/2016/11/5/1289584.png,0,0.9995052218437196,20,0,276,256,256,256,twilight sparkle,tsukuda
1290604.png,https://derpicdn.net/img/view/2016/11/7/1290604.png,0,0.9930763840675354,187,0,1005,730,818,730,twilight sparkle,danteayagawe
1291282.png,https://derpicdn.net/img/view/2016/11/8/1291282.png,0,0.9909892678260804,220,0,1238,1015,1018,1015,twilight sparkle,asika-aida
1293229.png,https://derpicdn.net/img/view/2016/11/11/1293229.png,0,0.9604273438453674,296,188,1128,1020,832,832,twilight sparkle,purpleblackkiwi
1293640.png,https://derpicdn.net/img/view/2016/11/12/1293640.png,0,0.9987289309501648,239,42,767,570,528,528,twilight sparkle,kukseleg
1296525.png,https://derpicdn.net/img/view/2016/11/15/1296525.png,0,0.9880961179733276,282,0,942,587,660,587,twilight sparkle,camyllea
1297952.png,https://derpicdn.net/img/view/2016/11/17/1297952.png,0,0.9880216717720032,186,69,610,493,424,424,twilight sparkle,windymils
1298226.png,https://derpicdn.net/img/view/2016/11/18/1298226.png,0,0.9578704237937928,0,129,2442,2629,2442,2500,twilight sparkle,amysticalartist|stepandy
1298275.png,https://derpicdn.net/img/view/2016/11/18/1298275.png,0,0.9987536668777466,114,0,856,728,742,728,twilight sparkle,silentpassion
1302633.png,https://derpicdn.net/img/view/2016/11/24/1302633.png,0,0.9470515847206116,95,0,1331,1098,1236,1098,twilight sparkle,docwario
1306944.png,https://derpicdn.net/img/view/2016/11/30/1306944.png,0,0.9836943745613098,299,4,935,640,636,636,twilight sparkle,wolfnanaki|trollie trollenberg
1306948.png,https://derpicdn.net/img/view/2016/11/30/1306948.png,0,0.9877813458442688,191,0,959,710,768,710,twilight sparkle,wolfnanaki|trollie trollenberg
1306950.png,https://derpicdn.net/img/view/2016/11/30/1306950.png,0,0.9850006103515624,201,0,951,703,750,703,twilight sparkle,wolfnanaki|trollie trollenberg
1306951.png,https://derpicdn.net/img/view/2016/11/30/1306951.png,0,0.9751245975494384,303,8,929,634,626,626,twilight sparkle,trollie trollenberg|wolfnanaki
1307302.png,https://derpicdn.net/img/view/2016/12/1/1307302.png,0,0.9981293678283693,265,15,783,533,518,518,twilight sparkle,daclusia
1308538.png,https://derpicdn.net/img/view/2016/12/2/1308538.png,0,0.9043968915939332,0,45,2934,3035,2934,2990,twilight sparkle,magister39
1308732.png,https://derpicdn.net/img/view/2016/12/3/1308732.png,0,0.9746301770210266,538,0,1068,450,530,450,twilight sparkle,lopoddity
1308732.png,https://derpicdn.net/img/view/2016/12/3/1308732.png,1,0.9191545844078064,249,18,585,354,336,336,twilight sparkle,lopoddity
1309390.png,https://derpicdn.net/img/view/2016/12/4/1309390.png,0,0.994762659072876,18,0,574,541,556,541,twilight sparkle,
1315444.png,https://derpicdn.net/img/view/2016/12/12/1315444.png,0,0.9870052337646484,191,23,897,729,706,706,twilight sparkle,windymils
1317367.png,https://derpicdn.net/img/view/2016/12/14/1317367.png,0,0.981308937072754,0,21,585,673,585,652,twilight sparkle,not-ordinary-pony
1318777.png,https://derpicdn.net/img/view/2016/12/16/1318777.png,0,0.9901699423789978,236,200,3498,3462,3262,3262,twilight sparkle,slb94
1320050.png,https://derpicdn.net/img/view/2016/12/18/1320050.png,0,0.9367635846138,204,0,848,601,644,601,twilight sparkle,princess-liliana
1322450.png,https://derpicdn.net/img/view/2016/12/22/1322450.png,0,0.9405304789543152,318,44,588,314,270,270,twilight sparkle,bypenandhoof
1322794.png,https://derpicdn.net/img/view/2016/12/22/1322794.png,0,0.9144123792648317,239,0,1200,960,961,960,twilight sparkle,joe0316|laptop-pone
1322814.png,https://derpicdn.net/img/view/2016/12/22/1322814.png,0,0.9900173544883728,0,0,270,272,270,272,twilight sparkle,stepandy
1322814.png,https://derpicdn.net/img/view/2016/12/22/1322814.png,1,0.9224307537078856,40,51,350,383,310,332,twilight sparkle,stepandy
132322.jpg,https://derpicdn.net/img/view/2012/10/25/132322.jpg,0,0.9966776967048644,677,0,1225,483,548,483,twilight sparkle,tcun
1323910.png,https://derpicdn.net/img/view/2016/12/24/1323910.png,0,0.9991997480392456,69,39,565,535,496,496,twilight sparkle,jack-pie
1324295.png,https://derpicdn.net/img/view/2016/12/24/1324295.png,0,0.9625349044799804,31,0,1033,811,1002,811,twilight sparkle,duskie-06
1326564.png,https://derpicdn.net/img/view/2016/12/27/1326564.png,0,0.9925749897956848,439,279,2221,2061,1782,1782,twilight sparkle,andelai
1328099.png,https://derpicdn.net/img/view/2016/12/30/1328099.png,0,0.9884881377220154,166,1355,636,1825,470,470,twilight sparkle,anontheanon
1329498.png,https://derpicdn.net/img/view/2017/1/1/1329498.png,0,0.9941091537475586,138,274,484,620,346,346,twilight sparkle,anontheanon
1330152.png,https://derpicdn.net/img/view/2017/1/2/1330152.png,0,0.9944535493850708,425,0,1195,707,770,707,twilight sparkle,sharmie
1332127.png,https://derpicdn.net/img/view/2017/1/4/1332127.png,0,0.9947239756584167,206,16,692,502,486,486,twilight sparkle,bloodatius
1333840.png,https://derpicdn.net/img/view/2017/1/7/1333840.png,0,0.9826554656028748,20,9,812,801,792,792,twilight sparkle,
1335264.png,https://derpicdn.net/img/view/2017/1/9/1335264.png,0,0.9293928146362304,0,0,10012,10493,10012,10493,twilight sparkle,cyanlightning
1335740.png,https://derpicdn.net/img/view/2017/1/9/1335740.png,0,0.9963790774345398,3635,959,10502,8621,6867,7662,twilight sparkle,cyanlightning
1335741.png,https://derpicdn.net/img/view/2017/1/9/1335741.png,0,0.983262836933136,4170,1854,10502,8458,6332,6604,twilight sparkle,cyanlightning
1338197.png,https://derpicdn.net/img/view/2017/1/13/1338197.png,0,0.9972911477088928,322,12,818,508,496,496,twilight sparkle,raptor007
1340095.png,https://derpicdn.net/img/view/2017/1/15/1340095.png,0,0.9879173040390016,157,38,957,838,800,800,twilight sparkle,haidiannotes
1343044.png,https://derpicdn.net/img/view/2017/1/19/1343044.png,0,0.9989796876907348,18,0,1118,1069,1100,1069,twilight sparkle,badumsquish
1343512.png,https://derpicdn.net/img/view/2017/1/20/1343512.png,0,0.9917024970054626,918,82,1608,772,690,690,twilight sparkle,amarynceus
1345787.png,https://derpicdn.net/img/view/2017/1/23/1345787.png,0,0.9804542064666748,111,0,565,407,454,407,twilight sparkle,lopoddity
1346357.png,https://derpicdn.net/img/view/2017/1/23/1346357.png,0,0.9894055128097534,154,0,564,391,410,391,twilight sparkle,ravensunart
1351.jpg,https://derpicdn.net/img/view/2012/1/22/1351.jpg,0,0.9948374629020692,327,27,721,421,394,394,twilight sparkle,johnjoseco
1352989.png,https://derpicdn.net/img/view/2017/2/1/1352989.png,0,0.9939276576042176,0,17,1854,1983,1854,1966,twilight sparkle,serenity
1355815.png,https://derpicdn.net/img/view/2017/2/5/1355815.png,0,0.9887308478355408,294,28,1278,1012,984,984,twilight sparkle,duskie-06
1356265.png,https://derpicdn.net/img/view/2017/2/6/1356265.png,0,0.9961425065994264,151,0,483,330,332,330,twilight sparkle,doekitty
135741.png,https://derpicdn.net/img/view/2012/10/29/135741.png,0,0.9001405835151672,0,0,427,601,427,601,twilight sparkle,elppajack
1358546.png,https://derpicdn.net/img/view/2017/2/9/1358546.png,0,0.9996579885482788,27,0,475,429,448,429,twilight sparkle,amarynceus
1358546.png,https://derpicdn.net/img/view/2017/2/9/1358546.png,1,0.9992942810058594,1050,0,1480,411,430,411,twilight sparkle,amarynceus
1358546.png,https://derpicdn.net/img/view/2017/2/9/1358546.png,2,0.9988093376159668,2184,0,2670,445,486,445,twilight sparkle,amarynceus
1358546.png,https://derpicdn.net/img/view/2017/2/9/1358546.png,3,0.9988030195236206,1590,0,2082,453,492,453,twilight sparkle,amarynceus
1358546.png,https://derpicdn.net/img/view/2017/2/9/1358546.png,4,0.9837766885757446,566,0,978,410,412,410,twilight sparkle,amarynceus
1358546.png,https://derpicdn.net/img/view/2017/2/9/1358546.png,6,0.9686715602874756,2142,513,2648,1019,506,506,twilight sparkle,amarynceus
1362307.png,https://derpicdn.net/img/view/2017/2/14/1362307.png,0,0.9782602787017822,183,0,1046,791,863,791,twilight sparkle,underpable
1362441.png,https://derpicdn.net/img/view/2017/2/14/1362441.png,0,0.9552886486053468,0,45,520,591,520,546,twilight sparkle,silversweety
1364962.png,https://derpicdn.net/img/view/2017/2/16/1364962.png,0,0.9984309077262878,563,0,1247,674,684,674,twilight sparkle,mitralexa
1366365.png,https://derpicdn.net/img/view/2017/2/18/1366365.png,0,0.9685991406440736,1,14,303,316,302,302,twilight sparkle,zigorsun
1368357.png,https://derpicdn.net/img/view/2017/2/20/1368357.png,0,0.9785487651824952,0,218,5401,6562,5401,6344,twilight sparkle,luckreza8
1369473.png,https://derpicdn.net/img/view/2017/2/21/1369473.png,0,0.9933190941810608,0,46,2894,3484,2894,3438,twilight sparkle,starlessnight22
1369780.png,https://derpicdn.net/img/view/2017/2/22/1369780.png,0,0.9844323992729188,62,30,400,368,338,338,twilight sparkle,phyllismi
1370487.png,https://derpicdn.net/img/view/2017/2/22/1370487.png,1,0.9209764003753662,406,0,1280,866,874,866,twilight sparkle,fawness
1372695.png,https://derpicdn.net/img/view/2017/2/25/1372695.png,0,0.9868269562721252,106,5,564,463,458,458,twilight sparkle,not-ordinary-pony
1372867.png,https://derpicdn.net/img/view/2017/2/25/1372867.png,0,0.959580421447754,75,0,4619,3327,4544,3327,twilight sparkle,orin331|limedazzle
1377.jpg,https://derpicdn.net/img/view/2012/1/22/1377.jpg,0,0.9911451935768129,570,0,1060,488,490,488,twilight sparkle,johnjoseco
1379055.png,https://derpicdn.net/img/view/2017/3/4/1379055.png,0,0.9989507794380188,267,0,799,447,532,447,twilight sparkle,miokomata
1379222.png,https://derpicdn.net/img/view/2017/3/4/1379222.png,0,0.9759766459465028,617,38,1433,854,816,816,twilight sparkle,ragurimo
1383.jpg,https://derpicdn.net/img/view/2012/1/22/1383.jpg,0,0.9922847151756288,208,0,796,562,588,562,twilight sparkle,johnjoseco
1383075.png,https://derpicdn.net/img/view/2017/3/9/1383075.png,0,0.9894319176673888,721,627,1197,1103,476,476,twilight sparkle,orang111
1383075.png,https://derpicdn.net/img/view/2017/3/9/1383075.png,1,0.9887072443962096,2469,620,2949,1100,480,480,twilight sparkle,orang111
1383075.png,https://derpicdn.net/img/view/2017/3/9/1383075.png,3,0.9110374450683594,1986,654,2420,1088,434,434,twilight sparkle,orang111
1385090.png,https://derpicdn.net/img/view/2017/3/12/1385090.png,0,0.980588674545288,105,54,309,258,204,204,twilight sparkle,kapusha-blr
1387684.png,https://derpicdn.net/img/view/2017/3/15/1387684.png,0,0.9989559650421144,27,0,967,890,940,890,twilight sparkle,rustle-rose
1390916.png,https://derpicdn.net/img/view/2017/3/19/1390916.png,0,0.9135060906410216,32,19,554,541,522,522,twilight sparkle,little-sketches
1395371.png,https://derpicdn.net/img/view/2017/3/24/1395371.png,0,0.9997122883796692,449,3,819,373,370,370,twilight sparkle,nanoblade
1396948.png,https://derpicdn.net/img/view/2017/3/26/1396948.png,0,0.9980395436286926,468,287,2564,2383,2096,2096,twilight sparkle,ravio-li
1398173.png,https://derpicdn.net/img/view/2017/3/28/1398173.png,0,0.9913269281387328,129,0,1067,848,938,848,twilight sparkle,silfoe
1398790.png,https://derpicdn.net/img/view/2017/3/29/1398790.png,0,0.9929425716400146,129,9,693,573,564,564,twilight sparkle,electricshine
1400159.png,https://derpicdn.net/img/view/2017/3/31/1400159.png,0,0.9935823678970336,97,0,545,430,448,430,twilight sparkle,king-kakapo
1401415.png,https://derpicdn.net/img/view/2017/4/1/1401415.png,0,0.998486876487732,8,0,442,428,434,428,twilight sparkle,crownhound
140327.jpg,https://derpicdn.net/img/view/2012/11/3/140327.jpg,0,0.9957965016365052,23,0,483,399,460,399,twilight sparkle,c0nker
1403821.png,https://derpicdn.net/img/view/2017/4/4/1403821.png,0,0.940522849559784,152,35,904,787,752,752,twilight sparkle,freeedon|longren
1404764.png,https://derpicdn.net/img/view/2017/4/5/1404764.png,0,0.9986180663108826,438,100,846,508,408,408,twilight sparkle,20thx5150
1404883.png,https://derpicdn.net/img/view/2017/4/5/1404883.png,0,0.9256524443626404,113,159,523,569,410,410,twilight sparkle,
1405449.png,https://derpicdn.net/img/view/2017/4/6/1405449.png,0,0.9979267716407776,355,20,697,362,342,342,twilight sparkle,helmie-d
1406708.png,https://derpicdn.net/img/view/2017/4/8/1406708.png,0,0.9920923709869384,216,2,972,758,756,756,twilight sparkle,mrasianhappydude
1408428.png,https://derpicdn.net/img/view/2017/4/10/1408428.png,1,0.9666215777397156,1964,2225,3976,4237,2012,2012,twilight sparkle,limedazzle
1408962.png,https://derpicdn.net/img/view/2017/4/11/1408962.png,0,0.9894053339958192,398,35,882,519,484,484,twilight sparkle,king-kakapo
1412846.png,https://derpicdn.net/img/view/2017/4/16/1412846.png,0,0.9150254130363464,592,87,1582,1077,990,990,twilight sparkle,thelittlesnake
1413479.png,https://derpicdn.net/img/view/2017/4/16/1413479.png,0,0.9957722425460817,1,5,289,293,288,288,twilight sparkle,espeonna
1417062.png,https://derpicdn.net/img/view/2017/4/20/1417062.png,0,0.9932225346565248,123,49,2121,2047,1998,1998,twilight sparkle,jykinturah
1420278.png,https://derpicdn.net/img/view/2017/4/24/1420278.png,0,0.9486711025238036,0,0,427,513,427,513,twilight sparkle,
1421184.png,https://derpicdn.net/img/view/2017/4/25/1421184.png,0,0.9958457350730896,123,0,465,290,342,290,twilight sparkle,lopoddity
1421184.png,https://derpicdn.net/img/view/2017/4/25/1421184.png,1,0.9704738855361938,304,8,640,344,336,336,twilight sparkle,lopoddity
1421522.png,https://derpicdn.net/img/view/2017/4/25/1421522.png,0,0.9840094447135924,113,0,845,699,732,699,twilight sparkle,theroyalprincesses
1422965.png,https://derpicdn.net/img/view/2017/4/27/1422965.png,0,0.9847874045372008,132,0,900,772,768,772,twilight sparkle,thasase1002
1425966.png,https://derpicdn.net/img/view/2017/5/1/1425966.png,0,0.9911115765571594,59,166,1163,1270,1104,1104,twilight sparkle,pabbley
1426557.png,https://derpicdn.net/img/view/2017/5/1/1426557.png,0,0.9990364909172058,93,0,1959,1772,1866,1772,twilight sparkle,doekitty
1427235.png,https://derpicdn.net/img/view/2017/5/2/1427235.png,0,0.9129442572593688,245,0,1329,1066,1084,1066,twilight sparkle,katputze
1429699.png,https://derpicdn.net/img/view/2017/5/6/1429699.png,0,0.9933086633682252,289,0,837,530,548,530,twilight sparkle,mitralexa
1432746.png,https://derpicdn.net/img/view/2017/5/9/1432746.png,0,0.9648459553718568,1439,331,2791,1683,1352,1352,twilight sparkle,billysan727
1434481.png,https://derpicdn.net/img/view/2017/5/12/1434481.png,0,0.9771919846534728,59,18,579,538,520,520,twilight sparkle,hoodie
1435917.png,https://derpicdn.net/img/view/2017/5/14/1435917.png,1,0.9880610704421996,2090,816,2570,1296,480,480,twilight sparkle,sand-filled-scarecrow
1435953.png,https://derpicdn.net/img/view/2017/5/14/1435953.png,0,0.9683303236961364,206,58,850,702,644,644,twilight sparkle,andelai
1437826.png,https://derpicdn.net/img/view/2017/5/16/1437826.png,0,0.9850559234619141,114,33,598,517,484,484,twilight sparkle,heir-of-rick
1442881.png,https://derpicdn.net/img/view/2017/5/22/1442881.png,0,0.9523590207099916,0,0,747,700,747,700,twilight sparkle,
1443393.png,https://derpicdn.net/img/view/2017/5/22/1443393.png,0,0.9509543776512146,470,0,2420,1712,1950,1712,twilight sparkle,arifproject
1445421.png,https://derpicdn.net/img/view/2017/5/25/1445421.png,0,0.9382748007774352,379,137,3531,3289,3152,3152,twilight sparkle,illumnious
1445576.png,https://derpicdn.net/img/view/2017/5/25/1445576.png,0,0.9741438627243042,549,179,887,517,338,338,twilight sparkle,lopoddity
1446211.png,https://derpicdn.net/img/view/2017/5/26/1446211.png,0,0.9917550683021544,1133,1444,2437,2748,1304,1304,twilight sparkle,liniitadash23
1446375.png,https://derpicdn.net/img/view/2017/5/26/1446375.png,0,0.9510390758514404,1198,111,2908,1821,1710,1710,twilight sparkle,frownfactory
1446891.png,https://derpicdn.net/img/view/2017/5/27/1446891.png,0,0.9340342879295348,292,0,1128,819,836,819,twilight sparkle,jay fosgitt
1450650.png,https://derpicdn.net/img/view/2017/5/31/1450650.png,0,0.9397162199020386,214,182,682,650,468,468,twilight sparkle,fanch1
1454208.png,https://derpicdn.net/img/view/2017/6/5/1454208.png,0,0.9333209991455078,311,103,901,693,590,590,twilight sparkle,drawntildawn
1454746.png,https://derpicdn.net/img/view/2017/6/5/1454746.png,0,0.9996823072433472,1147,0,1585,419,438,419,twilight sparkle,a-shy-nobody
1454746.png,https://derpicdn.net/img/view/2017/6/5/1454746.png,1,0.9795337319374084,27,320,817,1110,790,790,twilight sparkle,a-shy-nobody
1456211.png,https://derpicdn.net/img/view/2017/6/7/1456211.png,0,0.9630080461502076,2601,1014,3855,2268,1254,1254,twilight sparkle,bloodatius
1459084.png,https://derpicdn.net/img/view/2017/6/11/1459084.png,0,0.9172837138175964,294,0,1850,1080,1556,1080,twilight sparkle,
1460850.png,https://derpicdn.net/img/view/2017/6/13/1460850.png,0,0.9731819629669192,455,64,943,552,488,488,twilight sparkle,
1463539.png,https://derpicdn.net/img/view/2017/6/17/1463539.png,0,0.9931278228759766,812,368,1170,726,358,358,twilight sparkle,mkogwheel
1464187.png,https://derpicdn.net/img/view/2017/6/17/1464187.png,0,0.9824979901313782,211,1200,1175,2164,964,964,twilight sparkle,vector-brony
1464498.png,https://derpicdn.net/img/view/2017/6/18/1464498.png,1,0.9954820275306702,289,340,999,1050,710,710,twilight sparkle,shutterflyeqd
1470108.png,https://derpicdn.net/img/view/2017/6/24/1470108.png,0,0.9711108803749084,1339,185,4737,3583,3398,3398,twilight sparkle,pabbley
1470435.png,https://derpicdn.net/img/view/2017/6/24/1470435.png,0,0.9958640336990356,1007,358,1945,1296,938,938,twilight sparkle,dimfann
1473155.png,https://derpicdn.net/img/view/2017/6/28/1473155.png,0,0.9895891547203064,785,415,1707,1337,922,922,twilight sparkle,emera33
1473300.png,https://derpicdn.net/img/view/2017/6/28/1473300.png,0,0.9894362688064576,159,0,1891,1515,1732,1515,twilight sparkle,moozua
1474219.png,https://derpicdn.net/img/view/2017/6/29/1474219.png,0,0.9469287395477296,55,14,332,334,277,320,twilight sparkle,
1475040.png,https://derpicdn.net/img/view/2017/6/30/1475040.png,0,0.9900577068328856,15,0,499,468,484,468,twilight sparkle,dm29
1476478.png,https://derpicdn.net/img/view/2017/7/2/1476478.png,0,0.9813281297683716,350,0,858,491,508,491,twilight sparkle,dashie116
1480135.png,https://derpicdn.net/img/view/2017/7/6/1480135.png,0,0.9965087771415708,181,0,631,393,450,393,twilight sparkle,foxcarp
148161.png,https://derpicdn.net/img/view/2012/11/11/148161.png,0,0.9696783423423768,2098,0,5112,2735,3014,2735,twilight sparkle,sairoch
1483916.png,https://derpicdn.net/img/view/2017/7/11/1483916.png,0,0.9969225525856018,28,33,336,341,308,308,twilight sparkle,crownhound
1485751.png,https://derpicdn.net/img/view/2017/7/14/1485751.png,0,0.9945201277732848,33,72,453,492,420,420,twilight sparkle,maahir pandie|daniella demysh
1488.jpg,https://derpicdn.net/img/view/2012/1/22/1488.jpg,0,0.9847716689109802,0,0,462,480,462,480,twilight sparkle,mysticalpha
1488661.png,https://derpicdn.net/img/view/2017/7/17/1488661.png,0,0.98818176984787,428,0,1010,564,582,564,twilight sparkle,bezziie
1492734.png,https://derpicdn.net/img/view/2017/7/23/1492734.png,0,0.9941204786300659,225,0,1211,975,986,975,twilight sparkle,bluntwhiskey
1495182.png,https://derpicdn.net/img/view/2017/7/26/1495182.png,0,0.9707064628601074,25,0,323,312,298,312,twilight sparkle,rebeccabluebreeze|hierozaki
1497543.png,https://derpicdn.net/img/view/2017/7/29/1497543.png,0,0.9397242069244384,6,132,646,772,640,640,twilight sparkle,mewball
1500495.png,https://derpicdn.net/img/view/2017/8/1/1500495.png,0,0.9879238605499268,0,0,908,891,908,891,twilight sparkle,cherivinca
1500641.png,https://derpicdn.net/img/view/2017/8/2/1500641.png,0,0.9981092810630798,488,0,2070,1560,1582,1560,twilight sparkle,jetwave
1501773.png,https://derpicdn.net/img/view/2017/8/3/1501773.png,0,0.9975323677062988,85,7,607,529,522,522,twilight sparkle,kaliner123
1502042.png,https://derpicdn.net/img/view/2017/8/3/1502042.png,0,0.988402783870697,335,0,1693,1218,1358,1218,twilight sparkle,j24262756
1502341.png,https://derpicdn.net/img/view/2017/8/4/1502341.png,0,0.9946848154067992,537,43,1343,849,806,806,twilight sparkle,odiz
1503810.png,https://derpicdn.net/img/view/2017/8/6/1503810.png,0,0.9696717262268066,97,0,651,548,554,548,twilight sparkle,texasuberalles
150473.png,https://derpicdn.net/img/view/2012/11/13/150473.png,0,0.9984886646270752,466,0,888,388,422,388,twilight sparkle,soulspade
1507557.png,https://derpicdn.net/img/view/2017/8/10/1507557.png,0,0.9890209436416626,244,0,1526,1249,1282,1249,twilight sparkle,bigbuxart
1508055.png,https://derpicdn.net/img/view/2017/8/11/1508055.png,0,0.9159539937973022,79,0,1127,959,1048,959,twilight sparkle,135sky
1508891.png,https://derpicdn.net/img/view/2017/8/12/1508891.png,0,0.9601536393165588,0,29,488,557,488,528,twilight sparkle,
1511276.png,https://derpicdn.net/img/view/2017/8/15/1511276.png,0,0.9454445838928224,0,129,2161,2785,2161,2656,twilight sparkle,sketchmcreations
1511282.png,https://derpicdn.net/img/view/2017/8/15/1511282.png,0,0.9321009516716005,254,17,920,683,666,666,twilight sparkle,cloudlama
1512730.png,https://derpicdn.net/img/view/2017/8/17/1512730.png,0,0.9948341846466064,50,245,1370,1565,1320,1320,twilight sparkle,yinglongfujun
1512757.png,https://derpicdn.net/img/view/2017/8/17/1512757.png,0,0.9567606449127196,151,13,1200,1139,1049,1126,twilight sparkle,galawaille
1513385.png,https://derpicdn.net/img/view/2017/8/18/1513385.png,0,0.9788938164711,117,0,730,600,613,600,twilight sparkle,
1513609.png,https://derpicdn.net/img/view/2017/8/18/1513609.png,0,0.9521405100822448,0,11,873,971,873,960,twilight sparkle,unousaya
1514755.png,https://derpicdn.net/img/view/2017/8/19/1514755.png,0,0.91020667552948,63,0,501,422,438,422,twilight sparkle,snowillusory
1515617.png,https://derpicdn.net/img/view/2017/8/20/1515617.png,0,0.9905626773834229,273,181,873,781,600,600,twilight sparkle,neuro
1516177.png,https://derpicdn.net/img/view/2017/8/21/1516177.png,0,0.9521772861480712,3843,418,5434,2084,1591,1666,twilight sparkle,jhayarr23
1518064.png,https://derpicdn.net/img/view/2017/8/23/1518064.png,2,0.9515712261199952,892,301,2148,1557,1256,1256,twilight sparkle,limedazzle
1519191.png,https://derpicdn.net/img/view/2017/8/25/1519191.png,0,0.997805655002594,764,26,1218,480,454,454,twilight sparkle,chazcatrix
1520516.png,https://derpicdn.net/img/view/2017/8/26/1520516.png,0,0.9889934659004213,1407,385,3589,2567,2182,2182,twilight sparkle,docwario
1521248.png,https://derpicdn.net/img/view/2017/8/27/1521248.png,0,0.9837933778762816,857,0,2011,1046,1154,1046,twilight sparkle,j24262756
1521773.png,https://derpicdn.net/img/view/2017/8/28/1521773.png,0,0.9911159873008728,0,0,325,360,325,360,twilight sparkle,esmeia
1526786.png,https://derpicdn.net/img/view/2017/9/3/1526786.png,0,0.9931309223175048,540,14,936,410,396,396,twilight sparkle,dogi-crimson|sky-railroad
1526786.png,https://derpicdn.net/img/view/2017/9/3/1526786.png,1,0.9233803749084472,22,20,450,448,428,428,twilight sparkle,dogi-crimson|sky-railroad
1527841.png,https://derpicdn.net/img/view/2017/9/4/1527841.png,0,0.9221131801605223,248,634,678,1064,430,430,twilight sparkle,
1529217.png,https://derpicdn.net/img/view/2017/9/6/1529217.png,0,0.9961212873458862,656,0,1636,911,980,911,twilight sparkle,chaosangeldesu
1529860.png,https://derpicdn.net/img/view/2017/9/7/1529860.png,0,0.9956016540527344,214,0,1060,831,846,831,twilight sparkle,cutiepatootiee
1532766.png,https://derpicdn.net/img/view/2017/9/11/1532766.png,0,0.9805737137794496,185,117,389,321,204,204,twilight sparkle,lulubell
1534263.png,https://derpicdn.net/img/view/2017/9/13/1534263.png,0,0.9335572123527528,181,109,3093,3021,2912,2912,twilight sparkle,witchtaunter
1537.jpg,https://derpicdn.net/img/view/2012/1/23/1537.jpg,0,0.9970470070838928,100,8,450,358,350,350,twilight sparkle,mysticalpha
1537509.png,https://derpicdn.net/img/view/2017/9/17/1537509.png,0,0.9577780961990356,777,0,1251,401,474,401,twilight sparkle,
1538541.png,https://derpicdn.net/img/view/2017/9/18/1538541.png,0,0.9975472688674928,526,0,1710,1184,1184,1184,twilight sparkle,scarletskitty12
1538766.png,https://derpicdn.net/img/view/2017/9/18/1538766.png,0,0.9973852038383484,1191,316,1500,632,309,316,twilight sparkle,
1538766.png,https://derpicdn.net/img/view/2017/9/18/1538766.png,1,0.9733942747116088,78,0,460,320,382,320,twilight sparkle,
1538770.png,https://derpicdn.net/img/view/2017/9/18/1538770.png,0,0.9588097929954528,26,37,356,351,330,314,twilight sparkle,
1539014.png,https://derpicdn.net/img/view/2017/9/18/1539014.png,0,0.9591086506843568,161,231,431,501,270,270,twilight sparkle,jacky-bunny
1540.jpg,https://derpicdn.net/img/view/2012/1/23/1540.jpg,0,0.9914608597755432,50,28,542,520,492,492,twilight sparkle,mysticalpha
1540945.png,https://derpicdn.net/img/view/2017/9/21/1540945.png,0,0.99903804063797,215,92,831,708,616,616,twilight sparkle,funble
1541033.png,https://derpicdn.net/img/view/2017/9/21/1541033.png,0,0.973260223865509,1402,290,2468,1356,1066,1066,twilight sparkle,unousaya
1541912.png,https://derpicdn.net/img/view/2017/9/22/1541912.png,0,0.9973639845848083,568,0,1362,753,794,753,twilight sparkle,nine-doodles
15428.jpg,https://derpicdn.net/img/view/2012/6/22/15428.jpg,0,0.9736834764480592,288,0,1048,661,760,661,twilight sparkle,skipsy
1542839.png,https://derpicdn.net/img/view/2017/9/23/1542839.png,0,0.9691917300224304,136,0,1408,996,1272,996,twilight sparkle,
1543897.png,https://derpicdn.net/img/view/2017/9/24/1543897.png,0,0.9987856149673462,472,40,1030,598,558,558,twilight sparkle,alasou
1544145.png,https://derpicdn.net/img/view/2017/9/25/1544145.png,0,0.9870409965515136,0,0,1759,1827,1759,1827,twilight sparkle,fluffymaiden
1544586.png,https://derpicdn.net/img/view/2017/9/25/1544586.png,0,0.9851003885269164,809,78,1617,886,808,808,twilight sparkle,bunny-bitez
1546886.png,https://derpicdn.net/img/view/2017/9/28/1546886.png,0,0.982653260231018,226,96,1164,1034,938,938,twilight sparkle,badumsquish
1552895.png,https://derpicdn.net/img/view/2017/10/5/1552895.png,0,0.9562079906463624,1017,369,1713,1065,696,696,twilight sparkle,blackligerth
1552899.png,https://derpicdn.net/img/view/2017/10/5/1552899.png,0,0.9884819388389589,648,467,1144,963,496,496,twilight sparkle,blackligerth
1554347.png,https://derpicdn.net/img/view/2017/10/7/1554347.png,0,0.948223352432251,310,0,1682,1080,1372,1080,twilight sparkle,
1554965.png,https://derpicdn.net/img/view/2017/10/8/1554965.png,0,0.9853284358978271,166,0,2610,1800,2444,1800,twilight sparkle,
1556000.png,https://derpicdn.net/img/view/2017/10/9/1556000.png,0,0.9902039170265198,621,128,2265,1772,1644,1644,twilight sparkle,jetwave
1557068.png,https://derpicdn.net/img/view/2017/10/10/1557068.png,0,0.9826432466506958,1366,337,2218,1189,852,852,twilight sparkle,sacredroses-art
1557068.png,https://derpicdn.net/img/view/2017/10/10/1557068.png,1,0.9759705066680908,589,252,1489,1152,900,900,twilight sparkle,sacredroses-art
1557399.png,https://derpicdn.net/img/view/2017/10/10/1557399.png,0,0.9955601096153259,387,53,673,339,286,286,twilight sparkle,
1557513.png,https://derpicdn.net/img/view/2017/10/10/1557513.png,0,0.9986149668693542,626,304,1272,950,646,646,twilight sparkle,jp
1558033.png,https://derpicdn.net/img/view/2017/10/11/1558033.png,0,0.9982261061668396,155,283,709,837,554,554,twilight sparkle,phallen1
1558033.png,https://derpicdn.net/img/view/2017/10/11/1558033.png,1,0.9857062697410583,730,181,1250,701,520,520,twilight sparkle,phallen1
1563793.png,https://derpicdn.net/img/view/2017/10/17/1563793.png,0,0.9724841117858888,727,0,1765,895,1038,895,twilight sparkle,temp
1564573.png,https://derpicdn.net/img/view/2017/10/18/1564573.png,0,0.9342000484466552,163,0,655,444,492,444,twilight sparkle,lilboulder
1565090.png,https://derpicdn.net/img/view/2017/10/19/1565090.png,0,0.9892271757125854,217,0,627,406,410,406,twilight sparkle,lindsay cibos|angelwaveo6
1566358.png,https://derpicdn.net/img/view/2017/10/21/1566358.png,0,0.9881939888000488,877,18,1595,736,718,718,twilight sparkle,spetu
1566500.png,https://derpicdn.net/img/view/2017/10/21/1566500.png,0,0.9805352687835692,0,0,965,1088,965,1088,twilight sparkle,fuzon-s
1567161.png,https://derpicdn.net/img/view/2017/10/22/1567161.png,0,0.962826371192932,247,0,4654,5161,4407,5161,twilight sparkle,lahirien
1567459.png,https://derpicdn.net/img/view/2017/10/22/1567459.png,0,0.9526105523109436,0,0,434,484,434,484,twilight sparkle,
1567600.png,https://derpicdn.net/img/view/2017/10/22/1567600.png,0,0.9885289669036864,368,126,790,548,422,422,twilight sparkle,taneysha
1567920.png,https://derpicdn.net/img/view/2017/10/22/1567920.png,0,0.9977349042892456,3742,0,6842,2953,3100,2953,twilight sparkle,shutterflyeqd
1568469.png,https://derpicdn.net/img/view/2017/10/23/1568469.png,0,0.9949352741241456,68,0,626,530,558,530,twilight sparkle,hoodie
1568761.png,https://derpicdn.net/img/view/2017/10/24/1568761.png,0,0.9212350845336914,289,1,913,625,624,624,twilight sparkle,sion
1570056.png,https://derpicdn.net/img/view/2017/10/25/1570056.png,0,0.9813790917396544,87,84,431,428,344,344,twilight sparkle,probablyfakeblonde
1572900.png,https://derpicdn.net/img/view/2017/10/29/1572900.png,0,0.908731997013092,284,216,4064,3996,3780,3780,twilight sparkle,deyrasd|flipwix
1579598.png,https://derpicdn.net/img/view/2017/11/6/1579598.png,0,0.9974612593650818,1467,535,2155,1223,688,688,twilight sparkle,dezdark
1580693.png,https://derpicdn.net/img/view/2017/11/7/1580693.png,0,0.9567642211914062,15,0,449,416,434,416,twilight sparkle,
1582675.png,https://derpicdn.net/img/view/2017/11/10/1582675.png,0,0.993620216846466,155,0,2963,2719,2808,2719,twilight sparkle,yinglongfujun
1583211.png,https://derpicdn.net/img/view/2017/11/10/1583211.png,0,0.9649024605751038,67,189,3477,3599,3410,3410,twilight sparkle,jhayarr23
1583556.png,https://derpicdn.net/img/view/2017/11/11/1583556.png,0,0.9549258351325988,0,70,814,964,814,894,twilight sparkle,bloodatius
1585255.png,https://derpicdn.net/img/view/2017/11/13/1585255.png,0,0.9879541993141174,45,0,1915,1732,1870,1732,twilight sparkle,snow angel
1586882.png,https://derpicdn.net/img/view/2017/11/15/1586882.png,0,0.9640777707099916,638,0,3516,2407,2878,2407,twilight sparkle,jhayarr23
1587612.png,https://derpicdn.net/img/view/2017/11/16/1587612.png,0,0.9665187001228333,157,21,807,671,650,650,twilight sparkle,freefraq
1588738.png,https://derpicdn.net/img/view/2017/11/18/1588738.png,0,0.9337108731269836,182,343,1238,1399,1056,1056,twilight sparkle,andelai
1589485.png,https://derpicdn.net/img/view/2017/11/19/1589485.png,0,0.9960578083992004,62,0,470,396,408,396,twilight sparkle,tsitra360
1590265.png,https://derpicdn.net/img/view/2017/11/19/1590265.png,0,0.919215738773346,377,101,1919,1643,1542,1542,twilight sparkle,andelai
159105.jpg,https://derpicdn.net/img/view/2012/11/21/159105.jpg,0,0.9756523370742798,40,0,500,451,460,451,twilight sparkle,shepherd0821
1591101.png,https://derpicdn.net/img/view/2017/11/21/1591101.png,0,0.9969890713691713,297,0,657,342,360,342,twilight sparkle,treekickerdraws
1592024.png,https://derpicdn.net/img/view/2017/11/22/1592024.png,0,0.9845677018165588,4,0,1038,996,1034,996,twilight sparkle,zuko42
1594315.png,https://derpicdn.net/img/view/2017/11/26/1594315.png,0,0.999009370803833,196,22,742,568,546,546,twilight sparkle,foulco|bugplayer
1594367.png,https://derpicdn.net/img/view/2017/11/26/1594367.png,0,0.9953159689903259,105,0,1139,988,1034,988,twilight sparkle,pabbley
1594619.png,https://derpicdn.net/img/view/2017/11/26/1594619.png,0,0.9231581091880798,171,306,1215,1350,1044,1044,twilight sparkle,she-nightmare
1594812.png,https://derpicdn.net/img/view/2017/11/26/1594812.png,0,0.9970182776451112,245,134,557,446,312,312,twilight sparkle,alasou
1596366.png,https://derpicdn.net/img/view/2017/11/28/1596366.png,0,0.97962749004364,222,0,576,344,354,344,twilight sparkle,esmeia
1596947.png,https://derpicdn.net/img/view/2017/11/29/1596947.png,0,0.9961782097816468,727,0,2589,1567,1862,1567,twilight sparkle,alexbluebird
1597092.png,https://derpicdn.net/img/view/2017/11/29/1597092.png,0,0.9159039855003356,629,194,1167,732,538,538,twilight sparkle,polkadot-creeper
1600541.png,https://derpicdn.net/img/view/2017/12/4/1600541.png,0,0.9898597598075868,197,103,1527,1433,1330,1330,twilight sparkle,badumsquish
1600608.png,https://derpicdn.net/img/view/2017/12/4/1600608.png,0,0.9873055219650269,66,141,1024,1099,958,958,twilight sparkle,lnspira
1601298.png,https://derpicdn.net/img/view/2017/12/5/1601298.png,0,0.9542332887649536,1080,857,1424,1201,344,344,twilight sparkle,gabrielcoroum
1605360.png,https://derpicdn.net/img/view/2017/12/11/1605360.png,0,0.9967294335365297,416,6,946,536,530,530,twilight sparkle,snow angel
1605949.png,https://derpicdn.net/img/view/2017/12/12/1605949.png,0,0.995265007019043,872,39,1324,491,452,452,twilight sparkle,rossignolet
1608937.png,https://derpicdn.net/img/view/2017/12/16/1608937.png,0,0.9033154845237732,105,51,369,315,264,264,twilight sparkle,its-gloomy
1610369.png,https://derpicdn.net/img/view/2017/12/18/1610369.png,0,0.960426151752472,0,0,962,974,962,974,twilight sparkle,vinaramic
1610446.png,https://derpicdn.net/img/view/2017/12/18/1610446.png,0,0.9972368478775024,1115,0,2309,1151,1194,1151,twilight sparkle,kyokimute
1611591.png,https://derpicdn.net/img/view/2017/12/19/1611591.png,0,0.9950120449066162,101,0,1011,874,910,874,twilight sparkle,neonishe
1611985.png,https://derpicdn.net/img/view/2017/12/20/1611985.png,0,0.9691174030303956,227,0,1063,810,836,810,twilight sparkle,bastet-catmew
1612625.png,https://derpicdn.net/img/view/2017/12/21/1612625.png,0,0.9938291311264038,148,0,1720,1490,1572,1490,twilight sparkle,dusty-onyx
1612814.png,https://derpicdn.net/img/view/2017/12/21/1612814.png,0,0.9940200448036194,212,0,1472,1164,1260,1164,twilight sparkle,varllai
1613291.png,https://derpicdn.net/img/view/2017/12/22/1613291.png,0,0.9169185757637024,635,46,955,366,320,320,twilight sparkle,mkogwheel
1614076.png,https://derpicdn.net/img/view/2017/12/23/1614076.png,0,0.9338863492012024,233,48,857,672,624,624,twilight sparkle,windymils
1614867.png,https://derpicdn.net/img/view/2017/12/24/1614867.png,0,0.9918941855430604,998,0,2520,1274,1522,1274,twilight sparkle,j24262756
1615622.png,https://derpicdn.net/img/view/2017/12/25/1615622.png,0,0.9983824491500854,79,314,319,554,240,240,twilight sparkle,its-gloomy
1615622.png,https://derpicdn.net/img/view/2017/12/25/1615622.png,1,0.995356023311615,460,306,708,554,248,248,twilight sparkle,its-gloomy
1616046.png,https://derpicdn.net/img/view/2017/12/25/1616046.png,0,0.9198869466781616,977,231,2411,1665,1434,1434,twilight sparkle,bunxl
1617406.png,https://derpicdn.net/img/view/2017/12/27/1617406.png,0,0.9281864762306212,336,0,1804,1444,1468,1444,twilight sparkle,mimicproductions
1617640.png,https://derpicdn.net/img/view/2017/12/27/1617640.png,0,0.9612802267074584,797,677,1777,1657,980,980,twilight sparkle,klarapl
1618412.png,https://derpicdn.net/img/view/2017/12/28/1618412.png,0,0.99867182970047,990,0,1600,592,610,592,twilight sparkle,marsminer
1618652.png,https://derpicdn.net/img/view/2017/12/29/1618652.png,0,0.9483966231346128,1284,1154,2990,2860,1706,1706,twilight sparkle,docwario
1619291.png,https://derpicdn.net/img/view/2017/12/29/1619291.png,0,0.9972286224365234,372,48,956,632,584,584,twilight sparkle,kkmrarar
1619344.png,https://derpicdn.net/img/view/2017/12/30/1619344.png,0,0.9539135694503784,573,131,2325,1883,1752,1752,twilight sparkle,terrafomer
1620303.png,https://derpicdn.net/img/view/2017/12/31/1620303.png,0,0.9950543642044068,87,0,531,405,444,405,twilight sparkle,its-gloomy
1621161.png,https://derpicdn.net/img/view/2018/1/1/1621161.png,0,0.9990116357803344,954,74,1750,870,796,796,twilight sparkle,ask-colorsound
1623039.png,https://derpicdn.net/img/view/2018/1/3/1623039.png,0,0.9133117198944092,1890,722,3146,1978,1256,1256,twilight sparkle,mp-printer
1627500.png,https://derpicdn.net/img/view/2018/1/8/1627500.png,0,0.9931455254554749,1386,310,3400,2326,2014,2016,twilight sparkle,a4r91n
1627695.png,https://derpicdn.net/img/view/2018/1/9/1627695.png,0,0.9919141530990601,56,17,596,557,540,540,twilight sparkle,saphi-boo
1628499.png,https://derpicdn.net/img/view/2018/1/10/1628499.png,0,0.9993346333503724,14,0,366,346,352,346,twilight sparkle,miatsukyyy
1630115.png,https://derpicdn.net/img/view/2018/1/12/1630115.png,0,0.999604344367981,0,0,557,548,557,548,twilight sparkle,shad0w-galaxy
1630158.png,https://derpicdn.net/img/view/2018/1/12/1630158.png,0,0.9981587529182434,2266,0,4770,2464,2504,2464,twilight sparkle,orin331
1630446.png,https://derpicdn.net/img/view/2018/1/12/1630446.png,0,0.9745855927467346,131,224,835,928,704,704,twilight sparkle,little-tweenframes
163278.jpg,https://derpicdn.net/img/view/2012/11/26/163278.jpg,1,0.9518835544586182,1187,0,2000,814,813,814,twilight sparkle,yulyeen
1633145.png,https://derpicdn.net/img/view/2018/1/15/1633145.png,0,0.9575659036636353,18,0,454,390,436,390,twilight sparkle,yoshigreenwater|wawtoons
1633338.png,https://derpicdn.net/img/view/2018/1/16/1633338.png,0,0.9863218069076538,213,33,813,633,600,600,twilight sparkle,eternalsubscriber
1634232.png,https://derpicdn.net/img/view/2018/1/17/1634232.png,0,0.9511082768440248,17,0,711,648,694,648,twilight sparkle,kairean
1635035.png,https://derpicdn.net/img/view/2018/1/18/1635035.png,0,0.9608568549156188,579,0,967,376,388,376,twilight sparkle,yev-san
1635543.png,https://derpicdn.net/img/view/2018/1/19/1635543.png,0,0.996786653995514,67,3,495,431,428,428,twilight sparkle,andelai
1636141.png,https://derpicdn.net/img/view/2018/1/19/1636141.png,0,0.9986589550971984,569,21,1109,561,540,540,twilight sparkle,pastel-pony-princess
1636865.png,https://derpicdn.net/img/view/2018/1/20/1636865.png,0,0.9942246675491332,452,0,1680,1197,1228,1197,twilight sparkle,yaoilover113
1637341.png,https://derpicdn.net/img/view/2018/1/21/1637341.png,0,0.9861736297607422,419,20,775,376,356,356,twilight sparkle,victoriathething
1638712.png,https://derpicdn.net/img/view/2018/1/23/1638712.png,0,0.9434507489204408,273,0,729,450,456,450,twilight sparkle,lustrous-dreams
1639070.png,https://derpicdn.net/img/view/2018/1/23/1639070.png,0,0.9989157319068908,187,16,1047,876,860,860,twilight sparkle,dagmell
1641142.png,https://derpicdn.net/img/view/2018/1/26/1641142.png,0,0.990757942199707,0,0,679,751,679,751,twilight sparkle,turtlefarminguy
1645627.png,https://derpicdn.net/img/view/2018/2/1/1645627.png,0,0.9144569635391236,336,0,600,257,264,257,twilight sparkle,creeate97
164580.jpg,https://derpicdn.net/img/view/2012/11/27/164580.jpg,0,0.9996141195297241,657,3,1245,591,588,588,twilight sparkle,ss2sonic
164580.jpg,https://derpicdn.net/img/view/2012/11/27/164580.jpg,1,0.9974844455718994,106,267,586,747,480,480,twilight sparkle,ss2sonic
1646871.png,https://derpicdn.net/img/view/2018/2/2/1646871.png,0,0.9814331531524658,445,120,2504,2188,2059,2068,twilight sparkle,lilfunkman
1647490.png,https://derpicdn.net/img/view/2018/2/3/1647490.png,0,0.9977756142616272,0,56,441,534,441,478,twilight sparkle,dsp2003
1649114.png,https://derpicdn.net/img/view/2018/2/5/1649114.png,0,0.9730955362319946,6,51,658,703,652,652,twilight sparkle,kogarasumaru24
1651124.png,https://derpicdn.net/img/view/2018/2/8/1651124.png,0,0.966055691242218,493,1031,1067,1605,574,574,twilight sparkle,maria-fly
1653190.png,https://derpicdn.net/img/view/2018/2/11/1653190.png,0,0.9990204572677612,193,0,883,650,690,650,twilight sparkle,crownhound
1653671.png,https://derpicdn.net/img/view/2018/2/11/1653671.png,0,0.9294994473457336,62,118,660,700,598,582,twilight sparkle,4318530
1657187.png,https://derpicdn.net/img/view/2018/2/16/1657187.png,0,0.9863183498382568,2,0,406,384,404,384,twilight sparkle,brendahickey
1659510.png,https://derpicdn.net/img/view/2018/2/18/1659510.png,0,0.984756588935852,155,182,2719,2746,2564,2564,twilight sparkle,sollace
1661202.png,https://derpicdn.net/img/view/2018/2/20/1661202.png,0,0.9972280859947203,195,0,1383,1037,1188,1037,twilight sparkle,lemonspark
1667414.png,https://derpicdn.net/img/view/2018/2/27/1667414.png,0,0.9453021883964542,840,445,1584,1189,744,744,twilight sparkle,dsp2003
1669106.png,https://derpicdn.net/img/view/2018/3/1/1669106.png,0,0.9972346425056458,539,0,1359,647,820,647,twilight sparkle,noben
1669750.png,https://derpicdn.net/img/view/2018/3/2/1669750.png,0,0.983656406402588,0,0,1058,1054,1058,1054,twilight sparkle,moonatik
1669966.png,https://derpicdn.net/img/view/2018/3/2/1669966.png,0,0.9686427116394044,1000,0,2216,1126,1216,1126,twilight sparkle,badumsquish
1674692.png,https://derpicdn.net/img/view/2018/3/8/1674692.png,0,0.9970753788948059,475,0,1209,690,734,690,twilight sparkle,andelai
1675501.png,https://derpicdn.net/img/view/2018/3/9/1675501.png,0,0.9052621126174928,158,0,464,250,306,250,twilight sparkle,brendahickey
1675798.png,https://derpicdn.net/img/view/2018/3/10/1675798.png,0,0.9898445010185242,1084,0,3674,2357,2590,2357,twilight sparkle,sugarwings-art
1677545.png,https://derpicdn.net/img/view/2018/3/11/1677545.png,0,0.9201507568359376,97,0,789,624,692,624,twilight sparkle,hollowphantom
1679203.png,https://derpicdn.net/img/view/2018/3/13/1679203.png,0,0.9870497584342957,0,19,607,723,607,704,twilight sparkle,cloudyglow
1680748.png,https://derpicdn.net/img/view/2018/3/15/1680748.png,0,0.9606630802154541,438,0,1452,968,1014,968,twilight sparkle,ikirunosindo
1681428.png,https://derpicdn.net/img/view/2018/3/15/1681428.png,0,0.9983695149421692,409,8,1031,630,622,622,twilight sparkle,chaosangeldesu
1684468.png,https://derpicdn.net/img/view/2018/3/18/1684468.png,0,0.9979105591773988,0,60,361,430,361,370,twilight sparkle,turning-the-tides
1684468.png,https://derpicdn.net/img/view/2018/3/18/1684468.png,1,0.9968121647834778,836,545,1234,943,398,398,twilight sparkle,turning-the-tides
1684468.png,https://derpicdn.net/img/view/2018/3/18/1684468.png,2,0.987362265586853,569,0,997,423,428,423,twilight sparkle,turning-the-tides
1684643.png,https://derpicdn.net/img/view/2018/3/19/1684643.png,0,0.9862218499183656,69,0,877,761,808,761,twilight sparkle,luulyh
1685679.png,https://derpicdn.net/img/view/2018/3/20/1685679.png,0,0.9900322556495668,104,0,462,352,358,352,twilight sparkle,tre
1685697.png,https://derpicdn.net/img/view/2018/3/20/1685697.png,0,0.9516684412956238,12,27,586,601,574,574,twilight sparkle,tre
1687777.png,https://derpicdn.net/img/view/2018/3/23/1687777.png,0,0.9873523712158204,41,25,497,481,456,456,twilight sparkle,tallaferroxiv
1687952.png,https://derpicdn.net/img/view/2018/3/23/1687952.png,0,0.9848392009735109,12,156,1752,1896,1740,1740,twilight sparkle,phoenixrk49
1691738.png,https://derpicdn.net/img/view/2018/3/27/1691738.png,0,0.9918178915977478,231,3,575,347,344,344,twilight sparkle,ac-whiteraven
1692749.png,https://derpicdn.net/img/view/2018/3/28/1692749.png,0,0.9978094100952148,1370,870,1840,1340,470,470,twilight sparkle,mylittlegodzilla
1692749.png,https://derpicdn.net/img/view/2018/3/28/1692749.png,1,0.9854077100753784,0,373,671,1045,671,672,twilight sparkle,mylittlegodzilla
1693355.png,https://derpicdn.net/img/view/2018/3/28/1693355.png,0,0.9891428351402284,354,119,776,541,422,422,twilight sparkle,cold-blooded-twilight
1694819.png,https://derpicdn.net/img/view/2018/3/30/1694819.png,0,0.9770877361297609,0,0,1190,1049,1190,1049,twilight sparkle,hierozaki
1694948.png,https://derpicdn.net/img/view/2018/3/31/1694948.png,0,0.9286456108093262,814,0,4964,4516,4150,4516,twilight sparkle,jhayarr23
1696238.png,https://derpicdn.net/img/view/2018/4/1/1696238.png,0,0.9863109588623048,73,0,685,548,612,548,twilight sparkle,haden-2375
1698034.png,https://derpicdn.net/img/view/2018/4/3/1698034.png,0,0.9794996976852416,836,681,1138,968,302,287,twilight sparkle,
1699259.png,https://derpicdn.net/img/view/2018/4/4/1699259.png,0,0.994747519493103,418,0,1486,1026,1068,1026,twilight sparkle,pastelhorses|dapurpleheart
1699907.png,https://derpicdn.net/img/view/2018/4/5/1699907.png,0,0.9503532648086548,272,753,1662,2143,1390,1390,twilight sparkle,sea-maas
1702264.png,https://derpicdn.net/img/view/2018/4/8/1702264.png,0,0.9717212319374084,0,194,1796,2030,1796,1836,twilight sparkle,andoanimalia
1702574.png,https://derpicdn.net/img/view/2018/4/8/1702574.png,0,0.9304704070091248,393,114,1000,746,607,632,twilight sparkle,tralalayla
1703961.png,https://derpicdn.net/img/view/2018/4/10/1703961.png,0,0.9965757727622986,288,14,500,230,212,216,twilight sparkle,69beas
1704402.png,https://derpicdn.net/img/view/2018/4/10/1704402.png,0,0.9941562414169312,265,328,877,940,612,612,twilight sparkle,potetecyu_to
1711009.png,https://derpicdn.net/img/view/2018/4/18/1711009.png,0,0.9831209182739258,109,0,520,426,411,426,twilight sparkle,
1711548.png,https://derpicdn.net/img/view/2018/4/19/1711548.png,0,0.9090054035186768,0,138,480,624,480,486,twilight sparkle,uunicornicc
1712073.png,https://derpicdn.net/img/view/2018/4/19/1712073.png,0,0.938265323638916,438,0,1582,929,1144,929,twilight sparkle,fluttersheeeee
1712076.png,https://derpicdn.net/img/view/2018/4/19/1712076.png,0,0.9572449326515198,101,215,885,999,784,784,twilight sparkle,darkest-lunar-flower
1715125.png,https://derpicdn.net/img/view/2018/4/23/1715125.png,0,0.9537041783332824,3553,558,6439,3444,2886,2886,twilight sparkle,jhayarr23
1715813.png,https://derpicdn.net/img/view/2018/4/24/1715813.png,0,0.986270308494568,665,0,2069,1349,1404,1349,twilight sparkle,princesketchy
1716809.png,https://derpicdn.net/img/view/2018/4/25/1716809.png,0,0.9921804070472716,0,503,3768,4526,3768,4023,twilight sparkle,mandash1996
1717295.png,https://derpicdn.net/img/view/2018/4/26/1717295.png,0,0.9201481342315674,447,131,1075,759,628,628,twilight sparkle,sibashen
1718832.png,https://derpicdn.net/img/view/2018/4/28/1718832.png,0,0.9881635904312134,81,0,841,729,760,729,twilight sparkle,orang111
1718850.png,https://derpicdn.net/img/view/2018/4/28/1718850.png,0,0.9008949398994446,347,352,2983,2988,2636,2636,twilight sparkle,stardep
1718883.png,https://derpicdn.net/img/view/2018/4/28/1718883.png,0,0.9891632199287416,373,326,837,790,464,464,twilight sparkle,ragurimo
1718928.png,https://derpicdn.net/img/view/2018/4/28/1718928.png,0,0.996730625629425,240,0,786,543,546,543,twilight sparkle,rossignolet
1719345.png,https://derpicdn.net/img/view/2018/4/28/1719345.png,0,0.9744676947593688,143,3,539,399,396,396,twilight sparkle,
1719355.png,https://derpicdn.net/img/view/2018/4/28/1719355.png,0,0.9337533712387084,35,0,661,604,626,604,twilight sparkle,
1719373.png,https://derpicdn.net/img/view/2018/4/28/1719373.png,0,0.985630989074707,340,0,1292,950,952,950,twilight sparkle,lispp
1719571.png,https://derpicdn.net/img/view/2018/4/29/1719571.png,0,0.9987410902976992,2584,20,5142,2578,2558,2558,twilight sparkle,jhayarr23
1719651.png,https://derpicdn.net/img/view/2018/4/29/1719651.png,0,0.984993577003479,0,0,1394,1690,1394,1690,twilight sparkle,remcmaximus
1720169.png,https://derpicdn.net/img/view/2018/4/29/1720169.png,0,0.9187174439430236,114,125,2004,2015,1890,1890,twilight sparkle,andoanimalia
1721340.png,https://derpicdn.net/img/view/2018/5/1/1721340.png,0,0.9906411170959472,0,19,2711,2809,2711,2790,twilight sparkle,sketchmcreations
1721991.png,https://derpicdn.net/img/view/2018/5/1/1721991.png,0,0.9406921863555908,94,133,1562,1601,1468,1468,twilight sparkle,andoanimalia
1722141.png,https://derpicdn.net/img/view/2018/5/2/1722141.png,0,0.9896069765090942,2331,307,5049,3025,2718,2718,twilight sparkle,shutterflyeqd
1722198.png,https://derpicdn.net/img/view/2018/5/2/1722198.png,0,0.9954448342323304,426,35,1796,1405,1370,1370,twilight sparkle,jack-pie
1724558.png,https://derpicdn.net/img/view/2018/5/5/1724558.png,0,0.9828132390975952,126,20,826,720,700,700,twilight sparkle,
1725555.png,https://derpicdn.net/img/view/2018/5/6/1725555.png,0,0.9666060209274292,423,43,1301,921,878,878,twilight sparkle,fluttersheeeee
1734418.png,https://derpicdn.net/img/view/2018/5/16/1734418.png,0,0.9966781139373779,368,0,634,264,266,264,twilight sparkle,saladbomb
1735147.png,https://derpicdn.net/img/view/2018/5/17/1735147.png,0,0.9663678407669068,28,0,634,593,606,593,twilight sparkle,inuhoshi-to-darkpen
1735682.png,https://derpicdn.net/img/view/2018/5/18/1735682.png,0,0.9915453791618348,18,426,386,794,368,368,twilight sparkle,momoka
1735682.png,https://derpicdn.net/img/view/2018/5/18/1735682.png,1,0.9893395900726318,325,5,1021,701,696,696,twilight sparkle,momoka
1737287.png,https://derpicdn.net/img/view/2018/5/20/1737287.png,0,0.99718976020813,515,0,1000,472,485,472,twilight sparkle,noctylumi
1737985.png,https://derpicdn.net/img/view/2018/5/21/1737985.png,0,0.9902451038360596,283,225,1557,1499,1274,1274,twilight sparkle,orangejuicerus
1740629.png,https://derpicdn.net/img/view/2018/5/24/1740629.png,0,0.9482016563415528,0,0,3475,3701,3475,3701,twilight sparkle,dashiesparkle
1741909.png,https://derpicdn.net/img/view/2018/5/26/1741909.png,0,0.9762017130851746,1,0,931,845,930,845,twilight sparkle,
1744598.png,https://derpicdn.net/img/view/2018/5/29/1744598.png,0,0.997801661491394,390,37,2186,1833,1796,1796,twilight sparkle,potato22
1745782.png,https://derpicdn.net/img/view/2018/5/31/1745782.png,0,0.9913257360458374,26,3,254,231,228,228,twilight sparkle,azurepicker
1747.jpg,https://derpicdn.net/img/view/2012/1/23/1747.jpg,1,0.9679014086723328,1267,0,2339,833,1072,833,twilight sparkle,johnjoseco
1747641.png,https://derpicdn.net/img/view/2018/6/2/1747641.png,0,0.9373199343681335,272,0,1006,721,734,721,twilight sparkle,nounoo
1750693.png,https://derpicdn.net/img/view/2018/6/5/1750693.png,0,0.9914501905441284,5,29,695,719,690,690,twilight sparkle,drawbauchery
1750807.png,https://derpicdn.net/img/view/2018/6/5/1750807.png,0,0.945664644241333,0,11,197,215,197,204,twilight sparkle,peridotkitty
1751037.png,https://derpicdn.net/img/view/2018/6/6/1751037.png,0,0.9071763753890992,49,0,619,498,570,498,twilight sparkle,tohupo
1751080.png,https://derpicdn.net/img/view/2018/6/6/1751080.png,0,0.9901809096336364,4,99,632,727,628,628,twilight sparkle,rutkotka
1753239.png,https://derpicdn.net/img/view/2018/6/9/1753239.png,0,0.9926742315292358,27,3,255,231,228,228,twilight sparkle,azurepicker
1755108.png,https://derpicdn.net/img/view/2018/6/11/1755108.png,0,0.98242449760437,368,61,790,483,422,422,twilight sparkle,andelai
1756562.png,https://derpicdn.net/img/view/2018/6/13/1756562.png,0,0.990401327610016,90,32,784,726,694,694,twilight sparkle,johnjudes
1758347.png,https://derpicdn.net/img/view/2018/6/15/1758347.png,0,0.9972520470619202,1797,0,3473,1660,1676,1660,twilight sparkle,masem
1761340.png,https://derpicdn.net/img/view/2018/6/19/1761340.png,0,0.9883164167404176,500,127,1362,989,862,862,twilight sparkle,check3256
1761872.png,https://derpicdn.net/img/view/2018/6/20/1761872.png,0,0.9980483055114746,126,16,848,738,722,722,twilight sparkle,rapidstrike
1762343.png,https://derpicdn.net/img/view/2018/6/20/1762343.png,0,0.964971125125885,35,0,377,312,342,312,twilight sparkle,tiitcha
1762476.png,https://derpicdn.net/img/view/2018/6/21/1762476.png,0,0.9995993375778198,330,0,1864,1509,1534,1509,twilight sparkle,pabbley
1762527.png,https://derpicdn.net/img/view/2018/6/21/1762527.png,0,0.9867153763771056,484,40,882,438,398,398,twilight sparkle,esmeia
1762933.png,https://derpicdn.net/img/view/2018/6/21/1762933.png,0,0.9992859363555908,313,0,1873,1551,1560,1551,twilight sparkle,pabbley
1764723.png,https://derpicdn.net/img/view/2018/6/24/1764723.png,0,0.97624671459198,197,201,661,665,464,464,twilight sparkle,ghostlymarie
1770901.png,https://derpicdn.net/img/view/2018/7/2/1770901.png,1,0.9821618795394896,287,13,1361,1087,1074,1074,twilight sparkle,sourspot
1770901.png,https://derpicdn.net/img/view/2018/7/2/1770901.png,2,0.980096161365509,1696,783,2722,1809,1026,1026,twilight sparkle,sourspot
1770901.png,https://derpicdn.net/img/view/2018/7/2/1770901.png,3,0.9115064740180968,1769,0,2751,938,982,938,twilight sparkle,sourspot
1771046.png,https://derpicdn.net/img/view/2018/7/2/1771046.png,0,0.9937022924423218,272,116,4534,4378,4262,4262,twilight sparkle,dragonchaser123
1772391.png,https://derpicdn.net/img/view/2018/7/4/1772391.png,0,0.9427494406700134,114,106,928,920,814,814,twilight sparkle,feathershine1
1774286.png,https://derpicdn.net/img/view/2018/7/6/1774286.png,0,0.9181687235832214,88,45,716,673,628,628,twilight sparkle,loneless-art
1774821.png,https://derpicdn.net/img/view/2018/7/7/1774821.png,0,0.9968923926353456,381,115,1637,1371,1256,1256,twilight sparkle,dreamyeevee
1778272.png,https://derpicdn.net/img/view/2018/7/11/1778272.png,0,0.997407615184784,0,246,1418,1838,1418,1592,twilight sparkle,thejuicepit
1778272.png,https://derpicdn.net/img/view/2018/7/11/1778272.png,1,0.9868817329406738,2446,616,4278,2448,1832,1832,twilight sparkle,thejuicepit
1778272.png,https://derpicdn.net/img/view/2018/7/11/1778272.png,2,0.9687792658805848,203,4001,1503,5301,1300,1300,twilight sparkle,thejuicepit
1780737.png,https://derpicdn.net/img/view/2018/7/14/1780737.png,0,0.9985175132751464,562,779,1398,1615,836,836,twilight sparkle,freeedon
1782761.png,https://derpicdn.net/img/view/2018/7/17/1782761.png,0,0.9974068999290466,929,86,1575,732,646,646,twilight sparkle,ohemo
1783261.png,https://derpicdn.net/img/view/2018/7/17/1783261.png,0,0.9217899441719056,0,106,212,322,212,216,twilight sparkle,
1783573.png,https://derpicdn.net/img/view/2018/7/18/1783573.png,0,0.9884825348854064,36,0,726,661,690,661,twilight sparkle,kkotnim
1784513.png,https://derpicdn.net/img/view/2018/7/19/1784513.png,0,0.9976530671119692,275,77,1755,1557,1480,1480,twilight sparkle,dreamyeevee
1784661.png,https://derpicdn.net/img/view/2018/7/19/1784661.png,0,0.9127686023712158,395,0,809,391,414,391,twilight sparkle,posionjoke
1785202.png,https://derpicdn.net/img/view/2018/7/20/1785202.png,0,0.9947823882102966,236,467,2594,2825,2358,2358,twilight sparkle,skylacuna
1785297.png,https://derpicdn.net/img/view/2018/7/20/1785297.png,0,0.9764764904975892,6,0,1358,1339,1352,1339,twilight sparkle,rariedash
1786035.png,https://derpicdn.net/img/view/2018/7/21/1786035.png,0,0.9616398215293884,33,46,701,714,668,668,twilight sparkle,thealjavis
1787647.png,https://derpicdn.net/img/view/2018/7/23/1787647.png,0,0.9747235178947448,308,0,2208,1749,1900,1749,twilight sparkle,shyshyoctavia
1788652.png,https://derpicdn.net/img/view/2018/7/24/1788652.png,0,0.9743544459342957,1629,828,2219,1418,590,590,twilight sparkle,cckittycreative
1789009.png,https://derpicdn.net/img/view/2018/7/24/1789009.png,0,0.9959893226623536,23,13,381,371,358,358,twilight sparkle,bakuhaku
1792363.png,https://derpicdn.net/img/view/2018/7/29/1792363.png,0,0.9962956309318542,58,0,2384,2309,2326,2309,twilight sparkle,merry-carousel
1792768.png,https://derpicdn.net/img/view/2018/7/29/1792768.png,0,0.9889216423034668,164,0,2854,2647,2690,2647,twilight sparkle,amarthgul
1793596.png,https://derpicdn.net/img/view/2018/7/30/1793596.png,0,0.993902862071991,756,120,1124,488,368,368,twilight sparkle,rutkotka
1795648.png,https://derpicdn.net/img/view/2018/8/2/1795648.png,0,0.9900441169738772,0,0,1335,1360,1335,1360,twilight sparkle,binkyt11
1796150.png,https://derpicdn.net/img/view/2018/8/2/1796150.png,0,0.9948828220367432,460,0,1520,802,1060,802,twilight sparkle,shad0w-galaxy
1796502.png,https://derpicdn.net/img/view/2018/8/3/1796502.png,0,0.9974188208580016,3086,392,5446,2752,2360,2360,twilight sparkle,thefloatingtree
1796802.png,https://derpicdn.net/img/view/2018/8/3/1796802.png,0,0.9989259243011476,444,0,1956,1481,1512,1481,twilight sparkle,amberpendant
1796999.png,https://derpicdn.net/img/view/2018/8/3/1796999.png,0,0.990668535232544,161,0,741,571,580,571,twilight sparkle,pabbley
1798538.png,https://derpicdn.net/img/view/2018/8/5/1798538.png,0,0.9826936721801758,48,0,2958,2779,2910,2779,twilight sparkle,eagle1division
1799.png,https://derpicdn.net/img/view/2012/1/23/1799.png,0,0.9927693009376526,264,19,624,379,360,360,twilight sparkle,johnjoseco
1799482.png,https://derpicdn.net/img/view/2018/8/6/1799482.png,0,0.9991592168807985,77,0,515,426,438,426,twilight sparkle,dfectivedvice|sepiakeys
1799923.png,https://derpicdn.net/img/view/2018/8/6/1799923.png,0,0.9893670082092284,500,15,884,399,384,384,twilight sparkle,ak4neh
1801587.png,https://derpicdn.net/img/view/2018/8/8/1801587.png,0,0.9887908101081848,0,0,449,445,449,445,twilight sparkle,dusthiel
1801671.png,https://derpicdn.net/img/view/2018/8/8/1801671.png,0,0.9668310880661012,346,18,712,384,366,366,twilight sparkle,kei kun
1802.png,https://derpicdn.net/img/view/2012/1/23/1802.png,0,0.990566611289978,41,0,625,564,584,564,twilight sparkle,johnjoseco
1802121.png,https://derpicdn.net/img/view/2018/8/9/1802121.png,0,0.9885088801383972,935,286,1473,824,538,538,twilight sparkle,heir-of-rick
1802381.png,https://derpicdn.net/img/view/2018/8/9/1802381.png,0,0.9256858229637146,90,0,464,362,374,362,twilight sparkle,スカイ
1802746.png,https://derpicdn.net/img/view/2018/8/9/1802746.png,0,0.981546938419342,51,0,1355,1080,1304,1080,twilight sparkle,hierozaki
1803680.png,https://derpicdn.net/img/view/2018/8/11/1803680.png,0,0.9847784042358398,775,0,1799,900,1024,900,twilight sparkle,pink1ejack|jeki
1806077.png,https://derpicdn.net/img/view/2018/8/13/1806077.png,0,0.9879471063613892,24,204,2298,2449,2274,2245,twilight sparkle,wilvarin-liadon
1806680.png,https://derpicdn.net/img/view/2018/8/14/1806680.png,0,0.9761917591094972,127,0,693,507,566,507,twilight sparkle,tohupo
1807037.png,https://derpicdn.net/img/view/2018/8/15/1807037.png,0,0.9987361431121826,624,3,1582,961,958,958,twilight sparkle,danmakuman
1807420.png,https://derpicdn.net/img/view/2018/8/15/1807420.png,0,0.9830875396728516,310,0,2768,2340,2458,2340,twilight sparkle,imbirgiana
1808510.png,https://derpicdn.net/img/view/2018/8/16/1808510.png,0,0.9973779320716858,259,0,625,315,366,315,twilight sparkle,thecreativerey
1809128.png,https://derpicdn.net/img/view/2018/8/17/1809128.png,0,0.973641037940979,506,99,1148,741,642,642,twilight sparkle,tyantyai_mokka
1811161.png,https://derpicdn.net/img/view/2018/8/19/1811161.png,0,0.9958364963531494,484,0,2084,1555,1600,1555,twilight sparkle,jetwave
1811598.png,https://derpicdn.net/img/view/2018/8/20/1811598.png,0,0.9959120750427246,31,0,319,288,288,288,twilight sparkle,dsp2003
1813824.png,https://derpicdn.net/img/view/2018/8/23/1813824.png,0,0.9962142109870912,66,637,2138,2709,2072,2072,twilight sparkle,fluttersheeeee
1817520.png,https://derpicdn.net/img/view/2018/8/27/1817520.png,0,0.9884592890739441,483,31,1061,609,578,578,twilight sparkle,drmedrick
1820311.png,https://derpicdn.net/img/view/2018/8/30/1820311.png,0,0.9736818075180054,1302,436,1804,938,502,502,twilight sparkle,elzafox
1822.png,https://derpicdn.net/img/view/2012/1/23/1822.png,0,0.958938717842102,300,0,700,420,400,420,twilight sparkle,johnjoseco
1825665.png,https://derpicdn.net/img/view/2018/9/5/1825665.png,0,0.9924603700637816,426,0,1270,725,844,725,twilight sparkle,hierozaki
1826796.png,https://derpicdn.net/img/view/2018/9/7/1826796.png,0,0.9841587543487548,742,308,1704,1270,962,962,twilight sparkle,metalbladepegasus
1827183.png,https://derpicdn.net/img/view/2018/9/7/1827183.png,0,0.9985363483428956,170,0,2856,2605,2686,2605,twilight sparkle,plaguedogs123
1827868.png,https://derpicdn.net/img/view/2018/9/8/1827868.png,0,0.985917031764984,200,0,564,361,364,361,twilight sparkle,flash equestria photography
1829084.png,https://derpicdn.net/img/view/2018/9/10/1829084.png,0,0.9976117610931396,134,0,670,513,536,513,twilight sparkle,empyu
1829125.png,https://derpicdn.net/img/view/2018/9/10/1829125.png,0,0.9406830668449402,58,5,342,291,284,286,twilight sparkle,duop-qoub
1829142.png,https://derpicdn.net/img/view/2018/9/10/1829142.png,0,0.9717731475830078,89,0,739,604,650,604,twilight sparkle,kkotnim
1829303.png,https://derpicdn.net/img/view/2018/9/10/1829303.png,0,0.9989669322967528,740,0,1894,1101,1154,1101,twilight sparkle,evilenchantress
1831280.png,https://derpicdn.net/img/view/2018/9/12/1831280.png,0,0.9865143299102784,821,75,1555,809,734,734,twilight sparkle,cloud-drawings
1831326.png,https://derpicdn.net/img/view/2018/9/12/1831326.png,0,0.9985233545303344,0,0,589,594,589,594,twilight sparkle,ladychimaera
18343.png,https://derpicdn.net/img/view/2012/6/24/18343.png,0,0.9975551962852478,232,54,652,474,420,420,twilight sparkle,zev
1835413.png,https://derpicdn.net/img/view/2018/9/18/1835413.png,0,0.9678085446357728,681,0,1187,393,506,393,twilight sparkle,drafthoof|hierozaki
1837218.png,https://derpicdn.net/img/view/2018/9/20/1837218.png,0,0.9777571558952332,2799,0,4695,1705,1896,1705,twilight sparkle,fatfurparadise
1840758.png,https://derpicdn.net/img/view/2018/9/25/1840758.png,0,0.9979683756828308,153,0,461,301,308,301,twilight sparkle,lulubell
1842291.png,https://derpicdn.net/img/view/2018/9/27/1842291.png,0,0.9227227568626404,3,0,391,379,388,379,twilight sparkle,floofurr
1843413.png,https://derpicdn.net/img/view/2018/9/28/1843413.png,0,0.979755401611328,331,72,629,370,298,298,twilight sparkle,inuhoshi-to-darkpen
1844066.png,https://derpicdn.net/img/view/2018/9/29/1844066.png,0,0.9952910542488098,288,29,848,589,560,560,twilight sparkle,moonatik
1844211.png,https://derpicdn.net/img/view/2018/9/29/1844211.png,0,0.9997070431709292,682,21,1382,721,700,700,twilight sparkle,crownhound
1844697.png,https://derpicdn.net/img/view/2018/9/30/1844697.png,0,0.9987163543701172,115,0,913,784,798,784,twilight sparkle,youyu
1844899.png,https://derpicdn.net/img/view/2018/9/30/1844899.png,0,0.9965741634368896,400,38,3262,2900,2862,2862,twilight sparkle,pink1ejack
1844960.png,https://derpicdn.net/img/view/2018/9/30/1844960.png,0,0.9370715022087096,1398,806,2138,1546,740,740,twilight sparkle,nessacity
1846769.png,https://derpicdn.net/img/view/2018/10/3/1846769.png,0,0.997262179851532,514,250,1332,1068,818,818,twilight sparkle,mrscroup
1846792.png,https://derpicdn.net/img/view/2018/10/3/1846792.png,0,0.9814199805259703,288,184,912,808,624,624,twilight sparkle,andypriceart
1846906.png,https://derpicdn.net/img/view/2018/10/3/1846906.png,0,0.983191192150116,2456,329,3220,1093,764,764,twilight sparkle,ciderpunk
1847071.png,https://derpicdn.net/img/view/2018/10/3/1847071.png,0,0.9956238269805908,161,0,723,549,562,549,twilight sparkle,glorious-rarien
1847398.png,https://derpicdn.net/img/view/2018/10/3/1847398.png,0,0.9799900650978088,462,168,1304,1010,842,842,twilight sparkle,2387528112
1848144.png,https://derpicdn.net/img/view/2018/10/4/1848144.png,0,0.9301643371582032,467,240,1183,956,716,716,twilight sparkle,lou
1848932.png,https://derpicdn.net/img/view/2018/10/5/1848932.png,0,0.9903949499130248,121,3,895,777,774,774,twilight sparkle,figgot
1849783.png,https://derpicdn.net/img/view/2018/10/6/1849783.png,0,0.994271755218506,328,0,1340,973,1012,973,twilight sparkle,norithecat
1852918.png,https://derpicdn.net/img/view/2018/10/10/1852918.png,0,0.9547405838966372,373,140,2459,2342,2086,2202,twilight sparkle,sketchmcreations
1853777.png,https://derpicdn.net/img/view/2018/10/11/1853777.png,0,0.990451455116272,738,274,1324,860,586,586,twilight sparkle,koveliana
1854573.png,https://derpicdn.net/img/view/2018/10/12/1854573.png,0,0.9807573556900024,0,0,3326,3444,3326,3444,twilight sparkle,kimmyartmlp
1855022.png,https://derpicdn.net/img/view/2018/10/13/1855022.png,0,0.9790673851966858,0,0,427,541,427,541,twilight sparkle,
1859244.png,https://derpicdn.net/img/view/2018/10/17/1859244.png,0,0.9980528950691224,131,229,363,461,232,232,twilight sparkle,kazunekomori
1859244.png,https://derpicdn.net/img/view/2018/10/17/1859244.png,1,0.9615144133567808,311,90,603,382,292,292,twilight sparkle,kazunekomori
1859765.png,https://derpicdn.net/img/view/2018/10/18/1859765.png,0,0.9768384099006652,236,0,1120,874,884,874,twilight sparkle,heddopen
1861370.png,https://derpicdn.net/img/view/2018/10/20/1861370.png,0,0.9938942790031432,79,0,1061,959,982,959,twilight sparkle,imbirgiana
1863635.png,https://derpicdn.net/img/view/2018/10/23/1863635.png,0,0.9542730450630188,511,0,2367,1805,1856,1805,twilight sparkle,jack-pie
1865775.png,https://derpicdn.net/img/view/2018/10/25/1865775.png,0,0.9945180416107178,15,0,875,764,860,764,twilight sparkle,ifoxtrax
1867115.png,https://derpicdn.net/img/view/2018/10/27/1867115.png,0,0.9289345741271972,249,662,1749,2162,1500,1500,twilight sparkle,andoanimalia
1869778.png,https://derpicdn.net/img/view/2018/10/29/1869778.png,0,0.9610511660575868,797,71,2037,1311,1240,1240,twilight sparkle,moonatik
1869823.png,https://derpicdn.net/img/view/2018/10/29/1869823.png,0,0.9832347631454468,221,7,851,637,630,630,twilight sparkle,posionjoke
1870530.png,https://derpicdn.net/img/view/2018/10/30/1870530.png,0,0.995225429534912,275,0,931,622,656,622,twilight sparkle,baigak
18708.jpg,https://derpicdn.net/img/view/2012/6/24/18708.jpg,0,0.9937219023704528,118,72,900,854,782,782,twilight sparkle,pyruvate
1870856.png,https://derpicdn.net/img/view/2018/10/31/1870856.png,0,0.9835743904113772,442,116,1050,724,608,608,twilight sparkle,phucknuckl
1872454.png,https://derpicdn.net/img/view/2018/11/1/1872454.png,0,0.9667236804962158,30,0,702,649,672,649,twilight sparkle,shgurr
1874280.png,https://derpicdn.net/img/view/2018/11/3/1874280.png,0,0.9976609945297241,29,55,197,223,168,168,twilight sparkle,horsepaws
1874421.png,https://derpicdn.net/img/view/2018/11/3/1874421.png,0,0.9526135325431824,41,0,283,204,242,204,twilight sparkle,jopiter
1876105.png,https://derpicdn.net/img/view/2018/11/6/1876105.png,0,0.9993102550506592,165,161,561,557,396,396,twilight sparkle,vistamage
1878237.png,https://derpicdn.net/img/view/2018/11/9/1878237.png,0,0.9865540862083436,658,0,1748,897,1090,897,twilight sparkle,purplegrim40
1878418.png,https://derpicdn.net/img/view/2018/11/9/1878418.png,0,0.9764800071716307,1330,0,2234,734,904,734,twilight sparkle,kirasunnight
1886045.png,https://derpicdn.net/img/view/2018/11/19/1886045.png,0,0.9899166822433472,14,102,548,636,534,534,twilight sparkle,baigak
1887693.png,https://derpicdn.net/img/view/2018/11/21/1887693.png,0,0.9849053025245668,255,100,677,522,422,422,twilight sparkle,keethrynk|midnightpremiere
1890073.png,https://derpicdn.net/img/view/2018/11/24/1890073.png,0,0.9902715682983398,1775,0,4063,2187,2288,2187,twilight sparkle,chickenbrony
1890802.png,https://derpicdn.net/img/view/2018/11/25/1890802.png,0,0.9882754683494568,530,549,1378,1397,848,848,twilight sparkle,theanthropony
1891844.png,https://derpicdn.net/img/view/2018/11/27/1891844.png,0,0.9973887801170348,486,615,1580,1709,1094,1094,twilight sparkle,forythien
1896568.png,https://derpicdn.net/img/view/2018/12/2/1896568.png,0,0.9941087961196899,503,173,987,657,484,484,twilight sparkle,watertimdragon
1899402.png,https://derpicdn.net/img/view/2018/12/5/1899402.png,0,0.9664739966392516,572,155,3256,2839,2684,2684,twilight sparkle,darkest-lunar-flower
1901144.png,https://derpicdn.net/img/view/2018/12/7/1901144.png,0,0.9991816878318788,41,0,845,783,804,783,twilight sparkle,yunlongchen
1902095.png,https://derpicdn.net/img/view/2018/12/8/1902095.png,0,0.9989083409309388,40,0,848,783,808,783,twilight sparkle,yunlongchen
1904900.png,https://derpicdn.net/img/view/2018/12/10/1904900.png,0,0.9478019475936892,9,0,1089,1009,1080,1009,twilight sparkle,hierozaki
1911145.png,https://derpicdn.net/img/view/2018/12/17/1911145.png,0,0.9702134728431702,335,62,1375,1102,1040,1040,twilight sparkle,php97
1916454.png,https://derpicdn.net/img/view/2018/12/23/1916454.png,0,0.963792085647583,472,82,1514,1124,1042,1042,twilight sparkle,sk-ree
1917413.png,https://derpicdn.net/img/view/2018/12/24/1917413.png,0,0.9532507061958312,62,94,450,482,388,388,twilight sparkle,sion
1918985.png,https://derpicdn.net/img/view/2018/12/26/1918985.png,0,0.9532718062400818,173,0,894,852,721,852,twilight sparkle,oathkeeper21
1919597.png,https://derpicdn.net/img/view/2018/12/26/1919597.png,0,0.971388041973114,205,0,889,584,684,584,twilight sparkle,hierozaki
1923316.png,https://derpicdn.net/img/view/2018/12/31/1923316.png,0,0.979763388633728,313,84,1491,1262,1178,1178,twilight sparkle,danli69
1925180.png,https://derpicdn.net/img/view/2019/1/2/1925180.png,0,0.953527569770813,83,1076,1013,2006,930,930,twilight sparkle,スピカ
1928208.png,https://derpicdn.net/img/view/2019/1/6/1928208.png,0,0.9891920685768129,1265,0,2011,651,746,651,twilight sparkle,tingsan
1930029.png,https://derpicdn.net/img/view/2019/1/8/1930029.png,0,0.9986459016799928,168,12,1404,1248,1236,1236,twilight sparkle,shad0w-galaxy
1930085.png,https://derpicdn.net/img/view/2019/1/8/1930085.png,0,0.9987432956695556,1051,0,1500,427,449,427,twilight sparkle,xeniusfms
1930085.png,https://derpicdn.net/img/view/2019/1/8/1930085.png,1,0.9987238049507141,98,0,490,350,392,350,twilight sparkle,xeniusfms
19301.png,https://derpicdn.net/img/view/2012/6/24/19301.png,0,0.9528059363365172,496,94,910,508,414,414,twilight sparkle,no-ink
1931770.png,https://derpicdn.net/img/view/2019/1/10/1931770.png,0,0.9817492365837096,0,0,707,750,707,750,twilight sparkle,tohupo
1934691.png,https://derpicdn.net/img/view/2019/1/13/1934691.png,0,0.9578481912612916,831,0,1993,1112,1162,1112,twilight sparkle,candyclumsy
1934984.png,https://derpicdn.net/img/view/2019/1/14/1934984.png,0,0.9929699301719666,29,0,629,519,600,519,twilight sparkle,tastyrainbow
1935020.png,https://derpicdn.net/img/view/2019/1/14/1935020.png,0,0.9964386820793152,38,168,594,724,556,556,twilight sparkle,hattsy-nsfw
1937486.png,https://derpicdn.net/img/view/2019/1/17/1937486.png,0,0.9966168403625488,295,0,1095,738,800,738,twilight sparkle,cloud-fly
1940048.png,https://derpicdn.net/img/view/2019/1/20/1940048.png,0,0.9900920391082764,292,79,1408,1195,1116,1116,twilight sparkle,deltahedgehog
1944208.png,https://derpicdn.net/img/view/2019/1/25/1944208.png,0,0.9865990877151488,223,12,429,218,206,206,twilight sparkle,tzc
1946797.png,https://derpicdn.net/img/view/2019/1/28/1946797.png,0,0.998457670211792,1232,0,2382,1137,1150,1137,twilight sparkle,icychamber
1947228.png,https://derpicdn.net/img/view/2019/1/28/1947228.png,0,0.9990817308425904,0,68,2820,3274,2820,3206,twilight sparkle,andoanimalia
1948690.png,https://derpicdn.net/img/view/2019/1/30/1948690.png,0,0.998159885406494,38,66,496,524,458,458,twilight sparkle,pollynia
1948957.png,https://derpicdn.net/img/view/2019/1/30/1948957.png,0,0.9990033507347108,285,59,1409,1183,1124,1124,twilight sparkle,projectzuel
1949395.png,https://derpicdn.net/img/view/2019/1/31/1949395.png,0,0.9846763610839844,3023,0,4751,1625,1728,1625,twilight sparkle,andelai
1949395.png,https://derpicdn.net/img/view/2019/1/31/1949395.png,1,0.9611941576004028,851,175,2533,1857,1682,1682,twilight sparkle,andelai
1949628.png,https://derpicdn.net/img/view/2019/1/31/1949628.png,0,0.9486063718795776,401,249,1231,1079,830,830,twilight sparkle,bushbuck93
1950983.png,https://derpicdn.net/img/view/2019/2/2/1950983.png,0,0.986925721168518,114,68,1152,1106,1038,1038,twilight sparkle,鱼爪
1951818.png,https://derpicdn.net/img/view/2019/2/3/1951818.png,0,0.9863932728767396,709,0,1919,1168,1210,1168,twilight sparkle,nekosnicker
1952122.png,https://derpicdn.net/img/view/2019/2/3/1952122.png,0,0.9758185744285583,0,0,2507,2716,2507,2716,twilight sparkle,cloudyglow
1952394.png,https://derpicdn.net/img/view/2019/2/3/1952394.png,0,0.9785526394844056,420,0,1542,1108,1122,1108,twilight sparkle,saxopi
1955713.png,https://derpicdn.net/img/view/2019/2/7/1955713.png,0,0.985193371772766,312,0,766,424,454,424,twilight sparkle,neuro
1955713.png,https://derpicdn.net/img/view/2019/2/7/1955713.png,1,0.9261476397514344,243,336,721,773,478,437,twilight sparkle,neuro
1957223.png,https://derpicdn.net/img/view/2019/2/9/1957223.png,0,0.999695360660553,710,234,1998,1522,1288,1288,twilight sparkle,misterph0enix
1958519.png,https://derpicdn.net/img/view/2019/2/10/1958519.png,0,0.9937030076980592,65,63,523,521,458,458,twilight sparkle,云观雾里
1958750.png,https://derpicdn.net/img/view/2019/2/10/1958750.png,0,0.9825586676597596,377,81,2289,1993,1912,1912,twilight sparkle,artiks
1958751.png,https://derpicdn.net/img/view/2019/2/10/1958751.png,0,0.995148241519928,280,0,2400,2022,2120,2022,twilight sparkle,artiks
1959104.png,https://derpicdn.net/img/view/2019/2/11/1959104.png,0,0.9828624129295348,0,0,754,693,754,693,twilight sparkle,lazynore
1959607.png,https://derpicdn.net/img/view/2019/2/11/1959607.png,0,0.977334439754486,399,373,2231,2205,1832,1832,twilight sparkle,oinktweetstudios
1961026.png,https://derpicdn.net/img/view/2019/2/13/1961026.png,0,0.991064190864563,483,0,1373,820,890,820,twilight sparkle,danli69
1961279.png,https://derpicdn.net/img/view/2019/2/13/1961279.png,0,0.9968363642692566,843,896,3633,3686,2790,2790,twilight sparkle,mrkat7214
1962343.png,https://derpicdn.net/img/view/2019/2/15/1962343.png,0,0.99708354473114,668,433,1562,1327,894,894,twilight sparkle,iceofwaterflock
1963055.png,https://derpicdn.net/img/view/2019/2/15/1963055.png,0,0.9115034937858582,112,66,876,830,764,764,twilight sparkle,radiantrealm
1964956.png,https://derpicdn.net/img/view/2019/2/18/1964956.png,0,0.9858312010765076,0,121,903,1024,903,903,twilight sparkle,spookitty
1964957.png,https://derpicdn.net/img/view/2019/2/18/1964957.png,0,0.9817254543304444,14,72,1000,1024,986,952,twilight sparkle,spookitty
1965367.png,https://derpicdn.net/img/view/2019/2/18/1965367.png,0,0.9965404272079468,673,0,1701,1025,1028,1025,twilight sparkle,baigak
1966662.png,https://derpicdn.net/img/view/2019/2/20/1966662.png,0,0.9027954339981079,566,0,1119,530,553,530,twilight sparkle,
1967961.png,https://derpicdn.net/img/view/2019/2/21/1967961.png,0,0.9969896674156188,313,0,971,615,658,615,twilight sparkle,empyu
196817.png,https://derpicdn.net/img/view/2012/12/29/196817.png,0,0.918042540550232,967,152,1855,1040,888,888,twilight sparkle,danmakuman
1970952.png,https://derpicdn.net/img/view/2019/2/24/1970952.png,0,0.986941397190094,526,0,1346,768,820,768,twilight sparkle,greyscaleart
1971163.png,https://derpicdn.net/img/view/2019/2/25/1971163.png,0,0.9963635206222534,428,0,1404,966,976,966,twilight sparkle,mylittlegodzilla
1974400.png,https://derpicdn.net/img/view/2019/3/1/1974400.png,0,0.9979754090309144,303,0,915,604,612,604,twilight sparkle,sacredshedinja
1974870.png,https://derpicdn.net/img/view/2019/3/1/1974870.png,0,0.9852212071418762,459,293,827,661,368,368,twilight sparkle,skyeypony
1975733.png,https://derpicdn.net/img/view/2019/3/2/1975733.png,0,0.92293781042099,287,0,1543,983,1256,983,twilight sparkle,hierozaki
1976906.png,https://derpicdn.net/img/view/2019/3/3/1976906.png,0,0.9768951535224916,129,53,659,583,530,530,twilight sparkle,mequiloano
1983333.png,https://derpicdn.net/img/view/2019/3/11/1983333.png,0,0.9296401739120485,50,0,906,418,856,418,twilight sparkle,prince-lionel
1985764.png,https://derpicdn.net/img/view/2019/3/15/1985764.png,0,0.982634961605072,654,19,1726,1091,1072,1072,twilight sparkle,turnipberry
1989114.png,https://derpicdn.net/img/view/2019/3/18/1989114.png,0,0.9238089919090272,16,21,428,433,412,412,twilight sparkle,vale-bandicoot96
1990190.png,https://derpicdn.net/img/view/2019/3/19/1990190.png,0,0.98567533493042,263,0,1139,860,876,860,twilight sparkle,crossedcrown
1991663.png,https://derpicdn.net/img/view/2019/3/21/1991663.png,0,0.9922667145729064,27,22,2241,2236,2214,2214,twilight sparkle,yukomaussi
1993896.png,https://derpicdn.net/img/view/2019/3/24/1993896.png,0,0.9891030788421632,780,0,3524,2638,2744,2638,twilight sparkle,flushthebatsanta
1994591.png,https://derpicdn.net/img/view/2019/3/25/1994591.png,0,0.997671604156494,301,39,821,559,520,520,twilight sparkle,pixel-prism
1996044.png,https://derpicdn.net/img/view/2019/3/27/1996044.png,0,0.9670423269271852,8,0,1394,1236,1386,1236,twilight sparkle,cutepencilcase
1997449.png,https://derpicdn.net/img/view/2019/3/29/1997449.png,0,0.9877524375915528,423,427,1183,1187,760,760,twilight sparkle,taneysha
1997449.png,https://derpicdn.net/img/view/2019/3/29/1997449.png,1,0.9568015336990356,1067,534,1897,1364,830,830,twilight sparkle,taneysha
1999505.png,https://derpicdn.net/img/view/2019/3/31/1999505.png,0,0.9607202410697936,1389,0,4681,3143,3292,3143,twilight sparkle,digimonlover101
1999859.png,https://derpicdn.net/img/view/2019/4/1/1999859.png,0,0.9962822198867798,226,16,636,428,410,412,twilight sparkle,
2000190.png,https://derpicdn.net/img/view/2019/4/1/2000190.png,0,0.9967483282089232,0,0,546,512,546,512,twilight sparkle,crystalmagic6
2000738.png,https://derpicdn.net/img/view/2019/4/2/2000738.png,0,0.9969640970230104,1216,0,2750,1492,1534,1492,twilight sparkle,skeolan
2001711.png,https://derpicdn.net/img/view/2019/4/3/2001711.png,0,0.9871239066123962,1636,1565,3336,3265,1700,1700,twilight sparkle,imafutureguitarhero|buttercupsaiyan
2002386.png,https://derpicdn.net/img/view/2019/4/4/2002386.png,0,0.9991427063941956,980,433,2452,1905,1472,1472,twilight sparkle,sethisto
2002420.png,https://derpicdn.net/img/view/2019/4/4/2002420.png,0,0.9815793037414552,446,20,992,594,546,574,twilight sparkle,jhayarr23
2002776.png,https://derpicdn.net/img/view/2019/4/4/2002776.png,0,0.9877336621284484,132,0,1108,976,976,976,twilight sparkle,yuyusunshine
2003082.png,https://derpicdn.net/img/view/2019/4/4/2003082.png,0,0.9909265637397766,197,0,1265,993,1068,993,twilight sparkle,livehotsun
2003377.png,https://derpicdn.net/img/view/2019/4/5/2003377.png,0,0.980350136756897,128,237,708,817,580,580,twilight sparkle,varwing
2005891.png,https://derpicdn.net/img/view/2019/4/7/2005891.png,0,0.9567064046859741,1324,176,2220,1072,896,896,twilight sparkle,andelai
2006051.png,https://derpicdn.net/img/view/2019/4/8/2006051.png,0,0.9574686884880066,794,506,1766,1478,972,972,twilight sparkle,autumnvoyage
2009489.png,https://derpicdn.net/img/view/2019/4/12/2009489.png,0,0.972847580909729,394,0,872,462,478,462,twilight sparkle,jhayarr23
2009499.png,https://derpicdn.net/img/view/2019/4/12/2009499.png,0,0.9561883807182312,0,0,528,521,528,521,twilight sparkle,crystalmagic6
2009941.png,https://derpicdn.net/img/view/2019/4/12/2009941.png,0,0.9918563365936279,1569,131,2127,689,558,558,twilight sparkle,king-kakapo
2009941.png,https://derpicdn.net/img/view/2019/4/12/2009941.png,1,0.9590083956718444,558,773,1158,1373,600,600,twilight sparkle,king-kakapo
2012011.png,https://derpicdn.net/img/view/2019/4/14/2012011.png,0,0.9854618906974792,1241,0,2913,1470,1672,1470,twilight sparkle,reterica
2013633.png,https://derpicdn.net/img/view/2019/4/15/2013633.png,0,0.9909814596176147,0,217,1805,2181,1805,1964,twilight sparkle,pridark
2014338.png,https://derpicdn.net/img/view/2019/4/16/2014338.png,0,0.9440426826477052,575,0,951,374,376,374,twilight sparkle,thenornonthego
2014805.png,https://derpicdn.net/img/view/2019/4/17/2014805.png,0,0.9966576099395752,483,0,1027,517,544,517,twilight sparkle,lambyanxious
2016871.png,https://derpicdn.net/img/view/2019/4/19/2016871.png,0,0.9874852299690248,35,0,459,411,424,411,twilight sparkle,ikarooz
2018316.png,https://derpicdn.net/img/view/2019/4/20/2018316.png,0,0.9879658818244934,388,372,714,698,326,326,twilight sparkle,margony
2019214.png,https://derpicdn.net/img/view/2019/4/21/2019214.png,0,0.9886309504508972,388,372,714,698,326,326,twilight sparkle,margony
2023219.png,https://derpicdn.net/img/view/2019/4/26/2023219.png,0,0.9980241060256958,634,271,1556,1193,922,922,twilight sparkle,donmarcino
2024251.png,https://derpicdn.net/img/view/2019/4/27/2024251.png,0,0.9759161472320556,28,25,1098,1080,1070,1055,twilight sparkle,
2024294.png,https://derpicdn.net/img/view/2019/4/27/2024294.png,0,0.9775114655494692,2,37,432,467,430,430,twilight sparkle,
2024603.png,https://derpicdn.net/img/view/2019/4/27/2024603.png,0,0.9612558484077454,0,38,774,860,774,822,twilight sparkle,
2024674.png,https://derpicdn.net/img/view/2019/4/27/2024674.png,0,0.994415819644928,949,0,2663,1674,1714,1674,twilight sparkle,shibaroll
2025323.png,https://derpicdn.net/img/view/2019/4/28/2025323.png,0,0.969142496585846,172,295,1144,1267,972,972,twilight sparkle,phucknuckl
2025847.png,https://derpicdn.net/img/view/2019/4/28/2025847.png,0,0.9771046042442322,0,0,2729,3451,2729,3451,twilight sparkle,flushthebatsanta
2026087.png,https://derpicdn.net/img/view/2019/4/29/2026087.png,0,0.9378693699836732,0,382,5616,6844,5616,6462,twilight sparkle,jhayarr23
2026425.png,https://derpicdn.net/img/view/2019/4/29/2026425.png,0,0.9901643395423888,241,127,533,419,292,292,twilight sparkle,hardbrony
2026821.png,https://derpicdn.net/img/view/2019/4/29/2026821.png,0,0.9948331713676452,177,0,851,623,674,623,twilight sparkle,skyeypony
2026821.png,https://derpicdn.net/img/view/2019/4/29/2026821.png,1,0.9823532104492188,128,530,758,1135,630,605,twilight sparkle,skyeypony
2029438.png,https://derpicdn.net/img/view/2019/5/3/2029438.png,0,0.995675802230835,3385,0,7279,3468,3894,3468,twilight sparkle,cyanlightning
2030290.png,https://derpicdn.net/img/view/2019/5/4/2030290.png,0,0.9987131953239441,308,93,768,553,460,460,twilight sparkle,lurking tyger
2031320.png,https://derpicdn.net/img/view/2019/5/5/2031320.png,0,0.9834768176078796,595,0,1133,529,538,529,twilight sparkle,unoriginai
2031320.png,https://derpicdn.net/img/view/2019/5/5/2031320.png,1,0.9397423267364502,120,14,684,578,564,564,twilight sparkle,unoriginai
2032842.png,https://derpicdn.net/img/view/2019/5/6/2032842.png,0,0.9943926930427552,63,24,585,546,522,522,twilight sparkle,ch-chau
2032917.png,https://derpicdn.net/img/view/2019/5/7/2032917.png,0,0.9937071204185486,61,0,723,633,662,633,twilight sparkle,serafelis
2034837.png,https://derpicdn.net/img/view/2019/5/9/2034837.png,0,0.976568639278412,0,0,3967,4985,3967,4985,twilight sparkle,sollace
2043250.png,https://derpicdn.net/img/view/2019/5/19/2043250.png,0,0.9521601796150208,119,0,555,424,436,424,twilight sparkle,cleverpon
2044148.png,https://derpicdn.net/img/view/2019/5/20/2044148.png,0,0.9934827089309692,140,9,572,441,432,432,twilight sparkle,jacky-bunny
2046668.png,https://derpicdn.net/img/view/2019/5/23/2046668.png,0,0.9954813122749328,351,92,743,484,392,392,twilight sparkle,enigmadoodles
2048416.png,https://derpicdn.net/img/view/2019/5/25/2048416.png,0,0.9246330857276917,41,0,1191,1000,1150,1000,twilight sparkle,hazepages
20490.jpg,https://derpicdn.net/img/view/2012/6/25/20490.jpg,0,0.9120700359344482,166,149,502,485,336,336,twilight sparkle,johnjoseco
2052809.png,https://derpicdn.net/img/view/2019/5/29/2052809.png,0,0.9980443716049194,365,0,1103,738,738,738,twilight sparkle,neonishe
2053079.png,https://derpicdn.net/img/view/2019/5/30/2053079.png,0,0.9563578963279724,1083,45,2481,1443,1398,1398,twilight sparkle,whitediamonds|sonofaskywalker
2054187.png,https://derpicdn.net/img/view/2019/5/31/2054187.png,0,0.9983659982681274,556,1921,1610,2975,1054,1054,twilight sparkle,taaffeiite
2059250.png,https://derpicdn.net/img/view/2019/6/6/2059250.png,0,0.9875982999801636,800,745,2260,2205,1460,1460,twilight sparkle,shu-jeantte
2062579.png,https://derpicdn.net/img/view/2019/6/10/2062579.png,0,0.9893808364868164,327,124,813,610,486,486,twilight sparkle,imaplatypus
206570.png,https://derpicdn.net/img/view/2013/1/8/206570.png,0,0.9578726291656494,61,8,477,424,416,416,twilight sparkle,redintravenous|elslowmo
2065994.png,https://derpicdn.net/img/view/2019/6/15/2065994.png,0,0.9934964776039124,131,0,609,472,478,472,twilight sparkle,yakieringi014
2070707.png,https://derpicdn.net/img/view/2019/6/20/2070707.png,0,0.9105753898620604,50,0,2562,2080,2512,2080,twilight sparkle,takaneko13
2070831.png,https://derpicdn.net/img/view/2019/6/20/2070831.png,0,0.99429589509964,239,339,965,1065,726,726,twilight sparkle,ponballoon
2074082.png,https://derpicdn.net/img/view/2019/6/24/2074082.png,0,0.9992709755897522,155,27,359,231,204,204,twilight sparkle,pinkkoffin
2074985.jpg,https://derpicdn.net/img/view/2019/6/25/2074985.jpg,0,0.9390549063682556,55,124,1059,1128,1004,1004,twilight sparkle,spoosha
2075570.png,https://derpicdn.net/img/view/2019/6/26/2075570.png,0,0.9083603620529176,716,449,1566,1299,850,850,twilight sparkle,mediasmile666
2076394.png,https://derpicdn.net/img/view/2019/6/27/2076394.png,0,0.9928032755851746,580,0,1292,700,712,700,twilight sparkle,mediasmile666
2078490.png,https://derpicdn.net/img/view/2019/6/29/2078490.png,0,0.912925124168396,168,0,1502,1058,1334,1058,twilight sparkle,
2078979.png,https://derpicdn.net/img/view/2019/6/30/2078979.png,0,0.9976267218589784,222,0,608,378,386,378,twilight sparkle,vodkamewtwoni
2079205.png,https://derpicdn.net/img/view/2019/6/30/2079205.png,0,0.97862309217453,99,0,955,825,856,825,twilight sparkle,
2079478.png,https://derpicdn.net/img/view/2019/6/30/2079478.png,0,0.9891331791877748,70,26,956,912,886,886,twilight sparkle,
2080610.png,https://derpicdn.net/img/view/2019/7/1/2080610.png,0,0.9961885213851928,469,1326,1201,2058,732,732,twilight sparkle,neonishe
2080942.png,https://derpicdn.net/img/view/2019/7/2/2080942.png,0,0.9485334157943726,139,0,741,580,602,580,twilight sparkle,kimmyartmlp
2081127.png,https://derpicdn.net/img/view/2019/7/2/2081127.png,0,0.9914581775665284,0,0,2041,2167,2041,2167,twilight sparkle,cutepencilcase
2082233.png,https://derpicdn.net/img/view/2019/7/3/2082233.png,0,0.9977045059204102,133,0,1173,868,1040,868,twilight sparkle,kimspyr
2082345.png,https://derpicdn.net/img/view/2019/7/3/2082345.png,0,0.9982663989067078,548,41,968,461,420,420,twilight sparkle,serafelis
2082571.png,https://derpicdn.net/img/view/2019/7/4/2082571.png,0,0.9644044041633606,0,61,1530,1925,1530,1864,twilight sparkle,kingdark0001
2083571.png,https://derpicdn.net/img/view/2019/7/5/2083571.png,0,0.9455274343490601,0,0,551,532,551,532,twilight sparkle,770nanao15
2084069.png,https://derpicdn.net/img/view/2019/7/6/2084069.png,0,0.9893736243247986,87,0,709,611,622,611,twilight sparkle,
2084385.png,https://derpicdn.net/img/view/2019/7/6/2084385.png,0,0.997878909111023,360,0,1296,901,936,901,twilight sparkle,vird-gi
2084610.png,https://derpicdn.net/img/view/2019/7/6/2084610.png,0,0.999442994594574,411,0,2239,1639,1828,1639,twilight sparkle,ponballoon
2086900.png,https://derpicdn.net/img/view/2019/7/9/2086900.png,0,0.999444305896759,616,0,1386,733,770,733,twilight sparkle,elstiv
2089445.png,https://derpicdn.net/img/view/2019/7/12/2089445.png,0,0.9895594120025636,0,53,702,759,702,706,twilight sparkle,andelai
2089505.png,https://derpicdn.net/img/view/2019/7/12/2089505.png,0,0.9977216124534608,271,36,869,634,598,598,twilight sparkle,coffeecloud
2092535.png,https://derpicdn.net/img/view/2019/7/15/2092535.png,0,0.9592035412788392,268,964,1068,1764,800,800,twilight sparkle,mrkat7214
2092557.png,https://derpicdn.net/img/view/2019/7/15/2092557.png,0,0.976016879081726,0,189,2579,2809,2579,2620,twilight sparkle,flushthebatsanta
2093508.png,https://derpicdn.net/img/view/2019/7/16/2093508.png,0,0.95579594373703,0,0,914,788,914,788,twilight sparkle,crackerjackvn
2095178.png,https://derpicdn.net/img/view/2019/7/18/2095178.png,0,0.9944988489151,314,8,2260,1954,1946,1946,twilight sparkle,anonbelle
2095269.png,https://derpicdn.net/img/view/2019/7/18/2095269.png,0,0.998370885848999,0,0,1006,1016,1006,1016,twilight sparkle,artiks
2095269.png,https://derpicdn.net/img/view/2019/7/18/2095269.png,1,0.9902254939079284,1042,271,1889,1145,847,874,twilight sparkle,artiks
2095880.png,https://derpicdn.net/img/view/2019/7/19/2095880.png,0,0.9840300679206848,187,30,877,720,690,690,twilight sparkle,whitebarque
2096360.png,https://derpicdn.net/img/view/2019/7/20/2096360.png,1,0.9975900053977966,1349,812,1781,1244,432,432,twilight sparkle,saturdaymorningproj
2103573.png,https://derpicdn.net/img/view/2019/7/28/2103573.png,0,0.9736398458480836,0,11,1135,1265,1135,1254,twilight sparkle,autumnvoyage
2103760.png,https://derpicdn.net/img/view/2019/7/29/2103760.png,0,0.9971045255661012,85,0,537,440,452,440,twilight sparkle,forgalorga
2103766.png,https://derpicdn.net/img/view/2019/7/29/2103766.png,0,0.9798892736434937,75,40,456,456,381,416,twilight sparkle,forgalorga
2104148.png,https://derpicdn.net/img/view/2019/7/29/2104148.png,0,0.995425283908844,481,0,1567,910,1086,910,twilight sparkle,shad0w-galaxy
2104435.png,https://derpicdn.net/img/view/2019/7/30/2104435.png,0,0.9884415268898008,0,0,485,441,485,441,twilight sparkle,toroitimu
2104995.png,https://derpicdn.net/img/view/2019/7/30/2104995.png,0,0.9904756546020508,594,296,2160,1992,1566,1696,twilight sparkle,cluvry
2106548.png,https://derpicdn.net/img/view/2019/8/1/2106548.png,0,0.9625589847564696,0,0,1080,1307,1080,1307,twilight sparkle,wintah33
2109609.png,https://derpicdn.net/img/view/2019/8/5/2109609.png,0,0.9758440852165222,1324,95,2700,1515,1376,1420,twilight sparkle,sketchmcreations
2110217.png,https://derpicdn.net/img/view/2019/8/6/2110217.png,0,0.9430735111236572,61,47,889,875,828,828,twilight sparkle,lou
2113526.png,https://derpicdn.net/img/view/2019/8/9/2113526.png,0,0.975829541683197,0,0,1052,1031,1052,1031,twilight sparkle,
2114120.png,https://derpicdn.net/img/view/2019/8/10/2114120.png,0,0.993921399116516,71,0,3253,3058,3182,3058,twilight sparkle,andoanimalia
2114265.png,https://derpicdn.net/img/view/2019/8/10/2114265.png,0,0.9222399592399596,175,0,1517,1264,1342,1264,twilight sparkle,artiks
2115868.png,https://derpicdn.net/img/view/2019/8/12/2115868.png,0,0.9921708106994628,676,112,1860,1296,1184,1184,twilight sparkle,sadtrooper
2116445.png,https://derpicdn.net/img/view/2019/8/12/2116445.png,0,0.9945574402809144,41,60,1595,1614,1554,1554,twilight sparkle,artiks
2116658.png,https://derpicdn.net/img/view/2019/8/13/2116658.png,0,0.9220929145812988,125,0,4125,3747,4000,3747,twilight sparkle,cyanlightning
2116822.png,https://derpicdn.net/img/view/2019/8/13/2116822.png,0,0.9893736243247986,27,0,753,695,726,695,twilight sparkle,drakesparkle44
2119427.png,https://derpicdn.net/img/view/2019/8/16/2119427.png,0,0.9889115691184998,435,52,779,396,344,344,twilight sparkle,
2122144.png,https://derpicdn.net/img/view/2019/8/19/2122144.png,0,0.9894606471061708,1473,0,3511,1881,2038,1881,twilight sparkle,sketchmcreations
2122421.png,https://derpicdn.net/img/view/2019/8/19/2122421.png,0,0.9622151851654052,703,0,1543,794,840,794,twilight sparkle,anime-equestria
2123038.png,https://derpicdn.net/img/view/2019/8/20/2123038.png,0,0.982969045639038,684,106,1040,462,356,356,twilight sparkle,fwipfwop
2124515.png,https://derpicdn.net/img/view/2019/8/22/2124515.png,0,0.9671303033828736,160,147,1440,1427,1280,1280,twilight sparkle,silshadnic
2124637.png,https://derpicdn.net/img/view/2019/8/22/2124637.png,0,0.9950778484344482,116,3,666,553,550,550,twilight sparkle,gela-g-i-s-gela
2125222.png,https://derpicdn.net/img/view/2019/8/23/2125222.png,0,0.9320006370544434,1500,976,6850,7206,5350,6230,twilight sparkle,lahirien
2127195.png,https://derpicdn.net/img/view/2019/8/25/2127195.png,0,0.989396035671234,480,0,2262,1623,1782,1623,twilight sparkle,tigra0118
2130806.png,https://derpicdn.net/img/view/2019/8/29/2130806.png,0,0.9968546628952026,269,0,797,481,528,481,twilight sparkle,itstaylor-made
2133354.png,https://derpicdn.net/img/view/2019/9/1/2133354.png,0,0.9767650365829468,80,0,1936,1783,1856,1783,twilight sparkle,awalex
2135226.png,https://derpicdn.net/img/view/2019/9/3/2135226.png,0,0.9896472692489624,12,45,376,409,364,364,twilight sparkle,gabrielcoroum
2135227.png,https://derpicdn.net/img/view/2019/9/3/2135227.png,0,0.9665438532829284,245,0,509,257,264,257,twilight sparkle,gabrielcoroum
2135652.png,https://derpicdn.net/img/view/2019/9/3/2135652.png,0,0.9277293682098388,80,0,1318,1080,1238,1080,twilight sparkle,
2139150.png,https://derpicdn.net/img/view/2019/9/8/2139150.png,0,0.9521142244338988,599,1858,2297,3556,1698,1698,twilight sparkle,decprincess
2142322.png,https://derpicdn.net/img/view/2019/9/12/2142322.png,0,0.9437053799629213,116,127,486,472,370,345,twilight sparkle,stepandy
2146831.png,https://derpicdn.net/img/view/2019/9/18/2146831.png,0,0.9809367060661316,126,87,772,733,646,646,twilight sparkle,zakkurro
2147471.png,https://derpicdn.net/img/view/2019/9/19/2147471.png,0,0.9783198237419128,951,134,2511,1694,1560,1560,twilight sparkle,pesty_skillengton
2148295.png,https://derpicdn.net/img/view/2019/9/20/2148295.png,0,0.9911223649978638,495,0,929,407,434,407,twilight sparkle,22dots22
2148295.png,https://derpicdn.net/img/view/2019/9/20/2148295.png,1,0.985526978969574,152,364,438,650,286,286,twilight sparkle,22dots22
2154608.png,https://derpicdn.net/img/view/2019/9/28/2154608.png,0,0.9986986517906188,2014,135,3640,1761,1626,1626,twilight sparkle,akainu_pony
2155215.png,https://derpicdn.net/img/view/2019/9/28/2155215.png,0,0.9987921714782716,878,0,1476,588,598,588,twilight sparkle,renegade-157
2155540.png,https://derpicdn.net/img/view/2019/9/29/2155540.png,0,0.9980217814445496,3218,0,6526,3159,3308,3159,twilight sparkle,andoanimalia
2155778.png,https://derpicdn.net/img/view/2019/9/29/2155778.png,0,0.986990749835968,10,0,854,814,844,814,twilight sparkle,spoopygander
2156089.png,https://derpicdn.net/img/view/2019/9/29/2156089.png,0,0.9446080923080444,599,0,1545,780,946,780,twilight sparkle,hierozaki
2159391.png,https://derpicdn.net/img/view/2019/10/3/2159391.png,0,0.984091341495514,170,84,1450,1364,1280,1280,twilight sparkle,yinglongfujun
2160548.png,https://derpicdn.net/img/view/2019/10/5/2160548.png,0,0.9364364743232728,194,191,692,689,498,498,twilight sparkle,waterz-colrxz
2163895.png,https://derpicdn.net/img/view/2019/10/9/2163895.png,0,0.9367985129356384,44,0,544,484,500,484,twilight sparkle,sourspot
2164467.png,https://derpicdn.net/img/view/2019/10/10/2164467.png,0,0.9141889214515686,388,118,736,466,348,348,twilight sparkle,rxiantool
216520.png,https://derpicdn.net/img/view/2013/1/18/216520.png,0,0.9486545324325562,3067,338,5269,2540,2202,2202,twilight sparkle,larsurus
2165634.png,https://derpicdn.net/img/view/2019/10/11/2165634.png,0,0.9970709085464478,1731,547,3409,2225,1678,1678,twilight sparkle,arcane-thunder
2168062.png,https://derpicdn.net/img/view/2019/10/13/2168062.png,0,0.9977170825004578,5,0,1057,993,1052,993,twilight sparkle,sonofaskywalker
2169118.png,https://derpicdn.net/img/view/2019/10/15/2169118.png,0,0.9992981553077698,60,2,304,246,244,244,twilight sparkle,divided-s
2169938.png,https://derpicdn.net/img/view/2019/10/15/2169938.png,0,0.9788886904716492,0,13,346,405,346,392,twilight sparkle,
2171175.png,https://derpicdn.net/img/view/2019/10/17/2171175.png,0,0.9786365628242492,451,0,1079,620,628,620,twilight sparkle,shitigal-artust
2171235.png,https://derpicdn.net/img/view/2019/10/17/2171235.png,0,0.9896949529647828,143,0,593,439,450,439,twilight sparkle,wanderingpegasus
2171235.png,https://derpicdn.net/img/view/2019/10/17/2171235.png,1,0.9045155644416808,747,411,1059,723,312,312,twilight sparkle,wanderingpegasus
2171993.png,https://derpicdn.net/img/view/2019/10/17/2171993.png,0,0.9851976633071899,515,172,2457,2114,1942,1942,twilight sparkle,jlkatlass
2172181.png,https://derpicdn.net/img/view/2019/10/18/2172181.png,0,0.9546310901641846,482,67,802,387,320,320,twilight sparkle,tim-kangaroo
2174204.png,https://derpicdn.net/img/view/2019/10/20/2174204.png,0,0.9868842959403992,592,0,1088,423,496,423,twilight sparkle,sadtrooper
2174343.png,https://derpicdn.net/img/view/2019/10/20/2174343.png,0,0.9181365370750428,661,844,1289,1472,628,628,twilight sparkle,tassji-s
2175216.png,https://derpicdn.net/img/view/2019/10/21/2175216.png,0,0.9762794971466064,1223,601,1809,1187,586,586,twilight sparkle,serenepony
2175736.png,https://derpicdn.net/img/view/2019/10/21/2175736.png,0,0.9090055823326112,157,85,469,397,312,312,twilight sparkle,bronzepony
2176203.png,https://derpicdn.net/img/view/2019/10/22/2176203.png,0,0.900187611579895,53,17,433,397,380,380,twilight sparkle,
2176223.png,https://derpicdn.net/img/view/2019/10/22/2176223.png,0,0.957410216331482,534,71,1208,745,674,674,twilight sparkle,lrusu
2176364.png,https://derpicdn.net/img/view/2019/10/22/2176364.png,0,0.9965391755104064,15,2,413,400,398,398,twilight sparkle,
2178009.png,https://derpicdn.net/img/view/2019/10/24/2178009.png,0,0.9818428158760072,0,0,643,688,643,688,twilight sparkle,
2178159.png,https://derpicdn.net/img/view/2019/10/25/2178159.png,0,0.9811825156211852,193,11,1389,1207,1196,1196,twilight sparkle,yinglongfujun
2178306.png,https://derpicdn.net/img/view/2019/10/25/2178306.png,0,0.9746686816215516,572,931,1422,1781,850,850,twilight sparkle,nitei
2178375.png,https://derpicdn.net/img/view/2019/10/25/2178375.png,0,0.9958479404449464,1599,0,2833,1067,1234,1067,twilight sparkle,anonopony
2180348.png,https://derpicdn.net/img/view/2019/10/27/2180348.png,0,0.9942375421524048,591,529,1029,967,438,438,twilight sparkle,smudge proof
2180385.png,https://derpicdn.net/img/view/2019/10/27/2180385.png,0,0.9596586227416992,93,227,815,949,722,722,twilight sparkle,autumnvoyage
2180938.png,https://derpicdn.net/img/view/2019/10/28/2180938.png,0,0.993694543838501,270,34,710,474,440,440,twilight sparkle,
2184817.png,https://derpicdn.net/img/view/2019/11/1/2184817.png,0,0.934249997138977,970,838,2768,2636,1798,1798,twilight sparkle,n0kkun
2186952.png,https://derpicdn.net/img/view/2019/11/4/2186952.png,0,0.9701123237609864,43,0,233,167,190,167,twilight sparkle,sasha-flyer
2187548.png,https://derpicdn.net/img/view/2019/11/4/2187548.png,0,0.9985395073890686,568,119,1300,851,732,732,twilight sparkle,obeliskgirljohanny
2188728.png,https://derpicdn.net/img/view/2019/11/6/2188728.png,0,0.9701484441757202,39,32,250,248,211,216,twilight sparkle,sasha-flyer
2189037.png,https://derpicdn.net/img/view/2019/11/6/2189037.png,0,0.9926573038101196,486,32,882,428,396,396,twilight sparkle,tf-sential
2190401.png,https://derpicdn.net/img/view/2019/11/8/2190401.png,0,0.9966252446174622,577,27,2415,1865,1838,1838,twilight sparkle,sheeppony
2195233.png,https://derpicdn.net/img/view/2019/11/13/2195233.png,0,0.9649091362953186,736,99,3108,2555,2372,2456,twilight sparkle,cloudyglow
219712.jpg,https://derpicdn.net/img/view/2013/1/21/219712.jpg,0,0.9974986910820008,173,0,769,586,596,586,twilight sparkle,shinobe
2197543.png,https://derpicdn.net/img/view/2019/11/16/2197543.png,0,0.9791473150253296,30,0,450,407,420,407,twilight sparkle,mofumofutchi
2202884.png,https://derpicdn.net/img/view/2019/11/22/2202884.png,0,0.9723234176635742,21,0,461,420,440,420,twilight sparkle,reapir
2202888.png,https://derpicdn.net/img/view/2019/11/22/2202888.png,0,0.9835962057113647,65,21,500,491,435,470,twilight sparkle,reapir
2202889.png,https://derpicdn.net/img/view/2019/11/22/2202889.png,0,0.934540331363678,21,113,421,500,400,387,twilight sparkle,reapir
2202889.png,https://derpicdn.net/img/view/2019/11/22/2202889.png,1,0.9249111413955688,149,13,500,387,351,374,twilight sparkle,reapir
2202890.png,https://derpicdn.net/img/view/2019/11/22/2202890.png,0,0.9421619772911072,89,0,500,482,411,482,twilight sparkle,reapir
2202891.png,https://derpicdn.net/img/view/2019/11/22/2202891.png,0,0.9342865347862244,0,20,400,492,400,472,twilight sparkle,reapir
2202891.png,https://derpicdn.net/img/view/2019/11/22/2202891.png,1,0.9317076206207277,76,55,480,459,404,404,twilight sparkle,reapir
2202892.png,https://derpicdn.net/img/view/2019/11/22/2202892.png,0,0.9670576453208924,43,19,500,487,457,468,twilight sparkle,reapir
2203547.png,https://derpicdn.net/img/view/2019/11/23/2203547.png,0,0.925876259803772,256,0,1914,1625,1658,1625,twilight sparkle,nika-rain
2208292.png,https://derpicdn.net/img/view/2019/11/29/2208292.png,0,0.9762935042381288,0,23,1010,1147,1010,1124,twilight sparkle,andoanimalia
2209511.png,https://derpicdn.net/img/view/2019/11/30/2209511.png,0,0.9933141469955444,26,0,1196,1118,1170,1118,twilight sparkle,cutepencilcase
2212302.png,https://derpicdn.net/img/view/2019/12/4/2212302.png,0,0.9382501244544984,821,115,2223,1517,1402,1402,twilight sparkle,thewickedvix
2212433.png,https://derpicdn.net/img/view/2019/12/4/2212433.png,0,0.989694356918335,0,0,807,840,807,840,twilight sparkle,pshyzomancer
2213498.png,https://derpicdn.net/img/view/2019/12/6/2213498.png,0,0.9809136986732484,757,58,1695,996,938,938,twilight sparkle,whatsapokemon
2216382.png,https://derpicdn.net/img/view/2019/12/9/2216382.png,0,0.9601302742958068,212,0,741,507,529,507,twilight sparkle,wanderingpegasus
2216636.png,https://derpicdn.net/img/view/2019/12/9/2216636.png,1,0.9948931932449341,392,373,942,923,550,550,twilight sparkle,serodart
2217074.png,https://derpicdn.net/img/view/2019/12/10/2217074.png,0,0.9988204836845398,505,6,1377,878,872,872,twilight sparkle,oblivionheart13
2217543.png,https://derpicdn.net/img/view/2019/12/10/2217543.png,0,0.9980717301368712,621,0,1531,897,910,897,twilight sparkle,ask-colorsound
2218194.png,https://derpicdn.net/img/view/2019/12/11/2218194.png,0,0.9510053992271424,1236,0,3074,1769,1838,1769,twilight sparkle,robsa990
2218287.png,https://derpicdn.net/img/view/2019/12/11/2218287.png,0,0.9623992443084716,774,222,1276,724,502,502,twilight sparkle,kozachokzrotom
2219247.png,https://derpicdn.net/img/view/2019/12/13/2219247.png,0,0.994981586933136,841,4,2167,1330,1326,1326,twilight sparkle,nekowy
2220138.png,https://derpicdn.net/img/view/2019/12/14/2220138.png,0,0.9986523985862732,363,226,969,832,606,606,twilight sparkle,nathayro37
2226795.png,https://derpicdn.net/img/view/2019/12/22/2226795.png,0,0.9256120324134828,958,0,2696,1539,1738,1539,twilight sparkle,auroriia
2227554.png,https://derpicdn.net/img/view/2019/12/23/2227554.png,0,0.9622163772583008,1689,53,4263,2627,2574,2574,twilight sparkle,nightingalewolfie|bunmonmon
2227935.png,https://derpicdn.net/img/view/2019/12/23/2227935.png,0,0.9681664109230042,74,0,426,339,352,339,twilight sparkle,oddjuice
2228729.jpg,https://derpicdn.net/img/view/2019/12/24/2228729.jpg,0,0.9887926578521729,37,71,1293,1327,1256,1256,twilight sparkle,54600
2229733.png,https://derpicdn.net/img/view/2019/12/25/2229733.png,0,0.9527450799942015,899,31,1855,987,956,956,twilight sparkle,danli69
2230955.png,https://derpicdn.net/img/view/2019/12/27/2230955.png,0,0.9969448447227478,296,0,1402,948,1106,948,twilight sparkle,shido-tara
2231539.png,https://derpicdn.net/img/view/2019/12/27/2231539.png,0,0.9987170100212096,515,237,1111,833,596,596,twilight sparkle,spirit-fire360
2233507.png,https://derpicdn.net/img/view/2019/12/30/2233507.png,0,0.9893814921379088,157,122,1459,1424,1302,1302,twilight sparkle,teaflower300
223487.png,https://derpicdn.net/img/view/2013/1/25/223487.png,0,0.9890285134315492,0,0,525,530,525,530,twilight sparkle,frogmakesart
2235154.jpg,https://derpicdn.net/img/view/2019/12/31/2235154.jpg,0,0.9889023900032043,451,95,1361,1005,910,910,twilight sparkle,finchina
2235459.png,https://derpicdn.net/img/view/2020/1/1/2235459.png,0,0.9846002459526062,587,351,1003,767,416,416,twilight sparkle,nessacity
2237850.png,https://derpicdn.net/img/view/2020/1/3/2237850.png,0,0.9874810576438904,884,630,1764,1510,880,880,twilight sparkle,dream--chan
2238819.jpg,https://derpicdn.net/img/view/2020/1/4/2238819.jpg,0,0.95656156539917,340,154,978,792,638,638,twilight sparkle,yespurrymuch|kilka-chan-yana
2243973.jpg,https://derpicdn.net/img/view/2020/1/10/2243973.jpg,0,0.9823212027549744,395,168,659,432,264,264,twilight sparkle,novaintellus
2244763.jpg,https://derpicdn.net/img/view/2020/1/11/2244763.jpg,0,0.933005392551422,458,257,1050,849,592,592,twilight sparkle,tingyo
2246202.jpg,https://derpicdn.net/img/view/2020/1/13/2246202.jpg,0,0.9028304219245912,237,0,1055,782,818,782,twilight sparkle,luluneusa
2246501.jpg,https://derpicdn.net/img/view/2020/1/13/2246501.jpg,0,0.9907522201538086,0,0,1240,1552,1240,1552,twilight sparkle,avui
2246617.png,https://derpicdn.net/img/view/2020/1/13/2246617.png,0,0.9884288907051086,840,185,1348,693,508,508,twilight sparkle,wildviolet-m
2247021.jpg,https://derpicdn.net/img/view/2020/1/14/2247021.jpg,0,0.9570000767707824,224,9,990,768,766,759,twilight sparkle,sunshineshiny
2247034.jpg,https://derpicdn.net/img/view/2020/1/14/2247034.jpg,0,0.9908000230789183,122,198,536,612,414,414,twilight sparkle,sunshineshiny
2247126.jpg,https://derpicdn.net/img/view/2020/1/14/2247126.jpg,0,0.994961142539978,673,0,1803,1092,1130,1092,twilight sparkle,025aki
2249093.jpg,https://derpicdn.net/img/view/2020/1/16/2249093.jpg,0,0.9856218695640564,355,0,1223,858,868,858,twilight sparkle,dawnfire
2249358.png,https://derpicdn.net/img/view/2020/1/17/2249358.png,0,0.9964885115623474,1836,0,5902,3723,4066,3723,twilight sparkle,cyanlightning
2249425.png,https://derpicdn.net/img/view/2020/1/17/2249425.png,0,0.996646761894226,24,0,732,706,708,706,twilight sparkle,puddingskinmcgee
225111.png,https://derpicdn.net/img/view/2013/1/27/225111.png,0,0.9876053929328918,220,10,960,750,740,740,twilight sparkle,killryde
2252101.png,https://derpicdn.net/img/view/2020/1/20/2252101.png,0,0.9896764755249025,1377,323,2477,1423,1100,1100,twilight sparkle,airiniblock
2254396.jpg,https://derpicdn.net/img/view/2020/1/23/2254396.jpg,0,0.9613916873931884,96,0,1532,1397,1436,1397,twilight sparkle,54600
2256317.png,https://derpicdn.net/img/view/2020/1/25/2256317.png,1,0.9258544445037842,937,193,1333,589,396,396,twilight sparkle,verumtee
2257557.png,https://derpicdn.net/img/view/2020/1/26/2257557.png,0,0.99518620967865,9,0,1337,1284,1328,1284,twilight sparkle,lrusu
2259153.png,https://derpicdn.net/img/view/2020/1/28/2259153.png,0,0.9564884305000304,0,0,2573,2250,2573,2250,twilight sparkle,nookprint
2260840.jpg,https://derpicdn.net/img/view/2020/1/30/2260840.jpg,0,0.9990179538726808,387,0,2137,1747,1750,1747,twilight sparkle,joakingu
2261229.png,https://derpicdn.net/img/view/2020/1/30/2261229.png,0,0.9850764274597168,0,0,732,760,732,760,twilight sparkle,lilfunkman
2265195.jpg,https://derpicdn.net/img/view/2020/2/4/2265195.jpg,0,0.9166462421417236,331,0,1469,970,1138,970,twilight sparkle,gouransion
2265588.png,https://derpicdn.net/img/view/2020/2/4/2265588.png,0,0.9987608790397644,59,0,1187,1102,1128,1102,twilight sparkle,stuwor-art
2266137.jpg,https://derpicdn.net/img/view/2020/2/5/2266137.jpg,0,0.9990995526313782,401,0,1057,632,656,632,twilight sparkle,plutotheundead
2266405.png,https://derpicdn.net/img/view/2020/2/5/2266405.png,0,0.9891712069511414,1458,0,4856,3270,3398,3270,twilight sparkle,pink1ejack
2267483.png,https://derpicdn.net/img/view/2020/2/7/2267483.png,0,0.9117055535316468,0,415,3677,4547,3677,4132,twilight sparkle,cyanlightning
2268110.png,https://derpicdn.net/img/view/2020/2/7/2268110.png,0,0.9324952363967896,124,63,1500,1609,1376,1546,twilight sparkle,fakskis
2268224.jpg,https://derpicdn.net/img/view/2020/2/7/2268224.jpg,0,0.989537239074707,0,0,1197,1238,1197,1238,twilight sparkle,sakukitty
2268752.png,https://derpicdn.net/img/view/2020/2/8/2268752.png,0,0.996086061000824,961,0,2383,1352,1422,1352,twilight sparkle,yutakira92
2269028.png,https://derpicdn.net/img/view/2020/2/8/2269028.png,0,0.9888643026351928,360,0,2541,2246,2181,2246,twilight sparkle,n-steisha25
2269910.png,https://derpicdn.net/img/view/2020/2/9/2269910.png,0,0.9974983334541321,60,3,732,675,672,672,twilight sparkle,fenrirez
2270685.jpg,https://derpicdn.net/img/view/2020/2/10/2270685.jpg,0,0.9698862433433532,20,0,1280,1273,1260,1273,twilight sparkle,musicfirewind
2274058.jpg,https://derpicdn.net/img/view/2020/2/14/2274058.jpg,0,0.9795938730239868,79,0,1059,958,980,958,twilight sparkle,candyclumsy
227415.png,https://derpicdn.net/img/view/2013/1/29/227415.png,0,0.9935402870178224,0,0,1176,1286,1176,1286,twilight sparkle,fearingfun
2275962.jpg,https://derpicdn.net/img/view/2020/2/16/2275962.jpg,0,0.9185016751289368,419,1,1131,713,712,712,twilight sparkle,tohupo
2276493.jpg,https://derpicdn.net/img/view/2020/2/17/2276493.jpg,0,0.981154441833496,38,0,994,1080,956,1080,twilight sparkle,lostdreamm
2276493.jpg,https://derpicdn.net/img/view/2020/2/17/2276493.jpg,1,0.9222738742828368,0,0,859,980,859,980,twilight sparkle,lostdreamm
2276507.png,https://derpicdn.net/img/view/2020/2/17/2276507.png,0,0.9611908793449402,529,202,1667,1340,1138,1138,twilight sparkle,aemantaslim
2277581.png,https://derpicdn.net/img/view/2020/2/18/2277581.png,0,0.9010949730873108,651,243,817,409,166,166,twilight sparkle,redxbacon
2278264.png,https://derpicdn.net/img/view/2020/2/19/2278264.png,0,0.9935014247894288,0,0,567,593,567,593,twilight sparkle,tf-sential
2280601.png,https://derpicdn.net/img/view/2020/2/22/2280601.png,0,0.9481515884399414,6203,479,10493,4769,4290,4290,twilight sparkle,andoanimalia
2283688.png,https://derpicdn.net/img/view/2020/2/25/2283688.png,0,0.9911454319953918,24,150,368,494,344,344,twilight sparkle,sintakhra
2283688.png,https://derpicdn.net/img/view/2020/2/25/2283688.png,1,0.9439554810523988,517,244,789,516,272,272,twilight sparkle,sintakhra
2284394.png,https://derpicdn.net/img/view/2020/2/26/2284394.png,0,0.9959033727645874,2221,0,3999,1590,1778,1590,twilight sparkle,atlas-66
2284657.png,https://derpicdn.net/img/view/2020/2/27/2284657.png,0,0.9793148636817932,1088,317,1842,1071,754,754,twilight sparkle,loreto-arts
2286500.jpg,https://derpicdn.net/img/view/2020/2/29/2286500.jpg,0,0.973777949810028,148,0,686,535,538,535,twilight sparkle,twily27889053
2287409.jpg,https://derpicdn.net/img/view/2020/3/1/2287409.jpg,0,0.9044765830039978,0,0,1498,1629,1498,1629,twilight sparkle,andypriceart
2288330.png,https://derpicdn.net/img/view/2020/3/2/2288330.png,0,0.993506908416748,1119,200,2277,1358,1158,1158,twilight sparkle,jay-onjey|metalface069
2290510.jpg,https://derpicdn.net/img/view/2020/3/5/2290510.jpg,0,0.998724400997162,337,0,933,576,596,576,twilight sparkle,hikariviny
2290970.jpg,https://derpicdn.net/img/view/2020/3/6/2290970.jpg,0,0.9964697957038879,170,44,656,530,486,486,twilight sparkle,azrealrou
2291174.png,https://derpicdn.net/img/view/2020/3/6/2291174.png,0,0.9898895025253296,0,0,357,387,357,387,twilight sparkle,
2292509.jpg,https://derpicdn.net/img/view/2020/3/8/2292509.jpg,0,0.9990462660789492,808,183,1262,637,454,454,twilight sparkle,whatsapokemon
2292509.jpg,https://derpicdn.net/img/view/2020/3/8/2292509.jpg,1,0.9969769716262816,336,123,736,523,400,400,twilight sparkle,whatsapokemon
2292701.jpg,https://derpicdn.net/img/view/2020/3/8/2292701.jpg,0,0.9834619760513306,325,553,583,811,258,258,twilight sparkle,lostdreamm
2292829.jpg,https://derpicdn.net/img/view/2020/3/8/2292829.jpg,0,0.9923635721206664,314,0,1424,1069,1110,1069,twilight sparkle,phoenixrk49
2296532.jpg,https://derpicdn.net/img/view/2020/3/13/2296532.jpg,0,0.9992890357971193,358,0,846,448,488,448,twilight sparkle,musicfirewind
229832.png,https://derpicdn.net/img/view/2013/2/1/229832.png,0,0.9505290389060974,144,18,354,228,210,210,twilight sparkle,fillyphalanx
2299659.png,https://derpicdn.net/img/view/2020/3/17/2299659.png,0,0.9964119791984558,0,0,3077,3089,3077,3089,twilight sparkle,negatif22
2301203.png,https://derpicdn.net/img/view/2020/3/19/2301203.png,0,0.9960792064666748,680,0,1222,469,542,469,twilight sparkle,pledus
2301203.png,https://derpicdn.net/img/view/2020/3/19/2301203.png,1,0.9835327863693236,6,2,626,622,620,620,twilight sparkle,pledus
2301476.png,https://derpicdn.net/img/view/2020/3/19/2301476.png,0,0.9733878374099731,475,662,899,1086,424,424,twilight sparkle,ali-selle
2301522.png,https://derpicdn.net/img/view/2020/3/20/2301522.png,0,0.9223604202270508,119,210,1023,1114,904,904,twilight sparkle,th3bluerose
2301529.jpg,https://derpicdn.net/img/view/2020/3/20/2301529.jpg,0,0.98508620262146,0,0,554,616,554,616,twilight sparkle,chibicmps
2301752.jpg,https://derpicdn.net/img/view/2020/3/20/2301752.jpg,0,0.9921398758888244,0,1065,578,1743,578,678,twilight sparkle,025aki
2301752.jpg,https://derpicdn.net/img/view/2020/3/20/2301752.jpg,1,0.9913926124572754,0,0,1190,1122,1190,1122,twilight sparkle,025aki
23025.jpg,https://derpicdn.net/img/view/2012/6/27/23025.jpg,0,0.9893712401390076,15,0,577,503,562,503,twilight sparkle,tomoe-chi
2302736.png,https://derpicdn.net/img/view/2020/3/21/2302736.png,0,0.9830455183982848,314,0,3786,3305,3472,3305,twilight sparkle,azerta56
2302831.png,https://derpicdn.net/img/view/2020/3/21/2302831.png,0,0.9870971441268921,714,0,1290,468,576,468,twilight sparkle,xigege
2303763.jpg,https://derpicdn.net/img/view/2020/3/22/2303763.jpg,0,0.9889575242996216,67,2,415,350,348,348,twilight sparkle,twi-shys|mylittleyuri
2307383.png,https://derpicdn.net/img/view/2020/3/27/2307383.png,0,0.984930694103241,1105,64,2083,1042,978,978,twilight sparkle,pony-way
2307383.png,https://derpicdn.net/img/view/2020/3/27/2307383.png,1,0.9308568835258484,515,219,1407,1111,892,892,twilight sparkle,pony-way
2311966.png,https://derpicdn.net/img/view/2020/4/2/2311966.png,0,0.9962890744209292,531,330,1895,1694,1364,1364,twilight sparkle,melisareb
2311967.png,https://derpicdn.net/img/view/2020/4/2/2311967.png,0,0.9990150928497314,560,375,1886,1701,1326,1326,twilight sparkle,melisareb
2312471.jpg,https://derpicdn.net/img/view/2020/4/2/2312471.jpg,0,0.992988348007202,1195,96,1945,846,750,750,twilight sparkle,vanillaghosties
2313183.png,https://derpicdn.net/img/view/2020/4/3/2313183.png,0,0.9992015361785888,659,92,1207,640,548,548,twilight sparkle,nodambol|nodambol222
2313640.png,https://derpicdn.net/img/view/2020/4/4/2313640.png,0,0.9897056221961976,18,12,1159,1172,1141,1160,twilight sparkle,cloudyglow
2313966.jpg,https://derpicdn.net/img/view/2020/4/4/2313966.jpg,0,0.9986648559570312,342,0,914,553,572,553,twilight sparkle,zefirka
2316694.jpg,https://derpicdn.net/img/view/2020/4/7/2316694.jpg,0,0.9507752656936646,143,301,991,1149,848,848,twilight sparkle,rainbowmoon2512
2317318.jpg,https://derpicdn.net/img/view/2020/4/8/2317318.jpg,0,0.9944241642951964,70,0,1176,1081,1106,1081,twilight sparkle,falafeljake
2320113.jpg,https://derpicdn.net/img/view/2020/4/12/2320113.jpg,0,0.98909193277359,559,0,995,395,436,395,twilight sparkle,renderpoint
2320414.png,https://derpicdn.net/img/view/2020/4/12/2320414.png,0,0.9632710218429564,0,0,612,556,612,556,twilight sparkle,azamiii
2320617.png,https://derpicdn.net/img/view/2020/4/12/2320617.png,0,0.9515976905822754,216,0,2842,2615,2626,2615,twilight sparkle,sanroys
2320730.png,https://derpicdn.net/img/view/2020/4/12/2320730.png,0,0.9962606430053712,541,1003,3155,3617,2614,2614,twilight sparkle,mrkat7214
2323441.jpg,https://derpicdn.net/img/view/2020/4/15/2323441.jpg,0,0.9924185276031494,63,116,955,1008,892,892,twilight sparkle,chapaghettii
2326851.png,https://derpicdn.net/img/view/2020/4/20/2326851.png,0,0.995006799697876,2645,129,3691,1175,1046,1046,twilight sparkle,orin331
2327001.jpg,https://derpicdn.net/img/view/2020/4/20/2327001.jpg,0,0.9982159733772278,563,919,1239,1595,676,676,twilight sparkle,emeraldgalaxy
2328143.png,https://derpicdn.net/img/view/2020/4/21/2328143.png,0,0.9062631130218506,579,378,1515,1314,936,936,twilight sparkle,sugarstar
2332385.png,https://derpicdn.net/img/view/2020/4/26/2332385.png,0,0.990669012069702,849,512,1487,1150,638,638,twilight sparkle,jennyberry
2332405.jpg,https://derpicdn.net/img/view/2020/4/26/2332405.jpg,0,0.9950627088546752,360,94,642,376,282,282,twilight sparkle,scarletskitty12
2332546.png,https://derpicdn.net/img/view/2020/4/26/2332546.png,0,0.9840599298477172,311,182,685,556,374,374,twilight sparkle,sinrar
2332717.jpg,https://derpicdn.net/img/view/2020/4/27/2332717.jpg,0,0.9752551317214966,1159,176,1791,808,632,632,twilight sparkle,lomilykohi
2333979.png,https://derpicdn.net/img/view/2020/4/28/2333979.png,0,0.996079683303833,775,427,3015,2667,2240,2240,twilight sparkle,janelearts
2334484.jpg,https://derpicdn.net/img/view/2020/4/29/2334484.jpg,0,0.9842283129692078,0,38,1529,1584,1529,1546,twilight sparkle,julunis14
2334499.jpg,https://derpicdn.net/img/view/2020/4/29/2334499.jpg,0,0.996043622493744,0,0,1368,1490,1368,1490,twilight sparkle,julunis14
2334644.png,https://derpicdn.net/img/view/2020/4/29/2334644.png,0,0.9098555445671082,0,660,4881,6290,4881,5630,twilight sparkle,andoanimalia
2335534.png,https://derpicdn.net/img/view/2020/4/30/2335534.png,0,0.963746190071106,2636,724,7710,5798,5074,5074,twilight sparkle,andoanimalia
2336782.png,https://derpicdn.net/img/view/2020/5/1/2336782.png,0,0.998531937599182,36,44,680,688,644,644,twilight sparkle,minervaovo|ch-chau
2338961.png,https://derpicdn.net/img/view/2020/5/4/2338961.png,0,0.9333547949790956,99,210,753,864,654,654,twilight sparkle,cloudyglow
2339109.png,https://derpicdn.net/img/view/2020/5/4/2339109.png,0,0.9659189581871032,338,0,1530,1274,1192,1274,twilight sparkle,lightning-stars
2339774.png,https://derpicdn.net/img/view/2020/5/5/2339774.png,0,0.990304172039032,39,0,831,757,792,757,twilight sparkle,delphoart
2341524.png,https://derpicdn.net/img/view/2020/5/7/2341524.png,0,0.9677011370658876,47,0,383,290,336,290,twilight sparkle,pencils
2341524.png,https://derpicdn.net/img/view/2020/5/7/2341524.png,1,0.9485223293304444,0,47,268,307,268,260,twilight sparkle,pencils
2342113.png,https://derpicdn.net/img/view/2020/5/7/2342113.png,0,0.9682424068450928,121,470,4325,4674,4204,4204,twilight sparkle,irisarco
2342912.png,https://derpicdn.net/img/view/2020/5/8/2342912.png,0,0.99363112449646,280,28,870,618,590,590,twilight sparkle,shadowboltsfm
2344183.jpg,https://derpicdn.net/img/view/2020/5/10/2344183.jpg,0,0.964322566986084,0,0,3250,3288,3250,3288,twilight sparkle,darksly
2346565.png,https://derpicdn.net/img/view/2020/5/12/2346565.png,0,0.9824143052101136,329,57,1595,1323,1266,1266,twilight sparkle,shadowboltsfm
23489.png,https://derpicdn.net/img/view/2012/6/28/23489.png,0,0.9984129667282104,485,1,900,435,415,434,twilight sparkle,php27
2349014.png,https://derpicdn.net/img/view/2020/5/15/2349014.png,0,0.966495931148529,128,1,466,339,338,338,twilight sparkle,
2349015.png,https://derpicdn.net/img/view/2020/5/15/2349015.png,0,0.9882924556732178,118,48,422,352,304,304,twilight sparkle,
2349015.png,https://derpicdn.net/img/view/2020/5/15/2349015.png,1,0.9407744407653807,0,69,334,412,334,343,twilight sparkle,
2349843.png,https://derpicdn.net/img/view/2020/5/16/2349843.png,0,0.9772409200668336,25,7,427,409,402,402,twilight sparkle,
2350198.png,https://derpicdn.net/img/view/2020/5/16/2350198.png,0,0.9790334701538086,2093,436,3817,2160,1724,1724,twilight sparkle,limedazzle
2350255.png,https://derpicdn.net/img/view/2020/5/16/2350255.png,0,0.9939134120941162,1935,308,3857,2230,1922,1922,twilight sparkle,vultraz
2350434.png,https://derpicdn.net/img/view/2020/5/16/2350434.png,0,0.9920997619628906,0,24,836,870,836,846,twilight sparkle,nathayro37
2350870.jpg,https://derpicdn.net/img/view/2020/5/17/2350870.jpg,0,0.9957073330879213,51,0,777,617,726,617,twilight sparkle,therealf1rebird
2353133.png,https://derpicdn.net/img/view/2020/5/20/2353133.png,0,0.9607642889022828,136,23,600,509,464,486,twilight sparkle,rendoas
235375.png,https://derpicdn.net/img/view/2013/2/6/235375.png,0,0.9859505891799928,67,17,911,861,844,844,twilight sparkle,dotrim|umsauthorlava
2354886.png,https://derpicdn.net/img/view/2020/5/22/2354886.png,0,0.9790440797805786,2481,5,4641,2165,2160,2160,twilight sparkle,lavenderheartsmlp
241821.png,https://derpicdn.net/img/view/2013/2/13/241821.png,0,0.9474250674247742,74,0,640,529,566,529,twilight sparkle,loyaldis
245753.png,https://derpicdn.net/img/view/2013/2/16/245753.png,0,0.9532089829444884,327,26,1097,796,770,770,twilight sparkle,loyaldis
247205.png,https://derpicdn.net/img/view/2013/2/18/247205.png,0,0.9909178614616394,133,0,497,336,364,336,twilight sparkle,cielaart
248092.png,https://derpicdn.net/img/view/2013/2/18/248092.png,0,0.9563515186309814,156,0,988,719,832,719,twilight sparkle,petirep
249160.png,https://derpicdn.net/img/view/2013/2/19/249160.png,0,0.992690920829773,783,278,1953,1448,1170,1170,twilight sparkle,danmakuman
249375.png,https://derpicdn.net/img/view/2013/2/19/249375.png,0,0.9983460307121276,595,234,937,576,342,342,twilight sparkle,alasou
249375.png,https://derpicdn.net/img/view/2013/2/19/249375.png,1,0.9466668963432312,0,259,383,691,383,432,twilight sparkle,alasou
251243.png,https://derpicdn.net/img/view/2013/2/21/251243.png,0,0.9947475790977478,506,0,1150,641,644,641,twilight sparkle,weisdrachen
251368.png,https://derpicdn.net/img/view/2013/2/22/251368.png,0,0.950081706047058,0,123,2097,2263,2097,2140,twilight sparkle,jcosneverexisted
2523.png,https://derpicdn.net/img/view/2012/1/28/2523.png,0,0.9988479614257812,38,0,470,413,432,413,twilight sparkle,suikuzu
252830.png,https://derpicdn.net/img/view/2013/2/23/252830.png,0,0.978525698184967,893,151,1197,455,304,304,twilight sparkle,zutheskunk traces|agamnentzar
255185.png,https://derpicdn.net/img/view/2013/2/25/255185.png,0,0.9274182319641112,138,25,360,247,222,222,twilight sparkle,subjectnumber2394
258946.png,https://derpicdn.net/img/view/2013/3/1/258946.png,0,0.9852646589279176,68,192,220,344,152,152,twilight sparkle,marcusmaximus
260216.png,https://derpicdn.net/img/view/2013/3/2/260216.png,0,0.9997614026069641,233,0,703,468,470,468,twilight sparkle,gashi-gashi
2606.jpg,https://derpicdn.net/img/view/2012/1/29/2606.jpg,0,0.9982953667640686,1188,164,1824,800,636,636,twilight sparkle,bioniclegahlok
262005.png,https://derpicdn.net/img/view/2013/3/4/262005.png,0,0.9973568320274352,280,84,1032,836,752,752,twilight sparkle,docwario
262659.png,https://derpicdn.net/img/view/2013/3/4/262659.png,0,0.9441404342651368,0,548,1416,2176,1416,1628,twilight sparkle,joemasterpencil|drawntildawn
264060.png,https://derpicdn.net/img/view/2013/3/6/264060.png,0,0.9761054515838624,352,0,632,273,280,273,twilight sparkle,amelie-ami-chan
26567.jpg,https://derpicdn.net/img/view/2012/6/30/26567.jpg,0,0.9879286289215088,289,220,655,586,366,366,twilight sparkle,dreikaze
266279.png,https://derpicdn.net/img/view/2013/3/9/266279.png,0,0.9827232956886292,0,1,156,199,156,198,twilight sparkle,lulubell
268021.png,https://derpicdn.net/img/view/2013/3/11/268021.png,0,0.9616888761520386,656,20,1988,1352,1332,1332,twilight sparkle,killryde
27417.png,https://derpicdn.net/img/view/2012/7/1/27417.png,0,0.992170751094818,307,0,781,455,474,455,twilight sparkle,ashesg|megasweet
276890.png,https://derpicdn.net/img/view/2013/3/22/276890.png,0,0.9983081817626952,144,347,1228,1431,1084,1084,twilight sparkle,danmakuman
277664.jpg,https://derpicdn.net/img/view/2013/3/23/277664.jpg,0,0.9812519550323486,699,17,1497,815,798,798,twilight sparkle,mysticalpha
281081.jpg,https://derpicdn.net/img/view/2013/3/27/281081.jpg,0,0.9906851053237916,51,0,871,770,820,770,twilight sparkle,bluestreakfus
281628.png,https://derpicdn.net/img/view/2013/3/28/281628.png,0,0.9960098266601562,244,0,2544,2226,2300,2226,twilight sparkle,northernthestar|jcosneverexisted
290683.png,https://derpicdn.net/img/view/2013/4/7/290683.png,0,0.9838927388191224,294,0,1308,1006,1014,1006,twilight sparkle,feli
291604.png,https://derpicdn.net/img/view/2013/4/8/291604.png,0,0.9903264045715332,1831,839,3443,2451,1612,1612,twilight sparkle,etiluos
2961.png,https://derpicdn.net/img/view/2012/2/9/2961.png,0,0.9992920160293579,312,0,1122,736,810,736,twilight sparkle,stinkehund
300117.png,https://derpicdn.net/img/view/2013/4/16/300117.png,0,0.9693481326103208,116,0,604,468,488,468,twilight sparkle,kittehkatbar
301718.png,https://derpicdn.net/img/view/2013/4/18/301718.png,0,0.9912277460098268,205,0,3325,3025,3120,3025,twilight sparkle,geonine|eagle1division
308769.jpg,https://derpicdn.net/img/view/2013/4/26/308769.jpg,0,0.9966229200363159,116,170,562,616,446,446,twilight sparkle,whatsapokemon
31013.png,https://derpicdn.net/img/view/2012/7/4/31013.png,0,0.9680938720703124,621,108,1083,570,462,462,twilight sparkle,foxinshadow
31134.jpg,https://derpicdn.net/img/view/2012/7/4/31134.jpg,0,0.9277902841567992,91,0,617,478,526,478,twilight sparkle,
311685.png,https://derpicdn.net/img/view/2013/4/29/311685.png,0,0.9920852184295654,442,8,1042,608,600,600,twilight sparkle,sandwich-anomaly
313470.png,https://derpicdn.net/img/view/2013/5/1/313470.png,0,0.980879843235016,542,33,972,463,430,430,twilight sparkle,kevinsano edits|allosaurus
314997.jpg,https://derpicdn.net/img/view/2013/5/3/314997.jpg,0,0.9984626173973083,586,429,1496,1339,910,910,twilight sparkle,byondrage
319404.png,https://derpicdn.net/img/view/2013/5/8/319404.png,0,0.9574481844902042,303,92,789,578,486,486,twilight sparkle,derpsonhooves
324246.png,https://derpicdn.net/img/view/2013/5/13/324246.png,0,0.9967341423034668,279,418,621,760,342,342,twilight sparkle,
324246.png,https://derpicdn.net/img/view/2013/5/13/324246.png,1,0.9742516875267028,312,57,490,235,178,178,twilight sparkle,
324246.png,https://derpicdn.net/img/view/2013/5/13/324246.png,2,0.9366491436958312,755,416,965,626,210,210,twilight sparkle,
325575.jpg,https://derpicdn.net/img/view/2013/5/15/325575.jpg,0,0.9853181838989258,316,82,764,530,448,448,twilight sparkle,ende26
326086.png,https://derpicdn.net/img/view/2013/5/16/326086.png,0,0.9932453036308287,186,0,686,499,500,499,twilight sparkle,loyaldis
328189.png,https://derpicdn.net/img/view/2013/5/18/328189.png,0,0.9996488094329834,1137,422,1727,1012,590,590,twilight sparkle,geomancing
330222.jpg,https://derpicdn.net/img/view/2013/5/21/330222.jpg,0,0.9989452362060548,296,0,766,421,470,421,twilight sparkle,princesssilverglow
331783.png,https://derpicdn.net/img/view/2013/5/23/331783.png,0,0.9974811673164368,146,0,864,718,718,718,twilight sparkle,annakitsun3
332616.png,https://derpicdn.net/img/view/2013/5/24/332616.png,0,0.9962337017059326,483,105,863,485,380,380,twilight sparkle,kevinsano
344910.png,https://derpicdn.net/img/view/2013/6/10/344910.png,0,0.975959539413452,20,0,500,583,480,583,twilight sparkle,30clock
345412.png,https://derpicdn.net/img/view/2013/6/10/345412.png,0,0.9867697954177856,380,360,796,776,416,416,twilight sparkle,alasou
346452.png,https://derpicdn.net/img/view/2013/6/12/346452.png,0,0.9762166738510132,207,0,498,279,291,279,twilight sparkle,pandadox
347290.png,https://derpicdn.net/img/view/2013/6/13/347290.png,0,0.9743193984031676,1463,99,3891,2527,2428,2428,twilight sparkle,fureox
349371.png,https://derpicdn.net/img/view/2013/6/15/349371.png,0,0.9872589707374572,6,0,496,425,490,425,twilight sparkle,apple-707|c0nker
351676.png,https://derpicdn.net/img/view/2013/6/18/351676.png,0,0.994253635406494,421,89,713,381,292,292,twilight sparkle,thatguy1945
354513.png,https://derpicdn.net/img/view/2013/6/22/354513.png,0,0.9859052300453186,0,0,548,600,548,600,twilight sparkle,plsgts
354513.png,https://derpicdn.net/img/view/2013/6/22/354513.png,1,0.957396924495697,0,0,604,739,604,739,twilight sparkle,plsgts
355805.png,https://derpicdn.net/img/view/2013/6/24/355805.png,0,0.9875134229660034,74,0,800,711,726,711,twilight sparkle,lolopan
358721.png,https://derpicdn.net/img/view/2013/6/27/358721.png,0,0.9963569045066832,83,0,549,463,466,463,twilight sparkle,thattagen
361607.png,https://derpicdn.net/img/view/2013/7/1/361607.png,0,0.996173620223999,3045,0,5500,2599,2455,2599,twilight sparkle,theshadowstone
362800.jpg,https://derpicdn.net/img/view/2013/7/2/362800.jpg,0,0.9824388027191162,2265,348,3201,1284,936,936,twilight sparkle,wazzart
3654.png,https://derpicdn.net/img/view/2012/2/29/3654.png,0,0.9909626245498656,206,113,430,337,224,224,twilight sparkle,karzahnii
3654.png,https://derpicdn.net/img/view/2012/2/29/3654.png,1,0.9427348375320436,451,128,665,342,214,214,twilight sparkle,karzahnii
365657.png,https://derpicdn.net/img/view/2013/7/6/365657.png,0,0.9932286739349364,0,0,614,609,614,609,twilight sparkle,clockworkquartet
365657.png,https://derpicdn.net/img/view/2013/7/6/365657.png,1,0.916620671749115,167,0,800,636,633,636,twilight sparkle,clockworkquartet
368258.png,https://derpicdn.net/img/view/2013/7/9/368258.png,0,0.9212908744812012,277,34,2581,2338,2304,2304,twilight sparkle,theshadowstone
373646.png,https://derpicdn.net/img/view/2013/7/14/373646.png,0,0.9949171543121338,817,0,1261,431,444,431,twilight sparkle,kryptchild
373740.png,https://derpicdn.net/img/view/2013/7/14/373740.png,0,0.9803629517555236,7,2,473,468,466,466,twilight sparkle,kululu-xiao
375542.png,https://derpicdn.net/img/view/2013/7/16/375542.png,0,0.9428666830062866,133,0,705,549,572,549,twilight sparkle,dm29
377745.png,https://derpicdn.net/img/view/2013/7/18/377745.png,0,0.9829981923103333,274,0,1048,689,774,689,twilight sparkle,ensayne
382676.png,https://derpicdn.net/img/view/2013/7/24/382676.png,0,0.9926910996437072,261,0,1769,1353,1508,1353,twilight sparkle,tesslashy
383857.png,https://derpicdn.net/img/view/2013/7/29/383857.png,0,0.9080140590667723,233,157,2341,2265,2108,2108,twilight sparkle,lustrous-dreams
387589.png,https://derpicdn.net/img/view/2013/7/31/387589.png,0,0.982479691505432,380,0,1066,680,686,680,twilight sparkle,ensayne
389411.png,https://derpicdn.net/img/view/2013/8/2/389411.png,0,0.993127942085266,93,45,1099,1051,1006,1006,twilight sparkle,pixel-prism
390067.png,https://derpicdn.net/img/view/2013/8/3/390067.png,0,0.9873119592666626,672,0,1468,687,796,687,twilight sparkle,inkwell
391012.png,https://derpicdn.net/img/view/2013/8/4/391012.png,0,0.9982255697250366,331,34,631,334,300,300,twilight sparkle,reiduran
39234.png,https://derpicdn.net/img/view/2012/7/10/39234.png,0,0.9965326189994812,134,0,586,411,452,411,twilight sparkle,meltyvixen
395218.png,https://derpicdn.net/img/view/2013/8/9/395218.png,0,0.9836236238479614,125,6,351,232,226,226,twilight sparkle,pekou
400169.png,https://derpicdn.net/img/view/2013/8/14/400169.png,0,0.927838146686554,190,67,440,317,250,250,twilight sparkle,caroo
400711.png,https://derpicdn.net/img/view/2013/8/15/400711.png,0,0.9882383346557616,238,0,838,564,600,564,twilight sparkle,cuddlehooves
401353.png,https://derpicdn.net/img/view/2013/8/15/401353.png,0,0.9935369491577148,676,178,1352,854,676,676,twilight sparkle,ifthemainecoon
401475.png,https://derpicdn.net/img/view/2013/8/16/401475.png,0,0.966841757297516,562,4,914,356,352,352,twilight sparkle,pixel-prism
401791.png,https://derpicdn.net/img/view/2013/8/16/401791.png,0,0.9994705319404602,741,32,939,230,198,198,twilight sparkle,caroo
401826.png,https://derpicdn.net/img/view/2013/8/16/401826.png,0,0.968634307384491,300,0,720,359,420,359,twilight sparkle,caroo
402338.png,https://derpicdn.net/img/view/2013/8/17/402338.png,0,0.9951582551002502,184,42,500,374,316,332,twilight sparkle,
404550.jpg,https://derpicdn.net/img/view/2013/8/19/404550.jpg,0,0.9976623058319092,309,38,895,624,586,586,twilight sparkle,shinobe
406919.png,https://derpicdn.net/img/view/2013/8/22/406919.png,0,0.947540283203125,389,24,753,388,364,364,twilight sparkle,
407139.png,https://derpicdn.net/img/view/2013/8/22/407139.png,0,0.9981171488761902,248,351,754,857,506,506,twilight sparkle,bluntwhiskey
407419.jpg,https://derpicdn.net/img/view/2013/8/22/407419.jpg,0,0.986316740512848,25,0,385,346,360,346,twilight sparkle,kiriya
4097.jpg,https://derpicdn.net/img/view/2012/5/27/4097.jpg,0,0.9985027909278872,540,0,886,343,346,343,twilight sparkle,johnjoseco
4099.jpg,https://derpicdn.net/img/view/2012/5/27/4099.jpg,0,0.9990430474281312,0,0,406,406,406,406,twilight sparkle,johnjoseco
410796.png,https://derpicdn.net/img/view/2013/8/26/410796.png,0,0.994853138923645,509,26,991,508,482,482,twilight sparkle,askbumpywish
41359.png,https://derpicdn.net/img/view/2012/7/12/41359.png,0,0.9952961802482604,637,436,1365,1164,728,728,twilight sparkle,sakuyamon
414434.png,https://derpicdn.net/img/view/2013/8/30/414434.png,0,0.976716697216034,276,0,720,399,444,399,twilight sparkle,joey darkmeat|jobo37
415322.png,https://derpicdn.net/img/view/2013/8/31/415322.png,0,0.9974501729011536,1484,422,2590,1528,1106,1106,twilight sparkle,graphic-lee
416806.png,https://derpicdn.net/img/view/2013/9/2/416806.png,0,0.9870744943618774,5,1,405,401,400,400,twilight sparkle,karpet-shark
416888.png,https://derpicdn.net/img/view/2013/9/2/416888.png,0,0.9783481955528259,435,163,1025,753,590,590,twilight sparkle,bluntwhiskey
421718.jpg,https://derpicdn.net/img/view/2013/9/7/421718.jpg,0,0.9877417683601379,1253,0,2635,1338,1382,1338,twilight sparkle,bluntwhiskey
4218.jpg,https://derpicdn.net/img/view/2012/6/3/4218.jpg,0,0.9966422915458679,15,9,483,477,468,468,twilight sparkle,johnjoseco
425977.png,https://derpicdn.net/img/view/2013/9/12/425977.png,1,0.9972802400588988,40,4,424,388,384,384,twilight sparkle,couldysky|kazeco|shepherd0821
427565.png,https://derpicdn.net/img/view/2013/9/14/427565.png,0,0.9767048954963684,412,31,946,565,534,534,twilight sparkle,blacky-moon
430637.png,https://derpicdn.net/img/view/2013/9/19/430637.png,0,0.9586169123649596,215,96,785,666,570,570,twilight sparkle,lustrous-dreams
431749.png,https://derpicdn.net/img/view/2013/9/21/431749.png,0,0.9925923943519592,535,477,1087,1029,552,552,twilight sparkle,r0b0tassassin
431876.png,https://derpicdn.net/img/view/2013/9/21/431876.png,0,0.997785210609436,506,45,1654,1193,1148,1148,twilight sparkle,overdriv3n
432058.png,https://derpicdn.net/img/view/2013/9/21/432058.png,0,0.9864670038223268,282,0,616,320,334,320,twilight sparkle,killryde|celinesparkle
432870.jpg,https://derpicdn.net/img/view/2013/9/22/432870.jpg,0,0.9904939532279968,121,0,1115,961,994,961,twilight sparkle,lonelycross
434146.png,https://derpicdn.net/img/view/2013/9/24/434146.png,0,0.9970507621765136,501,56,931,486,430,430,twilight sparkle,xonitum
434625.png,https://derpicdn.net/img/view/2013/9/25/434625.png,0,0.9653711318969728,431,49,2487,2105,2056,2056,twilight sparkle,galekz
435248.png,https://derpicdn.net/img/view/2013/9/26/435248.png,0,0.9956218004226683,270,0,808,529,538,529,twilight sparkle,fatcakes
441428.jpg,https://derpicdn.net/img/view/2013/10/4/441428.jpg,0,0.998330533504486,498,0,1032,511,534,511,twilight sparkle,sweethd
441444.png,https://derpicdn.net/img/view/2013/10/4/441444.png,0,0.9963119626045228,233,0,631,393,398,393,twilight sparkle,tesuai
441714.png,https://derpicdn.net/img/view/2013/10/4/441714.png,0,0.9824398756027222,231,0,975,689,744,689,twilight sparkle,a4r91n
444333.jpg,https://derpicdn.net/img/view/2013/10/8/444333.jpg,0,0.9913868308067322,0,32,201,250,201,218,twilight sparkle,bluntwhiskey
444333.jpg,https://derpicdn.net/img/view/2013/10/8/444333.jpg,1,0.9375760555267334,35,28,227,248,192,220,twilight sparkle,bluntwhiskey
446363.jpg,https://derpicdn.net/img/view/2013/10/11/446363.jpg,0,0.9928976893424988,110,238,562,690,452,452,twilight sparkle,lyra-kotto
446363.jpg,https://derpicdn.net/img/view/2013/10/11/446363.jpg,1,0.9865492582321168,615,422,1000,848,385,426,twilight sparkle,lyra-kotto
448267.png,https://derpicdn.net/img/view/2013/10/13/448267.png,0,0.9985080361366272,992,198,2094,1300,1102,1102,twilight sparkle,doggonepony
455246.png,https://derpicdn.net/img/view/2013/10/24/455246.png,0,0.928262174129486,991,559,4000,3390,3009,2831,twilight sparkle,godoffury
456845.png,https://derpicdn.net/img/view/2013/10/26/456845.png,0,0.9879878163337708,611,244,919,552,308,308,twilight sparkle,raikoh
459894.png,https://derpicdn.net/img/view/2013/10/30/459894.png,0,0.9860719442367554,92,0,792,681,700,681,twilight sparkle,pepooni
460562.png,https://derpicdn.net/img/view/2013/10/30/460562.png,0,0.9891896247863772,207,0,1045,696,838,696,twilight sparkle,plsgts
461463.png,https://derpicdn.net/img/view/2013/10/31/461463.png,0,0.9796329140663148,68,0,372,292,304,292,twilight sparkle,mangneto
463767.png,https://derpicdn.net/img/view/2013/11/3/463767.png,0,0.9915156364440918,424,145,2206,1927,1782,1782,twilight sparkle,turtlefarminguy
465891.png,https://derpicdn.net/img/view/2013/11/6/465891.png,0,0.94321471452713,716,121,2406,1811,1690,1690,twilight sparkle,leopurofriki
479178.png,https://derpicdn.net/img/view/2013/11/23/479178.png,0,0.9595051407814026,361,68,763,470,402,402,twilight sparkle,
479327.png,https://derpicdn.net/img/view/2013/11/23/479327.png,0,0.9834186434745787,0,0,202,191,202,191,twilight sparkle,
480689.png,https://derpicdn.net/img/view/2013/11/24/480689.png,0,0.9903196692466736,857,211,2911,2265,2054,2054,twilight sparkle,
480719.png,https://derpicdn.net/img/view/2013/11/24/480719.png,0,0.9271044135093688,32,0,854,798,822,798,twilight sparkle,the-rasp-b
483514.png,https://derpicdn.net/img/view/2013/11/27/483514.png,0,0.969277322292328,2071,43,3889,1861,1818,1818,twilight sparkle,mamandil
485278.png,https://derpicdn.net/img/view/2013/11/29/485278.png,0,0.9831596612930298,254,51,416,213,162,162,twilight sparkle,ranban
485314.jpg,https://derpicdn.net/img/view/2013/11/29/485314.jpg,0,0.9899263978004456,282,359,524,601,242,242,twilight sparkle,anightlypony
485977.png,https://derpicdn.net/img/view/2013/11/30/485977.png,0,0.9000342488288879,589,167,1119,697,530,530,twilight sparkle,ruffu
486337.png,https://derpicdn.net/img/view/2013/11/30/486337.png,0,0.972820520401001,201,115,800,775,599,660,twilight sparkle,johnjoseco
486547.png,https://derpicdn.net/img/view/2013/11/30/486547.png,0,0.9980496168136596,3348,806,6000,3744,2652,2938,twilight sparkle,masem
486968.png,https://derpicdn.net/img/view/2013/12/1/486968.png,0,0.9965869784355164,930,49,1882,1001,952,952,twilight sparkle,vulpessentia
487191.png,https://derpicdn.net/img/view/2013/12/1/487191.png,0,0.9013068675994872,148,322,684,858,536,536,twilight sparkle,margony
487532.png,https://derpicdn.net/img/view/2013/12/2/487532.png,0,0.9386467337608336,100,52,550,514,450,462,twilight sparkle,johnjoseco
493202.png,https://derpicdn.net/img/view/2013/12/8/493202.png,0,0.9985349178314208,130,0,786,632,656,632,twilight sparkle,lil-kalli
493708.png,https://derpicdn.net/img/view/2013/12/9/493708.png,0,0.987183153629303,0,0,275,244,275,244,twilight sparkle,sambragg
494201.png,https://derpicdn.net/img/view/2013/12/10/494201.png,0,0.9891424179077148,1557,152,2971,1566,1414,1414,twilight sparkle,tenart
499828.png,https://derpicdn.net/img/view/2013/12/18/499828.png,0,0.9996099472045898,0,0,814,820,814,820,twilight sparkle,mynder|tsitra360
501946.jpg,https://derpicdn.net/img/view/2013/12/20/501946.jpg,0,0.9704371094703674,75,0,245,155,170,155,twilight sparkle,valornomad
504105.png,https://derpicdn.net/img/view/2013/12/22/504105.png,0,0.903210997581482,25,0,901,873,876,873,twilight sparkle,
504567.png,https://derpicdn.net/img/view/2013/12/23/504567.png,0,0.9273737668991088,49,967,1003,1921,954,954,twilight sparkle,glacierponi
508141.png,https://derpicdn.net/img/view/2013/12/28/508141.png,0,0.9398200511932372,45,61,307,323,262,262,twilight sparkle,soulspade|felynea
508923.png,https://derpicdn.net/img/view/2013/12/29/508923.png,0,0.9938066601753236,485,21,777,313,292,292,twilight sparkle,norang94
509003.png,https://derpicdn.net/img/view/2013/12/29/509003.png,0,0.915048360824585,1656,119,3240,1703,1584,1584,twilight sparkle,beamsaber
511599.png,https://derpicdn.net/img/view/2014/1/1/511599.png,0,0.9245976805686952,247,238,779,770,532,532,twilight sparkle,subjectnumber2394
520121.png,https://derpicdn.net/img/view/2014/1/10/520121.png,0,0.9787655472755432,330,0,858,496,528,496,twilight sparkle,jcosneverexisted
523991.png,https://derpicdn.net/img/view/2014/1/14/523991.png,0,0.942639708518982,605,515,1159,1069,554,554,twilight sparkle,pixel-prism
526210.png,https://derpicdn.net/img/view/2014/1/17/526210.png,0,0.9732117652893066,4,0,182,171,178,171,twilight sparkle,
527335.jpg,https://derpicdn.net/img/view/2014/1/18/527335.jpg,0,0.9362360835075378,390,490,768,868,378,378,twilight sparkle,muslipepito
527606.jpg,https://derpicdn.net/img/view/2014/1/18/527606.jpg,0,0.9586682319641112,1288,17,1698,427,410,410,twilight sparkle,kandlin
528059.png,https://derpicdn.net/img/view/2014/1/18/528059.png,0,0.96979558467865,425,239,1487,1301,1062,1062,twilight sparkle,clouddg
530338.png,https://derpicdn.net/img/view/2014/1/21/530338.png,0,0.9961007237434388,356,138,846,628,490,490,twilight sparkle,uher0
534816.png,https://derpicdn.net/img/view/2014/1/26/534816.png,0,0.9765348434448242,3239,134,5905,2800,2666,2666,twilight sparkle,byteslice
534825.png,https://derpicdn.net/img/view/2014/1/26/534825.png,0,0.9591123461723328,0,0,1162,1013,1162,1013,twilight sparkle,
535259.jpg,https://derpicdn.net/img/view/2014/1/26/535259.jpg,0,0.9963026642799376,0,25,440,509,440,484,twilight sparkle,raikoh
535980.png,https://derpicdn.net/img/view/2014/1/27/535980.png,0,0.9773191809654236,1433,125,3804,2645,2371,2520,twilight sparkle,redapropos
536099.png,https://derpicdn.net/img/view/2014/1/27/536099.png,0,0.9015200734138488,214,22,566,374,352,352,twilight sparkle,danmakuman
537766.png,https://derpicdn.net/img/view/2014/1/29/537766.png,0,0.9922484755516052,0,2,719,736,719,734,twilight sparkle,alkalizonian
542494.png,https://derpicdn.net/img/view/2014/2/3/542494.png,0,0.9917663335800172,395,0,865,464,470,464,twilight sparkle,arareroll
547472.png,https://derpicdn.net/img/view/2014/2/9/547472.png,0,0.9960041642189026,113,0,637,514,524,514,twilight sparkle,voilet14
549704.png,https://derpicdn.net/img/view/2014/2/12/549704.png,0,0.9796077609062196,124,0,1404,1114,1280,1114,twilight sparkle,kuren247
550316.png,https://derpicdn.net/img/view/2014/2/12/550316.png,0,0.9365081191062928,359,0,879,456,520,456,twilight sparkle,lindana506
551209.png,https://derpicdn.net/img/view/2014/2/14/551209.png,0,0.9786563515663148,0,0,1089,1037,1089,1037,twilight sparkle,savannaeve
554644.png,https://derpicdn.net/img/view/2014/2/17/554644.png,0,0.9355602264404296,745,0,1719,794,974,794,twilight sparkle,zelc-face|karl97
555375.png,https://derpicdn.net/img/view/2014/2/18/555375.png,0,0.9733288288116456,292,111,1130,949,838,838,twilight sparkle,toroitimu
559070.png,https://derpicdn.net/img/view/2014/2/22/559070.png,0,0.9928505420684814,262,101,620,459,358,358,twilight sparkle,egophiliac
559225.png,https://derpicdn.net/img/view/2014/2/22/559225.png,0,0.9452420473098756,105,2,435,332,330,330,twilight sparkle,silver1kunai
559330.png,https://derpicdn.net/img/view/2014/2/22/559330.png,0,0.9886621236801147,807,138,1165,496,358,358,twilight sparkle,twilightshadowart
559567.png,https://derpicdn.net/img/view/2014/2/23/559567.png,0,0.9770075678825378,122,0,534,396,412,396,twilight sparkle,probablyfakeblonde
561586.png,https://derpicdn.net/img/view/2014/2/26/561586.png,0,0.9808870553970336,0,0,743,676,743,676,twilight sparkle,kheltari
563179.png,https://derpicdn.net/img/view/2014/2/28/563179.png,0,0.9028106331825256,222,316,442,536,220,220,twilight sparkle,metal-kitty
564144.png,https://derpicdn.net/img/view/2014/3/1/564144.png,0,0.9965346455574036,876,155,1756,1035,880,880,twilight sparkle,stinkehund
564864.png,https://derpicdn.net/img/view/2014/3/2/564864.png,0,0.9982057809829712,0,0,924,915,924,915,twilight sparkle,luuandherdraws
565954.png,https://derpicdn.net/img/view/2014/3/3/565954.png,0,0.9880659580230712,0,0,789,800,789,800,twilight sparkle,twistedmindbrony
566575.png,https://derpicdn.net/img/view/2014/3/4/566575.png,0,0.9958512783050536,47,0,411,328,364,328,twilight sparkle,maren
567774.png,https://derpicdn.net/img/view/2014/3/6/567774.png,0,0.9247798919677734,2679,220,5799,3340,3120,3120,twilight sparkle,benybing
569462.png,https://derpicdn.net/img/view/2014/3/8/569462.png,0,0.9918037056922911,0,0,674,637,674,637,twilight sparkle,milkii-ways
570903.png,https://derpicdn.net/img/view/2014/3/9/570903.png,0,0.9964148998260498,288,270,742,724,454,454,twilight sparkle,shawnyall|dfectivedvice
571273.png,https://derpicdn.net/img/view/2014/3/10/571273.png,0,0.9599549770355223,19,0,561,453,542,453,twilight sparkle,thephoebster
573122.jpg,https://derpicdn.net/img/view/2014/3/12/573122.jpg,0,0.9134213924407959,13,0,477,448,464,448,twilight sparkle,nekubi
574438.png,https://derpicdn.net/img/view/2014/3/14/574438.png,0,0.9897747635841372,214,0,1132,857,918,857,twilight sparkle,blindcoyote
577995.png,https://derpicdn.net/img/view/2014/3/17/577995.png,0,0.9316229224205016,78,173,488,583,410,410,twilight sparkle,lustrous-dreams
579192.png,https://derpicdn.net/img/view/2014/3/18/579192.png,0,0.9863056540489196,56,0,558,471,502,471,twilight sparkle,fragnostic
57960.jpg,https://derpicdn.net/img/view/2012/7/26/57960.jpg,0,0.9830995798110962,0,0,2538,2500,2538,2500,twilight sparkle,mrw32
580790.jpg,https://derpicdn.net/img/view/2014/3/21/580790.jpg,0,0.9162493348121644,300,118,486,304,186,186,twilight sparkle,the0ne-u-lost
580974.png,https://derpicdn.net/img/view/2014/3/21/580974.png,0,0.9649795889854432,69,163,1078,1219,1009,1056,twilight sparkle,clockworkquartet
584869.png,https://derpicdn.net/img/view/2014/3/25/584869.png,0,0.9223731756210328,529,156,813,440,284,284,twilight sparkle,cynos-zilla
591063.png,https://derpicdn.net/img/view/2014/4/2/591063.png,0,0.9296400547027588,792,139,1226,573,434,434,twilight sparkle,santagiera
591730.png,https://derpicdn.net/img/view/2014/4/3/591730.png,0,0.9942720532417296,231,9,819,597,588,588,twilight sparkle,koveliana
592000.png,https://derpicdn.net/img/view/2014/4/3/592000.png,0,0.9661821126937866,239,0,531,281,292,281,twilight sparkle,prisma-neko
593315.png,https://derpicdn.net/img/view/2014/4/5/593315.png,0,0.9535818099975586,0,17,976,1007,976,990,twilight sparkle,
595938.png,https://derpicdn.net/img/view/2014/4/8/595938.png,0,0.9939519762992859,384,14,742,372,358,358,twilight sparkle,risu-nya
596196.png,https://derpicdn.net/img/view/2014/4/9/596196.png,0,0.9992493987083436,203,0,609,390,406,390,twilight sparkle,alasou
596893.png,https://derpicdn.net/img/view/2014/4/10/596893.png,0,0.9951037764549256,192,31,538,377,346,346,twilight sparkle,alasou
597841.png,https://derpicdn.net/img/view/2014/4/11/597841.png,0,0.9060904383659364,1920,682,2850,1612,930,930,twilight sparkle,l1nkoln
597845.jpg,https://derpicdn.net/img/view/2014/4/11/597845.jpg,0,0.9744154810905457,239,43,629,433,390,390,twilight sparkle,shinobe
598866.png,https://derpicdn.net/img/view/2014/4/12/598866.png,0,0.9667490124702454,12,0,650,594,638,594,twilight sparkle,ghst-qn
604517.png,https://derpicdn.net/img/view/2014/4/19/604517.png,0,0.9988891482353208,607,22,903,318,296,296,twilight sparkle,hanabitaihou
604517.png,https://derpicdn.net/img/view/2014/4/19/604517.png,1,0.9980714321136476,80,0,426,334,346,334,twilight sparkle,hanabitaihou
604517.png,https://derpicdn.net/img/view/2014/4/19/604517.png,2,0.9896144270896912,21,753,435,1167,414,414,twilight sparkle,hanabitaihou
604517.png,https://derpicdn.net/img/view/2014/4/19/604517.png,3,0.9685999155044556,593,811,929,1147,336,336,twilight sparkle,hanabitaihou
606356.png,https://derpicdn.net/img/view/2014/4/21/606356.png,0,0.9396514892578124,199,40,423,264,224,224,twilight sparkle,theshadowcheetah
607645.png,https://derpicdn.net/img/view/2014/4/23/607645.png,0,0.9878827333450316,112,29,796,713,684,684,twilight sparkle,alasou
608793.png,https://derpicdn.net/img/view/2014/4/24/608793.png,0,0.9214187264442444,2560,361,4412,2213,1852,1852,twilight sparkle,thebrokencog
609038.png,https://derpicdn.net/img/view/2014/4/25/609038.png,0,0.9860078692436218,96,0,340,235,244,235,twilight sparkle,lulubell
610163.jpg,https://derpicdn.net/img/view/2014/4/26/610163.jpg,0,0.9125564694404602,287,107,591,411,304,304,twilight sparkle,snapai
610851.png,https://derpicdn.net/img/view/2014/4/26/610851.png,0,0.9471341967582704,22,0,382,357,360,357,twilight sparkle,venezolanbrony|reiduran
610998.png,https://derpicdn.net/img/view/2014/4/27/610998.png,0,0.9977031946182252,5,0,1495,1358,1490,1358,twilight sparkle,ruinedomega
611396.png,https://derpicdn.net/img/view/2014/4/27/611396.png,0,0.9528591632843018,53,0,647,580,594,580,twilight sparkle,k-nattoh
612683.png,https://derpicdn.net/img/view/2014/4/29/612683.png,0,0.9870842695236206,454,48,758,352,304,304,twilight sparkle,nivrozs
612780.png,https://derpicdn.net/img/view/2014/4/29/612780.png,0,0.9036359786987304,125,1,991,867,866,866,twilight sparkle,nivrozs
616022.png,https://derpicdn.net/img/view/2014/5/3/616022.png,0,0.9995849728584292,586,136,1376,926,790,790,twilight sparkle,lustrous-dreams
617293.png,https://derpicdn.net/img/view/2014/5/4/617293.png,0,0.9795368313789368,353,0,1075,718,722,718,twilight sparkle,katputze
617326.png,https://derpicdn.net/img/view/2014/5/4/617326.png,0,0.9961504340171814,1143,134,1825,816,682,682,twilight sparkle,darkflame75
619981.png,https://derpicdn.net/img/view/2014/5/7/619981.png,0,0.988663375377655,19,0,363,329,344,329,twilight sparkle,johnjoseco
621538.jpg,https://derpicdn.net/img/view/2014/5/9/621538.jpg,0,0.9815181493759156,308,21,794,507,486,486,twilight sparkle,twilite-sparkleplz
623539.png,https://derpicdn.net/img/view/2014/5/11/623539.png,0,0.9875609278678894,264,1256,532,1524,268,268,twilight sparkle,esuka
623981.png,https://derpicdn.net/img/view/2014/5/11/623981.png,0,0.9924641251564026,76,0,366,245,290,245,twilight sparkle,griffsnuff
624086.jpg,https://derpicdn.net/img/view/2014/5/11/624086.jpg,0,0.9749287962913512,337,43,685,391,348,348,twilight sparkle,thedoggygal
624473.png,https://derpicdn.net/img/view/2014/5/12/624473.png,0,0.9663704633712769,659,14,1117,472,458,458,twilight sparkle,zepher-tensho
625467.jpg,https://derpicdn.net/img/view/2014/5/13/625467.jpg,0,0.9704418182373048,71,110,1279,1318,1208,1208,twilight sparkle,captainpudgemuffin
627051.png,https://derpicdn.net/img/view/2014/5/15/627051.png,0,0.9996275901794434,333,139,627,433,294,294,twilight sparkle,graphic-lee
627470.png,https://derpicdn.net/img/view/2014/5/15/627470.png,0,0.9931442737579346,775,216,1111,552,336,336,twilight sparkle,seidouryu
627515.png,https://derpicdn.net/img/view/2014/5/15/627515.png,0,0.9977908134460448,35,0,409,371,374,371,twilight sparkle,mn27
629210.png,https://derpicdn.net/img/view/2014/5/17/629210.png,0,0.9647690653800964,115,139,359,383,244,244,twilight sparkle,salvicorn
630878.png,https://derpicdn.net/img/view/2014/5/19/630878.png,0,0.994231343269348,243,271,2731,2759,2488,2488,twilight sparkle,90sigma
633590.png,https://derpicdn.net/img/view/2014/5/22/633590.png,0,0.9582377672195436,365,17,713,365,348,348,twilight sparkle,pixelkitties
633987.png,https://derpicdn.net/img/view/2014/5/23/633987.png,0,0.9980665445327759,182,20,776,614,594,594,twilight sparkle,alasou
634301.png,https://derpicdn.net/img/view/2014/5/23/634301.png,0,0.965938925743103,0,7,734,765,734,758,twilight sparkle,animelabg
635266.jpg,https://derpicdn.net/img/view/2014/5/24/635266.jpg,0,0.9944556951522828,378,153,906,681,528,528,twilight sparkle,gamermac
635543.png,https://derpicdn.net/img/view/2014/5/24/635543.png,0,0.9381752014160156,0,5,1500,1915,1500,1910,twilight sparkle,kyodashiro
637719.png,https://derpicdn.net/img/view/2014/5/27/637719.png,0,0.9943490624427797,296,93,766,563,470,470,twilight sparkle,farewelldecency
639405.png,https://derpicdn.net/img/view/2014/5/28/639405.png,0,0.983461618423462,628,0,1248,551,620,551,twilight sparkle,sion-ara
642127.png,https://derpicdn.net/img/view/2014/6/1/642127.png,0,0.997626006603241,225,0,743,500,518,500,twilight sparkle,sion-ara
64260.png,https://derpicdn.net/img/view/2012/8/1/64260.png,0,0.974198281764984,0,0,518,529,518,529,twilight sparkle,fearingfun
647922.png,https://derpicdn.net/img/view/2014/6/8/647922.png,0,0.993785560131073,178,181,486,489,308,308,twilight sparkle,thattagen
656434.png,https://derpicdn.net/img/view/2014/6/18/656434.png,0,0.9893248677253724,727,139,1280,701,553,562,twilight sparkle,aleximusprime
657833.png,https://derpicdn.net/img/view/2014/6/20/657833.png,0,0.9906372427940368,750,87,1196,533,446,446,twilight sparkle,twitchykismet
658876.png,https://derpicdn.net/img/view/2014/6/22/658876.png,0,0.9518580436706544,0,0,617,576,617,576,twilight sparkle,clockworkquartet
659518.png,https://derpicdn.net/img/view/2014/6/23/659518.png,0,0.9864453673362732,635,15,2705,2085,2070,2070,twilight sparkle,evilfrenzy
659602.png,https://derpicdn.net/img/view/2014/6/23/659602.png,0,0.9947052001953124,475,0,819,330,344,330,twilight sparkle,mr-tiaa
659848.png,https://derpicdn.net/img/view/2014/6/23/659848.png,0,0.9716316461563108,0,0,435,438,435,438,twilight sparkle,mewball
661896.png,https://derpicdn.net/img/view/2014/6/26/661896.png,0,0.9630311727523804,286,42,1194,950,908,908,twilight sparkle,abovespace
662572.png,https://derpicdn.net/img/view/2014/6/27/662572.png,0,0.977487325668335,251,0,3213,2783,2962,2783,twilight sparkle,benybing
663906.jpg,https://derpicdn.net/img/view/2014/6/29/663906.jpg,0,0.9780530333518982,83,35,367,319,284,284,twilight sparkle,onnanoko
665188.png,https://derpicdn.net/img/view/2014/7/1/665188.png,0,0.992798924446106,19,0,505,445,486,445,twilight sparkle,catitty
665989.jpg,https://derpicdn.net/img/view/2014/7/2/665989.jpg,0,0.9246625304222108,726,492,1884,1650,1158,1158,twilight sparkle,lolopan
668320.png,https://derpicdn.net/img/view/2014/7/5/668320.png,0,0.9934309124946594,1229,0,2823,1547,1594,1547,twilight sparkle,a4r91n
669304.png,https://derpicdn.net/img/view/2014/7/7/669304.png,0,0.9968715310096741,236,0,1256,1016,1020,1016,twilight sparkle,dfectivedvice
673631.png,https://derpicdn.net/img/view/2014/7/12/673631.png,0,0.940217673778534,1723,39,3515,1831,1792,1792,twilight sparkle,haltie
674823.png,https://derpicdn.net/img/view/2014/7/14/674823.png,0,0.9558683037757874,441,154,1217,930,776,776,twilight sparkle,pixelkitties|drewdini|dashiemlpfim
685487.png,https://derpicdn.net/img/view/2014/7/28/685487.png,0,0.9720097184181212,0,50,1280,1392,1280,1342,twilight sparkle,niegelvonwolf
688485.png,https://derpicdn.net/img/view/2014/8/1/688485.png,0,0.9931374788284302,132,11,814,693,682,682,twilight sparkle,sion
688558.png,https://derpicdn.net/img/view/2014/8/1/688558.png,0,0.9365741610527042,248,56,1076,884,828,828,twilight sparkle,an-m
689666.png,https://derpicdn.net/img/view/2014/8/2/689666.png,0,0.986556351184845,676,644,1328,1296,652,652,twilight sparkle,mistydash
692094.png,https://derpicdn.net/img/view/2014/8/5/692094.png,0,0.9989873766899108,132,17,448,333,316,316,twilight sparkle,moenkin
692547.png,https://derpicdn.net/img/view/2014/8/6/692547.png,0,0.9775035381317142,537,0,1875,1303,1338,1303,twilight sparkle,mscootaloo
696452.png,https://derpicdn.net/img/view/2014/8/10/696452.png,0,0.9663978815078736,61,26,585,550,524,524,twilight sparkle,iguana14
697878.jpg,https://derpicdn.net/img/view/2014/8/12/697878.jpg,0,0.9387939572334292,138,6,434,302,296,296,twilight sparkle,moudoku
697981.png,https://derpicdn.net/img/view/2014/8/12/697981.png,0,0.9864517450332642,41,6,433,398,392,392,twilight sparkle,mewball
698512.png,https://derpicdn.net/img/view/2014/8/13/698512.png,0,0.9993163347244264,1055,141,1821,907,766,766,twilight sparkle,maishida
700156.png,https://derpicdn.net/img/view/2014/8/15/700156.png,0,0.9992350339889526,57,306,405,654,348,348,twilight sparkle,cold-blooded-twilight
700156.png,https://derpicdn.net/img/view/2014/8/15/700156.png,1,0.989818036556244,477,316,815,654,338,338,twilight sparkle,cold-blooded-twilight
701372.png,https://derpicdn.net/img/view/2014/8/16/701372.png,0,0.9390069842338562,177,0,659,436,482,436,twilight sparkle,kaji-tanii
70166.png,https://derpicdn.net/img/view/2012/8/9/70166.png,0,0.9983143210411072,667,0,1293,588,626,588,twilight sparkle,sunibee
702152.png,https://derpicdn.net/img/view/2014/8/17/702152.png,0,0.931810975074768,1434,219,2696,1481,1262,1262,twilight sparkle,dilarus
702809.png,https://derpicdn.net/img/view/2014/8/18/702809.png,0,0.9944797158241272,367,52,767,452,400,400,twilight sparkle,daf
702840.png,https://derpicdn.net/img/view/2014/8/18/702840.png,0,0.984880030155182,475,25,927,477,452,452,twilight sparkle,abaddon41
703112.png,https://derpicdn.net/img/view/2014/8/19/703112.png,0,0.9707266688346864,14,0,254,224,240,224,twilight sparkle,shickietan
705142.png,https://derpicdn.net/img/view/2014/8/22/705142.png,0,0.9537801146507264,227,481,547,801,320,320,twilight sparkle,catitty
705499.png,https://derpicdn.net/img/view/2014/8/22/705499.png,0,0.99885231256485,274,0,936,603,662,603,twilight sparkle,rainbowscreen
708691.png,https://derpicdn.net/img/view/2014/8/26/708691.png,0,0.9961255788803101,2933,415,3475,957,542,542,twilight sparkle,jowybean
709503.png,https://derpicdn.net/img/view/2014/8/27/709503.png,0,0.9898508191108704,251,28,955,732,704,704,twilight sparkle,spectralunicorn
710932.png,https://derpicdn.net/img/view/2014/8/30/710932.png,0,0.9887056946754456,103,424,467,788,364,364,twilight sparkle,mewball
712007.png,https://derpicdn.net/img/view/2014/8/31/712007.png,0,0.9872006773948668,2439,2008,3057,2626,618,618,twilight sparkle,glacierponi
713781.png,https://derpicdn.net/img/view/2014/9/2/713781.png,0,0.9890829920768738,54,95,889,991,835,896,twilight sparkle,snowsky-s
713850.png,https://derpicdn.net/img/view/2014/9/3/713850.png,0,0.9677491188049316,0,52,720,1178,720,1126,twilight sparkle,pinki3-pi3
713918.png,https://derpicdn.net/img/view/2014/9/3/713918.png,0,0.9058517217636108,441,131,1475,1165,1034,1034,twilight sparkle,everlastingderp
714453.png,https://derpicdn.net/img/view/2014/9/4/714453.png,0,0.9796646237373352,351,209,1051,909,700,700,twilight sparkle,alasou
714944.jpg,https://derpicdn.net/img/view/2014/9/4/714944.jpg,0,0.906939685344696,339,0,649,292,310,292,twilight sparkle,probablyfakeblonde
717298.png,https://derpicdn.net/img/view/2014/9/7/717298.png,0,0.9632514119148254,0,0,752,753,752,753,twilight sparkle,grimslime
717783.jpg,https://derpicdn.net/img/view/2014/9/8/717783.jpg,0,0.9626871943473816,348,422,620,694,272,272,twilight sparkle,cosmicunicorn
717905.png,https://derpicdn.net/img/view/2014/9/8/717905.png,0,0.9951395392417908,525,0,965,430,440,430,twilight sparkle,sion
718449.png,https://derpicdn.net/img/view/2014/9/9/718449.png,0,0.9849334955215454,272,108,606,442,334,334,twilight sparkle,senx
718637.png,https://derpicdn.net/img/view/2014/9/9/718637.png,0,0.9992499351501464,150,4,474,328,324,324,twilight sparkle,nitronic
721347.jpg,https://derpicdn.net/img/view/2014/9/13/721347.jpg,0,0.9795260429382324,316,0,702,381,386,381,twilight sparkle,sweetsound
721507.png,https://derpicdn.net/img/view/2014/9/13/721507.png,0,0.9174103140830994,373,10,913,550,540,540,twilight sparkle,maren
725519.jpg,https://derpicdn.net/img/view/2014/9/19/725519.jpg,0,0.9973359107971193,314,0,922,568,608,568,twilight sparkle,purple-yoshi-draws
730750.png,https://derpicdn.net/img/view/2014/9/27/730750.png,1,0.9950377941131592,228,9,470,251,242,242,twilight sparkle,king-kakapo|alasou|zacatron94|semehammer
730762.png,https://derpicdn.net/img/view/2014/9/27/730762.png,0,0.9995039105415344,202,23,614,435,412,412,twilight sparkle,mangneto
731976.png,https://derpicdn.net/img/view/2014/9/29/731976.png,0,0.9889370203018188,0,0,1575,1509,1575,1509,twilight sparkle,meowing-ghost
733776.png,https://derpicdn.net/img/view/2014/10/1/733776.png,0,0.9938820004463196,5,3,207,205,202,202,twilight sparkle,lulubell
735350.png,https://derpicdn.net/img/view/2014/10/4/735350.png,0,0.9772825241088868,319,0,1081,678,762,678,twilight sparkle,nobody
736419.png,https://derpicdn.net/img/view/2014/10/5/736419.png,0,0.948417901992798,284,100,680,496,396,396,twilight sparkle,yakovlev-vad
742859.png,https://derpicdn.net/img/view/2014/10/14/742859.png,0,0.9726472496986388,76,15,568,507,492,492,twilight sparkle,caius
743732.jpg,https://derpicdn.net/img/view/2014/10/15/743732.jpg,0,0.9918991923332214,483,165,1515,1197,1032,1032,twilight sparkle,xwhitedreamsx
746356.png,https://derpicdn.net/img/view/2014/10/19/746356.png,0,0.9768288731575012,372,0,1280,946,908,946,twilight sparkle,kittehkatbar
746778.png,https://derpicdn.net/img/view/2014/10/20/746778.png,0,0.9139245748519896,798,64,1296,562,498,498,twilight sparkle,nadnerbd
746893.png,https://derpicdn.net/img/view/2014/10/20/746893.png,0,0.9964048266410828,46,0,398,340,352,340,twilight sparkle,xxstrawberry
752568.jpg,https://derpicdn.net/img/view/2014/10/28/752568.jpg,0,0.9326320886611938,165,0,751,483,586,483,twilight sparkle,chi-hayu
754659.png,https://derpicdn.net/img/view/2014/10/31/754659.png,0,0.9931415915489196,178,0,770,579,592,579,twilight sparkle,premann
756046.png,https://derpicdn.net/img/view/2014/11/2/756046.png,0,0.9546778798103333,202,0,786,558,584,558,twilight sparkle,mewball
757765.png,https://derpicdn.net/img/view/2014/11/4/757765.png,0,0.9937946796417236,311,0,713,396,402,396,twilight sparkle,kirrol|atryl edits
76117.png,https://derpicdn.net/img/view/2012/8/16/76117.png,0,0.946715772151947,329,629,985,1285,656,656,twilight sparkle,ninja-8004
762331.png,https://derpicdn.net/img/view/2014/11/11/762331.png,0,0.9159940481185912,42,2648,1024,3630,982,982,twilight sparkle,
767016.jpg,https://derpicdn.net/img/view/2014/11/18/767016.jpg,0,0.9986222982406616,28,7,420,399,392,392,twilight sparkle,haku
767193.png,https://derpicdn.net/img/view/2014/11/18/767193.png,0,0.9813650846481324,183,2,637,456,454,454,twilight sparkle,raponee
768768.jpg,https://derpicdn.net/img/view/2014/11/21/768768.jpg,0,0.9942920207977296,447,106,1283,942,836,836,twilight sparkle,aryanne
770619.png,https://derpicdn.net/img/view/2014/11/23/770619.png,0,0.9980681538581848,66,0,520,434,454,434,twilight sparkle,firebird145|dfectivedvice
772646.png,https://derpicdn.net/img/view/2014/11/27/772646.png,0,0.9110738039016724,360,307,762,709,402,402,twilight sparkle,kianamai|mutant-girl013
775190.jpg,https://derpicdn.net/img/view/2014/11/30/775190.jpg,0,0.9864543080329896,172,0,1350,1007,1178,1007,twilight sparkle,nekosnicker
778203.png,https://derpicdn.net/img/view/2014/12/5/778203.png,0,0.9975157380104064,129,0,737,560,608,560,twilight sparkle,daniel-sg
778584.png,https://derpicdn.net/img/view/2014/12/5/778584.png,0,0.9968360066413879,1222,0,2144,869,922,869,twilight sparkle,zacatron94
784551.jpg,https://derpicdn.net/img/view/2014/12/14/784551.jpg,0,0.9924176335334778,255,0,753,486,498,486,twilight sparkle,celestialx
786282.png,https://derpicdn.net/img/view/2014/12/16/786282.png,0,0.9973904490470886,0,0,1014,970,1014,970,twilight sparkle,nazonazopowerfu
786548.png,https://derpicdn.net/img/view/2014/12/17/786548.png,0,0.949492335319519,0,251,956,1311,956,1060,twilight sparkle,ladypixelheart
787552.png,https://derpicdn.net/img/view/2014/12/18/787552.png,0,0.9853426814079284,508,214,836,542,328,328,twilight sparkle,szafir87
788774.jpg,https://derpicdn.net/img/view/2014/12/20/788774.jpg,0,0.9907560944557192,1835,501,2655,1321,820,820,twilight sparkle,kianamai
788774.jpg,https://derpicdn.net/img/view/2014/12/20/788774.jpg,1,0.9801772832870485,172,221,1456,1505,1284,1284,twilight sparkle,kianamai
788774.jpg,https://derpicdn.net/img/view/2014/12/20/788774.jpg,2,0.929205596446991,910,1253,1734,2000,824,747,twilight sparkle,kianamai
789292.png,https://derpicdn.net/img/view/2014/12/21/789292.png,0,0.9904544949531556,126,0,632,466,506,466,twilight sparkle,clockworkquartet
791068.png,https://derpicdn.net/img/view/2014/12/23/791068.png,0,0.974601984024048,1163,70,1817,724,654,654,twilight sparkle,gem-magic
795340.png,https://derpicdn.net/img/view/2014/12/29/795340.png,0,0.9477851986885072,0,0,526,507,526,507,twilight sparkle,nora1211
795345.png,https://derpicdn.net/img/view/2014/12/29/795345.png,0,0.9942534565925598,137,0,717,572,580,572,twilight sparkle,nora1211
7955.png,https://derpicdn.net/img/view/2012/6/18/7955.png,0,0.9969870448112488,1682,0,3256,1449,1574,1449,twilight sparkle,leopurofriki
797561.jpg,https://derpicdn.net/img/view/2015/1/1/797561.jpg,0,0.9826188683509828,298,0,838,537,540,537,twilight sparkle,mad'n evil
797706.jpg,https://derpicdn.net/img/view/2015/1/2/797706.jpg,0,0.9075531363487244,416,122,938,644,522,522,twilight sparkle,mad'n evil
798237.png,https://derpicdn.net/img/view/2015/1/2/798237.png,0,0.9758765697479248,23,0,553,527,530,527,twilight sparkle,sion
799888.png,https://derpicdn.net/img/view/2015/1/5/799888.png,0,0.9685987234115601,114,0,516,355,402,355,twilight sparkle,0r0ch1
800418.png,https://derpicdn.net/img/view/2015/1/6/800418.png,0,0.9993107318878174,157,13,847,703,690,690,twilight sparkle,ambris
800420.png,https://derpicdn.net/img/view/2015/1/6/800420.png,0,0.9995195269584656,140,0,846,702,706,702,twilight sparkle,ambris
800422.png,https://derpicdn.net/img/view/2015/1/6/800422.png,0,0.9974344968795776,143,18,851,726,708,708,twilight sparkle,ambris
801400.jpg,https://derpicdn.net/img/view/2015/1/7/801400.jpg,0,0.9910777807235718,988,310,1526,848,538,538,twilight sparkle,kianamai
801834.png,https://derpicdn.net/img/view/2015/1/8/801834.png,0,0.996082842350006,85,7,437,359,352,352,twilight sparkle,php92
802185.png,https://derpicdn.net/img/view/2015/1/8/802185.png,0,0.9852062463760376,504,733,5000,4761,4496,4028,twilight sparkle,alicornoverlord
802358.png,https://derpicdn.net/img/view/2015/1/9/802358.png,0,0.9978399872779846,0,0,4192,4801,4192,4801,twilight sparkle,deathnyan
805557.png,https://derpicdn.net/img/view/2015/1/13/805557.png,0,0.9852080941200256,308,71,1486,1249,1178,1178,twilight sparkle,mrscroup
806994.png,https://derpicdn.net/img/view/2015/1/15/806994.png,0,0.9934592843055724,72,44,224,196,152,152,twilight sparkle,atryl
807394.png,https://derpicdn.net/img/view/2015/1/15/807394.png,0,0.9942179322242736,1134,165,1892,923,758,758,twilight sparkle,mailner
810464.png,https://derpicdn.net/img/view/2015/1/20/810464.png,0,0.9710950255393982,51,38,937,924,886,886,twilight sparkle,maren
810564.png,https://derpicdn.net/img/view/2015/1/20/810564.png,0,0.9991748929023744,2201,0,4287,1990,2086,1990,twilight sparkle,jeatz-axl
814635.png,https://derpicdn.net/img/view/2015/1/25/814635.png,0,0.9582000374794006,23,0,439,403,416,403,twilight sparkle,dilemmas4u
816948.jpg,https://derpicdn.net/img/view/2015/1/29/816948.jpg,0,0.9972108006477356,67,0,505,421,438,421,twilight sparkle,miikanism
817776.png,https://derpicdn.net/img/view/2015/1/30/817776.png,0,0.9721531867980956,6,29,963,999,957,970,twilight sparkle,snowsky-s
818231.png,https://derpicdn.net/img/view/2015/1/31/818231.png,0,0.9978767037391664,99,0,3413,3225,3314,3225,twilight sparkle,dasprid|bobsicle0|sebisscout1997|racefox|uxyd
818331.png,https://derpicdn.net/img/view/2015/1/31/818331.png,0,0.9892903566360474,358,0,814,440,456,440,twilight sparkle,mewball
824446.png,https://derpicdn.net/img/view/2015/2/8/824446.png,0,0.9787650108337402,72,6,600,534,528,528,twilight sparkle,arcadianphoenix
825286.png,https://derpicdn.net/img/view/2015/2/10/825286.png,0,0.9907016754150392,24,0,900,996,876,996,twilight sparkle,tsitra360
827668.png,https://derpicdn.net/img/view/2015/2/13/827668.png,0,0.996468722820282,311,103,559,351,248,248,twilight sparkle,lifyen
828978.png,https://derpicdn.net/img/view/2015/2/15/828978.png,0,0.9123222231864928,267,364,1087,1184,820,820,twilight sparkle,draneas
830898.png,https://derpicdn.net/img/view/2015/2/17/830898.png,0,0.987655520439148,44,51,1178,1185,1134,1134,twilight sparkle,voraire
83093.jpg,https://derpicdn.net/img/view/2012/8/26/83093.jpg,1,0.9120566844940186,0,46,928,1018,928,972,twilight sparkle,alcor
831670.png,https://derpicdn.net/img/view/2015/2/18/831670.png,0,0.983694553375244,470,130,858,518,388,388,twilight sparkle,umeguru
832314.png,https://derpicdn.net/img/view/2015/2/19/832314.png,0,0.9828001856803894,234,119,626,511,392,392,twilight sparkle,anearbyanimal
832755.png,https://derpicdn.net/img/view/2015/2/19/832755.png,0,0.9955269694328308,614,700,2108,2194,1494,1494,twilight sparkle,greenlinzerd
833535.png,https://derpicdn.net/img/view/2015/2/20/833535.png,0,0.9316670298576356,256,80,538,362,282,282,twilight sparkle,lifyen
838420.png,https://derpicdn.net/img/view/2015/2/27/838420.png,0,0.9928000569343568,2886,322,4374,1810,1488,1488,twilight sparkle,inkygarden
841291.png,https://derpicdn.net/img/view/2015/3/3/841291.png,0,0.9824185371398926,744,72,1398,726,654,654,twilight sparkle,irregular-entity
842522.jpg,https://derpicdn.net/img/view/2015/3/5/842522.jpg,0,0.9250730872154236,0,0,600,628,600,628,twilight sparkle,scheadar
842850.png,https://derpicdn.net/img/view/2015/3/5/842850.png,0,0.998738169670105,160,0,710,533,550,533,twilight sparkle,splashstarx
843061.png,https://derpicdn.net/img/view/2015/3/5/843061.png,0,0.998412013053894,301,67,589,355,288,288,twilight sparkle,poisindoodles
847803.png,https://derpicdn.net/img/view/2015/3/12/847803.png,0,0.9494211077690125,60,185,480,640,420,455,twilight sparkle,underpable
847906.jpg,https://derpicdn.net/img/view/2015/3/12/847906.jpg,0,0.9542267918586732,1660,0,2376,681,716,681,twilight sparkle,zapplebow|theparagon|mamandil
848526.jpg,https://derpicdn.net/img/view/2015/3/13/848526.jpg,0,0.9603841304779052,112,3,460,351,348,348,twilight sparkle,xjkenny
848702.png,https://derpicdn.net/img/view/2015/3/13/848702.png,0,0.9026696681976318,288,181,838,731,550,550,twilight sparkle,potzm
849837.png,https://derpicdn.net/img/view/2015/3/15/849837.png,0,0.9933164715766908,586,95,1108,617,522,522,twilight sparkle,comikazia
849837.png,https://derpicdn.net/img/view/2015/3/15/849837.png,1,0.974045753479004,254,252,668,666,414,414,twilight sparkle,comikazia
851745.jpg,https://derpicdn.net/img/view/2015/3/17/851745.jpg,0,0.976046085357666,197,35,497,335,300,300,twilight sparkle,wilvarin-liadon
852494.jpg,https://derpicdn.net/img/view/2015/3/18/852494.jpg,0,0.9649426937103271,464,0,1098,613,634,613,twilight sparkle,gamermac
854261.png,https://derpicdn.net/img/view/2015/3/21/854261.png,0,0.9941193461418152,0,0,640,588,640,588,twilight sparkle,jovalic
85662.png,https://derpicdn.net/img/view/2012/8/29/85662.png,0,0.9959633946418762,7,0,259,217,252,217,twilight sparkle,conicer
857665.png,https://derpicdn.net/img/view/2015/3/26/857665.png,0,0.9871891140937804,1242,0,2662,1307,1420,1307,twilight sparkle,snowsky-s
857713.jpg,https://derpicdn.net/img/view/2015/3/26/857713.jpg,0,0.99164617061615,114,35,402,323,288,288,twilight sparkle,kolshica
858455.png,https://derpicdn.net/img/view/2015/3/27/858455.png,0,0.9929073452949524,679,164,1295,780,616,616,twilight sparkle,kinkiepinkiepie
859923.png,https://derpicdn.net/img/view/2015/3/29/859923.png,0,0.9584513306617736,623,0,923,296,300,296,twilight sparkle,lima-hibiki
862058.png,https://derpicdn.net/img/view/2015/4/1/862058.png,0,0.9903643727302552,133,38,411,316,278,278,twilight sparkle,cold-blooded-twilight
864012.png,https://derpicdn.net/img/view/2015/4/3/864012.png,0,0.9989328980445862,405,0,1007,618,602,618,twilight sparkle,8bitamy
864954.png,https://derpicdn.net/img/view/2015/4/4/864954.png,0,0.9913930892944336,1131,0,3825,2789,2694,2789,twilight sparkle,paulysentry
865279.png,https://derpicdn.net/img/view/2015/4/5/865279.png,0,0.9743343591690063,0,0,948,957,948,957,twilight sparkle,vividvapor
866913.png,https://derpicdn.net/img/view/2015/4/6/866913.png,0,0.9992849826812744,0,0,1776,1839,1776,1839,twilight sparkle,waveywaves
867168.png,https://derpicdn.net/img/view/2015/4/6/867168.png,0,0.9732975959777832,3023,0,7378,4483,4355,4483,twilight sparkle,dasprid
867598.png,https://derpicdn.net/img/view/2015/4/7/867598.png,0,0.962669551372528,0,0,1409,1832,1409,1832,twilight sparkle,luckygirl88
867992.png,https://derpicdn.net/img/view/2015/4/7/867992.png,0,0.9970328211784364,2765,19,5777,3031,3012,3012,twilight sparkle,stillfire
869308.png,https://derpicdn.net/img/view/2015/4/9/869308.png,0,0.986333429813385,2324,0,6163,3880,3839,3880,twilight sparkle,slb94
869792.png,https://derpicdn.net/img/view/2015/4/9/869792.png,0,0.9527164101600648,47,0,867,603,820,603,twilight sparkle,lacedharlot
871999.png,https://derpicdn.net/img/view/2015/4/12/871999.png,0,0.9720937609672546,323,0,1311,926,988,926,twilight sparkle,icy wings
872244.jpg,https://derpicdn.net/img/view/2015/4/12/872244.jpg,0,0.9703400731086732,145,0,741,450,596,450,twilight sparkle,
872357.png,https://derpicdn.net/img/view/2015/4/12/872357.png,0,0.9182538986206056,12,84,404,476,392,392,twilight sparkle,smiba11
872465.png,https://derpicdn.net/img/view/2015/4/12/872465.png,0,0.9892165660858154,149,0,493,330,344,330,twilight sparkle,skorpionletun
872582.png,https://derpicdn.net/img/view/2015/4/12/872582.png,0,0.9309548735618592,2119,0,4015,1824,1896,1824,twilight sparkle,vector-brony
872726.png,https://derpicdn.net/img/view/2015/4/12/872726.png,0,0.9954482316970824,234,85,806,657,572,572,twilight sparkle,mechanized515
872839.png,https://derpicdn.net/img/view/2015/4/13/872839.png,0,0.956714928150177,299,1067,4473,5241,4174,4174,twilight sparkle,slb94
873117.png,https://derpicdn.net/img/view/2015/4/13/873117.png,0,0.9791433215141296,208,4,1164,960,956,956,twilight sparkle,bajanic
873562.png,https://derpicdn.net/img/view/2015/4/14/873562.png,0,0.9912609457969666,2406,924,3458,1976,1052,1052,twilight sparkle,da-futaba
873562.png,https://derpicdn.net/img/view/2015/4/14/873562.png,1,0.9393409490585328,0,21,2529,2543,2529,2522,twilight sparkle,da-futaba
873607.png,https://derpicdn.net/img/view/2015/4/14/873607.png,0,0.9797734022140504,15,0,577,539,562,539,twilight sparkle,mindofnoodles
874153.png,https://derpicdn.net/img/view/2015/4/14/874153.png,0,0.9901208877563475,321,0,1699,1254,1378,1254,twilight sparkle,impcjcaesar
874423.png,https://derpicdn.net/img/view/2015/4/15/874423.png,0,0.9954988956451416,3171,0,5840,2757,2669,2757,twilight sparkle,90sigma
875168.png,https://derpicdn.net/img/view/2015/4/16/875168.png,0,0.9619261622428894,61,0,385,323,324,323,twilight sparkle,munkari
876002.png,https://derpicdn.net/img/view/2015/4/17/876002.png,0,0.9976528882980348,379,14,801,436,422,422,twilight sparkle,raptor007
876107.png,https://derpicdn.net/img/view/2015/4/17/876107.png,0,0.9737530946731568,21,88,1883,1950,1862,1862,twilight sparkle,tizerfiction
876295.png,https://derpicdn.net/img/view/2015/4/17/876295.png,0,0.9680964946746826,101,58,851,808,750,750,twilight sparkle,puetsua
876296.png,https://derpicdn.net/img/view/2015/4/17/876296.png,0,0.9576169848442078,98,0,796,470,698,470,twilight sparkle,tiarawhy
876361.png,https://derpicdn.net/img/view/2015/4/17/876361.png,0,0.9958484172821044,1068,54,1955,968,887,914,twilight sparkle,davidsfire
876758.png,https://derpicdn.net/img/view/2015/4/18/876758.png,0,0.9873237013816832,88,20,832,764,744,744,twilight sparkle,mastgrr
877400.png,https://derpicdn.net/img/view/2015/4/18/877400.png,0,0.9908167123794556,1973,392,4986,3530,3013,3138,twilight sparkle,mrcbleck
878806.jpg,https://derpicdn.net/img/view/2015/4/20/878806.jpg,0,0.950060486793518,78,304,314,540,236,236,twilight sparkle,rocy canvas
878974.png,https://derpicdn.net/img/view/2015/4/20/878974.png,0,0.9937658309936525,45,19,257,231,212,212,twilight sparkle,lulubell
879368.png,https://derpicdn.net/img/view/2015/4/21/879368.png,0,0.9973635673522948,317,31,797,511,480,480,twilight sparkle,dsp2003
879597.png,https://derpicdn.net/img/view/2015/4/21/879597.png,0,0.9359802007675172,36,0,502,420,466,420,twilight sparkle,3d thread|creatorofpony
880171.png,https://derpicdn.net/img/view/2015/4/22/880171.png,0,0.9874913096427916,42,0,934,849,892,849,twilight sparkle,oneofyouare
880245.png,https://derpicdn.net/img/view/2015/4/22/880245.png,0,0.9915502667427064,257,171,1797,1711,1540,1540,twilight sparkle,unilx
882722.png,https://derpicdn.net/img/view/2015/4/25/882722.png,0,0.9950489997863772,483,295,891,703,408,408,twilight sparkle,freepaints
883295.png,https://derpicdn.net/img/view/2015/4/26/883295.png,0,0.9468809962272644,18,0,356,332,338,332,twilight sparkle,chibadeer
883612.png,https://derpicdn.net/img/view/2015/4/26/883612.png,0,0.998921275138855,254,0,502,240,248,240,twilight sparkle,hic-sunt-equi
884184.png,https://derpicdn.net/img/view/2015/4/27/884184.png,0,0.9818336367607116,469,153,1615,1299,1146,1146,twilight sparkle,discorded
884538.png,https://derpicdn.net/img/view/2015/4/28/884538.png,0,0.9890983104705808,17,0,1233,1136,1216,1136,twilight sparkle,meotashie|cerpcakeee
885519.png,https://derpicdn.net/img/view/2015/4/29/885519.png,0,0.960875391960144,0,0,800,867,800,867,twilight sparkle,php15
888564.png,https://derpicdn.net/img/view/2015/5/4/888564.png,0,0.9873250126838684,312,734,1142,1564,830,830,twilight sparkle,xebck
890212.png,https://derpicdn.net/img/view/2015/5/6/890212.png,0,0.9928749799728394,352,126,676,450,324,324,twilight sparkle,heir-of-rick
891965.png,https://derpicdn.net/img/view/2015/5/9/891965.png,0,0.9951779842376708,177,208,1007,1038,830,830,twilight sparkle,notenoughapples
896323.png,https://derpicdn.net/img/view/2015/5/15/896323.png,0,0.9272651076316832,71,44,1183,1156,1112,1112,twilight sparkle,amphoera
896475.png,https://derpicdn.net/img/view/2015/5/15/896475.png,0,0.9197817444801332,450,188,1028,766,578,578,twilight sparkle,dreamscapevalley
898439.jpg,https://derpicdn.net/img/view/2015/5/17/898439.jpg,0,0.961037814617157,4,0,661,814,657,814,twilight sparkle,rocy canvas
899060.png,https://derpicdn.net/img/view/2015/5/18/899060.png,0,0.9826200604438782,53,0,1277,1113,1224,1113,twilight sparkle,silverfox057
904509.png,https://derpicdn.net/img/view/2015/5/26/904509.png,0,0.9430413246154784,42,0,398,318,356,318,twilight sparkle,youhoujou
904510.png,https://derpicdn.net/img/view/2015/5/26/904510.png,0,0.9424667358398438,40,0,400,318,360,318,twilight sparkle,youhoujou
904511.png,https://derpicdn.net/img/view/2015/5/26/904511.png,0,0.9509578943252563,45,0,397,314,352,314,twilight sparkle,youhoujou
905427.png,https://derpicdn.net/img/view/2015/5/28/905427.png,0,0.9144895672798156,16,0,230,205,214,205,twilight sparkle,lulubell
905769.png,https://derpicdn.net/img/view/2015/5/28/905769.png,0,0.9981752038002014,24,39,432,447,408,408,twilight sparkle,tiffanymarsou
908055.png,https://derpicdn.net/img/view/2015/6/1/908055.png,0,0.9756076335906982,956,0,1978,1037,1022,1037,twilight sparkle,davidsfire
908179.png,https://derpicdn.net/img/view/2015/6/1/908179.png,0,0.9781651496887208,123,0,745,609,622,609,twilight sparkle,silbersternenlicht
910824.png,https://derpicdn.net/img/view/2015/6/5/910824.png,0,0.987820327281952,1554,560,2748,1754,1194,1194,twilight sparkle,xwhitedreamsx
911083.png,https://derpicdn.net/img/view/2015/6/6/911083.png,0,0.9900885224342346,736,25,2924,2213,2188,2188,twilight sparkle,kp-shadowsquirrel|illumnious
911833.png,https://derpicdn.net/img/view/2015/6/6/911833.png,0,0.9993306994438172,292,0,1864,1537,1572,1537,twilight sparkle,a4r91n
912772.png,https://derpicdn.net/img/view/2015/6/8/912772.png,0,0.9231461882591248,516,0,828,297,312,297,twilight sparkle,silverscarf
914772.png,https://derpicdn.net/img/view/2015/6/11/914772.png,0,0.9861391186714172,174,0,808,623,634,623,twilight sparkle,dambitail
915190.png,https://derpicdn.net/img/view/2015/6/12/915190.png,0,0.9959654211997986,195,75,563,443,368,368,twilight sparkle,luciferamon
916996.png,https://derpicdn.net/img/view/2015/6/14/916996.png,0,0.9777299165725708,132,1294,1454,2616,1322,1322,twilight sparkle,radiantrealm
917511.png,https://derpicdn.net/img/view/2015/6/15/917511.png,0,0.9965065717697144,462,16,970,524,508,508,twilight sparkle,jellybeanbullet
919799.png,https://derpicdn.net/img/view/2015/6/19/919799.png,0,0.949163019657135,59,77,775,793,716,716,twilight sparkle,stepandy|fonypony
921144.png,https://derpicdn.net/img/view/2015/6/21/921144.png,0,0.94549822807312,812,240,1892,1320,1080,1080,twilight sparkle,beamsaber
924026.png,https://derpicdn.net/img/view/2015/6/26/924026.png,0,0.9982893466949464,1447,118,3000,1752,1553,1634,twilight sparkle,scourge707
924869.png,https://derpicdn.net/img/view/2015/6/27/924869.png,0,0.9827315807342528,335,120,799,584,464,464,twilight sparkle,mattsykun
926848.png,https://derpicdn.net/img/view/2015/6/30/926848.png,0,0.9767197370529176,0,59,4109,4593,4109,4534,twilight sparkle,joemasterpencil
929542.png,https://derpicdn.net/img/view/2015/7/4/929542.png,0,0.9585429430007936,73,0,671,565,598,565,twilight sparkle,umeguru
929887.jpg,https://derpicdn.net/img/view/2015/7/4/929887.jpg,0,0.994350254535675,0,0,461,422,461,422,twilight sparkle,tyuubatu
931278.png,https://derpicdn.net/img/view/2015/7/6/931278.png,0,0.9047657251358032,3380,314,6000,3058,2620,2744,twilight sparkle,slb94
933171.png,https://derpicdn.net/img/view/2015/7/9/933171.png,0,0.9625327587127686,667,271,1047,651,380,380,twilight sparkle,xshanika
933418.png,https://derpicdn.net/img/view/2015/7/9/933418.png,0,0.9132952690124512,2020,0,3200,1165,1180,1165,twilight sparkle,facelesssoles
934249.png,https://derpicdn.net/img/view/2015/7/10/934249.png,0,0.9959336519241332,830,163,1480,813,650,650,twilight sparkle,raikoh
934379.png,https://derpicdn.net/img/view/2015/7/10/934379.png,0,0.9402608275413512,1058,0,2254,1144,1196,1144,twilight sparkle,potzm
935372.png,https://derpicdn.net/img/view/2015/7/12/935372.png,0,0.9120520949363708,3335,298,6000,3090,2665,2792,twilight sparkle,slb94
937096.png,https://derpicdn.net/img/view/2015/7/14/937096.png,0,0.9987459182739258,0,0,482,480,482,480,twilight sparkle,uncertainstardust
937398.png,https://derpicdn.net/img/view/2015/7/15/937398.png,0,0.987997829914093,56,64,468,476,412,412,twilight sparkle,king-kakapo
9376.jpg,https://derpicdn.net/img/view/2012/6/19/9376.jpg,0,0.9954700469970704,56,344,878,1166,822,822,twilight sparkle,zev|skutchi
940432.png,https://derpicdn.net/img/view/2015/7/20/940432.png,0,0.9902406930923462,906,819,5722,5807,4816,4988,twilight sparkle,the-aziz
941416.png,https://derpicdn.net/img/view/2015/7/22/941416.png,0,0.9891800880432128,75,0,331,255,256,255,twilight sparkle,lulubell
945022.jpg,https://derpicdn.net/img/view/2015/7/27/945022.jpg,0,0.92730450630188,1263,1102,2151,1990,888,888,twilight sparkle,greyscaleart
947055.png,https://derpicdn.net/img/view/2015/7/30/947055.png,0,0.9983844161033628,838,198,1642,1002,804,804,twilight sparkle,ohemo
947437.png,https://derpicdn.net/img/view/2015/7/30/947437.png,0,0.9169684052467346,567,41,1721,1195,1154,1154,twilight sparkle,locksto
948182.png,https://derpicdn.net/img/view/2015/8/1/948182.png,0,0.9486085176467896,200,58,820,678,620,620,twilight sparkle,potzm
952527.png,https://derpicdn.net/img/view/2015/8/6/952527.png,0,0.9295409917831421,73,0,477,395,404,395,twilight sparkle,dilandau203
953607.png,https://derpicdn.net/img/view/2015/8/8/953607.png,0,0.9822072386741638,53,0,567,505,514,505,twilight sparkle,puchiko
954255.png,https://derpicdn.net/img/view/2015/8/9/954255.png,0,0.9232308268547058,728,0,1280,471,552,471,twilight sparkle,wolftendragon
954371.jpg,https://derpicdn.net/img/view/2015/8/9/954371.jpg,0,0.9904447793960572,475,154,1405,1084,930,930,twilight sparkle,mrs1989
961068.png,https://derpicdn.net/img/view/2015/8/19/961068.png,0,0.9675490260124208,0,147,888,1100,888,953,twilight sparkle,sion-ara
961817.jpg,https://derpicdn.net/img/view/2015/8/20/961817.jpg,0,0.9933143854141236,1083,46,1869,832,786,786,twilight sparkle,tatemil
965319.png,https://derpicdn.net/img/view/2015/8/25/965319.png,0,0.9860205054283142,139,25,477,363,338,338,twilight sparkle,trishabeakens
966728.png,https://derpicdn.net/img/view/2015/8/27/966728.png,0,0.9154343008995056,134,0,310,175,176,175,twilight sparkle,hawthornss
968310.png,https://derpicdn.net/img/view/2015/8/29/968310.png,0,0.9647336006164552,556,26,1024,508,468,482,twilight sparkle,
969056.png,https://derpicdn.net/img/view/2015/8/30/969056.png,0,0.9932487010955808,499,0,2439,1867,1940,1867,twilight sparkle,glitchking123
969088.png,https://derpicdn.net/img/view/2015/8/30/969088.png,0,0.9704391956329346,187,0,685,495,498,495,twilight sparkle,silbersternenlicht
969197.png,https://derpicdn.net/img/view/2015/8/30/969197.png,0,0.9930688738822936,1258,0,3000,1722,1742,1722,twilight sparkle,poniesplease
972568.png,https://derpicdn.net/img/view/2015/9/4/972568.png,0,0.9952558875083924,394,0,748,345,354,345,twilight sparkle,raptor007
973065.jpg,https://derpicdn.net/img/view/2015/9/5/973065.jpg,0,0.9313335418701172,64,54,398,388,334,334,twilight sparkle,rt
974315.jpg,https://derpicdn.net/img/view/2015/9/7/974315.jpg,0,0.9993343949317932,0,29,1130,1323,1130,1294,twilight sparkle,cynux
975430.png,https://derpicdn.net/img/view/2015/9/8/975430.png,0,0.9766578078269958,290,0,776,468,486,468,twilight sparkle,lunartails
975640.png,https://derpicdn.net/img/view/2015/9/8/975640.png,0,0.9963407516479492,178,0,672,485,494,485,twilight sparkle,flyingbrickanimation|kilo
978434.png,https://derpicdn.net/img/view/2015/9/12/978434.png,0,0.9913309216499328,595,382,915,702,320,320,twilight sparkle,9de-light6
980538.png,https://derpicdn.net/img/view/2015/9/15/980538.png,0,0.9732773303985596,323,272,3143,3134,2820,2862,twilight sparkle,v0jelly
983885.png,https://derpicdn.net/img/view/2015/9/20/983885.png,0,0.9779709577560424,634,45,3688,3395,3054,3350,twilight sparkle,santafer
986130.png,https://derpicdn.net/img/view/2015/9/23/986130.png,0,0.9978814125061036,0,0,351,339,351,339,twilight sparkle,
986153.jpg,https://derpicdn.net/img/view/2015/9/23/986153.jpg,0,0.9947951436042786,557,0,1531,960,974,960,twilight sparkle,girlsay
987800.jpg,https://derpicdn.net/img/view/2015/9/26/987800.jpg,0,0.964508593082428,733,2,1383,652,650,650,twilight sparkle,astralispl
990005.png,https://derpicdn.net/img/view/2015/9/28/990005.png,0,0.9932267069816588,2058,87,5302,3331,3244,3244,twilight sparkle,slb94
994146.jpg,https://derpicdn.net/img/view/2015/10/4/994146.jpg,0,0.96602201461792,0,0,493,360,493,360,twilight sparkle,
996236.png,https://derpicdn.net/img/view/2015/10/7/996236.png,0,0.99162095785141,111,59,841,789,730,730,twilight sparkle,thecheeseburger
996393.png,https://derpicdn.net/img/view/2015/10/7/996393.png,0,0.9949226379394532,825,144,1585,904,760,760,twilight sparkle,vulpessentia|crutonart
998029.png,https://derpicdn.net/img/view/2015/10/9/998029.png,0,0.9415898323059082,237,0,1731,1080,1494,1080,twilight sparkle,star-lightstarbright
999412.png,https://derpicdn.net/img/view/2015/10/11/999412.png,0,0.9972025752067566,533,379,1477,1323,944,944,twilight sparkle,dfectivedvice|whazzam95
1000018.jpg,https://derpicdn.net/img/view/2015/10/11/1000018.jpg,0,0.9930638670921326,0,0,777,860,777,860,twilight sparkle,
1000275.jpg,https://derpicdn.net/img/view/2015/10/12/1000275.jpg,0,0.9670870900154114,350,0,1110,738,760,738,twilight sparkle,
1005034.png,https://derpicdn.net/img/view/2015/10/18/1005034.png,0,0.9110693335533142,245,0,729,478,484,478,twilight sparkle,blvckmagic
1006488.png,https://derpicdn.net/img/view/2015/10/20/1006488.png,0,0.9751492738723756,0,4,394,420,394,416,twilight sparkle,
1006730.png,https://derpicdn.net/img/view/2015/10/21/1006730.png,0,0.9979995489120485,281,0,2567,2185,2286,2185,twilight sparkle,missgoldendragon
1008148.png,https://derpicdn.net/img/view/2015/10/23/1008148.png,0,0.9058229923248292,2597,39,5389,3005,2792,2966,twilight sparkle,slb94
1008925.png,https://derpicdn.net/img/view/2015/10/24/1008925.png,0,0.9693474173545836,0,0,668,649,668,649,twilight sparkle,1nakir1
1009163.png,https://derpicdn.net/img/view/2015/10/24/1009163.png,0,0.9881306290626526,646,191,1252,797,606,606,twilight sparkle,jeki
1011958.png,https://derpicdn.net/img/view/2015/10/29/1011958.png,0,0.9212119579315186,1554,113,3998,2557,2444,2444,twilight sparkle,missgoldendragon|yanoda
1013050.png,https://derpicdn.net/img/view/2015/10/31/1013050.png,0,0.9996159076690674,220,7,478,265,258,258,twilight sparkle,canime
1014023.png,https://derpicdn.net/img/view/2015/11/1/1014023.png,0,0.9811496734619141,522,107,1126,771,604,664,twilight sparkle,php92
1017382.png,https://derpicdn.net/img/view/2015/11/6/1017382.png,0,0.9943963289260864,0,0,903,944,903,944,twilight sparkle,davidsfire
1017387.png,https://derpicdn.net/img/view/2015/11/6/1017387.png,0,0.967033326625824,18,11,932,925,914,914,twilight sparkle,davidsfire
1017461.png,https://derpicdn.net/img/view/2015/11/6/1017461.png,0,0.9904152750968932,453,349,945,841,492,492,twilight sparkle,myralilth
1018944.png,https://derpicdn.net/img/view/2015/11/8/1018944.png,0,0.9994866847991944,2261,0,4249,2043,1988,2043,twilight sparkle,djdavid98
1019012.png,https://derpicdn.net/img/view/2015/11/8/1019012.png,0,0.931576669216156,0,0,697,664,697,664,twilight sparkle,snowolive
1019035.png,https://derpicdn.net/img/view/2015/11/8/1019035.png,0,0.9883188009262084,973,0,3527,2545,2554,2545,twilight sparkle,slb94
1019643.png,https://derpicdn.net/img/view/2015/11/9/1019643.png,0,0.9136943221092224,1823,44,1975,226,152,182,twilight sparkle,zutheskunk edits|krusiu42|eagle1division
1020934.png,https://derpicdn.net/img/view/2015/11/11/1020934.png,0,0.9623942375183104,661,1945,2725,4009,2064,2064,twilight sparkle,falcotte
1021021.png,https://derpicdn.net/img/view/2015/11/11/1021021.png,0,0.9960184693336488,2447,0,5081,2702,2634,2702,twilight sparkle,slb94
1022283.png,https://derpicdn.net/img/view/2015/11/13/1022283.png,0,0.9934460520744324,1759,608,2719,1568,960,960,twilight sparkle,a4r91n
1023025.png,https://derpicdn.net/img/view/2015/11/15/1023025.png,0,0.968274474143982,13,2,540,530,527,528,twilight sparkle,coggler|frog&cog|gopherfrog
1027199.png,https://derpicdn.net/img/view/2015/11/21/1027199.png,0,0.9991294145584106,443,65,1177,799,734,734,twilight sparkle,girorogirl
1028908.png,https://derpicdn.net/img/view/2015/11/23/1028908.png,0,0.9982452392578124,885,0,1805,920,920,920,twilight sparkle,pon8d
1029728.png,https://derpicdn.net/img/view/2015/11/25/1029728.png,0,0.9896899461746216,3597,0,7903,4181,4306,4181,twilight sparkle,luckreza8
1029821.png,https://derpicdn.net/img/view/2015/11/25/1029821.png,0,0.9427655935287476,18,0,392,358,374,358,twilight sparkle,lulubell
1030324.png,https://derpicdn.net/img/view/2015/11/26/1030324.png,0,0.9518128633499146,1949,2013,2495,2559,546,546,twilight sparkle,pridark
1030574.png,https://derpicdn.net/img/view/2015/11/26/1030574.png,0,0.9278748631477356,459,251,893,685,434,434,twilight sparkle,jubileeglider|dfectivedvice
1033843.png,https://derpicdn.net/img/view/2015/11/30/1033843.png,0,0.9888575673103333,522,82,998,558,476,476,twilight sparkle,pinkiesheen
1035099.png,https://derpicdn.net/img/view/2015/12/2/1035099.png,0,0.9668527841567992,95,11,571,487,476,476,twilight sparkle,lightningnickel
1035270.png,https://derpicdn.net/img/view/2015/12/2/1035270.png,0,0.9706363081932068,0,0,589,676,589,676,twilight sparkle,jittery-the-dragon
1035846.png,https://derpicdn.net/img/view/2015/12/3/1035846.png,0,0.9824607968330384,280,0,1904,1576,1624,1576,twilight sparkle,aurelleah
1036427.png,https://derpicdn.net/img/view/2015/12/4/1036427.png,0,0.989720344543457,151,17,841,707,690,690,twilight sparkle,girorogirl
1036806.png,https://derpicdn.net/img/view/2015/12/4/1036806.png,0,0.954495906829834,536,545,6206,6373,5670,5828,twilight sparkle,osipush
1039755.png,https://derpicdn.net/img/view/2015/12/8/1039755.png,0,0.920238733291626,69,47,539,517,470,470,twilight sparkle,loyaldis
1040394.png,https://derpicdn.net/img/view/2015/12/9/1040394.png,0,0.992428183555603,418,53,958,593,540,540,twilight sparkle,vanillafox2035
1043126.png,https://derpicdn.net/img/view/2015/12/13/1043126.png,0,0.9755582809448242,1346,1334,2540,2528,1194,1194,twilight sparkle,osipush
1043443.png,https://derpicdn.net/img/view/2015/12/13/1043443.png,0,0.999183475971222,950,702,1870,1622,920,920,twilight sparkle,alexdealey
1047366.png,https://derpicdn.net/img/view/2015/12/19/1047366.png,0,0.9974998235702516,100,0,776,637,676,637,twilight sparkle,calliexsunshine
1049208.png,https://derpicdn.net/img/view/2015/12/20/1049208.png,0,0.9946703910827636,434,108,1084,758,650,650,twilight sparkle,blup-chan
1049941.png,https://derpicdn.net/img/view/2015/12/21/1049941.png,0,0.9929860830307008,146,18,822,694,676,676,twilight sparkle,mlp-firefox5013
1053025.png,https://derpicdn.net/img/view/2015/12/26/1053025.png,0,0.9994983673095704,3066,0,5868,2772,2802,2772,twilight sparkle,90sigma
1053068.png,https://derpicdn.net/img/view/2015/12/26/1053068.png,0,0.9969638586044312,729,0,2155,1317,1426,1317,twilight sparkle,mrfremen
1053140.png,https://derpicdn.net/img/view/2015/12/26/1053140.png,0,0.9976796507835388,163,25,1113,975,950,950,twilight sparkle,oinktweetstudios
1054638.png,https://derpicdn.net/img/view/2015/12/28/1054638.png,0,0.9940534234046936,1223,1380,2395,2552,1172,1172,twilight sparkle,ask-bluehorizon
1056060.png,https://derpicdn.net/img/view/2015/12/30/1056060.png,2,0.984296441078186,1260,497,1730,967,470,470,twilight sparkle,mr-tiaa
1057692.png,https://derpicdn.net/img/view/2016/1/2/1057692.png,0,0.9829261898994446,0,0,353,351,353,351,twilight sparkle,phyllismi
1060359.png,https://derpicdn.net/img/view/2016/1/5/1060359.png,0,0.9984129667282104,912,0,2142,1095,1230,1095,twilight sparkle,
1060934.png,https://derpicdn.net/img/view/2016/1/6/1060934.png,0,0.9854596853256226,0,0,308,303,308,303,twilight sparkle,fizzy-dog
1062854.png,https://derpicdn.net/img/view/2016/1/9/1062854.png,0,0.9694039225578308,519,2,925,408,406,406,twilight sparkle,jeshh
1065602.png,https://derpicdn.net/img/view/2016/1/13/1065602.png,0,0.989076554775238,22,58,346,382,324,324,twilight sparkle,nobody
1065878.png,https://derpicdn.net/img/view/2016/1/13/1065878.png,0,0.9946938753128052,96,58,506,468,410,410,twilight sparkle,ryuredwings
1067046.png,https://derpicdn.net/img/view/2016/1/15/1067046.png,0,0.9845917224884032,0,0,382,382,382,382,twilight sparkle,28gooddays
1067421.jpg,https://derpicdn.net/img/view/2016/1/16/1067421.jpg,0,0.980872631072998,5,0,583,539,578,539,twilight sparkle,girorogirl
1067748.png,https://derpicdn.net/img/view/2016/1/16/1067748.png,0,0.9768719673156738,667,248,1123,704,456,456,twilight sparkle,shellydreams
1068034.png,https://derpicdn.net/img/view/2016/1/17/1068034.png,0,0.9864622354507446,446,0,1012,565,566,565,twilight sparkle,miss-cats
1070415.png,https://derpicdn.net/img/view/2016/1/20/1070415.png,0,0.9786359071731568,182,0,1240,1042,1058,1042,twilight sparkle,thealjavis
1076322.png,https://derpicdn.net/img/view/2016/1/30/1076322.png,0,0.9380807876586914,182,91,746,655,564,564,twilight sparkle,sharmie
1078628.png,https://derpicdn.net/img/view/2016/2/2/1078628.png,0,0.9860969781875608,1249,248,2825,1824,1576,1576,twilight sparkle,tsand106
1079386.jpg,https://derpicdn.net/img/view/2016/2/3/1079386.jpg,0,0.9976770877838136,25,0,289,246,264,246,twilight sparkle,yukimaki
1080983.png,https://derpicdn.net/img/view/2016/2/5/1080983.png,0,0.9966205358505248,0,0,694,701,694,701,twilight sparkle,lupulrafinat
1081411.jpg,https://derpicdn.net/img/view/2016/2/6/1081411.jpg,0,0.9563661217689514,106,36,1063,1004,957,968,twilight sparkle,edrian
1081659.png,https://derpicdn.net/img/view/2016/2/6/1081659.png,0,0.9995245337486268,278,0,736,418,458,418,twilight sparkle,wonton soup
1084272.png,https://derpicdn.net/img/view/2016/2/10/1084272.png,0,0.9976755976676941,51,0,699,637,648,637,twilight sparkle,digiqrow
1085701.png,https://derpicdn.net/img/view/2016/2/11/1085701.png,0,0.9983610510826112,450,286,1560,1396,1110,1110,twilight sparkle,holiday252
1087084.png,https://derpicdn.net/img/view/2016/2/13/1087084.png,0,0.964033305644989,0,48,545,622,545,574,twilight sparkle,justisanimation
1090612.png,https://derpicdn.net/img/view/2016/2/17/1090612.png,0,0.951904296875,1652,102,5151,3782,3499,3680,twilight sparkle,speedox12
1098120.png,https://derpicdn.net/img/view/2016/2/27/1098120.png,0,0.9954352378845216,312,69,628,385,316,316,twilight sparkle,szafir87
1099402.png,https://derpicdn.net/img/view/2016/2/29/1099402.png,0,0.9860525727272034,279,0,569,289,290,289,twilight sparkle,divided-s
1099755.png,https://derpicdn.net/img/view/2016/3/1/1099755.png,0,0.946748912334442,833,0,1846,1110,1013,1110,twilight sparkle,sketchmcreations
1100872.jpg,https://derpicdn.net/img/view/2016/3/3/1100872.jpg,0,0.9501855373382568,63,51,605,593,542,542,twilight sparkle,leslers
1103889.jpg,https://derpicdn.net/img/view/2016/3/7/1103889.jpg,0,0.9243870973587036,1007,229,1599,821,592,592,twilight sparkle,karl97|probablyfakeblonde|gray-gold
1105004.png,https://derpicdn.net/img/view/2016/3/8/1105004.png,0,0.9543831348419192,241,137,2383,2279,2142,2142,twilight sparkle,lunarina
1109252.png,https://derpicdn.net/img/view/2016/3/15/1109252.png,0,0.9951746463775636,289,105,589,405,300,300,twilight sparkle,wangkingfun
1109545.png,https://derpicdn.net/img/view/2016/3/15/1109545.png,0,0.949881374835968,1248,0,4199,3666,2951,3666,twilight sparkle,itv-canterlot
1111362.png,https://derpicdn.net/img/view/2016/3/18/1111362.png,0,0.9960282444953918,3576,0,5858,2179,2282,2179,twilight sparkle,lil miss jay|slb94
1111895.png,https://derpicdn.net/img/view/2016/3/18/1111895.png,0,0.9857091307640076,949,493,1329,873,380,380,twilight sparkle,jawolfadultishart
1112070.png,https://derpicdn.net/img/view/2016/3/19/1112070.png,0,0.9924232363700868,0,0,262,264,262,264,twilight sparkle,raspberry-wings
111689.png,https://derpicdn.net/img/view/2012/10/2/111689.png,0,0.9984798431396484,442,340,1014,912,572,572,twilight sparkle,purplekecleon
1120540.jpg,https://derpicdn.net/img/view/2016/3/30/1120540.jpg,0,0.9494155049324036,1457,60,2963,1566,1506,1506,twilight sparkle,claudiaqh
1120620.png,https://derpicdn.net/img/view/2016/3/30/1120620.png,0,0.9748211503028872,559,33,771,245,212,212,twilight sparkle,cider
1122281.png,https://derpicdn.net/img/view/2016/4/2/1122281.png,0,0.9870948791503906,0,0,182,167,182,167,twilight sparkle,
1124251.jpg,https://derpicdn.net/img/view/2016/4/4/1124251.jpg,0,0.9913842678070068,30,0,592,535,562,535,twilight sparkle,91o42
1126823.png,https://derpicdn.net/img/view/2016/4/7/1126823.png,0,0.9798023700714112,306,24,1420,1138,1114,1114,twilight sparkle,soulfulmirror
1129589.png,https://derpicdn.net/img/view/2016/4/11/1129589.png,0,0.9994893074035645,0,106,2409,2850,2409,2744,twilight sparkle,slb94
1132044.png,https://derpicdn.net/img/view/2016/4/14/1132044.png,0,0.9944906234741212,1046,0,1978,904,932,904,twilight sparkle,pananovich|dfectivedvice
1132560.jpg,https://derpicdn.net/img/view/2016/4/15/1132560.jpg,0,0.9412783980369568,69,23,943,897,874,874,twilight sparkle,incmyk
113378.png,https://derpicdn.net/img/view/2012/10/4/113378.png,0,0.9416229724884032,234,123,614,503,380,380,twilight sparkle,starshinebeast
1134105.png,https://derpicdn.net/img/view/2016/4/17/1134105.png,0,0.992936074733734,222,106,1092,976,870,870,twilight sparkle,vincher
1138280.png,https://derpicdn.net/img/view/2016/4/23/1138280.png,0,0.9694690704345704,1459,0,6000,4790,4541,4790,twilight sparkle,eagle1division
1138738.png,https://derpicdn.net/img/view/2016/4/23/1138738.png,0,0.9387453198432922,24,0,1472,1386,1448,1386,twilight sparkle,befishproductions
1141208.png,https://derpicdn.net/img/view/2016/4/27/1141208.png,0,0.9739896059036256,303,25,751,473,448,448,twilight sparkle,livehotsun
1143180.png,https://derpicdn.net/img/view/2016/4/30/1143180.png,0,0.9126864671707152,584,0,1536,910,952,910,twilight sparkle,
1144.png,https://derpicdn.net/img/view/2012/1/22/1144.png,0,0.9891114234924316,959,354,1591,986,632,632,twilight sparkle,madmax
1145191.png,https://derpicdn.net/img/view/2016/5/2/1145191.png,0,0.9973487257957458,2414,0,5372,2903,2958,2903,twilight sparkle,slb94
1146582.png,https://derpicdn.net/img/view/2016/5/4/1146582.png,0,0.9964833855628968,379,203,2785,2609,2406,2406,twilight sparkle,techycutie|asparagusapparatus
1149834.png,https://derpicdn.net/img/view/2016/5/9/1149834.png,0,0.9252303242683412,1013,0,2929,1832,1916,1832,twilight sparkle,scarlet-spectrum
1150091.png,https://derpicdn.net/img/view/2016/5/9/1150091.png,0,0.9968469738960266,552,0,970,387,418,387,twilight sparkle,andyfirelife
1150091.png,https://derpicdn.net/img/view/2016/5/9/1150091.png,1,0.9959036111831664,0,23,437,473,437,450,twilight sparkle,andyfirelife
1150604.png,https://derpicdn.net/img/view/2016/5/10/1150604.png,0,0.9849948287010192,0,0,5292,5623,5292,5623,twilight sparkle,decprincess
1150792.png,https://derpicdn.net/img/view/2016/5/10/1150792.png,1,0.9786590337753296,0,586,364,952,364,366,twilight sparkle,vasillium
1151762.jpg,https://derpicdn.net/img/view/2016/5/11/1151762.jpg,0,0.9915512204170228,380,0,1584,1204,1204,1204,twilight sparkle,thekrispiestkreme
1157344.png,https://derpicdn.net/img/view/2016/5/18/1157344.png,0,0.9750869274139404,0,212,1994,2500,1994,2288,twilight sparkle,bluetech
1158406.png,https://derpicdn.net/img/view/2016/5/20/1158406.png,0,0.9575344324111938,721,0,1920,1189,1199,1189,twilight sparkle,slb94
1160043.png,https://derpicdn.net/img/view/2016/5/22/1160043.png,0,0.9400529265403748,575,11,1043,479,468,468,twilight sparkle,keronianniroro
1160609.png,https://derpicdn.net/img/view/2016/5/22/1160609.png,0,0.9993766546249392,784,0,1776,823,992,823,twilight sparkle,pastelhorses
1161976.jpg,https://derpicdn.net/img/view/2016/5/24/1161976.jpg,0,0.9076979160308838,17,41,293,317,276,276,twilight sparkle,eeviart
1163349.png,https://derpicdn.net/img/view/2016/5/26/1163349.png,0,0.9776405692100524,285,5,1778,1645,1493,1640,twilight sparkle,sketchmcreations
1163397.jpg,https://derpicdn.net/img/view/2016/5/26/1163397.jpg,0,0.9962345957756042,290,70,888,668,598,598,twilight sparkle,calena
1167067.png,https://derpicdn.net/img/view/2016/5/31/1167067.png,0,0.9761936068534852,2979,2898,5231,5150,2252,2252,twilight sparkle,alloutlol
1167092.png,https://derpicdn.net/img/view/2016/5/31/1167092.png,0,0.9372522830963136,0,859,6055,7315,6055,6456,twilight sparkle,tardifice
1169689.png,https://derpicdn.net/img/view/2016/6/4/1169689.png,0,0.9940195083618164,42,8,470,436,428,428,twilight sparkle,fj-c
1170389.png,https://derpicdn.net/img/view/2016/6/4/1170389.png,0,0.9814760684967041,31,61,357,383,326,322,twilight sparkle,
1172844.png,https://derpicdn.net/img/view/2016/6/7/1172844.png,0,0.9787825345993042,53,0,627,566,574,566,twilight sparkle,lustrous-dreams
1172848.png,https://derpicdn.net/img/view/2016/6/7/1172848.png,0,0.9801299571990968,212,0,784,528,572,528,twilight sparkle,lustrous-dreams
1177378.png,https://derpicdn.net/img/view/2016/6/13/1177378.png,0,0.9838452339172364,166,117,1822,1773,1656,1656,twilight sparkle,mlp-mckenna-starling
11780.png,https://derpicdn.net/img/view/2012/6/20/11780.png,0,0.9877738356590272,2470,0,4730,2173,2260,2173,twilight sparkle,jennieoo
1186204.png,https://derpicdn.net/img/view/2016/6/25/1186204.png,0,0.9568948149681092,1078,113,1638,673,560,560,twilight sparkle,halem1991
1191714.png,https://derpicdn.net/img/view/2016/7/2/1191714.png,0,0.9849055409431458,132,57,936,861,804,804,twilight sparkle,despotshy
1192202.png,https://derpicdn.net/img/view/2016/7/3/1192202.png,0,0.983522653579712,720,0,1024,274,304,274,twilight sparkle,phoeberia
1194650.png,https://derpicdn.net/img/view/2016/7/6/1194650.png,0,0.9987994432449341,2234,676,3316,1758,1082,1082,twilight sparkle,kinetic-spectrum
1195035.png,https://derpicdn.net/img/view/2016/7/6/1195035.png,0,0.917738139629364,3530,188,7000,3678,3470,3490,twilight sparkle,tardifice
1195279.png,https://derpicdn.net/img/view/2016/7/7/1195279.png,0,0.9990732669830322,375,66,863,554,488,488,twilight sparkle,pabbley
1195913.png,https://derpicdn.net/img/view/2016/7/8/1195913.png,0,0.9667266011238098,459,9,3361,2997,2902,2988,twilight sparkle,slb94
1196473.png,https://derpicdn.net/img/view/2016/7/8/1196473.png,0,0.9690402150154114,685,419,2480,2441,1795,2022,twilight sparkle,rainbowjune
1198479.png,https://derpicdn.net/img/view/2016/7/11/1198479.png,0,0.9693788886070251,355,111,919,675,564,564,twilight sparkle,rulsis
1199362.png,https://derpicdn.net/img/view/2016/7/12/1199362.png,0,0.9889686703681946,429,0,1191,683,762,683,twilight sparkle,deathpwny
1205470.png,https://derpicdn.net/img/view/2016/7/20/1205470.png,0,0.9898138046264648,180,52,434,306,254,254,twilight sparkle,yuyusunshine
1206038.png,https://derpicdn.net/img/view/2016/7/21/1206038.png,0,0.9607261419296264,0,0,2697,3021,2697,3021,twilight sparkle,freak0uo
1209218.png,https://derpicdn.net/img/view/2016/7/25/1209218.png,0,0.9904912114143372,24,0,608,543,584,543,twilight sparkle,xbi
1211179.png,https://derpicdn.net/img/view/2016/7/28/1211179.png,0,0.9976314306259156,956,0,2000,1046,1044,1046,twilight sparkle,thecreativerey
1221974.png,https://derpicdn.net/img/view/2016/8/10/1221974.png,0,0.9133132696151732,1279,194,3753,2668,2474,2474,twilight sparkle,korsoo
1222538.png,https://derpicdn.net/img/view/2016/8/11/1222538.png,0,0.983718752861023,0,17,974,1091,974,1074,twilight sparkle,pastelhorses
1223733.png,https://derpicdn.net/img/view/2016/8/13/1223733.png,0,0.9742777347564696,0,0,630,615,630,615,twilight sparkle,musicfirewind
1224176.png,https://derpicdn.net/img/view/2016/8/13/1224176.png,0,0.9950752854347228,181,56,1021,896,840,840,twilight sparkle,exceru-karina
1226243.png,https://derpicdn.net/img/view/2016/8/16/1226243.png,0,0.9615482091903688,61,0,695,616,634,616,twilight sparkle,thatcasualbrony
1226837.png,https://derpicdn.net/img/view/2016/8/16/1226837.png,0,0.9654962420463562,328,159,680,511,352,352,twilight sparkle,yuyusunshine
1228515.png,https://derpicdn.net/img/view/2016/8/19/1228515.png,0,0.9724974632263184,1,0,441,430,440,430,twilight sparkle,mococo
1229752.png,https://derpicdn.net/img/view/2016/8/20/1229752.png,0,0.9794960618019104,42,0,498,459,456,459,twilight sparkle,
1230274.png,https://derpicdn.net/img/view/2016/8/21/1230274.png,0,0.9607830643653872,0,915,5209,6180,5209,5265,twilight sparkle,pink1ejack
1233313.png,https://derpicdn.net/img/view/2016/8/25/1233313.png,0,0.9872381091117859,0,0,635,651,635,651,twilight sparkle,kinda-l
1235866.png,https://derpicdn.net/img/view/2016/8/28/1235866.png,0,0.9882819056510924,0,0,913,906,913,906,twilight sparkle,the1xeno1
1236001.png,https://derpicdn.net/img/view/2016/8/28/1236001.png,0,0.9109079837799072,923,34,1805,916,882,882,twilight sparkle,majorcooke
123680.png,https://derpicdn.net/img/view/2012/10/15/123680.png,0,0.9911240339279176,0,0,228,236,228,236,twilight sparkle,darkpandax
1239227.png,https://derpicdn.net/img/view/2016/9/1/1239227.png,0,0.9854221343994141,0,63,1442,1741,1442,1678,twilight sparkle,theclassicthinker
1242866.png,https://derpicdn.net/img/view/2016/9/6/1242866.png,0,0.9894708395004272,179,0,819,633,640,633,twilight sparkle,zogzor
1243218.png,https://derpicdn.net/img/view/2016/9/6/1243218.png,0,0.9479542970657348,0,0,8763,11507,8763,11507,twilight sparkle,cyanlightning
1244811.png,https://derpicdn.net/img/view/2016/9/8/1244811.png,0,0.996397078037262,493,0,3095,2584,2602,2584,twilight sparkle,scarletskitty12
1246030.png,https://derpicdn.net/img/view/2016/9/10/1246030.png,0,0.9974066019058228,139,15,439,315,300,300,twilight sparkle,kukseleg
1249439.png,https://derpicdn.net/img/view/2016/9/14/1249439.png,0,0.9854491353034972,731,24,1155,448,424,424,twilight sparkle,acesrockz
1249439.png,https://derpicdn.net/img/view/2016/9/14/1249439.png,1,0.9791869521141052,0,176,386,578,386,402,twilight sparkle,acesrockz
1252849.png,https://derpicdn.net/img/view/2016/9/19/1252849.png,0,0.9371768832206726,417,0,787,304,370,304,twilight sparkle,hyperwave9000
1255808.png,https://derpicdn.net/img/view/2016/9/22/1255808.png,0,0.9987613558769226,49,36,615,602,566,566,twilight sparkle,strangiesleepy
1257210.png,https://derpicdn.net/img/view/2016/9/24/1257210.png,0,0.9750043153762816,0,0,673,628,673,628,twilight sparkle,cowsrtasty
1257413.png,https://derpicdn.net/img/view/2016/9/24/1257413.png,0,0.92879056930542,424,278,6006,5860,5582,5582,twilight sparkle,pink1ejack
1258078.png,https://derpicdn.net/img/view/2016/9/25/1258078.png,0,0.993840217590332,100,20,1332,1252,1232,1232,twilight sparkle,sketchmcreations
1262098.png,https://derpicdn.net/img/view/2016/10/1/1262098.png,0,0.9981834888458252,1414,11,2260,857,846,846,twilight sparkle,geraritydevillefort
1264293.png,https://derpicdn.net/img/view/2016/10/3/1264293.png,0,0.9778355956077576,994,173,1992,1171,998,998,twilight sparkle,vasillium
1264501.png,https://derpicdn.net/img/view/2016/10/4/1264501.png,1,0.9911218881607056,1081,2001,2217,3137,1136,1136,twilight sparkle,wizardski
1264501.png,https://derpicdn.net/img/view/2016/10/4/1264501.png,2,0.9629237651824952,247,2222,1115,3090,868,868,twilight sparkle,wizardski
1265324.png,https://derpicdn.net/img/view/2016/10/5/1265324.png,0,0.9855148196220398,1130,0,2516,1464,1386,1464,twilight sparkle,sketchmcreations
1265640.png,https://derpicdn.net/img/view/2016/10/5/1265640.png,0,0.9745374917984008,0,6,614,698,614,692,twilight sparkle,
1266174.png,https://derpicdn.net/img/view/2016/10/6/1266174.png,0,0.9918335676193236,0,90,1469,1576,1469,1486,twilight sparkle,eagle1division
1267176.png,https://derpicdn.net/img/view/2016/10/7/1267176.png,0,0.9862391352653505,400,312,1642,1554,1242,1242,twilight sparkle,yaaaco
1275726.png,https://derpicdn.net/img/view/2016/10/18/1275726.png,0,0.9985128045082092,2559,0,5247,2566,2688,2566,twilight sparkle,slb94
1277377.png,https://derpicdn.net/img/view/2016/10/20/1277377.png,0,0.968219757080078,708,118,3376,2786,2668,2668,twilight sparkle,sketchmcreations
1277488.png,https://derpicdn.net/img/view/2016/10/20/1277488.png,0,0.9760608673095704,93,509,3369,3825,3276,3316,twilight sparkle,sketchmcreations
1278112.png,https://derpicdn.net/img/view/2016/10/21/1278112.png,0,0.9748331308364868,1654,106,3916,2418,2262,2312,twilight sparkle,sketchmcreations
1281419.png,https://derpicdn.net/img/view/2016/10/25/1281419.png,0,0.9841870069503784,0,297,160,471,160,174,twilight sparkle,
1282038.png,https://derpicdn.net/img/view/2016/10/26/1282038.png,0,0.9253484606742859,208,52,740,584,532,532,twilight sparkle,bloodorangepancakes
1285996.png,https://derpicdn.net/img/view/2016/11/1/1285996.png,0,0.9913177490234376,137,0,403,257,266,257,twilight sparkle,lulubell
1288472.png,https://derpicdn.net/img/view/2016/11/4/1288472.png,0,0.988588571548462,228,0,3050,2695,2822,2695,twilight sparkle,dashiesparkle
1288923.png,https://derpicdn.net/img/view/2016/11/5/1288923.png,0,0.987947642803192,41,0,389,337,348,337,twilight sparkle,
1289665.png,https://derpicdn.net/img/view/2016/11/6/1289665.png,0,0.9612221717834472,221,667,3459,4000,3238,3333,twilight sparkle,slb94
1290935.png,https://derpicdn.net/img/view/2016/11/7/1290935.png,0,0.9574046730995178,366,777,1122,1533,756,756,twilight sparkle,sparkiss-pony
1293559.png,https://derpicdn.net/img/view/2016/11/11/1293559.png,0,0.9404274821281432,152,43,826,717,674,674,twilight sparkle,loladotz
1295458.png,https://derpicdn.net/img/view/2016/11/14/1295458.png,0,0.998661458492279,777,9,1667,981,890,972,twilight sparkle,spellboundcanvas
129952.png,https://derpicdn.net/img/view/2012/10/22/129952.png,0,0.9760254621505736,249,13,415,179,166,166,twilight sparkle,ctulhu666
1301818.png,https://derpicdn.net/img/view/2016/11/23/1301818.png,0,0.9970963001251221,540,0,3536,2857,2996,2857,twilight sparkle,yanoda|deratrox
1302569.png,https://derpicdn.net/img/view/2016/11/24/1302569.png,0,0.9973378777503968,1008,30,1658,680,650,650,twilight sparkle,sheandog
1303001.png,https://derpicdn.net/img/view/2016/11/25/1303001.png,0,0.9800931215286256,50,31,480,461,430,430,twilight sparkle,palettepony895
1303027.png,https://derpicdn.net/img/view/2016/11/25/1303027.png,0,0.9323552250862122,178,0,1236,851,1058,851,twilight sparkle,davidsfire|sailortrekkie92
1303304.png,https://derpicdn.net/img/view/2016/11/25/1303304.png,0,0.9982305765151978,138,199,706,767,568,568,twilight sparkle,windymils
1303451.png,https://derpicdn.net/img/view/2016/11/25/1303451.png,0,0.9182546138763428,0,0,5081,5123,5081,5123,twilight sparkle,pink1ejack
1304341.png,https://derpicdn.net/img/view/2016/11/27/1304341.png,0,0.993899941444397,2008,287,3398,1677,1390,1390,twilight sparkle,coma392
1306142.png,https://derpicdn.net/img/view/2016/11/29/1306142.png,0,0.967077136039734,144,32,748,636,604,604,twilight sparkle,
1306272.png,https://derpicdn.net/img/view/2016/11/29/1306272.png,0,0.9808816313743592,0,0,612,595,612,595,twilight sparkle,thebosscamacho|blah23z
1307311.png,https://derpicdn.net/img/view/2016/12/1/1307311.png,0,0.9896656274795532,288,35,766,513,478,478,twilight sparkle,daclusia
1308733.png,https://derpicdn.net/img/view/2016/12/3/1308733.png,0,0.9730499982833862,452,0,798,338,346,338,twilight sparkle,lopoddity
1310990.png,https://derpicdn.net/img/view/2016/12/6/1310990.png,0,0.9746607542037964,0,18,800,936,800,918,twilight sparkle,sonikku001
1312145.png,https://derpicdn.net/img/view/2016/12/7/1312145.png,0,0.913726806640625,208,20,1112,924,904,904,twilight sparkle,tamyarts
1315531.png,https://derpicdn.net/img/view/2016/12/12/1315531.png,0,0.9960323572158812,187,0,485,287,298,287,twilight sparkle,lulubell
1321943.png,https://derpicdn.net/img/view/2016/12/21/1321943.png,0,0.9923980832099916,110,123,914,927,804,804,twilight sparkle,shiny-cooler
1322044.png,https://derpicdn.net/img/view/2016/12/21/1322044.png,0,0.9806093573570251,29,0,607,550,578,550,twilight sparkle,
1322183.png,https://derpicdn.net/img/view/2016/12/21/1322183.png,0,0.9265073537826538,133,9,393,269,260,260,twilight sparkle,ashidaru
1326672.png,https://derpicdn.net/img/view/2016/12/28/1326672.png,0,0.9818047285079956,0,22,1300,1366,1300,1344,twilight sparkle,moondreamer16
1329092.png,https://derpicdn.net/img/view/2016/12/31/1329092.png,0,0.9735015034675598,568,126,886,444,318,318,twilight sparkle,
1332049.png,https://derpicdn.net/img/view/2017/1/4/1332049.png,0,0.9806697964668274,77,0,675,590,598,590,twilight sparkle,
1333205.png,https://derpicdn.net/img/view/2017/1/6/1333205.png,0,0.9667185544967652,0,274,10052,11476,10052,11202,twilight sparkle,cyanlightning
1333483.png,https://derpicdn.net/img/view/2017/1/6/1333483.png,0,0.9043487906455994,551,287,849,585,298,298,twilight sparkle,zilleniose-chu
1338168.png,https://derpicdn.net/img/view/2017/1/12/1338168.png,0,0.9946596026420592,482,0,1400,806,918,806,twilight sparkle,drakesparkle44|dashiesparkle
1339229.png,https://derpicdn.net/img/view/2017/1/14/1339229.png,0,0.9946810603141784,6,0,682,645,676,645,twilight sparkle,stacyhirano34
1339976.png,https://derpicdn.net/img/view/2017/1/15/1339976.png,0,0.9834873676300048,0,72,2786,2800,2786,2728,twilight sparkle,dbleki
1345589.png,https://derpicdn.net/img/view/2017/1/22/1345589.png,0,0.9854856729507446,150,0,1530,1283,1380,1283,twilight sparkle,marejestic
1346812.png,https://derpicdn.net/img/view/2017/1/24/1346812.png,0,0.9738568067550659,431,19,613,201,182,182,twilight sparkle,asklevee
1347608.png,https://derpicdn.net/img/view/2017/1/25/1347608.png,0,0.9991956949234008,89,82,569,562,480,480,twilight sparkle,marisdoodles
1348827.png,https://derpicdn.net/img/view/2017/1/27/1348827.png,0,0.960524320602417,0,7,469,513,469,506,twilight sparkle,iknowpony
1348842.png,https://derpicdn.net/img/view/2017/1/27/1348842.png,0,0.9947002530097958,446,0,974,521,528,521,twilight sparkle,iknowpony
1350314.png,https://derpicdn.net/img/view/2017/1/29/1350314.png,0,0.9969423413276672,2282,0,4900,2522,2618,2522,twilight sparkle,tomfraggle
1350809.png,https://derpicdn.net/img/view/2017/1/29/1350809.png,0,0.99788635969162,85,0,421,334,336,334,twilight sparkle,
1354252.png,https://derpicdn.net/img/view/2017/2/3/1354252.png,0,0.980209231376648,102,5,654,557,552,552,twilight sparkle,not-ordinary-pony
1355393.png,https://derpicdn.net/img/view/2017/2/5/1355393.png,0,0.99665629863739,97,0,1391,1286,1294,1286,twilight sparkle,cloud-drawings
1356883.png,https://derpicdn.net/img/view/2017/2/6/1356883.png,0,0.982567012310028,0,0,909,1175,909,1175,twilight sparkle,cloudyskie
1357757.png,https://derpicdn.net/img/view/2017/2/8/1357757.png,1,0.9904979467391968,373,0,683,266,310,266,twilight sparkle,flash equestria photography
1366733.png,https://derpicdn.net/img/view/2017/2/18/1366733.png,0,0.997968852519989,729,0,2909,2089,2180,2089,twilight sparkle,huckser
1367796.png,https://derpicdn.net/img/view/2017/2/19/1367796.png,0,0.9991609454154968,608,0,2064,1427,1456,1427,twilight sparkle,cannoncar
1369001.png,https://derpicdn.net/img/view/2017/2/21/1369001.png,0,0.9927972555160522,4394,0,5816,1378,1422,1378,twilight sparkle,scaryjerryrd
1371293.png,https://derpicdn.net/img/view/2017/2/23/1371293.png,0,0.901118814945221,331,167,531,367,200,200,twilight sparkle,sehad
1375771.png,https://derpicdn.net/img/view/2017/2/28/1375771.png,0,0.9886009693145752,656,39,3100,2599,2444,2560,twilight sparkle,ironm17
1377466.png,https://derpicdn.net/img/view/2017/3/2/1377466.png,0,0.9920837879180908,21,150,353,482,332,332,twilight sparkle,little-tweenframes
1377466.png,https://derpicdn.net/img/view/2017/3/2/1377466.png,1,0.9751066565513612,555,68,1037,550,482,482,twilight sparkle,little-tweenframes
1384274.png,https://derpicdn.net/img/view/2017/3/11/1384274.png,0,0.9879400730133056,47,0,2487,2330,2440,2330,twilight sparkle,tomfraggle
1389617.png,https://derpicdn.net/img/view/2017/3/17/1389617.png,0,0.9568321108818054,326,0,1000,688,674,688,twilight sparkle,
1390257.png,https://derpicdn.net/img/view/2017/3/18/1390257.png,0,0.9344346523284912,214,0,700,483,486,483,twilight sparkle,hiltsroxy
1391127.png,https://derpicdn.net/img/view/2017/3/19/1391127.png,0,0.9953919649124146,126,23,564,461,438,438,twilight sparkle,ms-xana
1392018.png,https://derpicdn.net/img/view/2017/3/20/1392018.png,0,0.9987896680831908,261,19,627,385,366,366,twilight sparkle,yuyusunshine
1395719.png,https://derpicdn.net/img/view/2017/3/25/1395719.png,0,0.9985150098800659,65,0,575,507,510,507,twilight sparkle,xkaix2501
1395780.png,https://derpicdn.net/img/view/2017/3/25/1395780.png,0,0.9945222735404968,77,0,699,599,622,599,twilight sparkle,kingdark0001
1397405.png,https://derpicdn.net/img/view/2017/3/27/1397405.png,1,0.9853184819221495,1814,70,2540,796,726,726,twilight sparkle,thebrokencog
1397509.png,https://derpicdn.net/img/view/2017/3/27/1397509.png,0,0.975814938545227,169,19,575,425,406,406,twilight sparkle,zeplich
1399445.png,https://derpicdn.net/img/view/2017/3/30/1399445.png,0,0.9733946919441224,0,291,3519,3906,3519,3615,twilight sparkle,badumsquish
1399495.png,https://derpicdn.net/img/view/2017/3/30/1399495.png,0,0.9881415963172911,187,0,1031,841,844,841,twilight sparkle,pabbley
1403428.png,https://derpicdn.net/img/view/2017/4/3/1403428.png,0,0.9986827373504642,2720,0,6174,3414,3454,3414,twilight sparkle,pink1ejack
1404589.png,https://derpicdn.net/img/view/2017/4/5/1404589.png,0,0.9829184412956238,2875,0,6555,3513,3680,3513,twilight sparkle,luckreza8
1407492.png,https://derpicdn.net/img/view/2017/4/9/1407492.png,0,0.9922946691513062,273,387,1237,1351,964,964,twilight sparkle,wawtoons
1407492.png,https://derpicdn.net/img/view/2017/4/9/1407492.png,1,0.9831004142761228,1924,67,2720,863,796,796,twilight sparkle,wawtoons
1409025.png,https://derpicdn.net/img/view/2017/4/11/1409025.png,0,0.9979124665260316,700,0,2890,1971,2190,1971,twilight sparkle,amy mebberson|aqua-pony
1410555.png,https://derpicdn.net/img/view/2017/4/13/1410555.png,0,0.9335083961486816,181,53,815,687,634,634,twilight sparkle,queenofsilvers
1411667.png,https://derpicdn.net/img/view/2017/4/15/1411667.png,0,0.9956110715866088,1712,0,4972,3043,3260,3043,twilight sparkle,spottedlions|e-49|rainybrony
1414245.png,https://derpicdn.net/img/view/2017/4/17/1414245.png,0,0.9917373061180116,382,660,3508,3786,3126,3126,twilight sparkle,matthewboyz
1416256.png,https://derpicdn.net/img/view/2017/4/19/1416256.png,0,0.969097137451172,128,0,1130,859,1002,859,twilight sparkle,doekitty
1417065.png,https://derpicdn.net/img/view/2017/4/20/1417065.png,0,0.9798765182495116,46,15,1112,987,1066,972,twilight sparkle,jykinturah
1419781.png,https://derpicdn.net/img/view/2017/4/23/1419781.png,0,0.9942795634269714,0,0,1375,1347,1375,1347,twilight sparkle,katakiuchi4u
1429347.png,https://derpicdn.net/img/view/2017/5/5/1429347.png,0,0.998083770275116,175,0,481,299,306,299,twilight sparkle,cynos-zilla
1429764.png,https://derpicdn.net/img/view/2017/5/6/1429764.png,0,0.9930118918418884,443,19,1339,915,896,896,twilight sparkle,jack-pie
1430213.png,https://derpicdn.net/img/view/2017/5/6/1430213.png,0,0.9547786712646484,0,180,1213,1446,1213,1266,twilight sparkle,nstone53
1434492.png,https://derpicdn.net/img/view/2017/5/12/1434492.png,0,0.9104521870613098,145,24,613,492,468,468,twilight sparkle,demonboy
1435757.png,https://derpicdn.net/img/view/2017/5/13/1435757.png,0,0.999745786190033,95,94,1069,1068,974,974,twilight sparkle,looji
1436089.png,https://derpicdn.net/img/view/2017/5/14/1436089.png,0,0.998242437839508,1519,360,6431,5272,4912,4912,twilight sparkle,dragonm97hd
1437661.png,https://derpicdn.net/img/view/2017/5/15/1437661.png,0,0.9828152060508728,60,0,902,824,842,824,twilight sparkle,bloodatius
1441191.png,https://derpicdn.net/img/view/2017/5/20/1441191.png,0,0.9242182374000548,294,0,1844,1080,1550,1080,twilight sparkle,
1451880.png,https://derpicdn.net/img/view/2017/6/2/1451880.png,0,0.99235337972641,0,25,825,869,825,844,twilight sparkle,bravefleet|datonetrumpet
1456400.png,https://derpicdn.net/img/view/2017/6/7/1456400.png,0,0.994455099105835,1118,20,5676,4578,4558,4558,twilight sparkle,fluttershy_z
1463610.png,https://derpicdn.net/img/view/2017/6/17/1463610.png,0,0.9944280982017516,135,125,2021,2011,1886,1886,twilight sparkle,slb94
1468672.png,https://derpicdn.net/img/view/2017/6/22/1468672.png,0,0.974303126335144,16,32,698,714,682,682,twilight sparkle,bunny-hana
1470329.png,https://derpicdn.net/img/view/2017/6/24/1470329.png,0,0.9731775522232056,162,26,1702,1566,1540,1540,twilight sparkle,pastelhorses
1471699.png,https://derpicdn.net/img/view/2017/6/25/1471699.png,0,0.9974449276924132,280,211,1030,961,750,750,twilight sparkle,sugarwings-art
1473885.png,https://derpicdn.net/img/view/2017/6/29/1473885.png,0,0.9887130260467528,423,347,709,633,286,286,twilight sparkle,
1473885.png,https://derpicdn.net/img/view/2017/6/29/1473885.png,1,0.9099812507629396,66,538,248,720,182,182,twilight sparkle,
1473885.png,https://derpicdn.net/img/view/2017/6/29/1473885.png,2,0.9082272052764891,1669,386,1920,672,251,286,twilight sparkle,
1475946.png,https://derpicdn.net/img/view/2017/7/1/1475946.png,0,0.9194830656051636,424,0,1074,614,650,614,twilight sparkle,yuyusunshine
1477047.png,https://derpicdn.net/img/view/2017/7/2/1477047.png,0,0.9984319806098938,33,247,429,643,396,396,twilight sparkle,xmemorized
1477047.png,https://derpicdn.net/img/view/2017/7/2/1477047.png,1,0.9975679516792296,573,159,899,485,326,326,twilight sparkle,xmemorized
1478007.png,https://derpicdn.net/img/view/2017/7/4/1478007.png,0,0.9723461866378784,58,0,812,572,754,572,twilight sparkle,agrol
1480196.png,https://derpicdn.net/img/view/2017/7/6/1480196.png,0,0.9140377640724182,2428,130,4562,2264,2134,2134,twilight sparkle,aqua-pony
1485690.png,https://derpicdn.net/img/view/2017/7/13/1485690.png,0,0.9879367351531982,1227,438,1883,1094,656,656,twilight sparkle,shutterflyeqd
1487426.png,https://derpicdn.net/img/view/2017/7/16/1487426.png,0,0.9970299005508424,4715,2432,6655,4372,1940,1940,twilight sparkle,jhayarr23
1487426.png,https://derpicdn.net/img/view/2017/7/16/1487426.png,1,0.9903840422630308,0,1327,2102,3459,2102,2132,twilight sparkle,jhayarr23
1487426.png,https://derpicdn.net/img/view/2017/7/16/1487426.png,2,0.9581034779548644,2830,1277,4478,2925,1648,1648,twilight sparkle,jhayarr23
1492834.png,https://derpicdn.net/img/view/2017/7/23/1492834.png,0,0.9924652576446532,69,27,467,425,398,398,twilight sparkle,
1494548.png,https://derpicdn.net/img/view/2017/7/25/1494548.png,0,0.9793476462364196,63,37,445,476,382,439,twilight sparkle,trini-mite
1496150.png,https://derpicdn.net/img/view/2017/7/27/1496150.png,0,0.9972017407417296,4731,0,10819,5826,6088,5826,twilight sparkle,illumnious
1501473.png,https://derpicdn.net/img/view/2017/8/3/1501473.png,0,0.9972917437553406,261,4,989,732,728,728,twilight sparkle,pabbley
1501669.png,https://derpicdn.net/img/view/2017/8/3/1501669.png,0,0.9753313660621644,0,0,208,228,208,228,twilight sparkle,
1502608.png,https://derpicdn.net/img/view/2017/8/4/1502608.png,0,0.9908401370048524,1056,0,1986,912,930,912,twilight sparkle,
150589.jpg,https://derpicdn.net/img/view/2012/11/13/150589.jpg,0,0.9754878878593444,81,65,1683,1667,1602,1602,twilight sparkle,jacky-bunny
1505918.png,https://derpicdn.net/img/view/2017/8/8/1505918.png,0,0.984013020992279,18,40,454,476,436,436,twilight sparkle,marsminer
1507135.png,https://derpicdn.net/img/view/2017/8/10/1507135.png,0,0.9993245005607604,117,0,455,329,338,329,twilight sparkle,windymils
1508188.png,https://derpicdn.net/img/view/2017/8/11/1508188.png,0,0.9984675645828248,837,182,1909,1254,1072,1072,twilight sparkle,sugarwings-art
1509537.png,https://derpicdn.net/img/view/2017/8/13/1509537.png,0,0.9948043823242188,532,0,1880,1111,1348,1111,twilight sparkle,j24262756
1510376.png,https://derpicdn.net/img/view/2017/8/14/1510376.png,0,0.967439830303192,0,222,3062,3284,3062,3062,twilight sparkle,mandash1996
1511908.png,https://derpicdn.net/img/view/2017/8/16/1511908.png,0,0.9608595371246338,1488,55,3674,2241,2186,2186,twilight sparkle,jhayarr23
1512417.png,https://derpicdn.net/img/view/2017/8/16/1512417.png,0,0.9950608611106871,2174,42,4452,2388,2278,2346,twilight sparkle,lydianyan
1512768.png,https://derpicdn.net/img/view/2017/8/17/1512768.png,0,0.9815308451652528,0,0,926,893,926,893,twilight sparkle,zogzor
1515411.png,https://derpicdn.net/img/view/2017/8/20/1515411.png,0,0.999344527721405,217,494,559,836,342,342,twilight sparkle,heir-of-rick
1516175.png,https://derpicdn.net/img/view/2017/8/21/1516175.png,0,0.9974667429924012,901,67,2550,1755,1649,1688,twilight sparkle,sketchmcreations
1517289.png,https://derpicdn.net/img/view/2017/8/22/1517289.png,0,0.9977732300758362,1066,0,3290,2207,2224,2207,twilight sparkle,pink1ejack
1518566.png,https://derpicdn.net/img/view/2017/8/24/1518566.png,0,0.9806885719299316,344,76,848,580,504,504,twilight sparkle,roguemccloud
1518985.png,https://derpicdn.net/img/view/2017/8/24/1518985.png,0,0.97624009847641,583,0,3303,2664,2720,2664,twilight sparkle,magister39
1519234.png,https://derpicdn.net/img/view/2017/8/25/1519234.png,0,0.980809211730957,24,0,1158,1107,1134,1107,twilight sparkle,corevaluesart
1523586.png,https://derpicdn.net/img/view/2017/8/30/1523586.png,0,0.9558224081993104,649,0,1587,849,938,849,twilight sparkle,j24262756
1524158.png,https://derpicdn.net/img/view/2017/8/31/1524158.png,0,0.996729850769043,1169,360,2591,1782,1422,1422,twilight sparkle,kysimon
1524456.png,https://derpicdn.net/img/view/2017/8/31/1524456.png,0,0.9967045187950134,1073,160,2565,1652,1492,1492,twilight sparkle,yinglongfujun
1525409.png,https://derpicdn.net/img/view/2017/9/1/1525409.png,0,0.9573962688446044,0,0,1674,1713,1674,1713,twilight sparkle,
1530582.png,https://derpicdn.net/img/view/2017/9/8/1530582.png,0,0.9930495023727416,302,40,642,380,340,340,twilight sparkle,rubbermage
1535895.png,https://derpicdn.net/img/view/2017/9/15/1535895.png,0,0.94338458776474,137,72,419,354,282,282,twilight sparkle,little-tweenframes
1538787.png,https://derpicdn.net/img/view/2017/9/18/1538787.png,0,0.9172444939613342,790,0,7752,6484,6962,6484,twilight sparkle,amarthgul
1538988.png,https://derpicdn.net/img/view/2017/9/18/1538988.png,0,0.9721445441246032,429,28,973,572,544,544,twilight sparkle,blvckmagic
1539857.png,https://derpicdn.net/img/view/2017/9/20/1539857.png,0,0.9340771436691284,430,46,1594,1210,1164,1164,twilight sparkle,elijah
1540755.png,https://derpicdn.net/img/view/2017/9/21/1540755.png,0,0.9496459364891052,1005,891,1869,1755,864,864,twilight sparkle,rawrienstein
1542845.png,https://derpicdn.net/img/view/2017/9/23/1542845.png,0,0.9778302907943726,0,0,374,423,374,423,twilight sparkle,
1544212.png,https://derpicdn.net/img/view/2017/9/25/1544212.png,0,0.95704847574234,0,279,2524,2897,2524,2618,twilight sparkle,jhayarr23
1544765.png,https://derpicdn.net/img/view/2017/9/25/1544765.png,0,0.9901648163795472,369,18,3111,2760,2742,2742,twilight sparkle,estories
1545092.png,https://derpicdn.net/img/view/2017/9/26/1545092.png,0,0.9426654577255248,733,19,1175,461,442,442,twilight sparkle,astr0zone
1546509.png,https://derpicdn.net/img/view/2017/9/28/1546509.png,0,0.9665048718452454,488,0,1084,570,596,570,twilight sparkle,neuro
1547084.png,https://derpicdn.net/img/view/2017/9/28/1547084.png,0,0.9951964616775512,802,357,3328,2883,2526,2526,twilight sparkle,mr.smile
1550269.png,https://derpicdn.net/img/view/2017/10/2/1550269.png,0,0.9899940490722656,1858,0,3492,1627,1634,1627,twilight sparkle,auroriia
1552156.png,https://derpicdn.net/img/view/2017/10/4/1552156.png,0,0.9794377088546752,170,0,798,606,628,606,twilight sparkle,neuro
1554296.png,https://derpicdn.net/img/view/2017/10/7/1554296.png,0,0.9988569617271424,586,0,1418,710,832,710,twilight sparkle,foughtdragon01
1555552.png,https://derpicdn.net/img/view/2017/10/8/1555552.png,0,0.9899646639823914,212,0,796,572,584,572,twilight sparkle,woonborg
1555630.png,https://derpicdn.net/img/view/2017/10/8/1555630.png,0,0.975619912147522,0,1058,3103,4130,3103,3072,twilight sparkle,pink1ejack
1557973.png,https://derpicdn.net/img/view/2017/10/11/1557973.png,0,0.9946413040161132,778,200,1220,642,442,442,twilight sparkle,bronyvectors|osipush|estories|ahsokafan100|krusiu42|shutterflyeqd|auburnborbon|taneysha|90sigma
1558322.png,https://derpicdn.net/img/view/2017/10/11/1558322.png,0,0.986902356147766,0,0,586,579,586,579,twilight sparkle,
1560478.png,https://derpicdn.net/img/view/2017/10/14/1560478.png,0,0.9835898876190186,458,49,812,403,354,354,twilight sparkle,nadairead
1561253.png,https://derpicdn.net/img/view/2017/10/14/1561253.png,0,0.9248190522193908,0,7,807,945,807,938,twilight sparkle,clouddg
1562143.png,https://derpicdn.net/img/view/2017/10/15/1562143.png,0,0.9838277697563172,241,44,587,390,346,346,twilight sparkle,flipwix
156463.png,https://derpicdn.net/img/view/2012/11/18/156463.png,0,0.9960376620292664,213,23,509,319,296,296,twilight sparkle,tunderi
1567818.png,https://derpicdn.net/img/view/2017/10/22/1567818.png,0,0.9916941523551941,15,0,1117,1057,1102,1057,twilight sparkle,pastelhorses
1567859.png,https://derpicdn.net/img/view/2017/10/22/1567859.png,0,0.9705075025558472,2160,1367,3508,2715,1348,1348,twilight sparkle,aaftergloweeye
1568568.png,https://derpicdn.net/img/view/2017/10/23/1568568.png,0,0.96440452337265,202,62,1694,1554,1492,1492,twilight sparkle,bepreeh
1570976.png,https://derpicdn.net/img/view/2017/10/27/1570976.png,0,0.9410239458084106,335,51,1269,985,934,934,twilight sparkle,trungtranhaitrung
1571968.png,https://derpicdn.net/img/view/2017/10/28/1571968.png,0,0.9369214177131652,0,0,1416,1455,1416,1455,twilight sparkle,ashee
1574511.png,https://derpicdn.net/img/view/2017/10/31/1574511.png,0,0.9884630441665648,163,92,405,334,242,242,twilight sparkle,saphi-boo
1577256.png,https://derpicdn.net/img/view/2017/11/3/1577256.png,0,0.9878376126289368,7,0,687,414,680,414,twilight sparkle,
1577516.png,https://derpicdn.net/img/view/2017/11/4/1577516.png,0,0.985393524169922,153,74,497,418,344,344,twilight sparkle,metal-kitty
1578534.png,https://derpicdn.net/img/view/2017/11/5/1578534.png,0,0.9996931552886964,596,273,1350,1027,754,754,twilight sparkle,lilfunkman
1589275.png,https://derpicdn.net/img/view/2017/11/18/1589275.png,0,0.9804353713989258,94,20,610,536,516,516,twilight sparkle,snakeythingy
1589536.png,https://derpicdn.net/img/view/2017/11/19/1589536.png,0,0.92494535446167,822,280,1618,1076,796,796,twilight sparkle,cinnamontee
1589794.png,https://derpicdn.net/img/view/2017/11/19/1589794.png,0,0.9748160839080808,62,0,1000,993,938,993,twilight sparkle,rossignolet
1589799.png,https://derpicdn.net/img/view/2017/11/19/1589799.png,0,0.9360741376876832,38,7,694,663,656,656,twilight sparkle,rossignolet
1590111.png,https://derpicdn.net/img/view/2017/11/19/1590111.png,0,0.9689419865608216,141,0,945,719,804,719,twilight sparkle,gray--day
1604257.png,https://derpicdn.net/img/view/2017/12/10/1604257.png,0,0.9204818606376648,0,39,451,565,451,526,twilight sparkle,youkneez
1604404.png,https://derpicdn.net/img/view/2017/12/10/1604404.png,0,0.9759262800216676,0,0,829,826,829,826,twilight sparkle,knesie
1605129.png,https://derpicdn.net/img/view/2017/12/11/1605129.png,0,0.9003843069076538,848,121,3974,3247,3126,3126,twilight sparkle,drewdini
1605484.png,https://derpicdn.net/img/view/2017/12/11/1605484.png,0,0.9986282587051392,240,11,744,515,504,504,twilight sparkle,patty-plmh
1605882.png,https://derpicdn.net/img/view/2017/12/12/1605882.png,0,0.9976887702941896,100,695,1730,2325,1630,1630,twilight sparkle,creativitybox18
1619325.png,https://derpicdn.net/img/view/2017/12/29/1619325.png,0,0.9875847101211548,243,575,639,971,396,396,twilight sparkle,antelon
1619534.png,https://derpicdn.net/img/view/2017/12/30/1619534.png,0,0.995711088180542,202,11,972,781,770,770,twilight sparkle,dori-to
1619973.png,https://derpicdn.net/img/view/2017/12/30/1619973.png,0,0.9673358201980592,43,4,787,748,744,744,twilight sparkle,mewball
1620083.png,https://derpicdn.net/img/view/2017/12/30/1620083.png,0,0.9974899291992188,299,0,1063,744,764,744,twilight sparkle,yomitai
1620107.png,https://derpicdn.net/img/view/2017/12/30/1620107.png,0,0.9386157989501952,409,674,739,1004,330,330,twilight sparkle,janegumball
1622158.png,https://derpicdn.net/img/view/2018/1/2/1622158.png,0,0.9593163728713988,153,122,4972,5630,4819,5508,twilight sparkle,jhayarr23
1626443.png,https://derpicdn.net/img/view/2018/1/7/1626443.png,0,0.92974853515625,315,0,1819,1080,1504,1080,twilight sparkle,shad0w-galaxy
1631554.png,https://derpicdn.net/img/view/2018/1/13/1631554.png,0,0.9739164113998412,820,0,1900,1080,1080,1080,twilight sparkle,0cream-puff0
1632296.png,https://derpicdn.net/img/view/2018/1/14/1632296.png,0,0.9985865354537964,116,0,618,495,502,495,twilight sparkle,xxmissteaxx
1632774.png,https://derpicdn.net/img/view/2018/1/15/1632774.png,0,0.983737289905548,345,0,1853,1504,1508,1504,twilight sparkle,maxiima
1633601.png,https://derpicdn.net/img/view/2018/1/16/1633601.png,0,0.9545077681541444,64,0,536,432,472,432,twilight sparkle,twinkepaint
1645440.png,https://derpicdn.net/img/view/2018/1/31/1645440.png,0,0.993192493915558,905,278,1777,1150,872,872,twilight sparkle,ashidaru
1647489.png,https://derpicdn.net/img/view/2018/2/3/1647489.png,0,0.9977146983146667,0,56,443,534,443,478,twilight sparkle,dsp2003
1650147.png,https://derpicdn.net/img/view/2018/2/7/1650147.png,0,0.9352867007255554,100,169,524,593,424,424,twilight sparkle,greyscaleart|dilarus
1651510.png,https://derpicdn.net/img/view/2018/2/9/1651510.png,0,0.9083790183067322,341,101,763,523,422,422,twilight sparkle,kojiro-brushard
1655132.png,https://derpicdn.net/img/view/2018/2/13/1655132.png,0,0.9956056475639344,34,346,468,780,434,434,twilight sparkle,secretgoombaman12345
1661317.png,https://derpicdn.net/img/view/2018/2/20/1661317.png,0,0.9649950265884399,179,0,807,566,628,566,twilight sparkle,alpaca-pharaoh
1661366.png,https://derpicdn.net/img/view/2018/2/20/1661366.png,0,0.9992486238479614,735,0,2391,1582,1656,1582,twilight sparkle,dezdark
1664219.png,https://derpicdn.net/img/view/2018/2/24/1664219.png,0,0.9884425401687622,253,452,863,1062,610,610,twilight sparkle,rossignolet
1664557.png,https://derpicdn.net/img/view/2018/2/24/1664557.png,0,0.9995288252830504,186,528,900,1242,714,714,twilight sparkle,pony-berserker
1668741.png,https://derpicdn.net/img/view/2018/3/1/1668741.png,0,0.998841404914856,426,72,850,496,424,424,twilight sparkle,dm29
1669308.png,https://derpicdn.net/img/view/2018/3/1/1669308.png,0,0.9990853071212769,475,18,1359,902,884,884,twilight sparkle,partycannoninc
1670515.png,https://derpicdn.net/img/view/2018/3/3/1670515.png,0,0.959228515625,852,441,1240,829,388,388,twilight sparkle,verumtee|wubcakeva
1673550.png,https://derpicdn.net/img/view/2018/3/6/1673550.png,0,0.9987037181854248,2046,65,3660,1679,1614,1614,twilight sparkle,andoanimalia
1673880.png,https://derpicdn.net/img/view/2018/3/7/1673880.png,0,0.9991533160209656,1133,65,2273,1205,1140,1140,twilight sparkle,stargazer carp
1674490.png,https://derpicdn.net/img/view/2018/3/8/1674490.png,0,0.9931316971778872,61,98,411,448,350,350,twilight sparkle,aqua-pony
1674551.png,https://derpicdn.net/img/view/2018/3/8/1674551.png,0,0.9759411811828612,137,0,645,491,508,491,twilight sparkle,770nanao15
1676544.png,https://derpicdn.net/img/view/2018/3/10/1676544.png,0,0.9954277873039246,468,0,838,360,370,360,twilight sparkle,dottyboxx
1679491.png,https://derpicdn.net/img/view/2018/3/14/1679491.png,0,0.9903109073638916,495,85,1215,805,720,720,twilight sparkle,vaetan
1687084.png,https://derpicdn.net/img/view/2018/3/22/1687084.png,0,0.9806242585182192,1035,0,2906,1957,1871,1957,twilight sparkle,sketchmcreations
1687297.png,https://derpicdn.net/img/view/2018/3/22/1687297.png,0,0.9294115900993348,550,1170,870,1490,320,320,twilight sparkle,phoenixrk49
1688187.png,https://derpicdn.net/img/view/2018/3/23/1688187.png,0,0.9812684655189514,996,5,2004,1013,1008,1008,twilight sparkle,felsette
1689549.png,https://derpicdn.net/img/view/2018/3/24/1689549.png,0,0.9390351176261902,76,97,829,929,753,832,twilight sparkle,
1690330.png,https://derpicdn.net/img/view/2018/3/25/1690330.png,0,0.9790088534355164,296,122,770,596,474,474,twilight sparkle,songbirdserenade
1692011.png,https://derpicdn.net/img/view/2018/3/27/1692011.png,0,0.9817036390304564,398,0,2692,1943,2294,1943,twilight sparkle,bunxl
1692352.png,https://derpicdn.net/img/view/2018/3/27/1692352.png,0,0.9852278232574464,644,81,1230,667,586,586,twilight sparkle,countryroads
1693342.png,https://derpicdn.net/img/view/2018/3/28/1693342.png,0,0.9994884729385376,1562,0,3094,1469,1532,1469,twilight sparkle,andoanimalia
1697445.png,https://derpicdn.net/img/view/2018/4/2/1697445.png,0,0.999254047870636,460,0,1118,640,658,640,twilight sparkle,mezmaroon
1700442.png,https://derpicdn.net/img/view/2018/4/6/1700442.png,0,0.9548382759094238,163,7,495,339,332,332,twilight sparkle,lulubell
1702673.png,https://derpicdn.net/img/view/2018/4/8/1702673.png,0,0.992182195186615,4,0,424,391,420,391,twilight sparkle,
1703054.png,https://derpicdn.net/img/view/2018/4/9/1703054.png,0,0.9979687929153442,0,0,397,373,397,373,twilight sparkle,
1705174.png,https://derpicdn.net/img/view/2018/4/11/1705174.png,0,0.9685413241386414,11,0,343,332,332,332,twilight sparkle,shelikof launch
1706565.png,https://derpicdn.net/img/view/2018/4/13/1706565.png,0,0.9992063641548156,59,36,659,636,600,600,twilight sparkle,leviostars
1711500.png,https://derpicdn.net/img/view/2018/4/19/1711500.png,0,0.9864805936813354,1875,0,3475,1550,1600,1550,twilight sparkle,uunicornicc
1711510.png,https://derpicdn.net/img/view/2018/4/19/1711510.png,0,0.995806872844696,144,15,1258,1129,1114,1114,twilight sparkle,uunicornicc
1711516.png,https://derpicdn.net/img/view/2018/4/19/1711516.png,0,0.931066393852234,56,0,1570,1420,1514,1420,twilight sparkle,uunicornicc
1712728.png,https://derpicdn.net/img/view/2018/4/20/1712728.png,0,0.9633089303970336,549,0,1280,721,731,721,twilight sparkle,paintcoloryt
1714263.png,https://derpicdn.net/img/view/2018/4/22/1714263.png,0,0.9658008217811584,0,91,249,351,249,260,twilight sparkle,
1717368.png,https://derpicdn.net/img/view/2018/4/26/1717368.png,0,0.9792011976242064,0,0,2589,2814,2589,2814,twilight sparkle,sketchmcreations
1717671.png,https://derpicdn.net/img/view/2018/4/26/1717671.png,0,0.9697343707084656,0,92,2715,3240,2715,3148,twilight sparkle,aqua-pony
1717911.png,https://derpicdn.net/img/view/2018/4/27/1717911.png,0,0.9809598922729492,0,0,2526,2964,2526,2964,twilight sparkle,ejlightning007arts
1718554.png,https://derpicdn.net/img/view/2018/4/27/1718554.png,0,0.9756515622138976,0,0,955,978,955,978,twilight sparkle,latia122
1719247.png,https://derpicdn.net/img/view/2018/4/28/1719247.png,0,0.9461175203323364,63,0,459,393,396,393,twilight sparkle,
1719652.png,https://derpicdn.net/img/view/2018/4/29/1719652.png,0,0.9934186935424804,608,0,1536,829,928,829,twilight sparkle,kimjoman
1720089.png,https://derpicdn.net/img/view/2018/4/29/1720089.png,0,0.9953723549842834,0,1385,3674,5093,3674,3708,twilight sparkle,mintjuice
1720898.png,https://derpicdn.net/img/view/2018/4/30/1720898.png,0,0.994473934173584,0,0,599,616,599,616,twilight sparkle,spellboundcanvas
1721281.png,https://derpicdn.net/img/view/2018/5/1/1721281.png,1,0.9962153434753418,768,387,1084,703,316,316,twilight sparkle,weasley-detectives
1722838.png,https://derpicdn.net/img/view/2018/5/3/1722838.png,0,0.9732638597488404,0,402,2637,3190,2637,2788,twilight sparkle,ejlightning007arts
1722915.png,https://derpicdn.net/img/view/2018/5/3/1722915.png,0,0.951691508293152,261,0,1459,1158,1198,1158,twilight sparkle,1drfl_world_end
1723406.png,https://derpicdn.net/img/view/2018/5/3/1723406.png,0,0.9821144938468932,70,0,2568,2252,2498,2252,twilight sparkle,andoanimalia
1724411.png,https://derpicdn.net/img/view/2018/5/5/1724411.png,0,0.959891676902771,124,0,846,697,722,697,twilight sparkle,soctavia
1729854.png,https://derpicdn.net/img/view/2018/5/11/1729854.png,0,0.9177223443984984,0,139,387,540,387,401,twilight sparkle,
1730214.png,https://derpicdn.net/img/view/2018/5/11/1730214.png,0,0.9616039991378784,417,0,1179,745,762,745,twilight sparkle,brok-enwings
1730717.png,https://derpicdn.net/img/view/2018/5/12/1730717.png,0,0.9872514605522156,346,5,728,387,382,382,twilight sparkle,laurasscetches
1731541.png,https://derpicdn.net/img/view/2018/5/13/1731541.png,0,0.9957694411277772,357,0,1491,1016,1134,1016,twilight sparkle,eagle1division
173243.jpg,https://derpicdn.net/img/view/2012/12/5/173243.jpg,0,0.9896454215049744,0,18,566,606,566,588,twilight sparkle,paintedhoofprints
1734736.png,https://derpicdn.net/img/view/2018/5/17/1734736.png,0,0.9681950211524964,3463,0,6507,2378,3044,2378,twilight sparkle,caliazian
1740964.png,https://derpicdn.net/img/view/2018/5/25/1740964.png,0,0.9364190697669984,441,129,1271,959,830,830,twilight sparkle,cluvry
1741074.png,https://derpicdn.net/img/view/2018/5/25/1741074.png,0,0.982758641242981,385,5,823,443,438,438,twilight sparkle,raydonxd
1741483.png,https://derpicdn.net/img/view/2018/5/26/1741483.png,0,0.9531559348106384,0,0,1500,1500,1500,1500,twilight sparkle,zaron|zaronart
1741899.png,https://derpicdn.net/img/view/2018/5/26/1741899.png,0,0.9777694344520568,78,0,910,740,832,740,twilight sparkle,
1744991.png,https://derpicdn.net/img/view/2018/5/30/1744991.png,0,0.9767071008682252,42,0,374,332,332,332,twilight sparkle,
1749806.png,https://derpicdn.net/img/view/2018/6/4/1749806.png,0,0.9737128615379332,86,74,1446,1434,1360,1360,twilight sparkle,pearjamdoesstuff
1750815.png,https://derpicdn.net/img/view/2018/6/6/1750815.png,0,0.9935823082923888,534,170,1694,1330,1160,1160,twilight sparkle,marbola
1751014.png,https://derpicdn.net/img/view/2018/6/6/1751014.png,0,0.9961184859275818,94,41,530,477,436,436,twilight sparkle,jadejellie
1752361.png,https://derpicdn.net/img/view/2018/6/8/1752361.png,0,0.9795311689376832,82,4,730,652,648,648,twilight sparkle,sintakhra
1753569.png,https://derpicdn.net/img/view/2018/6/9/1753569.png,0,0.9695719480514526,37,0,1649,1080,1612,1080,twilight sparkle,
1753948.png,https://derpicdn.net/img/view/2018/6/9/1753948.png,0,0.9959236383438108,1112,127,3416,2431,2304,2304,twilight sparkle,arcane-thunder
1757920.png,https://derpicdn.net/img/view/2018/6/15/1757920.png,0,0.9928757548332214,61,0,867,798,806,798,twilight sparkle,ravvij
1758018.png,https://derpicdn.net/img/view/2018/6/15/1758018.png,0,0.9520537853240968,149,0,765,586,616,586,twilight sparkle,sugaryicecreammlp
1759064.png,https://derpicdn.net/img/view/2018/6/16/1759064.png,0,0.9802661538124084,350,19,1188,857,838,838,twilight sparkle,yajima
1760295.png,https://derpicdn.net/img/view/2018/6/18/1760295.png,0,0.9924690723419192,863,505,1221,863,358,358,twilight sparkle,sozglitch
1760295.png,https://derpicdn.net/img/view/2018/6/18/1760295.png,1,0.9840934276580808,230,7,504,281,274,274,twilight sparkle,sozglitch
1761828.png,https://derpicdn.net/img/view/2018/6/20/1761828.png,0,0.997260332107544,658,0,1396,733,738,733,twilight sparkle,ponypadding
1762251.png,https://derpicdn.net/img/view/2018/6/20/1762251.png,0,0.9871670603752136,167,0,599,422,432,422,twilight sparkle,serafelis
1766487.png,https://derpicdn.net/img/view/2018/6/26/1766487.png,0,0.9975057244300842,1383,0,2835,1368,1452,1368,twilight sparkle,arcane-thunder
1766858.png,https://derpicdn.net/img/view/2018/6/27/1766858.png,0,0.948581337928772,321,30,2039,1838,1718,1808,twilight sparkle,zuzella96
1767807.png,https://derpicdn.net/img/view/2018/6/28/1767807.png,0,0.9919830560684204,64,0,752,675,688,675,twilight sparkle,johnjudes
1768589.png,https://derpicdn.net/img/view/2018/6/29/1768589.png,0,0.9958028197288512,145,54,1049,958,904,904,twilight sparkle,luximus17
1770131.png,https://derpicdn.net/img/view/2018/7/1/1770131.png,0,0.9852869510650636,352,29,1410,1087,1058,1058,twilight sparkle,joey
1772010.png,https://derpicdn.net/img/view/2018/7/3/1772010.png,0,0.9804105162620544,0,0,546,554,546,554,twilight sparkle,ch-chau
1772346.png,https://derpicdn.net/img/view/2018/7/3/1772346.png,0,0.9294340014457704,416,200,2122,1906,1706,1706,twilight sparkle,zanefir-dran|felinus-fenix
1772960.png,https://derpicdn.net/img/view/2018/7/4/1772960.png,0,0.9837229251861572,310,165,894,749,584,584,twilight sparkle,friendlyraccoon
1774268.png,https://derpicdn.net/img/view/2018/7/6/1774268.png,0,0.9897264838218688,479,87,800,445,321,358,twilight sparkle,duskswordsman
1775439.png,https://derpicdn.net/img/view/2018/7/7/1775439.png,0,0.9929226040840148,276,28,1984,1736,1708,1708,twilight sparkle,punk-pegasus
1782581.png,https://derpicdn.net/img/view/2018/7/16/1782581.png,0,0.9843984842300416,0,115,3782,4079,3782,3964,twilight sparkle,dragonchaser123
1783032.png,https://derpicdn.net/img/view/2018/7/17/1783032.png,0,0.9670040011405944,1088,193,1690,795,602,602,twilight sparkle,miiv12
1783032.png,https://derpicdn.net/img/view/2018/7/17/1783032.png,1,0.9031875729560852,761,208,1321,768,560,560,twilight sparkle,miiv12
1783686.png,https://derpicdn.net/img/view/2018/7/18/1783686.png,0,0.9923907518386841,0,5,663,739,663,734,twilight sparkle,fishtoonz
1784981.png,https://derpicdn.net/img/view/2018/7/19/1784981.png,0,0.9794533252716064,2401,1319,3693,2611,1292,1292,twilight sparkle,artdigistique14
1784981.png,https://derpicdn.net/img/view/2018/7/19/1784981.png,1,0.9565011262893676,1090,560,2652,2122,1562,1562,twilight sparkle,artdigistique14
1785036.png,https://derpicdn.net/img/view/2018/7/19/1785036.png,0,0.9730059504508972,263,0,905,618,642,618,twilight sparkle,ponkus
1786267.png,https://derpicdn.net/img/view/2018/7/21/1786267.png,0,0.931751787662506,6,33,802,801,796,768,twilight sparkle,artiks
179129.png,https://derpicdn.net/img/view/2012/12/11/179129.png,0,0.9407106041908264,0,0,759,711,759,711,twilight sparkle,reikomuffin
1794124.png,https://derpicdn.net/img/view/2018/7/31/1794124.png,0,0.9317616820335388,0,0,219,218,219,218,twilight sparkle,
1794179.png,https://derpicdn.net/img/view/2018/7/31/1794179.png,0,0.9979564547538756,151,82,691,622,540,540,twilight sparkle,duskie-06
1797726.png,https://derpicdn.net/img/view/2018/8/4/1797726.png,0,0.993394136428833,115,45,809,739,694,694,twilight sparkle,saturdaymorningproj
1800438.png,https://derpicdn.net/img/view/2018/8/7/1800438.png,0,0.963376760482788,297,283,2013,1999,1716,1716,twilight sparkle,lifesharbinger
1802735.png,https://derpicdn.net/img/view/2018/8/9/1802735.png,0,0.9068785309791564,775,0,1677,854,902,854,twilight sparkle,hierozaki
1802757.png,https://derpicdn.net/img/view/2018/8/9/1802757.png,0,0.9905992150306702,0,73,2715,3127,2715,3054,twilight sparkle,andoanimalia
1804744.png,https://derpicdn.net/img/view/2018/8/12/1804744.png,0,0.9874223470687866,198,226,748,776,550,550,twilight sparkle,polarisbunny|sunny-dean
1807422.png,https://derpicdn.net/img/view/2018/8/15/1807422.png,0,0.998708188533783,139,209,385,455,246,246,twilight sparkle,celticsphinx
1807422.png,https://derpicdn.net/img/view/2018/8/15/1807422.png,1,0.9963213801383972,318,95,612,389,294,294,twilight sparkle,celticsphinx
1807572.png,https://derpicdn.net/img/view/2018/8/15/1807572.png,0,0.9990479350090028,467,554,999,1086,532,532,twilight sparkle,saturdaymorningproj
1807572.png,https://derpicdn.net/img/view/2018/8/15/1807572.png,1,0.9264463782310486,979,491,1537,1049,558,558,twilight sparkle,saturdaymorningproj
1813177.png,https://derpicdn.net/img/view/2018/8/22/1813177.png,0,0.9977627396583556,414,423,838,847,424,424,twilight sparkle,samum41
1817116.png,https://derpicdn.net/img/view/2018/8/26/1817116.png,0,0.9209694266319276,714,0,1550,873,836,873,twilight sparkle,nitei
1819106.png,https://derpicdn.net/img/view/2018/8/29/1819106.png,0,0.9952531456947328,2539,169,4441,2071,1902,1902,twilight sparkle,uunicornicc
1819854.png,https://derpicdn.net/img/view/2018/8/29/1819854.png,0,0.9549769163131714,0,58,2498,2750,2498,2692,twilight sparkle,andoanimalia
1821158.png,https://derpicdn.net/img/view/2018/8/31/1821158.png,0,0.9591635465621948,718,1501,4762,5287,4044,3786,twilight sparkle,luckreza8
1823807.png,https://derpicdn.net/img/view/2018/9/3/1823807.png,0,0.9983612298965454,36,0,2041,1942,2005,1942,twilight sparkle,mariashapony
1824007.png,https://derpicdn.net/img/view/2018/9/3/1824007.png,0,0.9445622563362122,151,0,1413,975,1262,975,twilight sparkle,hierozaki
1832102.png,https://derpicdn.net/img/view/2018/9/13/1832102.png,0,0.9627690315246582,62,50,448,436,386,386,twilight sparkle,melodytheartpony
1841408.png,https://derpicdn.net/img/view/2018/9/26/1841408.png,0,0.9822760224342346,3222,0,8056,5002,4834,5002,twilight sparkle,illumnious
1843349.png,https://derpicdn.net/img/view/2018/9/28/1843349.png,0,0.9579628705978394,135,0,1683,1080,1548,1080,twilight sparkle,ashvall
1844834.png,https://derpicdn.net/img/view/2018/9/30/1844834.png,0,0.9992862939834596,62,0,2298,2207,2236,2207,twilight sparkle,pink1ejack
1854891.png,https://derpicdn.net/img/view/2018/10/12/1854891.png,0,0.9368050694465636,847,279,5104,4701,4257,4422,twilight sparkle,andoanimalia
1855608.png,https://derpicdn.net/img/view/2018/10/13/1855608.png,0,0.9278035163879396,375,1,833,459,458,458,twilight sparkle,boyslushie
1859452.png,https://derpicdn.net/img/view/2018/10/18/1859452.png,0,0.9899197816848756,80,9,524,453,444,444,twilight sparkle,kazunekomori
1861608.png,https://derpicdn.net/img/view/2018/10/20/1861608.png,0,0.9899753332138062,465,408,939,882,474,474,twilight sparkle,vyazinrei
1862763.png,https://derpicdn.net/img/view/2018/10/22/1862763.png,0,0.978252649307251,1963,188,4940,3232,2977,3044,twilight sparkle,shutterflyeqd
186440.png,https://derpicdn.net/img/view/2012/12/18/186440.png,0,0.9950254559516908,287,9,1375,1097,1088,1088,twilight sparkle,trefleix
1864954.png,https://derpicdn.net/img/view/2018/10/24/1864954.png,0,0.9727576971054076,725,105,2119,1499,1394,1394,twilight sparkle,minamikoboyasy
1867821.png,https://derpicdn.net/img/view/2018/10/27/1867821.png,1,0.9128865003585817,442,301,3550,3631,3108,3330,twilight sparkle,walrusinc
1868567.png,https://derpicdn.net/img/view/2018/10/28/1868567.png,0,0.9472998976707458,227,489,2500,2817,2273,2328,twilight sparkle,alterhouse
1869056.png,https://derpicdn.net/img/view/2018/10/29/1869056.png,0,0.996410071849823,1684,136,6256,4708,4572,4572,twilight sparkle,famousmari5
1872529.png,https://derpicdn.net/img/view/2018/11/1/1872529.png,0,0.9631884694099426,1493,463,6833,5803,5340,5340,twilight sparkle,illumnious
1872755.png,https://derpicdn.net/img/view/2018/11/1/1872755.png,0,0.9989414811134338,235,285,511,561,276,276,twilight sparkle,slushshe
1872755.png,https://derpicdn.net/img/view/2018/11/1/1872755.png,1,0.9202214479446412,484,189,756,461,272,272,twilight sparkle,slushshe
1875979.png,https://derpicdn.net/img/view/2018/11/5/1875979.png,0,0.9669029116630554,0,0,963,877,963,877,twilight sparkle,taurson
1876106.png,https://derpicdn.net/img/view/2018/11/6/1876106.png,0,0.9972889423370358,502,0,1146,631,644,631,twilight sparkle,artiks
1878847.png,https://derpicdn.net/img/view/2018/11/10/1878847.png,0,0.9856001734733582,18,3,300,285,282,282,twilight sparkle,horsepaws
1880031.png,https://derpicdn.net/img/view/2018/11/11/1880031.png,0,0.9995293617248536,0,16,304,326,304,310,twilight sparkle,wanderingpegasus
1882041.png,https://derpicdn.net/img/view/2018/11/14/1882041.png,0,0.9858723282814026,382,275,1094,987,712,712,twilight sparkle,kriss-studios
1884039.png,https://derpicdn.net/img/view/2018/11/17/1884039.png,0,0.9969754219055176,221,0,851,626,630,626,twilight sparkle,
1884878.png,https://derpicdn.net/img/view/2018/11/18/1884878.png,0,0.9816381335258484,2,88,260,346,258,258,twilight sparkle,wanderingpegasus
1884878.png,https://derpicdn.net/img/view/2018/11/18/1884878.png,1,0.9599971771240234,239,0,631,361,392,361,twilight sparkle,wanderingpegasus
1885460.png,https://derpicdn.net/img/view/2018/11/18/1885460.png,0,0.9863062500953674,341,38,1723,1420,1382,1382,twilight sparkle,2387528112
1887313.png,https://derpicdn.net/img/view/2018/11/21/1887313.png,0,0.999045193195343,424,284,1026,886,602,602,twilight sparkle,clockworkquartet
1888134.png,https://derpicdn.net/img/view/2018/11/22/1888134.png,0,0.9909358620643616,13,127,595,651,582,524,twilight sparkle,
1893178.png,https://derpicdn.net/img/view/2018/11/28/1893178.png,0,0.9866251349449158,798,94,1214,510,416,416,twilight sparkle,dementra369
1894765.png,https://derpicdn.net/img/view/2018/11/30/1894765.png,0,0.9788150191307068,248,0,1571,1260,1323,1260,twilight sparkle,nadnerbd
1894772.png,https://derpicdn.net/img/view/2018/11/30/1894772.png,0,0.9907666444778442,652,127,934,409,282,282,twilight sparkle,mequiloano
1895046.png,https://derpicdn.net/img/view/2018/12/1/1895046.png,0,0.9961026906967164,264,0,630,361,366,361,twilight sparkle,saphi-boo
1896481.png,https://derpicdn.net/img/view/2018/12/2/1896481.png,0,0.954978346824646,235,50,815,630,580,580,twilight sparkle,shad0w-galaxy
1898760.png,https://derpicdn.net/img/view/2018/12/5/1898760.png,0,0.9799025654792786,50,0,1674,1541,1624,1541,twilight sparkle,nummynumz
1898760.png,https://derpicdn.net/img/view/2018/12/5/1898760.png,1,0.919901430606842,165,363,1800,2139,1635,1776,twilight sparkle,nummynumz
1900705.png,https://derpicdn.net/img/view/2018/12/7/1900705.png,0,0.930222988128662,344,132,976,764,632,632,twilight sparkle,anontheanon
1900860.png,https://derpicdn.net/img/view/2018/12/7/1900860.png,0,0.954537570476532,0,0,4365,4785,4365,4785,twilight sparkle,andoanimalia
1902944.png,https://derpicdn.net/img/view/2018/12/8/1902944.png,0,0.9989427924156188,779,0,1853,1019,1074,1019,twilight sparkle,schokocream
19073.png,https://derpicdn.net/img/view/2012/6/24/19073.png,0,0.9623622894287108,18,284,294,560,276,276,twilight sparkle,michos|johnjoseco
1909571.png,https://derpicdn.net/img/view/2018/12/16/1909571.png,0,0.9924281239509584,229,0,725,478,496,478,twilight sparkle,ikarooz
191.png,https://derpicdn.net/img/view/2012/1/12/191.png,0,0.9972896575927734,2784,29,4740,1985,1956,1956,twilight sparkle,maximillianveers
1910795.png,https://derpicdn.net/img/view/2018/12/17/1910795.png,0,0.9980592727661132,422,8,920,506,498,498,twilight sparkle,scobionicle99
1911162.png,https://derpicdn.net/img/view/2018/12/17/1911162.png,0,0.999625563621521,952,0,1492,536,540,536,twilight sparkle,hierozaki
1911813.png,https://derpicdn.net/img/view/2018/12/18/1911813.png,4,0.9770776033401488,696,1832,1570,2706,874,874,twilight sparkle,silverhopexiii
191363.jpg,https://derpicdn.net/img/view/2012/12/23/191363.jpg,0,0.998434603214264,1561,21,2599,1059,1038,1038,twilight sparkle,madelezabeth
1913981.png,https://derpicdn.net/img/view/2018/12/20/1913981.png,0,0.9700794816017152,729,0,1707,865,978,865,twilight sparkle,artiks
1915428.png,https://derpicdn.net/img/view/2018/12/22/1915428.png,0,0.9928097128868104,99,0,651,537,552,537,twilight sparkle,tastyrainbow
1915512.png,https://derpicdn.net/img/view/2018/12/22/1915512.png,0,0.9974294304847716,58,84,434,460,376,376,twilight sparkle,tastyrainbow
1915924.png,https://derpicdn.net/img/view/2018/12/22/1915924.png,0,0.9789472818374634,260,218,1646,1604,1386,1386,twilight sparkle,andoanimalia
1921041.png,https://derpicdn.net/img/view/2018/12/28/1921041.png,0,0.9002230763435364,1439,0,4153,2648,2714,2648,twilight sparkle,andoanimalia
1921827.png,https://derpicdn.net/img/view/2018/12/30/1921827.png,0,0.991481363773346,407,22,793,408,386,386,twilight sparkle,feathers-ruffled
1924337.png,https://derpicdn.net/img/view/2019/1/1/1924337.png,0,0.9797492623329164,1939,0,3441,1357,1502,1357,twilight sparkle,whiteskyline
1927974.png,https://derpicdn.net/img/view/2019/1/6/1927974.png,0,0.9524897933006288,22,0,644,586,622,586,twilight sparkle,skumpup
192813.png,https://derpicdn.net/img/view/2012/12/25/192813.png,0,0.9773520231246948,0,1,208,235,208,234,twilight sparkle,ladypixelheart
1929551.png,https://derpicdn.net/img/view/2019/1/8/1929551.png,0,0.9921973347663879,23,0,559,498,536,498,twilight sparkle,wanderingpegasus
1931490.png,https://derpicdn.net/img/view/2019/1/10/1931490.png,0,0.9167659282684326,104,376,5000,5300,4896,4924,twilight sparkle,luckreza8
1934213.png,https://derpicdn.net/img/view/2019/1/13/1934213.png,0,0.9984702467918396,514,0,1894,1262,1380,1262,twilight sparkle,shad0w-galaxy
1934794.png,https://derpicdn.net/img/view/2019/1/14/1934794.png,0,0.9434136152267456,0,51,532,683,532,632,twilight sparkle,
1939271.png,https://derpicdn.net/img/view/2019/1/19/1939271.png,0,0.9160424470901488,669,70,2011,1412,1342,1342,twilight sparkle,cutepencilcase
1939924.png,https://derpicdn.net/img/view/2019/1/20/1939924.png,0,0.9830355048179626,0,0,1171,1170,1171,1170,twilight sparkle,5oussn
1940753.png,https://derpicdn.net/img/view/2019/1/21/1940753.png,0,0.9990205764770508,405,219,693,507,288,288,twilight sparkle,ea657
1943784.png,https://derpicdn.net/img/view/2019/1/25/1943784.png,0,0.987579345703125,1072,30,1410,368,338,338,twilight sparkle,vipeydashie
1945727.png,https://derpicdn.net/img/view/2019/1/27/1945727.png,0,0.9971128702163696,130,0,618,478,488,478,twilight sparkle,lazynore
1946527.png,https://derpicdn.net/img/view/2019/1/28/1946527.png,0,0.9528770446777344,69,15,813,759,744,744,twilight sparkle,turtlefarminguy
1946927.png,https://derpicdn.net/img/view/2019/1/28/1946927.png,0,0.9983475804328918,510,0,1458,884,948,884,twilight sparkle,klaudy
1947638.png,https://derpicdn.net/img/view/2019/1/29/1947638.png,0,0.9990575909614564,0,0,297,295,297,295,twilight sparkle,srsishere
1947644.png,https://derpicdn.net/img/view/2019/1/29/1947644.png,0,0.9822011590003968,15,25,449,459,434,434,twilight sparkle,srsishere
1952130.png,https://derpicdn.net/img/view/2019/2/3/1952130.png,0,0.9948652982711792,1011,0,2961,1906,1950,1906,twilight sparkle,cloudyglow
1953266.png,https://derpicdn.net/img/view/2019/2/4/1953266.png,0,0.9835571050643921,175,0,830,721,655,721,twilight sparkle,虎喵君
1953592.png,https://derpicdn.net/img/view/2019/2/4/1953592.png,0,0.9861385226249696,54,121,1638,1674,1584,1553,twilight sparkle,deltahedgehog
1954706.png,https://derpicdn.net/img/view/2019/2/6/1954706.png,0,0.9661840200424194,176,4,624,452,448,448,twilight sparkle,liefsong
1955499.png,https://derpicdn.net/img/view/2019/2/7/1955499.png,0,0.965684413909912,392,4,704,316,312,312,twilight sparkle,milky-rabbit
1956355.png,https://derpicdn.net/img/view/2019/2/8/1956355.png,0,0.9766885042190552,0,17,2214,2285,2214,2268,twilight sparkle,creepypastapon3
1957615.png,https://derpicdn.net/img/view/2019/2/9/1957615.png,0,0.999750554561615,2784,0,5496,2589,2712,2589,twilight sparkle,chainchomp2
1960619.png,https://derpicdn.net/img/view/2019/2/13/1960619.png,0,0.974681794643402,0,0,868,852,868,852,twilight sparkle,lilliesinthegarden
1963058.png,https://derpicdn.net/img/view/2019/2/15/1963058.png,0,0.9779511094093324,121,80,845,804,724,724,twilight sparkle,radiantrealm
1963060.png,https://derpicdn.net/img/view/2019/2/15/1963060.png,0,0.9209783673286438,99,56,881,838,782,782,twilight sparkle,radiantrealm
1963061.png,https://derpicdn.net/img/view/2019/2/15/1963061.png,0,0.9308722019195556,116,108,848,840,732,732,twilight sparkle,radiantrealm
1963273.png,https://derpicdn.net/img/view/2019/2/16/1963273.png,0,0.9954411387443542,1668,0,4872,3089,3204,3089,twilight sparkle,twilirity
1963510.png,https://derpicdn.net/img/view/2019/2/16/1963510.png,0,0.9835922718048096,2849,0,5700,2579,2851,2579,twilight sparkle,mundschenk85
1965803.png,https://derpicdn.net/img/view/2019/2/19/1965803.png,0,0.9958446025848388,0,73,315,403,315,330,twilight sparkle,wanderingpegasus
1966145.png,https://derpicdn.net/img/view/2019/2/19/1966145.png,0,0.9099871516227722,77,0,1243,720,1166,720,twilight sparkle,
1966556.png,https://derpicdn.net/img/view/2019/2/19/1966556.png,0,0.9430471062660216,276,68,812,604,536,536,twilight sparkle,
1968402.png,https://derpicdn.net/img/view/2019/2/22/1968402.png,0,0.9319441914558412,68,52,693,734,625,682,twilight sparkle,
1968723.png,https://derpicdn.net/img/view/2019/2/22/1968723.png,0,0.9995704293251038,75,102,453,480,378,378,twilight sparkle,tf-sential
1971144.png,https://derpicdn.net/img/view/2019/2/25/1971144.png,0,0.951471209526062,962,59,1358,455,396,396,twilight sparkle,lupiarts
1971144.png,https://derpicdn.net/img/view/2019/2/25/1971144.png,1,0.936075747013092,411,356,821,766,410,410,twilight sparkle,lupiarts
1978517.png,https://derpicdn.net/img/view/2019/3/6/1978517.png,0,0.9663658738136292,453,0,1315,727,862,727,twilight sparkle,
1978521.png,https://derpicdn.net/img/view/2019/3/6/1978521.png,0,0.9816153049468994,233,0,1159,904,926,904,twilight sparkle,
1978522.png,https://derpicdn.net/img/view/2019/3/6/1978522.png,0,0.9915010929107666,63,67,747,751,684,684,twilight sparkle,
197902.png,https://derpicdn.net/img/view/2012/12/30/197902.png,0,0.9721982479095459,666,6,946,286,280,280,twilight sparkle,kryptid
1979446.png,https://derpicdn.net/img/view/2019/3/7/1979446.png,0,0.9888713359832764,5,24,551,570,546,546,twilight sparkle,
1980099.png,https://derpicdn.net/img/view/2019/3/8/1980099.png,0,0.9704030156135559,252,0,596,312,344,312,twilight sparkle,zeroponycreations
1981226.png,https://derpicdn.net/img/view/2019/3/9/1981226.png,0,0.9928905963897704,363,55,1091,783,728,728,twilight sparkle,yinglongfujun
1982719.png,https://derpicdn.net/img/view/2019/3/11/1982719.png,0,0.99736750125885,0,0,304,306,304,306,twilight sparkle,lulubell
1988107.png,https://derpicdn.net/img/view/2019/3/17/1988107.png,0,0.9994770884513856,887,0,1481,547,594,547,twilight sparkle,novaspark
1991439.png,https://derpicdn.net/img/view/2019/3/21/1991439.png,0,0.997306764125824,681,34,2617,1970,1936,1936,twilight sparkle,aeonkrow
1992510.png,https://derpicdn.net/img/view/2019/3/23/1992510.png,0,0.9714335203170776,0,0,2830,2743,2830,2743,twilight sparkle,andoanimalia
1994610.png,https://derpicdn.net/img/view/2019/3/25/1994610.png,0,0.983083963394165,305,0,1691,1356,1386,1356,twilight sparkle,fensu-san
1994610.png,https://derpicdn.net/img/view/2019/3/25/1994610.png,1,0.9530268907546996,247,1444,1545,2742,1298,1298,twilight sparkle,fensu-san
1995373.png,https://derpicdn.net/img/view/2019/3/26/1995373.png,0,0.9798579216003418,0,0,2224,2276,2224,2226,twilight sparkle,cloudyglow
1997351.png,https://derpicdn.net/img/view/2019/3/29/1997351.png,0,0.9212885499000548,0,104,4750,5246,4750,5142,twilight sparkle,ejlightning007arts
1997511.png,https://derpicdn.net/img/view/2019/3/29/1997511.png,0,0.9860257506370544,0,0,4211,4258,4211,4258,twilight sparkle,andoanimalia
1997849.png,https://derpicdn.net/img/view/2019/3/29/1997849.png,0,0.9667128920555116,791,14,6115,5338,5324,5324,twilight sparkle,andoanimalia
1998192.png,https://derpicdn.net/img/view/2019/3/30/1998192.png,0,0.9986055493354796,0,0,597,573,597,573,twilight sparkle,craftybrony
1999858.png,https://derpicdn.net/img/view/2019/4/1/1999858.png,0,0.9824033975601196,58,0,754,704,696,704,twilight sparkle,
1999860.png,https://derpicdn.net/img/view/2019/4/1/1999860.png,0,0.945307731628418,41,0,749,677,708,677,twilight sparkle,
1999865.png,https://derpicdn.net/img/view/2019/4/1/1999865.png,0,0.9777863621711732,407,0,999,550,592,550,twilight sparkle,
2000611.png,https://derpicdn.net/img/view/2019/4/2/2000611.png,0,0.967002272605896,467,216,2057,1806,1590,1590,twilight sparkle,linklyshow
2009886.png,https://derpicdn.net/img/view/2019/4/12/2009886.png,0,0.9798739552497864,101,137,1475,1511,1374,1374,twilight sparkle,yunnecora
2011569.png,https://derpicdn.net/img/view/2019/4/14/2011569.png,0,0.9873448610305786,672,0,1450,746,778,746,twilight sparkle,phoenixrk49
2013669.png,https://derpicdn.net/img/view/2019/4/15/2013669.png,0,0.9984917044639589,3463,43,5860,2443,2397,2400,twilight sparkle,andoanimalia
2014314.png,https://derpicdn.net/img/view/2019/4/16/2014314.png,0,0.9782652258872986,883,0,2287,1359,1404,1359,twilight sparkle,llhopell
2014839.png,https://derpicdn.net/img/view/2019/4/17/2014839.png,0,0.9601924419403076,357,0,903,496,546,496,twilight sparkle,lambyanxious
2019705.png,https://derpicdn.net/img/view/2019/4/22/2019705.png,0,0.9381836652755736,92,220,3002,3130,2910,2910,twilight sparkle,twilirity
2020619.png,https://derpicdn.net/img/view/2019/4/23/2020619.png,0,0.9695727229118348,26,52,934,960,908,908,twilight sparkle,
2024290.png,https://derpicdn.net/img/view/2019/4/27/2024290.png,0,0.9851820468902588,50,23,476,449,426,426,twilight sparkle,ch-chau
2025782.png,https://derpicdn.net/img/view/2019/4/28/2025782.png,0,0.9994913339614868,1359,0,2027,537,668,537,twilight sparkle,
2025782.png,https://derpicdn.net/img/view/2019/4/28/2025782.png,1,0.9993476271629332,767,0,1425,589,658,589,twilight sparkle,
2026014.png,https://derpicdn.net/img/view/2019/4/28/2026014.png,0,0.9861463904380798,758,0,1920,986,1162,986,twilight sparkle,
2026117.png,https://derpicdn.net/img/view/2019/4/29/2026117.png,0,0.9981305599212646,0,35,625,679,625,644,twilight sparkle,flushthebatsanta|phucknuckl
2027114.png,https://derpicdn.net/img/view/2019/4/30/2027114.png,0,0.9608699679374696,1137,95,3000,2047,1863,1952,twilight sparkle,cloudyglow|yanoda
2028077.png,https://derpicdn.net/img/view/2019/5/1/2028077.png,0,0.9922744631767272,229,197,515,483,286,286,twilight sparkle,d.w.h.cn
2028094.png,https://derpicdn.net/img/view/2019/5/1/2028094.png,0,0.9587999582290648,0,0,3000,3282,3000,3282,twilight sparkle,cloudyglow
2028618.png,https://derpicdn.net/img/view/2019/5/1/2028618.png,0,0.9955602884292604,1205,63,3299,2157,2094,2094,twilight sparkle,ev04kaa
2028848.png,https://derpicdn.net/img/view/2019/5/2/2028848.png,0,0.998132586479187,13,36,1037,1060,1024,1024,twilight sparkle,phucknuckl|glancojusticar
2032474.png,https://derpicdn.net/img/view/2019/5/6/2032474.png,0,0.9630762338638306,24,72,564,612,540,540,twilight sparkle,gloryworm
2034386.png,https://derpicdn.net/img/view/2019/5/9/2034386.png,0,0.9985233545303344,0,0,304,301,304,301,twilight sparkle,
2035967.png,https://derpicdn.net/img/view/2019/5/11/2035967.png,0,0.9984449148178101,100,869,710,1479,610,610,twilight sparkle,异瞳jill
2039124.png,https://derpicdn.net/img/view/2019/5/15/2039124.png,0,0.9812608361244202,33,32,277,276,244,244,twilight sparkle,wanderingpegasus
2039665.png,https://derpicdn.net/img/view/2019/5/15/2039665.png,0,0.9868715405464172,0,0,2123,2082,2123,2082,twilight sparkle,sollace
2044385.png,https://derpicdn.net/img/view/2019/5/20/2044385.png,0,0.9258930087089542,662,617,1948,1903,1286,1286,twilight sparkle,dantethehuman
2044571.png,https://derpicdn.net/img/view/2019/5/20/2044571.png,0,0.9384523034095764,188,0,1926,1360,1738,1360,twilight sparkle,katputze
2047024.png,https://derpicdn.net/img/view/2019/5/23/2047024.png,0,0.9984830021858216,155,12,573,430,418,418,twilight sparkle,jellybeanbullet
2051419.png,https://derpicdn.net/img/view/2019/5/28/2051419.png,0,0.9891130924224854,726,0,1478,734,752,734,twilight sparkle,noodlefreak88
2051673.png,https://derpicdn.net/img/view/2019/5/28/2051673.png,0,0.9800338745117188,51,34,497,488,446,454,twilight sparkle,crystalmagic6
2053894.png,https://derpicdn.net/img/view/2019/5/31/2053894.png,0,0.939994752407074,0,29,441,563,441,534,twilight sparkle,
2054620.png,https://derpicdn.net/img/view/2019/5/31/2054620.png,0,0.9971693754196168,476,49,1148,721,672,672,twilight sparkle,daedoodles
2054620.png,https://derpicdn.net/img/view/2019/5/31/2054620.png,1,0.9969998002052308,81,0,599,485,518,485,twilight sparkle,daedoodles
2058950.png,https://derpicdn.net/img/view/2019/6/6/2058950.png,0,0.9893368482589722,0,0,3768,3476,3768,3476,twilight sparkle,illumnious
2060216.png,https://derpicdn.net/img/view/2019/6/7/2060216.png,0,0.9942864775657654,0,0,365,341,365,341,twilight sparkle,ask-ociel
2061021.png,https://derpicdn.net/img/view/2019/6/8/2061021.png,0,0.9967816472053528,138,24,1104,990,966,966,twilight sparkle,sjart117
2063640.png,https://derpicdn.net/img/view/2019/6/12/2063640.png,0,0.9413929581642152,19,0,277,223,258,223,twilight sparkle,smirk
2064130.png,https://derpicdn.net/img/view/2019/6/13/2064130.png,0,0.9815363883972168,3616,0,7000,3210,3384,3210,twilight sparkle,caliazian
2068097.png,https://derpicdn.net/img/view/2019/6/17/2068097.png,0,0.9182843565940856,7,136,683,812,676,676,twilight sparkle,autumnvoyage
2071073.png,https://derpicdn.net/img/view/2019/6/21/2071073.png,0,0.9997227787971495,1478,523,2194,1239,716,716,twilight sparkle,shad0w-galaxy
2073872.png,https://derpicdn.net/img/view/2019/6/24/2073872.png,0,0.9454196691513062,160,47,1000,905,840,858,twilight sparkle,
2074267.png,https://derpicdn.net/img/view/2019/6/24/2074267.png,0,0.9808698296546936,50,25,826,801,776,776,twilight sparkle,
2074446.png,https://derpicdn.net/img/view/2019/6/24/2074446.png,0,0.9885694980621338,97,1199,349,1451,252,252,twilight sparkle,sintakhra
2074446.png,https://derpicdn.net/img/view/2019/6/24/2074446.png,1,0.9788607954978944,402,375,670,643,268,268,twilight sparkle,sintakhra
2074446.png,https://derpicdn.net/img/view/2019/6/24/2074446.png,2,0.9643883109092712,347,1069,800,1579,453,510,twilight sparkle,sintakhra
2075593.png,https://derpicdn.net/img/view/2019/6/26/2075593.png,0,0.9819173216819764,640,295,1520,1175,880,880,twilight sparkle,mediasmile666
2076816.png,https://derpicdn.net/img/view/2019/6/27/2076816.png,0,0.9491446614265442,1590,183,3144,1737,1554,1554,twilight sparkle,burnflameheart
2078401.png,https://derpicdn.net/img/view/2019/6/29/2078401.png,0,0.999556839466095,0,0,1135,1058,1135,1058,twilight sparkle,etoz
2078401.png,https://derpicdn.net/img/view/2019/6/29/2078401.png,1,0.9917422533035278,1573,484,2511,1422,938,938,twilight sparkle,etoz
2080042.png,https://derpicdn.net/img/view/2019/7/1/2080042.png,0,0.991567075252533,1010,441,1496,927,486,486,twilight sparkle,qweeli
2081236.png,https://derpicdn.net/img/view/2019/7/2/2081236.png,0,0.935417413711548,159,0,387,227,228,227,twilight sparkle,
2087375.png,https://derpicdn.net/img/view/2019/7/9/2087375.png,0,0.9975549578666688,0,25,1199,1227,1199,1202,twilight sparkle,artmlpk
2091864.png,https://derpicdn.net/img/view/2019/7/14/2091864.png,0,0.9762150049209596,229,44,1485,1300,1256,1256,twilight sparkle,lilveon
2095313.png,https://derpicdn.net/img/view/2019/7/18/2095313.png,0,0.9989122152328492,473,0,1157,607,684,607,twilight sparkle,sadtrooper
2097243.png,https://derpicdn.net/img/view/2019/7/21/2097243.png,0,0.9688364863395692,344,38,678,372,334,334,twilight sparkle,renarde-louve
2097888.png,https://derpicdn.net/img/view/2019/7/21/2097888.png,0,0.9104389548301696,154,97,656,599,502,502,twilight sparkle,dragonfoxgirl
2098358.png,https://derpicdn.net/img/view/2019/7/22/2098358.png,0,0.955300271511078,211,0,2489,2221,2278,2221,twilight sparkle,phucknuckl
2098781.png,https://derpicdn.net/img/view/2019/7/22/2098781.png,0,0.9805241823196412,0,42,1829,2088,1829,2046,twilight sparkle,kimjimisarty
2108296.png,https://derpicdn.net/img/view/2019/8/3/2108296.png,0,0.9992369413375854,61,120,1305,1364,1244,1244,twilight sparkle,lakunae
2108308.png,https://derpicdn.net/img/view/2019/8/3/2108308.png,0,0.974002242088318,1475,432,2275,1232,800,800,twilight sparkle,nexcoyotlgt
2108443.png,https://derpicdn.net/img/view/2019/8/4/2108443.png,0,0.9981571435928344,199,0,757,553,558,553,twilight sparkle,colorful-horses
2108671.png,https://derpicdn.net/img/view/2019/8/4/2108671.png,0,0.9747431874275208,34,3,519,509,485,506,twilight sparkle,
2108940.png,https://derpicdn.net/img/view/2019/8/4/2108940.png,0,0.9885293841362,560,0,1608,992,1048,992,twilight sparkle,shad0w-galaxy
2109420.png,https://derpicdn.net/img/view/2019/8/5/2109420.png,0,0.9863829612731934,0,0,2294,2338,2294,2338,twilight sparkle,pizzamovies
2114905.png,https://derpicdn.net/img/view/2019/8/11/2114905.png,0,0.9932757019996644,249,455,1327,1533,1078,1078,twilight sparkle,mazzianz
2115832.png,https://derpicdn.net/img/view/2019/8/12/2115832.png,0,0.991316020488739,207,246,915,954,708,708,twilight sparkle,t72b
2116431.png,https://derpicdn.net/img/view/2019/8/12/2116431.png,0,0.9799486994743348,131,13,731,613,600,600,twilight sparkle,violyreart|violyre
2117354.png,https://derpicdn.net/img/view/2019/8/13/2117354.png,0,0.9886236786842346,26,48,622,644,596,596,twilight sparkle,
2119389.png,https://derpicdn.net/img/view/2019/8/16/2119389.png,0,0.9979367852211,1542,3,3226,1687,1684,1684,twilight sparkle,niggerdrawfag
2122201.png,https://derpicdn.net/img/view/2019/8/19/2122201.png,0,0.9555066227912904,132,53,370,291,238,238,twilight sparkle,zigragirl
2123417.png,https://derpicdn.net/img/view/2019/8/20/2123417.png,0,0.9746628999710084,0,175,3603,4307,3603,4132,twilight sparkle,andoanimalia
2123773.png,https://derpicdn.net/img/view/2019/8/21/2123773.png,0,0.9476771950721741,0,36,2419,2654,2419,2618,twilight sparkle,sketchmcreations
2124580.png,https://derpicdn.net/img/view/2019/8/22/2124580.png,0,0.9848018288612366,959,913,1639,1593,680,680,twilight sparkle,cuttledreams
2124580.png,https://derpicdn.net/img/view/2019/8/22/2124580.png,1,0.9271554946899414,1016,75,1642,701,626,626,twilight sparkle,cuttledreams
2125094.png,https://derpicdn.net/img/view/2019/8/23/2125094.png,0,0.9679670929908752,88,0,586,588,498,588,twilight sparkle,
2126662.png,https://derpicdn.net/img/view/2019/8/24/2126662.png,0,0.9709827303886414,104,60,414,370,310,310,twilight sparkle,crippling depression
2126733.png,https://derpicdn.net/img/view/2019/8/24/2126733.png,0,0.9653509259223938,124,0,1154,923,1030,923,twilight sparkle,
2129454.png,https://derpicdn.net/img/view/2019/8/27/2129454.png,0,0.9871331453323364,356,74,4694,4412,4338,4338,twilight sparkle,andoanimalia
2132059.png,https://derpicdn.net/img/view/2019/8/31/2132059.png,0,0.9803753495216372,1109,1325,1929,2145,820,820,twilight sparkle,cutepencilcase
2135356.png,https://derpicdn.net/img/view/2019/9/3/2135356.png,0,0.9989373683929444,25,0,317,280,292,280,twilight sparkle,renarde-louve
2135356.png,https://derpicdn.net/img/view/2019/9/3/2135356.png,1,0.9946719408035278,793,0,1065,267,272,267,twilight sparkle,renarde-louve
2135356.png,https://derpicdn.net/img/view/2019/9/3/2135356.png,2,0.9926815032958984,401,0,667,260,266,260,twilight sparkle,renarde-louve
2135356.png,https://derpicdn.net/img/view/2019/9/3/2135356.png,3,0.9885659217834472,410,680,696,966,286,286,twilight sparkle,renarde-louve
2135356.png,https://derpicdn.net/img/view/2019/9/3/2135356.png,4,0.9583861231803894,35,718,295,978,260,260,twilight sparkle,renarde-louve
2135356.png,https://derpicdn.net/img/view/2019/9/3/2135356.png,5,0.9552626013755798,824,691,1108,975,284,284,twilight sparkle,renarde-louve
2136861.png,https://derpicdn.net/img/view/2019/9/5/2136861.png,0,0.9575300812721252,0,1,4819,5183,4819,5182,twilight sparkle,caliazian
2138016.png,https://derpicdn.net/img/view/2019/9/6/2138016.png,0,0.9958091974258424,496,0,3424,2880,2928,2880,twilight sparkle,digimonlover101
2138019.png,https://derpicdn.net/img/view/2019/9/6/2138019.png,0,0.9903079271316528,10,0,332,404,322,404,twilight sparkle,
2138550.png,https://derpicdn.net/img/view/2019/9/7/2138550.png,0,0.9716125726699828,1745,94,2819,1168,1074,1074,twilight sparkle,deannaphantom13
2138705.png,https://derpicdn.net/img/view/2019/9/7/2138705.png,0,0.9889096021652222,0,0,2708,2620,2708,2620,twilight sparkle,suramii
2138845.png,https://derpicdn.net/img/view/2019/9/7/2138845.png,0,0.9975873231887816,569,0,973,392,404,392,twilight sparkle,tf-sential
2139476.png,https://derpicdn.net/img/view/2019/9/8/2139476.png,0,0.9963003993034364,933,0,1725,789,792,789,twilight sparkle,angellightyt
2149749.png,https://derpicdn.net/img/view/2019/9/21/2149749.png,0,0.9973212480545044,0,388,337,734,337,346,twilight sparkle,aco77aco
2149749.png,https://derpicdn.net/img/view/2019/9/21/2149749.png,1,0.9490286707878112,318,1,598,281,280,280,twilight sparkle,aco77aco
215060.png,https://derpicdn.net/img/view/2013/1/17/215060.png,0,0.9990156888961792,62,10,446,394,384,384,twilight sparkle,ailatf
2152181.png,https://derpicdn.net/img/view/2019/9/24/2152181.png,0,0.9977600574493408,783,0,3197,2414,2414,2414,twilight sparkle,therealakineko
2153112.png,https://derpicdn.net/img/view/2019/9/25/2153112.png,0,0.9823623895645142,170,0,808,539,638,539,twilight sparkle,gardianripu
2154676.png,https://derpicdn.net/img/view/2019/9/28/2154676.png,0,0.9859590530395508,36,0,402,358,366,358,twilight sparkle,dragonfruitdarigan
2155752.png,https://derpicdn.net/img/view/2019/9/29/2155752.png,0,0.9684684872627258,0,0,534,534,534,534,twilight sparkle,sandwichbuns
215634.png,https://derpicdn.net/img/view/2013/1/17/215634.png,0,0.9865466356277466,460,376,968,884,508,508,twilight sparkle,navitaserussirus
2157281.png,https://derpicdn.net/img/view/2019/10/1/2157281.png,0,0.9968209862709044,404,0,618,211,214,211,twilight sparkle,caroo
2158444.png,https://derpicdn.net/img/view/2019/10/2/2158444.png,0,0.9942461848258972,91,0,749,646,658,646,twilight sparkle,zalakir
2158604.png,https://derpicdn.net/img/view/2019/10/2/2158604.png,0,0.9835577011108398,0,408,2664,3288,2664,2880,twilight sparkle,liddieneko|sollace
2165864.png,https://derpicdn.net/img/view/2019/10/11/2165864.png,0,0.988927721977234,0,0,1342,1353,1342,1353,twilight sparkle,9centschange
2165865.png,https://derpicdn.net/img/view/2019/10/11/2165865.png,0,0.9876389503479004,0,0,1340,1353,1340,1353,twilight sparkle,9centschange
2167231.png,https://derpicdn.net/img/view/2019/10/13/2167231.png,0,0.9959083795547484,30,0,552,521,522,521,twilight sparkle,polymercorgi
2168808.png,https://derpicdn.net/img/view/2019/10/14/2168808.png,0,0.9654480218887328,324,39,612,327,288,288,twilight sparkle,
2169001.png,https://derpicdn.net/img/view/2019/10/14/2169001.png,0,0.9579548835754396,359,81,773,495,414,414,twilight sparkle,theo-0
2169122.png,https://derpicdn.net/img/view/2019/10/15/2169122.png,0,0.9958008527755736,126,0,386,248,260,248,twilight sparkle,divided-s
2169207.png,https://derpicdn.net/img/view/2019/10/15/2169207.png,0,0.9893454313278198,24,67,926,939,902,872,twilight sparkle,
2169940.png,https://derpicdn.net/img/view/2019/10/15/2169940.png,0,0.9699794054031372,0,6,491,714,491,708,twilight sparkle,
2172923.png,https://derpicdn.net/img/view/2019/10/18/2172923.png,0,0.9361651539802552,79,0,431,384,352,384,twilight sparkle,
2173119.png,https://derpicdn.net/img/view/2019/10/18/2173119.png,0,0.9867843389511108,636,35,1116,515,480,480,twilight sparkle,icoboo
2174845.png,https://derpicdn.net/img/view/2019/10/20/2174845.png,0,0.9985709190368652,34,0,498,450,464,450,twilight sparkle,sk-ree
2176181.png,https://derpicdn.net/img/view/2019/10/22/2176181.png,0,0.9973799586296082,270,0,1400,1091,1130,1091,twilight sparkle,
2178196.png,https://derpicdn.net/img/view/2019/10/25/2178196.png,0,0.9991549849510192,1668,0,4250,2590,2582,2590,twilight sparkle,90sigma
2180805.png,https://derpicdn.net/img/view/2019/10/28/2180805.png,0,0.9980154037475586,90,0,512,399,422,399,twilight sparkle,glazirka
2182574.png,https://derpicdn.net/img/view/2019/10/30/2182574.png,0,0.9971382021903992,0,132,1720,1870,1720,1738,twilight sparkle,tokokami
2185021.png,https://derpicdn.net/img/view/2019/11/1/2185021.png,0,0.907004415988922,285,0,659,367,374,367,twilight sparkle,
218731.png,https://derpicdn.net/img/view/2013/1/20/218731.png,0,0.9179561138153076,139,440,327,628,188,188,twilight sparkle,unicorn9927
2187651.png,https://derpicdn.net/img/view/2019/11/4/2187651.png,0,0.9969194531440736,359,26,893,560,534,534,twilight sparkle,renarde-louve
2189795.png,https://derpicdn.net/img/view/2019/11/7/2189795.png,1,0.9261412024497986,387,111,853,577,466,466,twilight sparkle,wanderingpegasus
2196083.png,https://derpicdn.net/img/view/2019/11/14/2196083.png,0,0.9851067662239076,858,503,1276,921,418,418,twilight sparkle,atariboy2600
2196083.png,https://derpicdn.net/img/view/2019/11/14/2196083.png,3,0.9663859605789183,1366,215,1640,489,274,274,twilight sparkle,atariboy2600
2196919.png,https://derpicdn.net/img/view/2019/11/15/2196919.png,0,0.9990283846855164,62,0,402,334,340,334,twilight sparkle,georgisse-tyan
2198803.png,https://derpicdn.net/img/view/2019/11/17/2198803.png,0,0.9848406314849854,434,36,1058,660,624,624,twilight sparkle,sweetsismagic
2199449.png,https://derpicdn.net/img/view/2019/11/18/2199449.png,0,0.9979475736618042,818,78,1880,1140,1062,1062,twilight sparkle,allyster-black
2200529.png,https://derpicdn.net/img/view/2019/11/20/2200529.png,0,0.994852602481842,0,0,2332,2462,2332,2462,twilight sparkle,severity-gray
2202886.png,https://derpicdn.net/img/view/2019/11/22/2202886.png,0,0.9785172343254088,0,8,430,468,430,460,twilight sparkle,reapir
2202887.png,https://derpicdn.net/img/view/2019/11/22/2202887.png,0,0.9287157654762268,116,0,500,382,384,382,twilight sparkle,reapir
2204417.png,https://derpicdn.net/img/view/2019/11/24/2204417.png,0,0.9989441633224488,563,0,1345,765,782,765,twilight sparkle,cloudyglow
2205568.png,https://derpicdn.net/img/view/2019/11/25/2205568.png,0,0.9341572523117064,1152,245,1808,901,656,656,twilight sparkle,plinkie_poi
2212000.png,https://derpicdn.net/img/view/2019/12/4/2212000.png,0,0.9585355520248412,0,0,314,390,314,390,twilight sparkle,
2213661.png,https://derpicdn.net/img/view/2019/12/6/2213661.png,0,0.9849238991737366,334,0,912,534,578,534,twilight sparkle,lonerdemiurge_nail
2215184.png,https://derpicdn.net/img/view/2019/12/7/2215184.png,0,0.92228364944458,169,72,1021,924,852,852,twilight sparkle,owlpirate
2215288.png,https://derpicdn.net/img/view/2019/12/7/2215288.png,0,0.9844661951065063,45,130,893,978,848,848,twilight sparkle,xbi
2216.jpg,https://derpicdn.net/img/view/2012/1/24/2216.jpg,0,0.9977206587791444,435,174,769,508,334,334,twilight sparkle,ninjaham
2218037.png,https://derpicdn.net/img/view/2019/12/11/2218037.png,0,0.9852684736251832,390,0,758,334,368,334,twilight sparkle,geometrymathalgebra
2219406.png,https://derpicdn.net/img/view/2019/12/13/2219406.png,0,0.9783263206481934,494,126,960,592,466,466,twilight sparkle,quinntonic
2220668.png,https://derpicdn.net/img/view/2019/12/14/2220668.png,0,0.9993622303009032,379,0,1549,1043,1170,1043,twilight sparkle,nixworld
2222199.png,https://derpicdn.net/img/view/2019/12/16/2222199.png,0,0.9520955085754396,5769,2168,10097,6496,4328,4328,twilight sparkle,andoanimalia
2224033.jpg,https://derpicdn.net/img/view/2019/12/18/2224033.jpg,0,0.9901131987571716,295,40,759,504,464,464,twilight sparkle,pprinceran
2225476.jpg,https://derpicdn.net/img/view/2019/12/20/2225476.jpg,0,0.9968841075897216,284,11,1074,801,790,790,twilight sparkle,pucksterv|styroponyworks
2226875.png,https://derpicdn.net/img/view/2019/12/22/2226875.png,0,0.9875336289405824,238,0,1042,800,804,800,twilight sparkle,galacticflashd
2226896.png,https://derpicdn.net/img/view/2019/12/22/2226896.png,0,0.9826987385749816,189,0,1179,863,990,863,twilight sparkle,galacticflashd
2229565.png,https://derpicdn.net/img/view/2019/12/25/2229565.png,0,0.9940705895423888,180,25,808,653,628,628,twilight sparkle,moon-potion
2230085.png,https://derpicdn.net/img/view/2019/12/25/2230085.png,0,0.9102557897567748,0,85,1012,1127,1012,1042,twilight sparkle,trash anon
2234500.png,https://derpicdn.net/img/view/2019/12/31/2234500.png,0,0.999516487121582,431,772,879,1220,448,448,twilight sparkle,タツオ
2237139.png,https://derpicdn.net/img/view/2020/1/3/2237139.png,0,0.9588636755943298,0,0,427,475,427,475,twilight sparkle,
2237141.png,https://derpicdn.net/img/view/2020/1/3/2237141.png,0,0.9872676730155944,2,11,432,441,430,430,twilight sparkle,
2237205.png,https://derpicdn.net/img/view/2020/1/3/2237205.png,0,0.994570016860962,1605,0,2775,1026,1170,1026,twilight sparkle,starry-tamara
2237888.png,https://derpicdn.net/img/view/2020/1/3/2237888.png,0,0.9613127112388612,0,53,1255,1321,1255,1268,twilight sparkle,creativecocoacookie
2239010.png,https://derpicdn.net/img/view/2020/1/5/2239010.png,0,0.9903544783592224,0,0,1459,1286,1459,1286,twilight sparkle,cuddlelamb
2239905.png,https://derpicdn.net/img/view/2020/1/6/2239905.png,0,0.9952861070632936,732,79,1814,1161,1082,1082,twilight sparkle,decprincess
2240821.png,https://derpicdn.net/img/view/2020/1/7/2240821.png,0,0.9002915024757385,2213,552,3571,1910,1358,1358,twilight sparkle,zoarvek
2241182.png,https://derpicdn.net/img/view/2020/1/7/2241182.png,0,0.9864083528518676,582,7,1188,613,606,606,twilight sparkle,renarde-louve
2241735.jpg,https://derpicdn.net/img/view/2020/1/8/2241735.jpg,0,0.971675455570221,189,162,483,456,294,294,twilight sparkle,moodi
2242434.png,https://derpicdn.net/img/view/2020/1/9/2242434.png,0,0.9975998401641846,2891,1266,4685,3060,1794,1794,twilight sparkle,pony quarantine
2242434.png,https://derpicdn.net/img/view/2020/1/9/2242434.png,1,0.990256667137146,3065,44,4487,1466,1422,1422,twilight sparkle,pony quarantine
2242434.png,https://derpicdn.net/img/view/2020/1/9/2242434.png,2,0.9861570596694946,1436,319,3562,2445,2126,2126,twilight sparkle,pony quarantine
2244857.jpg,https://derpicdn.net/img/view/2020/1/11/2244857.jpg,0,0.99358069896698,277,0,1151,849,874,849,twilight sparkle,lilliesinthegarden
2245911.jpg,https://derpicdn.net/img/view/2020/1/13/2245911.jpg,0,0.973649263381958,475,0,1053,575,578,575,twilight sparkle,scarletskitty12
2248328.png,https://derpicdn.net/img/view/2020/1/15/2248328.png,0,0.9988934993743896,136,3,638,505,502,502,twilight sparkle,lucidlarceny
2249236.png,https://derpicdn.net/img/view/2020/1/16/2249236.png,0,0.9911112189292908,49,0,689,605,640,605,twilight sparkle,noodlefreak88
2252614.png,https://derpicdn.net/img/view/2020/1/20/2252614.png,0,0.9367941617965698,208,8,986,786,778,778,twilight sparkle,andoanimalia
2253172.png,https://derpicdn.net/img/view/2020/1/21/2253172.png,0,0.9884450435638428,491,273,1009,791,518,518,twilight sparkle,spirit-fire360
2256026.png,https://derpicdn.net/img/view/2020/1/24/2256026.png,0,0.9782664179801941,458,0,1108,621,650,621,twilight sparkle,brainiac
2257779.jpg,https://derpicdn.net/img/view/2020/1/26/2257779.jpg,0,0.9907600283622742,381,92,859,570,478,478,twilight sparkle,bloodatius
225818.png,https://derpicdn.net/img/view/2013/1/27/225818.png,0,0.9700666666030884,0,0,210,219,210,219,twilight sparkle,lulubell
2258259.png,https://derpicdn.net/img/view/2020/1/27/2258259.png,0,0.993074595928192,8,42,608,642,600,600,twilight sparkle,rainbow eevee
2262011.jpg,https://derpicdn.net/img/view/2020/1/31/2262011.jpg,0,0.9881376028060912,158,0,1280,1150,1122,1150,twilight sparkle,shaslan
2263462.png,https://derpicdn.net/img/view/2020/2/2/2263462.png,0,0.9731588959693908,685,0,5873,3780,5188,3780,twilight sparkle,looneytunerian
2266342.png,https://derpicdn.net/img/view/2020/2/5/2266342.png,0,0.9987087249755859,680,27,1920,1267,1240,1240,twilight sparkle,lemonsoup
2267492.jpg,https://derpicdn.net/img/view/2020/2/7/2267492.jpg,0,0.9812052845954896,28,17,894,883,866,866,twilight sparkle,m-al
2270186.png,https://derpicdn.net/img/view/2020/2/10/2270186.png,0,0.941956102848053,0,15,361,558,361,543,twilight sparkle,
2271138.png,https://derpicdn.net/img/view/2020/2/11/2271138.png,0,0.999152898788452,845,52,1381,588,536,536,twilight sparkle,sepiakeys
2274107.png,https://derpicdn.net/img/view/2020/2/14/2274107.png,0,0.9858001470565796,53,0,779,481,726,481,twilight sparkle,wandeh
2275667.png,https://derpicdn.net/img/view/2020/2/16/2275667.png,0,0.9893664121627808,479,0,911,431,432,431,twilight sparkle,rainbow eevee
227601.jpg,https://derpicdn.net/img/view/2013/1/29/227601.jpg,0,0.9936090707778932,0,0,298,290,298,290,twilight sparkle,php27
2276315.png,https://derpicdn.net/img/view/2020/2/16/2276315.png,0,0.9957926273345948,1061,144,1579,662,518,518,twilight sparkle,jamescorck
2276315.png,https://derpicdn.net/img/view/2020/2/16/2276315.png,1,0.9854872822761536,417,176,875,634,458,458,twilight sparkle,jamescorck
2278333.jpg,https://derpicdn.net/img/view/2020/2/19/2278333.jpg,0,0.9645388126373292,224,0,1302,1073,1078,1073,twilight sparkle,modularpon
2279534.png,https://derpicdn.net/img/view/2020/2/20/2279534.png,0,0.9983354210853576,1230,0,2332,988,1102,988,twilight sparkle,sadtrooper
2281184.png,https://derpicdn.net/img/view/2020/2/22/2281184.png,0,0.9898486733436584,0,0,668,605,668,605,twilight sparkle,tf-sential
2281187.jpg,https://derpicdn.net/img/view/2020/2/22/2281187.jpg,0,0.9872488975524902,472,0,924,443,452,443,twilight sparkle,tf-sential
2283200.png,https://derpicdn.net/img/view/2020/2/25/2283200.png,0,0.9898066520690918,51,5,725,679,674,674,twilight sparkle,skyeskyekitty
2284573.jpg,https://derpicdn.net/img/view/2020/2/27/2284573.jpg,0,0.9638327956199646,526,23,1148,645,622,622,twilight sparkle,moh_mlp2
228564.png,https://derpicdn.net/img/view/2013/1/30/228564.png,0,0.9945020079612732,1114,245,2174,1305,1060,1060,twilight sparkle,fikakorv
2286240.png,https://derpicdn.net/img/view/2020/2/29/2286240.png,0,0.9722010493278505,877,0,1969,1026,1092,1026,twilight sparkle,alicorn-without-horn
2286299.png,https://derpicdn.net/img/view/2020/2/29/2286299.png,0,0.915410578250885,223,34,1813,1624,1590,1590,twilight sparkle,galinn-arts
2292205.png,https://derpicdn.net/img/view/2020/3/7/2292205.png,0,0.9658309817314148,2799,656,4845,2702,2046,2046,twilight sparkle,lavenderheartsmlp
2293646.png,https://derpicdn.net/img/view/2020/3/9/2293646.png,0,0.9909856915473938,207,109,1413,1315,1206,1206,twilight sparkle,小huhu狸君呀
2293660.png,https://derpicdn.net/img/view/2020/3/9/2293660.png,0,0.9982569217681884,66,25,704,663,638,638,twilight sparkle,小huhu狸君呀
2295543.png,https://derpicdn.net/img/view/2020/3/12/2295543.png,0,0.9244276285171508,470,138,1076,744,606,606,twilight sparkle,fanaticpanda
2297.png,https://derpicdn.net/img/view/2012/1/25/2297.png,0,0.9115819334983826,0,55,495,609,495,554,twilight sparkle,kevinbolk
2297061.png,https://derpicdn.net/img/view/2020/3/14/2297061.png,0,0.9967349767684937,259,32,481,254,222,222,twilight sparkle,tf-sential
2298563.png,https://derpicdn.net/img/view/2020/3/16/2298563.png,0,0.9994257092475892,858,208,1428,778,570,570,twilight sparkle,dusthiel
2301261.jpg,https://derpicdn.net/img/view/2020/3/19/2301261.jpg,0,0.9932094216346741,509,0,2075,1334,1566,1334,twilight sparkle,miss-jessiie
2301497.png,https://derpicdn.net/img/view/2020/3/20/2301497.png,0,0.9967709183692932,677,7,1207,537,530,530,twilight sparkle,bw-2
2301703.png,https://derpicdn.net/img/view/2020/3/20/2301703.png,0,0.9853180646896362,107,15,461,369,354,354,twilight sparkle,agrol
2302112.png,https://derpicdn.net/img/view/2020/3/20/2302112.png,0,0.9111464023590088,80,0,1238,1157,1158,1157,twilight sparkle,bublebee123
2302729.png,https://derpicdn.net/img/view/2020/3/21/2302729.png,0,0.9924776554107666,29,0,629,560,600,560,twilight sparkle,ali-selle
2303610.png,https://derpicdn.net/img/view/2020/3/22/2303610.png,0,0.9318864345550536,861,0,2281,1312,1420,1312,twilight sparkle,rurihal
230421.jpg,https://derpicdn.net/img/view/2013/2/1/230421.jpg,0,0.9416979551315308,311,67,487,243,176,176,twilight sparkle,
2304236.jpg,https://derpicdn.net/img/view/2020/3/23/2304236.jpg,0,0.9493995308876038,172,435,868,1131,696,696,twilight sparkle,nyota71
2309210.png,https://derpicdn.net/img/view/2020/3/29/2309210.png,0,0.9483674168586732,0,0,651,672,651,672,twilight sparkle,twic0rd
2309602.png,https://derpicdn.net/img/view/2020/3/30/2309602.png,0,0.9800418019294742,658,0,4075,2869,3417,2869,twilight sparkle,sketchmcreations
2311502.jpg,https://derpicdn.net/img/view/2020/4/1/2311502.jpg,0,0.9081719517707824,552,0,1000,413,448,413,twilight sparkle,riukime
2311516.png,https://derpicdn.net/img/view/2020/4/1/2311516.png,0,0.9816246032714844,0,52,592,742,592,690,twilight sparkle,
2312755.jpg,https://derpicdn.net/img/view/2020/4/3/2312755.jpg,0,0.9611788988113404,530,17,1400,887,870,870,twilight sparkle,liaaqila
2319421.png,https://derpicdn.net/img/view/2020/4/11/2319421.png,0,0.9953948259353638,83,0,913,822,830,822,twilight sparkle,mrstrats
2320544.jpg,https://derpicdn.net/img/view/2020/4/12/2320544.jpg,0,0.9758871793746948,1056,164,1558,666,502,502,twilight sparkle,phathusa
2321137.png,https://derpicdn.net/img/view/2020/4/13/2321137.png,0,0.975497543811798,199,0,555,344,356,344,twilight sparkle,fractiouslemon
2321230.jpg,https://derpicdn.net/img/view/2020/4/13/2321230.jpg,0,0.9468675255775452,256,0,2415,2169,2159,2169,twilight sparkle,bloodatius
2323334.png,https://derpicdn.net/img/view/2020/4/15/2323334.png,0,0.9931681752204896,170,0,1388,1144,1218,1144,twilight sparkle,artiks
2324874.jpg,https://derpicdn.net/img/view/2020/4/17/2324874.jpg,0,0.9982321858406068,1621,1313,2437,2129,816,816,twilight sparkle,citi
2324874.jpg,https://derpicdn.net/img/view/2020/4/17/2324874.jpg,1,0.9934250712394714,893,1884,1477,2468,584,584,twilight sparkle,citi
2324874.jpg,https://derpicdn.net/img/view/2020/4/17/2324874.jpg,2,0.9926607608795166,1292,249,2086,1043,794,794,twilight sparkle,citi
2324874.jpg,https://derpicdn.net/img/view/2020/4/17/2324874.jpg,3,0.9724820852279664,1,145,1249,1393,1248,1248,twilight sparkle,citi
2325341.png,https://derpicdn.net/img/view/2020/4/18/2325341.png,0,0.9745509028434752,0,139,836,976,836,837,twilight sparkle,kingdark0001
2325665.jpg,https://derpicdn.net/img/view/2020/4/18/2325665.jpg,1,0.9609055519104004,1995,1794,2363,2162,368,368,twilight sparkle,citi
232683.png,https://derpicdn.net/img/view/2013/2/3/232683.png,0,0.9829405546188354,0,1030,2243,3362,2243,2332,twilight sparkle,dentist73548
2330993.jpg,https://derpicdn.net/img/view/2020/4/25/2330993.jpg,0,0.9973941445350648,266,0,1166,936,900,936,twilight sparkle,empty-soupcan
2331690.png,https://derpicdn.net/img/view/2020/4/25/2331690.png,0,0.9969466328620912,369,0,991,614,622,614,twilight sparkle,gouransion
2332296.png,https://derpicdn.net/img/view/2020/4/26/2332296.png,0,0.908339262008667,14,2,966,954,952,952,twilight sparkle,symbianl|mochi2-arts
2332619.png,https://derpicdn.net/img/view/2020/4/26/2332619.png,0,0.9100877642631532,84,0,1036,720,952,720,twilight sparkle,
2338914.jpg,https://derpicdn.net/img/view/2020/5/4/2338914.jpg,0,0.9403076767921448,680,631,984,935,304,304,twilight sparkle,alexvanarsdale
2339222.jpg,https://derpicdn.net/img/view/2020/5/4/2339222.jpg,0,0.9945648312568665,58,56,852,850,794,794,twilight sparkle,noupie
2340107.png,https://derpicdn.net/img/view/2020/5/5/2340107.png,0,0.9945310950279236,298,27,724,453,426,426,twilight sparkle,shad0w-galaxy
2340387.jpg,https://derpicdn.net/img/view/2020/5/5/2340387.jpg,0,0.9959917664527892,459,2,1225,768,766,766,twilight sparkle,leslers
2341484.png,https://derpicdn.net/img/view/2020/5/7/2341484.png,0,0.9701706171035768,225,0,2245,1440,2020,1440,twilight sparkle,aryatheeditor
2344474.jpg,https://derpicdn.net/img/view/2020/5/10/2344474.jpg,0,0.9684308767318726,1381,8,1931,558,550,550,twilight sparkle,creeate97
2344474.jpg,https://derpicdn.net/img/view/2020/5/10/2344474.jpg,1,0.9386590123176576,130,387,708,965,578,578,twilight sparkle,creeate97
2345787.jpg,https://derpicdn.net/img/view/2020/5/11/2345787.jpg,0,0.9621546268463136,90,95,450,455,360,360,twilight sparkle,autogatos
2346215.jpg,https://derpicdn.net/img/view/2020/5/12/2346215.jpg,0,0.9962501525878906,486,79,1006,599,520,520,twilight sparkle,cyzarineinkling
2346437.png,https://derpicdn.net/img/view/2020/5/12/2346437.png,0,0.9610223770141602,292,0,3042,2695,2750,2695,twilight sparkle,fakskis
2348614.png,https://derpicdn.net/img/view/2020/5/14/2348614.png,0,0.9786304235458374,933,455,3153,2675,2220,2220,twilight sparkle,kawaiicreative
2349012.png,https://derpicdn.net/img/view/2020/5/15/2349012.png,0,0.9653743505477904,0,0,507,533,507,533,twilight sparkle,
2349366.png,https://derpicdn.net/img/view/2020/5/15/2349366.png,0,0.9604074954986572,1068,0,2416,1319,1348,1319,twilight sparkle,cloudyglow
2349831.png,https://derpicdn.net/img/view/2020/5/16/2349831.png,0,0.993100881576538,77,0,793,704,716,704,twilight sparkle,
2351749.png,https://derpicdn.net/img/view/2020/5/18/2351749.png,0,0.9658390879631042,122,0,888,659,766,659,twilight sparkle,threetwotwo32232
2353109.png,https://derpicdn.net/img/view/2020/5/20/2353109.png,0,0.9737759828567504,171,50,481,360,310,310,twilight sparkle,dongoverlord
2353538.png,https://derpicdn.net/img/view/2020/5/20/2353538.png,0,0.9909133911132812,1468,676,2182,1390,714,714,twilight sparkle,inlaru
2355575.png,https://derpicdn.net/img/view/2020/5/22/2355575.png,0,0.9813115000724792,629,774,2119,2264,1490,1490,twilight sparkle,greenbrothersart
2356125.jpg,https://derpicdn.net/img/view/2020/5/23/2356125.jpg,0,0.9779798984527588,174,0,1260,1038,1086,1038,twilight sparkle,nekosnicker
2356431.png,https://derpicdn.net/img/view/2020/5/24/2356431.png,0,0.9957472681999208,363,41,1147,825,784,784,twilight sparkle,sugar morning
239009.png,https://derpicdn.net/img/view/2013/2/10/239009.png,0,0.9903039336204528,61,162,419,520,358,358,twilight sparkle,pekou
241884.png,https://derpicdn.net/img/view/2013/2/13/241884.png,0,0.9551029205322266,379,0,859,477,480,477,twilight sparkle,grumblepluck
24564.png,https://derpicdn.net/img/view/2012/6/29/24564.png,0,0.9359629154205322,286,0,688,380,402,380,twilight sparkle,
245657.png,https://derpicdn.net/img/view/2013/2/16/245657.png,0,0.967106819152832,263,243,589,569,326,326,twilight sparkle,renaifoxi
246423.png,https://derpicdn.net/img/view/2013/2/17/246423.png,0,0.9149717092514038,634,255,1504,1125,870,870,twilight sparkle,pony-boggle|softcoremirth
248158.jpg,https://derpicdn.net/img/view/2013/2/18/248158.jpg,0,0.993166208267212,327,0,725,396,398,396,twilight sparkle,joakaha
249558.png,https://derpicdn.net/img/view/2013/2/20/249558.png,0,0.9957340955734252,208,0,674,432,466,432,twilight sparkle,si1vr
251176.png,https://derpicdn.net/img/view/2013/2/21/251176.png,0,0.9855058193206788,307,54,513,260,206,206,twilight sparkle,theluckyangel
251466.png,https://derpicdn.net/img/view/2013/2/22/251466.png,0,0.9778685569763184,22,163,838,979,816,816,twilight sparkle,digitalclay
255241.png,https://derpicdn.net/img/view/2013/2/25/255241.png,0,0.9673197865486144,377,0,755,356,378,356,twilight sparkle,kittehkatbar
25647.png,https://derpicdn.net/img/view/2012/6/29/25647.png,0,0.9977411031723022,335,346,659,670,324,324,twilight sparkle,madmax
25647.png,https://derpicdn.net/img/view/2012/6/29/25647.png,1,0.9883525371551514,1148,299,1500,651,352,352,twilight sparkle,madmax
25647.png,https://derpicdn.net/img/view/2012/6/29/25647.png,2,0.9611196517944336,869,303,1245,679,376,376,twilight sparkle,madmax
256935.png,https://derpicdn.net/img/view/2013/2/27/256935.png,0,0.9939064383506776,825,166,2719,2060,1894,1894,twilight sparkle,hungrysohma
26163.jpg,https://derpicdn.net/img/view/2012/6/30/26163.jpg,0,0.9823110699653624,242,92,634,484,392,392,twilight sparkle,johnjoseco
26353.png,https://derpicdn.net/img/view/2012/6/30/26353.png,0,0.9252591133117676,206,37,928,759,722,722,twilight sparkle,thex-plotion
264778.png,https://derpicdn.net/img/view/2013/3/7/264778.png,0,0.9807286858558656,339,0,1373,934,1034,934,twilight sparkle,pauuhanthothecat
271517.png,https://derpicdn.net/img/view/2013/3/15/271517.png,0,0.9107062816619872,110,43,590,523,480,480,twilight sparkle,arnachy
272673.png,https://derpicdn.net/img/view/2013/3/17/272673.png,0,0.9440889954566956,78,0,666,568,588,568,twilight sparkle,rainbowdrool
277514.png,https://derpicdn.net/img/view/2013/3/23/277514.png,0,0.9573839902877808,516,417,860,761,344,344,twilight sparkle,alasou
281941.png,https://derpicdn.net/img/view/2013/3/28/281941.png,0,0.996588170528412,194,0,730,524,536,524,twilight sparkle,ahrimatt
284869.png,https://derpicdn.net/img/view/2013/4/1/284869.png,0,0.9643893837928772,36,0,616,477,580,477,twilight sparkle,strangemoose
287289.jpg,https://derpicdn.net/img/view/2013/4/3/287289.jpg,0,0.9397674202919006,28,84,584,640,556,556,twilight sparkle,gamermac
287421.png,https://derpicdn.net/img/view/2013/4/3/287421.png,0,0.967357575893402,0,0,1048,1029,1048,1029,twilight sparkle,aruurara
290055.png,https://derpicdn.net/img/view/2013/4/6/290055.png,0,0.9854972958564758,488,934,4968,4824,4480,3890,twilight sparkle,zutheskunk traces
292584.jpg,https://derpicdn.net/img/view/2013/4/9/292584.jpg,0,0.9664070606231692,289,0,769,464,480,464,twilight sparkle,black-rose-studios
294088.png,https://derpicdn.net/img/view/2013/4/10/294088.png,0,0.9977073073387146,100,124,1118,1142,1018,1018,twilight sparkle,nekocrispy
296822.png,https://derpicdn.net/img/view/2013/4/13/296822.png,0,0.9938547015190125,32,17,418,403,386,386,twilight sparkle,sanraia
300714.png,https://derpicdn.net/img/view/2013/4/17/300714.png,0,0.9042611122131348,109,99,407,397,298,298,twilight sparkle,sharmie
306792.png,https://derpicdn.net/img/view/2013/4/24/306792.png,0,0.952155828475952,577,563,1145,1131,568,568,twilight sparkle,konrax
309373.jpg,https://derpicdn.net/img/view/2013/4/27/309373.jpg,0,0.9130555987358092,0,0,805,740,805,740,twilight sparkle,kayla-la
310075.jpg,https://derpicdn.net/img/view/2013/4/27/310075.jpg,0,0.9550992846488952,447,83,913,549,466,466,twilight sparkle,jowybean
312799.jpg,https://derpicdn.net/img/view/2013/4/30/312799.jpg,0,0.9940877556800842,254,0,720,566,466,566,twilight sparkle,yuji8sushi
321600.png,https://derpicdn.net/img/view/2013/5/10/321600.png,0,0.982397198677063,90,128,630,668,540,540,twilight sparkle,blackswhites
32466.png,https://derpicdn.net/img/view/2012/7/5/32466.png,0,0.9711105823516846,0,21,223,248,223,227,twilight sparkle,furseiseki
324802.jpg,https://derpicdn.net/img/view/2013/5/14/324802.jpg,0,0.9802599549293518,87,73,297,283,210,210,twilight sparkle,ichibangravity
326110.png,https://derpicdn.net/img/view/2013/5/16/326110.png,0,0.9558191299438475,67,190,389,512,322,322,twilight sparkle,pegacornss
326745.png,https://derpicdn.net/img/view/2013/5/16/326745.png,0,0.9992930889129642,184,2,432,250,248,248,twilight sparkle,mewball|allosaurus
327949.png,https://derpicdn.net/img/view/2013/5/18/327949.png,0,0.9509682655334472,46,17,370,341,324,324,twilight sparkle,mrasianhappydude
33148.png,https://derpicdn.net/img/view/2012/7/5/33148.png,0,0.95743989944458,0,26,2482,2604,2482,2578,twilight sparkle,kittyhawk-contrail
334256.png,https://derpicdn.net/img/view/2013/5/26/334256.png,0,0.9991323947906494,518,51,812,345,294,294,twilight sparkle,phallen1
336358.png,https://derpicdn.net/img/view/2013/5/29/336358.png,0,0.9863383173942566,118,84,558,524,440,440,twilight sparkle,kaermter
337639.png,https://derpicdn.net/img/view/2013/5/31/337639.png,0,0.9499862790107728,394,342,1106,1054,712,712,twilight sparkle,assasinmonkey
338533.png,https://derpicdn.net/img/view/2013/6/1/338533.png,0,0.942942202091217,177,0,943,707,766,707,twilight sparkle,underwearninja
341213.png,https://derpicdn.net/img/view/2013/6/5/341213.png,0,0.9844387769699096,8,21,346,359,338,338,twilight sparkle,spainfischer|kenket
348452.png,https://derpicdn.net/img/view/2013/6/14/348452.png,0,0.9925829768180848,68,121,730,783,662,662,twilight sparkle,familyof6
349855.jpg,https://derpicdn.net/img/view/2013/6/16/349855.jpg,0,0.9757766723632812,17,0,625,574,608,574,twilight sparkle,nonananana
353388.png,https://derpicdn.net/img/view/2013/6/21/353388.png,0,0.9743692874908448,2245,341,3285,1381,1040,1040,twilight sparkle,jaquelindreamz
356100.png,https://derpicdn.net/img/view/2013/6/24/356100.png,0,0.9001354575157166,49,0,511,376,462,376,twilight sparkle,ranban
358496.png,https://derpicdn.net/img/view/2013/6/27/358496.png,0,0.9929723143577576,0,65,558,641,558,576,twilight sparkle,sharmie
3615.png,https://derpicdn.net/img/view/2012/2/28/3615.png,0,0.930129051208496,409,0,900,503,491,503,twilight sparkle,jesrartes
367724.png,https://derpicdn.net/img/view/2013/7/8/367724.png,0,0.99322247505188,122,3,684,565,562,562,twilight sparkle,couldysky
370235.png,https://derpicdn.net/img/view/2013/7/11/370235.png,0,0.980338454246521,441,283,1523,1365,1082,1082,twilight sparkle,couratiel
376779.png,https://derpicdn.net/img/view/2013/7/17/376779.png,0,0.9913082718849182,325,26,759,460,434,434,twilight sparkle,flarities
379768.png,https://derpicdn.net/img/view/2013/7/20/379768.png,0,0.9464895725250244,691,14,1280,648,589,634,twilight sparkle,ensayne
380364.png,https://derpicdn.net/img/view/2013/7/21/380364.png,0,0.9189959764480592,423,464,1039,1080,616,616,twilight sparkle,maren
380913.png,https://derpicdn.net/img/view/2013/7/22/380913.png,0,0.9569064974784852,40,0,518,458,478,458,twilight sparkle,mewball
38134.jpg,https://derpicdn.net/img/view/2012/7/9/38134.jpg,0,0.9970052242279052,84,10,498,424,414,414,twilight sparkle,johnjoseco
384048.png,https://derpicdn.net/img/view/2013/7/29/384048.png,0,0.9369750618934632,416,576,760,942,344,366,twilight sparkle,dm29
384048.png,https://derpicdn.net/img/view/2013/7/29/384048.png,1,0.9176161289215088,109,0,677,545,568,545,twilight sparkle,dm29
384746.png,https://derpicdn.net/img/view/2013/7/29/384746.png,0,0.9401190280914308,203,122,609,528,406,406,twilight sparkle,jamescorck
387376.png,https://derpicdn.net/img/view/2013/7/31/387376.png,0,0.9893865585327148,170,0,670,493,500,493,twilight sparkle,ghost
390008.png,https://derpicdn.net/img/view/2013/8/3/390008.png,0,0.9992202520370485,301,0,677,366,376,366,twilight sparkle,sandwich-anomaly
39178.jpg,https://derpicdn.net/img/view/2012/7/10/39178.jpg,0,0.9810646176338196,512,4,900,422,388,418,twilight sparkle,maxiria
39691.png,https://derpicdn.net/img/view/2012/7/10/39691.png,0,0.9842829704284668,30,0,492,424,462,424,twilight sparkle,trollie trollenberg|epic-panda17
39715.jpg,https://derpicdn.net/img/view/2012/7/10/39715.jpg,0,0.9846178889274596,281,0,695,395,414,395,twilight sparkle,trollie trollenberg
39716.jpg,https://derpicdn.net/img/view/2012/7/10/39716.jpg,0,0.998669683933258,238,6,580,348,342,342,twilight sparkle,trollie trollenberg
397179.png,https://derpicdn.net/img/view/2013/8/11/397179.png,0,0.9974188804626464,215,110,1319,1214,1104,1104,twilight sparkle,bluntwhiskey
398618.png,https://derpicdn.net/img/view/2013/8/12/398618.png,0,0.9979509115219116,318,16,2840,2538,2522,2522,twilight sparkle,agamnentzar|mactavish1996
399472.png,https://derpicdn.net/img/view/2013/8/13/399472.png,0,0.9981397986412048,500,0,1838,1295,1338,1295,twilight sparkle,negasun
399974.png,https://derpicdn.net/img/view/2013/8/14/399974.png,0,0.9883878231048584,62,5,546,489,484,484,twilight sparkle,toodles3702
400001.png,https://derpicdn.net/img/view/2013/8/14/400001.png,0,0.994175910949707,43,0,313,250,270,250,twilight sparkle,srsishere
401211.png,https://derpicdn.net/img/view/2013/8/15/401211.png,0,0.9882733821868896,341,395,2645,2699,2304,2304,twilight sparkle,kibbiethegreat
402640.jpg,https://derpicdn.net/img/view/2013/8/17/402640.jpg,0,0.9893822669982908,0,0,363,317,363,317,twilight sparkle,c-minded
402773.jpg,https://derpicdn.net/img/view/2013/8/17/402773.jpg,0,0.9905245304107666,676,70,1040,434,364,364,twilight sparkle,zokkili
402773.jpg,https://derpicdn.net/img/view/2013/8/17/402773.jpg,1,0.9578469395637512,112,0,500,354,388,354,twilight sparkle,zokkili
405139.jpg,https://derpicdn.net/img/view/2013/8/20/405139.jpg,0,0.9027827978134156,651,70,1515,934,864,864,twilight sparkle,my-magic-dream
407136.jpg,https://derpicdn.net/img/view/2013/8/22/407136.jpg,0,0.9878529906272888,588,0,1178,573,590,573,twilight sparkle,frankier77
407137.png,https://derpicdn.net/img/view/2013/8/22/407137.png,0,0.9996845126152042,258,0,838,559,580,559,twilight sparkle,
407416.jpg,https://derpicdn.net/img/view/2013/8/22/407416.jpg,0,0.9672595858573914,68,0,430,328,362,328,twilight sparkle,kiriya
410320.png,https://derpicdn.net/img/view/2013/8/25/410320.png,0,0.985029399394989,300,7,754,461,454,454,twilight sparkle,hounan
414454.png,https://derpicdn.net/img/view/2013/8/30/414454.png,0,0.9357898831367492,274,95,542,363,268,268,twilight sparkle,rariedash
417332.jpg,https://derpicdn.net/img/view/2013/9/2/417332.jpg,0,0.9945221543312072,0,85,936,1149,936,1064,twilight sparkle,gamermac
418753.png,https://derpicdn.net/img/view/2013/9/4/418753.png,0,0.9529038071632384,94,21,468,395,374,374,twilight sparkle,wiggles
420319.png,https://derpicdn.net/img/view/2013/9/6/420319.png,0,0.9914227128028872,51,0,345,268,294,268,twilight sparkle,secret-pony
424205.png,https://derpicdn.net/img/view/2013/9/10/424205.png,0,0.9741788506507874,258,24,702,468,444,444,twilight sparkle,thattagen
424829.png,https://derpicdn.net/img/view/2013/9/11/424829.png,0,0.9927310347557068,464,2951,1262,3749,798,798,twilight sparkle,kitsunehino
42519.png,https://derpicdn.net/img/view/2012/7/13/42519.png,0,0.9795116782188416,219,236,421,438,202,202,twilight sparkle,foxinshadow
430386.png,https://derpicdn.net/img/view/2013/9/18/430386.png,0,0.9075391888618468,228,0,1642,1371,1414,1371,twilight sparkle,yukomaussi
434514.png,https://derpicdn.net/img/view/2013/9/25/434514.png,0,0.9960570931434632,256,63,536,343,280,280,twilight sparkle,collaredginger
451528.jpg,https://derpicdn.net/img/view/2013/10/18/451528.jpg,0,0.9984651207923888,16,123,396,503,380,380,twilight sparkle,foxenawolf
455217.jpg,https://derpicdn.net/img/view/2013/10/24/455217.jpg,0,0.999431312084198,281,0,1419,1138,1138,1138,twilight sparkle,bluntwhiskey
459452.png,https://derpicdn.net/img/view/2013/10/29/459452.png,0,0.9984588623046876,0,0,196,190,196,190,twilight sparkle,lulubell
463530.jpg,https://derpicdn.net/img/view/2013/11/3/463530.jpg,0,0.9814075827598572,2,59,489,590,487,531,twilight sparkle,
464418.png,https://derpicdn.net/img/view/2013/11/4/464418.png,0,0.9952715039253236,467,0,659,188,192,188,twilight sparkle,brianblackberry
464418.png,https://derpicdn.net/img/view/2013/11/4/464418.png,1,0.9908775687217712,82,254,260,432,178,178,twilight sparkle,brianblackberry
464876.png,https://derpicdn.net/img/view/2013/11/5/464876.png,0,0.9995136857032776,488,0,936,429,448,429,twilight sparkle,amphoera
466527.png,https://derpicdn.net/img/view/2013/11/7/466527.png,0,0.9382123947143556,245,88,659,502,414,414,twilight sparkle,thattagen
4685.png,https://derpicdn.net/img/view/2012/6/17/4685.png,0,0.9766510128974916,633,0,993,279,360,279,twilight sparkle,rizcifra
470527.png,https://derpicdn.net/img/view/2013/11/11/470527.png,0,0.9732708930969238,0,193,1052,1337,1052,1144,twilight sparkle,slitherpon
470548.png,https://derpicdn.net/img/view/2013/11/12/470548.png,0,0.9883272051811218,206,0,880,624,674,624,twilight sparkle,goosebumps-fan57
47180.jpg,https://derpicdn.net/img/view/2012/7/17/47180.jpg,0,0.984185516834259,0,0,604,633,604,633,twilight sparkle,mysticalpha
479005.jpg,https://derpicdn.net/img/view/2013/11/23/479005.jpg,0,0.9809041023254396,122,12,648,538,526,526,twilight sparkle,zokkili
480052.png,https://derpicdn.net/img/view/2013/11/24/480052.png,0,0.9920110702514648,180,0,647,474,467,474,twilight sparkle,ilv
481143.jpg,https://derpicdn.net/img/view/2013/11/25/481143.jpg,0,0.9685831069946288,41,0,1175,720,1134,720,twilight sparkle,
481213.png,https://derpicdn.net/img/view/2013/11/25/481213.png,0,0.9873933792114258,724,409,2660,2345,1936,1936,twilight sparkle,mrcbleck
482258.png,https://derpicdn.net/img/view/2013/11/26/482258.png,0,0.9223986268043518,70,0,666,584,596,584,twilight sparkle,empty-10
483403.png,https://derpicdn.net/img/view/2013/11/27/483403.png,0,0.9988565444946288,0,0,2262,2306,2262,2306,twilight sparkle,theshadowstone
483608.png,https://derpicdn.net/img/view/2013/11/27/483608.png,0,0.9835007786750792,133,0,939,770,806,770,twilight sparkle,agletka
484958.png,https://derpicdn.net/img/view/2013/11/29/484958.png,0,0.9200085997581482,820,103,1586,869,766,766,twilight sparkle,kippzu
485111.png,https://derpicdn.net/img/view/2013/11/29/485111.png,0,0.9976839423179626,186,33,558,405,372,372,twilight sparkle,scobionicle99
485547.png,https://derpicdn.net/img/view/2013/11/29/485547.png,0,0.9780881404876708,78,0,796,669,718,669,twilight sparkle,january3rd
486144.png,https://derpicdn.net/img/view/2013/11/30/486144.png,0,0.9661569595336914,197,0,543,344,346,344,twilight sparkle,miikanism
486714.png,https://derpicdn.net/img/view/2013/12/1/486714.png,0,0.9614354968070984,142,0,1650,1506,1508,1506,twilight sparkle,spikedmauler
488778.png,https://derpicdn.net/img/view/2013/12/3/488778.png,0,0.9980844855308532,202,36,684,518,482,482,twilight sparkle,alasou
489722.png,https://derpicdn.net/img/view/2013/12/5/489722.png,0,0.9285554289817808,91,0,539,384,448,384,twilight sparkle,madmax
498084.png,https://derpicdn.net/img/view/2013/12/15/498084.png,0,0.9795396327972412,2681,1569,4987,3875,2306,2306,twilight sparkle,tim015|dfectivedvice
498822.png,https://derpicdn.net/img/view/2013/12/16/498822.png,0,0.9784485697746276,3499,131,4627,1259,1128,1128,twilight sparkle,zodiacnicola
500186.png,https://derpicdn.net/img/view/2013/12/18/500186.png,0,0.9895954728126526,246,218,604,576,358,358,twilight sparkle,cosmicponye
501698.png,https://derpicdn.net/img/view/2013/12/20/501698.png,0,0.991571009159088,61,0,1573,1423,1512,1423,twilight sparkle,kyodashiro
502889.png,https://derpicdn.net/img/view/2013/12/21/502889.png,0,0.9536013007164,59,52,831,824,772,772,twilight sparkle,
503548.png,https://derpicdn.net/img/view/2013/12/22/503548.png,0,0.9969423413276672,611,44,889,322,278,278,twilight sparkle,foxenawolf
503740.png,https://derpicdn.net/img/view/2013/12/22/503740.png,0,0.9822601079940796,316,0,886,512,570,512,twilight sparkle,booponies
503750.jpg,https://derpicdn.net/img/view/2013/12/22/503750.jpg,0,0.9921108484268188,6,0,272,248,266,248,twilight sparkle,iizuna
503817.png,https://derpicdn.net/img/view/2013/12/22/503817.png,0,0.9197903275489808,429,75,1271,917,842,842,twilight sparkle,kittenlollipop
503915.png,https://derpicdn.net/img/view/2013/12/22/503915.png,0,0.9855043888092041,35,0,581,528,546,528,twilight sparkle,kevinsano
504342.png,https://derpicdn.net/img/view/2013/12/23/504342.png,0,0.9971316456794742,1683,383,2267,967,584,584,twilight sparkle,janji009
504342.png,https://derpicdn.net/img/view/2013/12/23/504342.png,1,0.9738010168075562,546,427,1208,1089,662,662,twilight sparkle,janji009
507367.png,https://derpicdn.net/img/view/2013/12/27/507367.png,0,0.9370591044425964,608,446,1144,982,536,536,twilight sparkle,me
509291.png,https://derpicdn.net/img/view/2013/12/29/509291.png,0,0.9297674894332886,1525,649,2999,2123,1474,1474,twilight sparkle,stainless33
510.png,https://derpicdn.net/img/view/2012/1/16/510.png,0,0.9834941625595092,196,0,4360,4056,4164,4056,twilight sparkle,the smiling pony
511549.png,https://derpicdn.net/img/view/2014/1/1/511549.png,0,0.9774015545845032,599,170,1103,674,504,504,twilight sparkle,ravingfoxie
512641.png,https://derpicdn.net/img/view/2014/1/2/512641.png,0,0.9024801850318908,1880,101,3180,1401,1300,1300,twilight sparkle,strachattack
51294.png,https://derpicdn.net/img/view/2012/7/21/51294.png,0,0.999448835849762,228,3,552,327,324,324,twilight sparkle,kloudmutt
514719.png,https://derpicdn.net/img/view/2014/1/4/514719.png,0,0.997053861618042,141,158,661,678,520,520,twilight sparkle,twizzle|dolly
516543.png,https://derpicdn.net/img/view/2014/1/6/516543.png,0,0.9160609841346741,1020,347,3354,2681,2334,2334,twilight sparkle,dubstepbrony4life|darknisfan1995
517276.png,https://derpicdn.net/img/view/2014/1/6/517276.png,0,0.94871187210083,1065,294,1917,1146,852,852,twilight sparkle,hidden-cat
519597.png,https://derpicdn.net/img/view/2014/1/9/519597.png,0,0.9909846186637878,103,8,431,336,328,328,twilight sparkle,ranban
525893.jpg,https://derpicdn.net/img/view/2014/1/16/525893.jpg,0,0.9915528297424316,92,0,588,483,496,483,twilight sparkle,shu
529619.png,https://derpicdn.net/img/view/2014/1/20/529619.png,0,0.9096431136131288,21,34,269,282,248,248,twilight sparkle,dm29
53392.jpg,https://derpicdn.net/img/view/2012/7/23/53392.jpg,0,0.9454882740974426,854,254,1280,688,426,434,twilight sparkle,sweethd
539183.png,https://derpicdn.net/img/view/2014/1/31/539183.png,0,0.9618469476699828,57,0,304,258,247,258,twilight sparkle,
541935.jpg,https://derpicdn.net/img/view/2014/2/3/541935.jpg,0,0.9658759832382202,6,0,526,494,520,494,twilight sparkle,arareroll
543330.png,https://derpicdn.net/img/view/2014/2/4/543330.png,0,0.9732593894004822,86,0,692,492,606,492,twilight sparkle,k-nattoh
544904.png,https://derpicdn.net/img/view/2014/2/6/544904.png,0,0.9490412473678588,199,33,631,465,432,432,twilight sparkle,theflyingmagpie
544912.png,https://derpicdn.net/img/view/2014/2/6/544912.png,0,0.9117639660835266,134,0,622,483,488,483,twilight sparkle,theflyingmagpie
548558.png,https://derpicdn.net/img/view/2014/2/10/548558.png,0,0.9650630950927734,221,245,953,977,732,732,twilight sparkle,diigii-doll
551376.png,https://derpicdn.net/img/view/2014/2/14/551376.png,0,0.9714540243148804,366,80,674,388,308,308,twilight sparkle,comikazia
551700.jpg,https://derpicdn.net/img/view/2014/2/14/551700.jpg,0,0.9983235001564026,303,21,1067,785,764,764,twilight sparkle,catscratchpaper
552053.png,https://derpicdn.net/img/view/2014/2/14/552053.png,0,0.9804790019989014,1492,52,2788,1348,1296,1296,twilight sparkle,a4r91n
554536.png,https://derpicdn.net/img/view/2014/2/17/554536.png,0,0.9710813760757446,143,43,961,861,818,818,twilight sparkle,pegacornss
556317.png,https://derpicdn.net/img/view/2014/2/19/556317.png,0,0.9946020245552064,144,0,516,368,372,368,twilight sparkle,neoanimegirl
558172.png,https://derpicdn.net/img/view/2014/2/21/558172.png,0,0.9997658133506776,523,0,1183,638,660,638,twilight sparkle,snow angel
558819.png,https://derpicdn.net/img/view/2014/2/22/558819.png,0,0.9827198386192322,72,17,766,711,694,694,twilight sparkle,inlucidreverie
562443.png,https://derpicdn.net/img/view/2014/2/27/562443.png,0,0.9920027256011964,0,0,613,406,613,406,twilight sparkle,jinzhan
563995.png,https://derpicdn.net/img/view/2014/3/1/563995.png,0,0.9733290076255798,279,0,1395,1066,1116,1066,twilight sparkle,90sigma
564858.png,https://derpicdn.net/img/view/2014/3/2/564858.png,0,0.9651824235916138,1390,342,2026,978,636,636,twilight sparkle,php92
565396.png,https://derpicdn.net/img/view/2014/3/2/565396.png,0,0.942940592765808,232,54,740,562,508,508,twilight sparkle,xenon
565603.png,https://derpicdn.net/img/view/2014/3/3/565603.png,0,0.9899090528488159,179,138,619,578,440,440,twilight sparkle,senx
566403.png,https://derpicdn.net/img/view/2014/3/4/566403.png,0,0.9795864820480348,1059,247,1591,779,532,532,twilight sparkle,pony-berserker
567695.png,https://derpicdn.net/img/view/2014/3/6/567695.png,0,0.9986914992332458,1478,1378,1976,1876,498,498,twilight sparkle,blitzdrachin
567695.png,https://derpicdn.net/img/view/2014/3/6/567695.png,1,0.97661954164505,453,0,2000,1545,1547,1545,twilight sparkle,blitzdrachin
571807.png,https://derpicdn.net/img/view/2014/3/11/571807.png,0,0.9852365851402284,538,0,788,198,250,198,twilight sparkle,juicedane
576988.png,https://derpicdn.net/img/view/2014/3/16/576988.png,0,0.9868506193161012,1790,2,3900,2272,2110,2270,twilight sparkle,drawponies
578210.png,https://derpicdn.net/img/view/2014/3/17/578210.png,0,0.932479977607727,0,56,321,392,321,336,twilight sparkle,
578210.png,https://derpicdn.net/img/view/2014/3/17/578210.png,1,0.9083639979362488,370,63,575,313,205,250,twilight sparkle,
578706.png,https://derpicdn.net/img/view/2014/3/18/578706.png,0,0.9577404260635376,0,272,722,1044,722,772,twilight sparkle,drawponies
578923.png,https://derpicdn.net/img/view/2014/3/18/578923.png,0,0.9856563806533812,616,0,1304,667,688,667,twilight sparkle,kerydarling
579243.jpg,https://derpicdn.net/img/view/2014/3/19/579243.jpg,0,0.945772647857666,0,0,500,666,500,666,twilight sparkle,kinkyspree
579767.png,https://derpicdn.net/img/view/2014/3/19/579767.png,0,0.993887424468994,297,0,693,384,396,384,twilight sparkle,christmaslolly
580111.jpg,https://derpicdn.net/img/view/2014/3/20/580111.jpg,0,0.9847431778907776,222,0,728,498,506,498,twilight sparkle,holotuff
580601.png,https://derpicdn.net/img/view/2014/3/20/580601.png,0,0.977028489112854,60,0,592,502,532,502,twilight sparkle,fragnostic
584034.jpg,https://derpicdn.net/img/view/2014/3/24/584034.jpg,0,0.99707293510437,480,0,1140,561,660,561,twilight sparkle,joycall6
585454.png,https://derpicdn.net/img/view/2014/3/26/585454.png,0,0.950321078300476,349,0,641,274,292,274,twilight sparkle,mixermike622
586252.png,https://derpicdn.net/img/view/2014/3/27/586252.png,0,0.9091508388519288,362,0,1048,676,686,676,twilight sparkle,dm29
586337.png,https://derpicdn.net/img/view/2014/3/27/586337.png,0,0.9948413968086244,196,0,1006,775,810,775,twilight sparkle,cold-blooded-twilight
587616.png,https://derpicdn.net/img/view/2014/3/29/587616.png,0,0.9893441796302797,445,56,1141,752,696,696,twilight sparkle,senx
588007.png,https://derpicdn.net/img/view/2014/3/29/588007.png,0,0.9524327516555786,2308,120,3202,1014,894,894,twilight sparkle,threewontoo
589619.png,https://derpicdn.net/img/view/2014/3/31/589619.png,0,0.9002201557159424,2301,172,2725,596,424,424,twilight sparkle,
589890.png,https://derpicdn.net/img/view/2014/3/31/589890.png,0,0.9985988736152648,2075,743,3665,2333,1590,1590,twilight sparkle,ambassad0r
591001.png,https://derpicdn.net/img/view/2014/4/2/591001.png,0,0.9920243620872498,1487,0,2793,1234,1306,1234,twilight sparkle,vird-gi
592498.jpg,https://derpicdn.net/img/view/2014/4/4/592498.jpg,0,0.9994418025016784,166,15,690,539,524,524,twilight sparkle,lil miss jay
593365.png,https://derpicdn.net/img/view/2014/4/5/593365.png,0,0.944025993347168,68,31,721,658,653,627,twilight sparkle,pegacornss
597856.png,https://derpicdn.net/img/view/2014/4/11/597856.png,0,0.97275573015213,324,38,1018,732,694,694,twilight sparkle,mrasianhappydude
598216.png,https://derpicdn.net/img/view/2014/4/11/598216.png,0,0.9952230453491212,49,285,765,1001,716,716,twilight sparkle,queensmil3y
598485.png,https://derpicdn.net/img/view/2014/4/12/598485.png,0,0.9469670057296752,89,0,1339,1218,1250,1218,twilight sparkle,zacatron94
604616.png,https://derpicdn.net/img/view/2014/4/19/604616.png,0,0.9575655460357666,637,166,1366,930,729,764,twilight sparkle,
608958.png,https://derpicdn.net/img/view/2014/4/24/608958.png,0,0.963425874710083,227,412,2419,2620,2192,2208,twilight sparkle,neko-me
609471.png,https://derpicdn.net/img/view/2014/4/25/609471.png,0,0.9931113123893738,951,330,1403,782,452,452,twilight sparkle,ranban
609471.png,https://derpicdn.net/img/view/2014/4/25/609471.png,2,0.9592478275299072,584,91,1070,577,486,486,twilight sparkle,ranban
609529.png,https://derpicdn.net/img/view/2014/4/25/609529.png,0,0.9944035410881042,180,424,3866,4110,3686,3686,twilight sparkle,uxyd|djdavid98
610368.jpg,https://derpicdn.net/img/view/2014/4/26/610368.jpg,0,0.93324077129364,162,0,446,294,284,294,twilight sparkle,
619331.png,https://derpicdn.net/img/view/2014/5/6/619331.png,0,0.9980262517929076,0,35,3839,3957,3839,3922,twilight sparkle,uxyd|djdavid98
620741.png,https://derpicdn.net/img/view/2014/5/8/620741.png,0,0.980193257331848,1414,0,3114,1670,1700,1670,twilight sparkle,theshadowstone
621398.png,https://derpicdn.net/img/view/2014/5/9/621398.png,0,0.942374050617218,316,0,846,495,530,495,twilight sparkle,dm29
621772.png,https://derpicdn.net/img/view/2014/5/9/621772.png,0,0.9226708412170408,2329,135,6000,4483,3671,4348,twilight sparkle,masem
622400.png,https://derpicdn.net/img/view/2014/5/10/622400.png,0,0.9645699858665466,610,11,1142,573,532,562,twilight sparkle,buzer
622420.png,https://derpicdn.net/img/view/2014/5/10/622420.png,0,0.9989629983901978,5568,0,9594,3868,4026,3868,twilight sparkle,atomicmillennial
624610.png,https://derpicdn.net/img/view/2014/5/12/624610.png,0,0.9782176017761228,0,200,271,474,271,274,twilight sparkle,the-doodle-queen
624663.png,https://derpicdn.net/img/view/2014/5/12/624663.png,0,0.9886409640312196,276,49,772,545,496,496,twilight sparkle,krucification
625299.png,https://derpicdn.net/img/view/2014/5/13/625299.png,0,0.9252585768699646,14,0,460,439,446,439,twilight sparkle,dormantflame
628316.png,https://derpicdn.net/img/view/2014/5/16/628316.png,0,0.9938778281211852,1585,67,3075,1557,1490,1490,twilight sparkle,vector-brony
629382.png,https://derpicdn.net/img/view/2014/5/17/629382.png,0,0.9917355179786682,1840,0,3081,1376,1241,1376,twilight sparkle,vector-brony
6318.png,https://derpicdn.net/img/view/2012/6/18/6318.png,0,0.9046552777290344,0,27,750,811,750,784,twilight sparkle,wicklesmack
631868.jpg,https://derpicdn.net/img/view/2014/5/20/631868.jpg,0,0.9874075055122375,20,0,830,761,810,761,twilight sparkle,iizuna
63191.png,https://derpicdn.net/img/view/2012/7/31/63191.png,0,0.901669442653656,310,125,797,596,487,471,twilight sparkle,the weaver
644352.png,https://derpicdn.net/img/view/2014/6/4/644352.png,0,0.9907152056694032,484,1,836,353,352,352,twilight sparkle,petrifish
649811.png,https://derpicdn.net/img/view/2014/6/10/649811.png,0,0.9584638476371764,158,10,360,212,202,202,twilight sparkle,kaji-tanii
650522.png,https://derpicdn.net/img/view/2014/6/11/650522.png,0,0.9897536635398864,8,112,524,628,516,516,twilight sparkle,mn27
650591.png,https://derpicdn.net/img/view/2014/6/11/650591.png,0,0.9051448702812196,319,131,749,561,430,430,twilight sparkle,derpsonhooves
651746.png,https://derpicdn.net/img/view/2014/6/13/651746.png,0,0.90270334482193,20,10,342,332,322,322,twilight sparkle,shacklefunk
656183.jpg,https://derpicdn.net/img/view/2014/6/18/656183.jpg,0,0.9571899175643921,194,0,724,480,530,480,twilight sparkle,prettypinkpony
657562.jpg,https://derpicdn.net/img/view/2014/6/20/657562.jpg,0,0.9871086478233336,391,0,997,593,606,593,twilight sparkle,redanon
657913.png,https://derpicdn.net/img/view/2014/6/20/657913.png,0,0.9874048233032228,79,20,457,398,378,378,twilight sparkle,dear-cotton-candy
661662.png,https://derpicdn.net/img/view/2014/6/26/661662.png,0,0.9848356842994692,0,0,725,751,725,751,twilight sparkle,leapingriver
662528.png,https://derpicdn.net/img/view/2014/6/27/662528.png,0,0.9918172359466552,901,0,2389,1378,1488,1378,twilight sparkle,iados
662713.png,https://derpicdn.net/img/view/2014/6/27/662713.png,0,0.9308821558952332,195,210,1127,1142,932,932,twilight sparkle,danmakuman
664955.png,https://derpicdn.net/img/view/2014/6/30/664955.png,0,0.9767327904701232,215,0,1555,1305,1340,1305,twilight sparkle,porygon2z
665508.png,https://derpicdn.net/img/view/2014/7/1/665508.png,0,0.999647855758667,619,68,1055,504,436,436,twilight sparkle,uncertainstardust
668192.jpg,https://derpicdn.net/img/view/2014/7/5/668192.jpg,0,0.959926187992096,1004,0,1980,943,976,943,twilight sparkle,canvymamamoo
669971.png,https://derpicdn.net/img/view/2014/7/8/669971.png,0,0.9762304425239564,450,0,992,504,542,504,twilight sparkle,pepooni
673352.png,https://derpicdn.net/img/view/2014/7/12/673352.png,0,0.9970077276229858,0,55,340,437,340,382,twilight sparkle,dm29
679944.png,https://derpicdn.net/img/view/2014/7/21/679944.png,0,0.9973995685577391,92,185,3048,3141,2956,2956,twilight sparkle,theshadowstone
684735.png,https://derpicdn.net/img/view/2014/7/27/684735.png,0,0.9976342916488647,349,73,771,495,422,422,twilight sparkle,dragon-cookies
688422.png,https://derpicdn.net/img/view/2014/8/1/688422.png,0,0.9971354007720948,362,62,670,370,308,308,twilight sparkle,thattagen
69236.png,https://derpicdn.net/img/view/2012/8/7/69236.png,0,0.9390251636505128,1613,517,3549,2453,1936,1936,twilight sparkle,scotch208
694434.png,https://derpicdn.net/img/view/2014/8/8/694434.png,0,0.9153647422790528,0,12,1674,1994,1674,1982,twilight sparkle,porygon2z
696047.png,https://derpicdn.net/img/view/2014/8/10/696047.png,0,0.9893759489059448,110,21,1006,917,896,896,twilight sparkle,twotail813
701943.png,https://derpicdn.net/img/view/2014/8/17/701943.png,0,0.9902787208557128,440,24,952,536,512,512,twilight sparkle,toycake
705083.png,https://derpicdn.net/img/view/2014/8/21/705083.png,0,0.9843621253967284,0,0,847,543,847,543,twilight sparkle,foudubulbe
705460.jpg,https://derpicdn.net/img/view/2014/8/22/705460.jpg,0,0.9480084776878356,303,40,811,548,508,508,twilight sparkle,daikoku
707176.png,https://derpicdn.net/img/view/2014/8/24/707176.png,0,0.982455849647522,76,99,1080,1103,1004,1004,twilight sparkle,grayflower
708369.png,https://derpicdn.net/img/view/2014/8/26/708369.png,0,0.97807115316391,80,128,538,586,458,458,twilight sparkle,macheteponies
708411.png,https://derpicdn.net/img/view/2014/8/26/708411.png,0,0.9934898018836976,198,0,816,602,618,602,twilight sparkle,zacatron94
708913.png,https://derpicdn.net/img/view/2014/8/27/708913.png,0,0.9936458468437196,93,58,515,480,422,422,twilight sparkle,sirpayne
710080.png,https://derpicdn.net/img/view/2014/8/28/710080.png,0,0.9844858646392822,185,193,367,375,182,182,twilight sparkle,metal-kitty
710763.jpg,https://derpicdn.net/img/view/2014/8/30/710763.jpg,0,0.917211413383484,472,187,974,689,502,502,twilight sparkle,newyorkx3
711802.jpg,https://derpicdn.net/img/view/2014/8/31/711802.jpg,0,0.9892706274986268,170,0,646,475,476,475,twilight sparkle,renaifoxi
714130.png,https://derpicdn.net/img/view/2014/9/3/714130.png,0,0.9973682165145874,74,0,808,601,734,601,twilight sparkle,sion-ara
714171.png,https://derpicdn.net/img/view/2014/9/3/714171.png,0,0.9940812587738036,0,0,1902,1950,1902,1950,twilight sparkle,snowsky-s
71757.png,https://derpicdn.net/img/view/2012/8/11/71757.png,0,0.915718674659729,471,0,1187,688,716,688,twilight sparkle,sunibee
718382.png,https://derpicdn.net/img/view/2014/9/9/718382.png,0,0.963167369365692,1198,995,3430,3227,2232,2232,twilight sparkle,arcadianphoenix
719919.png,https://derpicdn.net/img/view/2014/9/11/719919.png,0,0.9947001338005066,336,0,912,576,576,576,twilight sparkle,mirululu
719955.png,https://derpicdn.net/img/view/2014/9/11/719955.png,0,0.9875278472900392,213,0,574,284,361,284,twilight sparkle,
722783.png,https://derpicdn.net/img/view/2014/9/15/722783.png,0,0.9947088360786438,478,473,956,951,478,478,twilight sparkle,
724039.png,https://derpicdn.net/img/view/2014/9/17/724039.png,0,0.9973395466804504,273,0,677,401,404,401,twilight sparkle,aleximusprime
724960.jpg,https://derpicdn.net/img/view/2014/9/18/724960.jpg,0,0.9935555458068848,324,19,676,371,352,352,twilight sparkle,braffy
727096.jpg,https://derpicdn.net/img/view/2014/9/22/727096.jpg,0,0.9824194312095642,725,43,1016,335,291,292,twilight sparkle,prettypinkpony
730065.png,https://derpicdn.net/img/view/2014/9/26/730065.png,0,0.9250589609146118,0,0,389,373,389,373,twilight sparkle,marshmellowcannibal
734412.png,https://derpicdn.net/img/view/2014/10/3/734412.png,0,0.9994447231292723,612,0,1180,551,568,551,twilight sparkle,klemm
73941.png,https://derpicdn.net/img/view/2012/8/13/73941.png,0,0.9274579882621764,184,54,810,680,626,626,twilight sparkle,adamscage
74057.png,https://derpicdn.net/img/view/2012/8/13/74057.png,0,0.9870981574058532,355,65,957,667,602,602,twilight sparkle,adamscage
741718.png,https://derpicdn.net/img/view/2014/10/12/741718.png,0,0.9994134306907654,1085,15,1662,615,577,600,twilight sparkle,
742897.png,https://derpicdn.net/img/view/2014/10/14/742897.png,0,0.9952735900878906,5,0,305,285,300,285,twilight sparkle,dm29
748064.jpg,https://derpicdn.net/img/view/2014/10/22/748064.jpg,0,0.9858981966972352,174,43,500,369,326,326,twilight sparkle,murasaki-to
74863.png,https://derpicdn.net/img/view/2012/8/15/74863.png,0,0.9249503612518308,122,12,370,260,248,248,twilight sparkle,sukaponta
757210.png,https://derpicdn.net/img/view/2014/11/3/757210.png,0,0.9933868050575256,1240,27,4156,2943,2916,2916,twilight sparkle,slb94
761614.png,https://derpicdn.net/img/view/2014/11/10/761614.png,1,0.998908281326294,722,624,1239,1150,517,526,twilight sparkle,
761614.png,https://derpicdn.net/img/view/2014/11/10/761614.png,2,0.9984032511711121,776,0,1096,305,320,305,twilight sparkle,
761614.png,https://derpicdn.net/img/view/2014/11/10/761614.png,3,0.9792098402976992,133,0,579,438,446,438,twilight sparkle,
762949.png,https://derpicdn.net/img/view/2014/11/12/762949.png,0,0.9941434264183044,29,0,861,781,832,781,twilight sparkle,
763651.png,https://derpicdn.net/img/view/2014/11/13/763651.png,0,0.9964025020599364,26,0,392,355,366,355,twilight sparkle,dm29
769473.png,https://derpicdn.net/img/view/2014/11/22/769473.png,0,0.9879918098449708,214,13,762,561,548,548,twilight sparkle,supermare
771792.png,https://derpicdn.net/img/view/2014/11/25/771792.png,0,0.9478819966316224,406,191,1708,1493,1302,1302,twilight sparkle,fauxsquared
771912.png,https://derpicdn.net/img/view/2014/11/25/771912.png,0,0.9908992648124696,262,3,478,219,216,216,twilight sparkle,epiclunadragon
774636.png,https://derpicdn.net/img/view/2014/11/30/774636.png,0,0.9748466610908508,99,0,755,652,656,652,twilight sparkle,midnightpremiere
776095.png,https://derpicdn.net/img/view/2014/12/1/776095.png,0,0.9941882491111756,708,139,1954,1385,1246,1246,twilight sparkle,jowybean
776681.jpg,https://derpicdn.net/img/view/2014/12/2/776681.jpg,0,0.9393475651741028,456,42,842,428,386,386,twilight sparkle,30clock
7801.jpg,https://derpicdn.net/img/view/2012/6/18/7801.jpg,0,0.999088168144226,0,343,356,713,356,370,twilight sparkle,gomigomipomi
782288.jpg,https://derpicdn.net/img/view/2014/12/10/782288.jpg,0,0.9855556488037108,0,0,539,549,539,549,twilight sparkle,brendahickey
78460.png,https://derpicdn.net/img/view/2012/8/20/78460.png,0,0.9887501001358032,212,138,720,646,508,508,twilight sparkle,cainescroll
787134.png,https://derpicdn.net/img/view/2014/12/18/787134.png,0,0.9988822340965272,182,673,508,999,326,326,twilight sparkle,pia-sama
787353.png,https://derpicdn.net/img/view/2014/12/18/787353.png,0,0.9859033823013306,58,0,248,187,190,187,twilight sparkle,lulubell
787900.png,https://derpicdn.net/img/view/2014/12/19/787900.png,0,0.9409987330436708,0,127,1024,1193,1024,1066,twilight sparkle,sycotei-b
791873.png,https://derpicdn.net/img/view/2014/12/24/791873.png,0,0.9070168137550354,629,30,813,214,184,184,twilight sparkle,virenth
793124.png,https://derpicdn.net/img/view/2014/12/26/793124.png,0,0.9921985864639282,263,291,601,629,338,338,twilight sparkle,nothingspecialx9
795349.png,https://derpicdn.net/img/view/2014/12/29/795349.png,0,0.9484591484069824,101,0,600,529,499,529,twilight sparkle,nora1211
797159.png,https://derpicdn.net/img/view/2015/1/1/797159.png,0,0.9691398739814758,2169,730,5203,3764,3034,3034,twilight sparkle,zvn
79882.jpg,https://derpicdn.net/img/view/2012/8/22/79882.jpg,0,0.9108072519302368,265,184,543,462,278,278,twilight sparkle,littlepirate
801277.png,https://derpicdn.net/img/view/2015/1/7/801277.png,0,0.9980530738830566,257,33,593,369,336,336,twilight sparkle,onikama
801787.png,https://derpicdn.net/img/view/2015/1/8/801787.png,0,0.9278225898742676,228,0,594,347,366,347,twilight sparkle,dear-cotton-candy
802116.png,https://derpicdn.net/img/view/2015/1/8/802116.png,0,0.9442852139472958,127,9,501,383,374,374,twilight sparkle,dinkelion
803738.png,https://derpicdn.net/img/view/2015/1/11/803738.png,0,0.9487922787666321,9,0,463,448,454,448,twilight sparkle,looji
803916.png,https://derpicdn.net/img/view/2015/1/11/803916.png,0,0.9976206421852112,0,0,244,241,244,241,twilight sparkle,lulubell
805586.png,https://derpicdn.net/img/view/2015/1/13/805586.png,0,0.9476876854896544,73,18,559,504,486,486,twilight sparkle,lustrous-dreams
808116.png,https://derpicdn.net/img/view/2015/1/16/808116.png,0,0.999350130558014,735,0,1079,332,344,332,twilight sparkle,dennelx3
80813.png,https://derpicdn.net/img/view/2012/8/23/80813.png,0,0.9634879231452942,119,0,471,332,352,332,twilight sparkle,207mg
808383.png,https://derpicdn.net/img/view/2015/1/17/808383.png,0,0.9770252704620358,14,0,634,572,620,572,twilight sparkle,mewball
808800.png,https://derpicdn.net/img/view/2015/1/17/808800.png,0,0.9964759349822998,2347,0,5000,2734,2653,2734,twilight sparkle,dashiesparkle
809201.jpg,https://derpicdn.net/img/view/2015/1/18/809201.jpg,0,0.9977893829345704,1098,0,2270,975,1172,975,twilight sparkle,iados
809413.jpg,https://derpicdn.net/img/view/2015/1/18/809413.jpg,0,0.997299075126648,2973,0,5277,2257,2304,2257,twilight sparkle,handmantoot
811218.png,https://derpicdn.net/img/view/2015/1/21/811218.png,0,0.9916719794273376,525,35,2217,1727,1692,1692,twilight sparkle,scobionicle99
812189.png,https://derpicdn.net/img/view/2015/1/22/812189.png,0,0.9453526139259338,2371,565,3891,2085,1520,1520,twilight sparkle,malamol
812920.png,https://derpicdn.net/img/view/2015/1/23/812920.png,0,0.9994531869888306,83,0,1763,1626,1680,1626,twilight sparkle,scarlet-spectrum
813652.png,https://derpicdn.net/img/view/2015/1/24/813652.png,0,0.9918096661567688,429,326,585,482,156,156,twilight sparkle,nukilik
814812.png,https://derpicdn.net/img/view/2015/1/26/814812.png,0,0.9965195655822754,103,112,415,424,312,312,twilight sparkle,poisindoodles
815453.jpg,https://derpicdn.net/img/view/2015/1/27/815453.jpg,0,0.9804807901382446,1134,489,1566,921,432,432,twilight sparkle,sensko
815599.jpg,https://derpicdn.net/img/view/2015/1/27/815599.jpg,0,0.9199528098106384,410,164,716,470,306,306,twilight sparkle,redanon
824765.jpg,https://derpicdn.net/img/view/2015/2/9/824765.jpg,0,0.9882420897483826,0,37,424,525,424,488,twilight sparkle,tsitra360
825860.png,https://derpicdn.net/img/view/2015/2/11/825860.png,0,0.9893279671669006,65,124,495,554,430,430,twilight sparkle,pegacornss
826694.jpg,https://derpicdn.net/img/view/2015/2/12/826694.jpg,0,0.996758759021759,725,161,1159,595,434,434,twilight sparkle,emcrasher
829609.png,https://derpicdn.net/img/view/2015/2/15/829609.png,0,0.9880958795547484,178,84,1106,1012,928,928,twilight sparkle,the--cloudsmasher|terror--bite
829790.png,https://derpicdn.net/img/view/2015/2/16/829790.png,0,0.9913176894187928,0,0,230,264,230,264,twilight sparkle,
829790.png,https://derpicdn.net/img/view/2015/2/16/829790.png,1,0.939775824546814,0,0,246,287,246,287,twilight sparkle,
837167.png,https://derpicdn.net/img/view/2015/2/25/837167.png,0,0.9962538480758668,220,50,584,414,364,364,twilight sparkle,sintakhra
838813.png,https://derpicdn.net/img/view/2015/2/28/838813.png,0,0.9670884609222412,634,323,1078,767,444,444,twilight sparkle,heir-of-rick
838968.png,https://derpicdn.net/img/view/2015/2/28/838968.png,0,0.9615358114242554,117,0,1319,1148,1202,1148,twilight sparkle,infinitewarlock
839349.png,https://derpicdn.net/img/view/2015/2/28/839349.png,0,0.9990357160568236,72,112,536,576,464,464,twilight sparkle,snowsky-s
840166.png,https://derpicdn.net/img/view/2015/3/1/840166.png,0,0.9604009985923768,0,0,5000,5337,5000,5337,twilight sparkle,dashiesparkle
842560.png,https://derpicdn.net/img/view/2015/3/5/842560.png,0,0.998904824256897,175,0,829,566,654,566,twilight sparkle,yajima
845775.jpg,https://derpicdn.net/img/view/2015/3/9/845775.jpg,0,0.9744320511817932,0,127,580,875,580,748,twilight sparkle,burning-heart-brony
846555.png,https://derpicdn.net/img/view/2015/3/10/846555.png,0,0.9795649647712708,38,22,900,954,862,932,twilight sparkle,acharmingpony
848439.jpg,https://derpicdn.net/img/view/2015/3/13/848439.jpg,0,0.992664098739624,525,76,769,320,244,244,twilight sparkle,tf-sential
848439.jpg,https://derpicdn.net/img/view/2015/3/13/848439.jpg,3,0.9864376783370972,1427,23,1695,291,268,268,twilight sparkle,tf-sential
851185.png,https://derpicdn.net/img/view/2015/3/17/851185.png,0,0.9846228957176208,290,68,544,322,254,254,twilight sparkle,jowybean
85648.png,https://derpicdn.net/img/view/2012/8/29/85648.png,0,0.9977948069572448,456,0,3148,2375,2692,2375,twilight sparkle,silentazrael
856717.jpg,https://derpicdn.net/img/view/2015/3/25/856717.jpg,0,0.990310788154602,44,0,766,645,722,645,twilight sparkle,kimmychan1
857316.png,https://derpicdn.net/img/view/2015/3/26/857316.png,0,0.9976237416267396,869,0,1861,967,992,967,twilight sparkle,neoncel
860321.png,https://derpicdn.net/img/view/2015/3/30/860321.png,0,0.9736724495887756,8,0,250,234,242,234,twilight sparkle,lulubell
862597.png,https://derpicdn.net/img/view/2015/4/1/862597.png,0,0.9969849586486816,91,93,1507,1509,1416,1416,twilight sparkle,ambassad0r
863733.png,https://derpicdn.net/img/view/2015/4/3/863733.png,0,0.9916282892227172,955,0,1871,887,916,887,twilight sparkle,gray--day
864956.png,https://derpicdn.net/img/view/2015/4/4/864956.png,0,0.9642137885093688,1202,12,3825,2752,2623,2740,twilight sparkle,paulysentry
870342.png,https://derpicdn.net/img/view/2015/4/10/870342.png,0,0.9427005648612976,974,118,2300,1444,1326,1326,twilight sparkle,vird-gi
872062.png,https://derpicdn.net/img/view/2015/4/12/872062.png,0,0.9933043122291564,25,22,709,706,684,684,twilight sparkle,rapidstrike
872488.png,https://derpicdn.net/img/view/2015/4/12/872488.png,0,0.9864539504051208,875,0,1563,652,688,652,twilight sparkle,nekokevin
872639.png,https://derpicdn.net/img/view/2015/4/12/872639.png,0,0.9085524678230286,28,46,308,326,280,280,twilight sparkle,3d4d
872754.png,https://derpicdn.net/img/view/2015/4/12/872754.png,0,0.9949218630790708,104,0,610,465,506,465,twilight sparkle,ctb-36
875040.png,https://derpicdn.net/img/view/2015/4/16/875040.png,0,0.9773069024086,124,0,1022,851,898,851,twilight sparkle,wolfy-pony
875315.png,https://derpicdn.net/img/view/2015/4/16/875315.png,0,0.977707028388977,18,6,730,718,712,712,twilight sparkle,dambitail
875406.png,https://derpicdn.net/img/view/2015/4/16/875406.png,0,0.9833824634552002,300,26,762,488,462,462,twilight sparkle,syo-senpai
878134.png,https://derpicdn.net/img/view/2015/4/19/878134.png,0,0.9828670024871826,1029,1209,2235,2415,1206,1206,twilight sparkle,dalagar
879443.png,https://derpicdn.net/img/view/2015/4/21/879443.png,0,0.9199837446212769,0,0,552,420,552,420,twilight sparkle,3d thread|creatorofpony
880111.png,https://derpicdn.net/img/view/2015/4/22/880111.png,0,0.9995787739753724,497,50,849,402,352,352,twilight sparkle,pentoolqueen
880238.png,https://derpicdn.net/img/view/2015/4/22/880238.png,0,0.9731173515319824,709,283,1165,739,456,456,twilight sparkle,majkashinoda626
881864.png,https://derpicdn.net/img/view/2015/4/25/881864.png,0,0.9830065369606018,84,0,378,292,294,292,twilight sparkle,befishproductions
884014.png,https://derpicdn.net/img/view/2015/4/27/884014.png,0,0.9960581064224244,455,6,861,412,406,406,twilight sparkle,han_hyui
884502.png,https://derpicdn.net/img/view/2015/4/28/884502.png,0,0.9668675661087036,2245,123,3538,1423,1293,1300,twilight sparkle,porygon2z
884504.png,https://derpicdn.net/img/view/2015/4/28/884504.png,0,0.9191601872444152,2048,32,3571,1628,1523,1596,twilight sparkle,porygon2z
885344.png,https://derpicdn.net/img/view/2015/4/29/885344.png,0,0.942390501499176,84,228,780,924,696,696,twilight sparkle,madacon
887192.png,https://derpicdn.net/img/view/2015/5/2/887192.png,0,0.9971466064453124,201,7,905,711,704,704,twilight sparkle,chocolateponi
888255.png,https://derpicdn.net/img/view/2015/5/3/888255.png,0,0.9921759963035583,599,0,1289,664,690,664,twilight sparkle,koveliana
888848.png,https://derpicdn.net/img/view/2015/5/4/888848.png,0,0.95531165599823,482,0,1452,975,970,975,twilight sparkle,gomhoren
891142.png,https://derpicdn.net/img/view/2015/5/7/891142.png,0,0.9987930655479432,15,16,491,492,476,476,twilight sparkle,mrpotat0wned
893193.png,https://derpicdn.net/img/view/2015/5/10/893193.png,0,0.9774360060691832,161,0,697,528,536,528,twilight sparkle,empyu
893263.png,https://derpicdn.net/img/view/2015/5/10/893263.png,0,0.9914707541465759,303,662,1123,1482,820,820,twilight sparkle,snowsky-s
893520.png,https://derpicdn.net/img/view/2015/5/10/893520.png,0,0.9918071031570436,333,430,979,1076,646,646,twilight sparkle,galekz
898365.png,https://derpicdn.net/img/view/2015/5/17/898365.png,0,0.9246160387992859,128,546,2540,2958,2412,2412,twilight sparkle,blocksy-art
899861.png,https://derpicdn.net/img/view/2015/5/19/899861.png,0,0.9859788417816162,73,21,1131,1079,1058,1058,twilight sparkle,zomgitsalaura
901861.png,https://derpicdn.net/img/view/2015/5/22/901861.png,0,0.9902435541152954,481,0,1265,698,784,698,twilight sparkle,m-p-l
902151.jpg,https://derpicdn.net/img/view/2015/5/23/902151.jpg,0,0.9989241957664492,339,0,773,419,434,419,twilight sparkle,nokno76
903153.png,https://derpicdn.net/img/view/2015/5/24/903153.png,0,0.9447228908538818,785,0,1883,1004,1098,1004,twilight sparkle,snow angel
903626.png,https://derpicdn.net/img/view/2015/5/25/903626.png,0,0.9970548748970032,125,0,523,385,398,385,twilight sparkle,flower-power-love
904042.png,https://derpicdn.net/img/view/2015/5/25/904042.png,0,0.9930695891380308,1316,0,2744,1220,1428,1220,twilight sparkle,porygon2z
906596.png,https://derpicdn.net/img/view/2015/5/30/906596.png,0,0.9853375554084778,2178,252,4000,2184,1822,1932,twilight sparkle,spier17
910773.png,https://derpicdn.net/img/view/2015/6/5/910773.png,0,0.9958152174949646,1598,36,3086,1524,1488,1488,twilight sparkle,supermare
912988.png,https://derpicdn.net/img/view/2015/6/8/912988.png,0,0.996459424495697,321,0,765,422,444,422,twilight sparkle,silbersternenlicht
913134.png,https://derpicdn.net/img/view/2015/6/8/913134.png,0,0.9983436465263368,0,0,1140,1089,1140,1089,twilight sparkle,amberpendant
915695.png,https://derpicdn.net/img/view/2015/6/13/915695.png,0,0.9964355826377868,659,0,1069,401,410,401,twilight sparkle,wrenhat
91590.jpg,https://derpicdn.net/img/view/2012/9/6/91590.jpg,0,0.9912810921669006,355,42,559,246,204,204,twilight sparkle,shepherd0821
91590.jpg,https://derpicdn.net/img/view/2012/9/6/91590.jpg,1,0.9909501075744628,82,20,302,240,220,220,twilight sparkle,shepherd0821
915974.png,https://derpicdn.net/img/view/2015/6/13/915974.png,0,0.9595632553100586,68,0,900,819,832,819,twilight sparkle,ayahana
919039.png,https://derpicdn.net/img/view/2015/6/18/919039.png,0,0.9986727833747864,811,0,1815,887,1004,887,twilight sparkle,exedrus
923174.png,https://derpicdn.net/img/view/2015/6/24/923174.png,0,0.9951866269111632,550,0,1430,874,880,874,twilight sparkle,fluffymaiden
923963.png,https://derpicdn.net/img/view/2015/6/26/923963.png,0,0.9979066848754884,1406,59,2848,1501,1442,1442,twilight sparkle,dazed-and-wandering
925936.png,https://derpicdn.net/img/view/2015/6/29/925936.png,0,0.997882843017578,1090,0,2509,1482,1419,1482,twilight sparkle,valadrem
926986.png,https://derpicdn.net/img/view/2015/6/30/926986.png,0,0.9706478714942932,18,0,476,423,458,423,twilight sparkle,flutterthrash
927398.png,https://derpicdn.net/img/view/2015/7/1/927398.png,0,0.9946428537368774,55,0,277,216,222,216,twilight sparkle,misocosmis
927398.png,https://derpicdn.net/img/view/2015/7/1/927398.png,1,0.9802217483520508,498,19,878,399,380,380,twilight sparkle,misocosmis
930666.png,https://derpicdn.net/img/view/2015/7/5/930666.png,0,0.9954026937484741,453,71,1007,625,554,554,twilight sparkle,wolfy-pony
932388.jpg,https://derpicdn.net/img/view/2015/7/8/932388.jpg,0,0.9032595753669742,442,176,788,522,346,346,twilight sparkle,yajima
933049.png,https://derpicdn.net/img/view/2015/7/9/933049.png,0,0.9491633772850036,636,903,1248,1515,612,612,twilight sparkle,aquagalaxy
934733.png,https://derpicdn.net/img/view/2015/7/11/934733.png,0,0.9148914217948914,2012,0,3200,1160,1188,1160,twilight sparkle,facelesssoles
935806.png,https://derpicdn.net/img/view/2015/7/12/935806.png,0,0.9855085015296936,158,158,1870,1870,1712,1712,twilight sparkle,bluerainbow01
939814.jpg,https://derpicdn.net/img/view/2015/7/19/939814.jpg,0,0.9803991913795472,683,0,1651,968,968,968,twilight sparkle,kawaiipony2
940698.png,https://derpicdn.net/img/view/2015/7/20/940698.png,0,0.9738482832908628,26,56,504,534,478,478,twilight sparkle,silbersternenlicht
941303.png,https://derpicdn.net/img/view/2015/7/21/941303.png,0,0.9972687363624572,1263,0,2311,879,1048,879,twilight sparkle,flamevulture17
941303.png,https://derpicdn.net/img/view/2015/7/21/941303.png,1,0.9871321320533752,383,0,1531,1043,1148,1043,twilight sparkle,flamevulture17
942923.png,https://derpicdn.net/img/view/2015/7/24/942923.png,0,0.9853962063789368,0,70,954,1068,954,998,twilight sparkle,chromaskunk
942952.png,https://derpicdn.net/img/view/2015/7/24/942952.png,0,0.9336213469505308,3362,152,3882,672,520,520,twilight sparkle,ratofdrawn
945128.png,https://derpicdn.net/img/view/2015/7/27/945128.png,0,0.96207195520401,3381,1395,3777,1791,396,396,twilight sparkle,kwark85
945128.png,https://derpicdn.net/img/view/2015/7/27/945128.png,1,0.9499987363815308,2039,425,2663,1049,624,624,twilight sparkle,kwark85
945128.png,https://derpicdn.net/img/view/2015/7/27/945128.png,2,0.9420947432518004,935,584,1507,1156,572,572,twilight sparkle,kwark85
947523.png,https://derpicdn.net/img/view/2015/7/30/947523.png,0,0.9936205744743348,415,52,1155,792,740,740,twilight sparkle,sourspot
947925.png,https://derpicdn.net/img/view/2015/7/31/947925.png,0,0.996754229068756,138,0,844,599,706,599,twilight sparkle,segraece
949207.png,https://derpicdn.net/img/view/2015/8/2/949207.png,0,0.9063151478767396,80,5,622,547,542,542,twilight sparkle,rocy canvas
949712.png,https://derpicdn.net/img/view/2015/8/3/949712.png,0,0.9993433356285096,419,6,891,478,472,472,twilight sparkle,dsp2003
953736.png,https://derpicdn.net/img/view/2015/8/8/953736.png,0,0.9058734178543092,635,0,5473,4619,4838,4619,twilight sparkle,tardifice
953888.png,https://derpicdn.net/img/view/2015/8/8/953888.png,0,0.9700428247451782,283,113,597,427,314,314,twilight sparkle,suziouwabami
954870.png,https://derpicdn.net/img/view/2015/8/10/954870.png,0,0.9978853464126588,11,3,463,455,452,452,twilight sparkle,karmirafox
957155.png,https://derpicdn.net/img/view/2015/8/13/957155.png,0,0.9561566710472108,44,0,650,592,606,592,twilight sparkle,anyponedrawn
960339.png,https://derpicdn.net/img/view/2015/8/18/960339.png,0,0.9991894960403442,656,0,1112,450,456,450,twilight sparkle,riokenng3
961355.png,https://derpicdn.net/img/view/2015/8/19/961355.png,0,0.9995270371437072,18,0,414,363,396,363,twilight sparkle,inuhoshi-to-darkpen
961389.png,https://derpicdn.net/img/view/2015/8/20/961389.png,0,0.987175703048706,0,0,2210,2429,2210,2429,twilight sparkle,beavernator
964485.png,https://derpicdn.net/img/view/2015/8/24/964485.png,0,0.9926193356513976,2746,0,8628,5780,5882,5780,twilight sparkle,slb94
968073.png,https://derpicdn.net/img/view/2015/8/29/968073.png,0,0.988525927066803,0,0,2782,2856,2782,2856,twilight sparkle,
970311.png,https://derpicdn.net/img/view/2015/9/1/970311.png,0,0.9714730978012084,0,77,755,855,755,778,twilight sparkle,variant
971516.png,https://derpicdn.net/img/view/2015/9/2/971516.png,0,0.9973090291023254,0,0,149,134,149,134,twilight sparkle,vixelzf
973707.png,https://derpicdn.net/img/view/2015/9/6/973707.png,0,0.9863473773002625,367,246,753,632,386,386,twilight sparkle,dsana
975737.png,https://derpicdn.net/img/view/2015/9/9/975737.png,0,0.9987947940826416,287,0,695,408,408,408,twilight sparkle,jadekettu
978459.png,https://derpicdn.net/img/view/2015/9/12/978459.png,1,0.9440967440605164,2559,392,3149,982,590,590,twilight sparkle,thegreatrouge
981328.png,https://derpicdn.net/img/view/2015/9/16/981328.png,0,0.9918006658554076,65,85,787,807,722,722,twilight sparkle,fillyscoots42
981893.png,https://derpicdn.net/img/view/2015/9/17/981893.png,0,0.9490785598754884,253,375,675,797,422,422,twilight sparkle,umimizunone
981965.png,https://derpicdn.net/img/view/2015/9/17/981965.png,0,0.9996609687805176,2860,0,5540,2645,2680,2645,twilight sparkle,hawk9mm|8-notes
982452.png,https://derpicdn.net/img/view/2015/9/18/982452.png,0,0.9996058344841005,133,0,439,287,306,287,twilight sparkle,pocki07
983790.jpg,https://derpicdn.net/img/view/2015/9/20/983790.jpg,0,0.9649629592895508,880,227,1234,581,354,354,twilight sparkle,mechagen
985390.png,https://derpicdn.net/img/view/2015/9/22/985390.png,0,0.9914022088050842,895,71,1613,789,718,718,twilight sparkle,missrenakitsune
985682.png,https://derpicdn.net/img/view/2015/9/22/985682.png,0,0.993167757987976,120,20,540,440,420,420,twilight sparkle,rivibaes
986398.png,https://derpicdn.net/img/view/2015/9/23/986398.png,0,0.9928517937660216,428,3,852,427,424,424,twilight sparkle,tokipeach
986884.png,https://derpicdn.net/img/view/2015/9/24/986884.png,0,0.9990725517272948,1805,0,3522,1519,1717,1519,twilight sparkle,hawk9mm|dashiesparkle
987792.jpg,https://derpicdn.net/img/view/2015/9/25/987792.jpg,1,0.9312340617179872,2778,336,3454,1012,676,676,twilight sparkle,jowybean
989356.jpg,https://derpicdn.net/img/view/2015/9/27/989356.jpg,0,0.9084120988845824,253,227,853,827,600,600,twilight sparkle,maytee
991360.jpg,https://derpicdn.net/img/view/2015/9/30/991360.jpg,0,0.9714444875717164,0,26,683,854,683,828,twilight sparkle,
992624.png,https://derpicdn.net/img/view/2015/10/2/992624.png,0,0.9705302715301514,203,0,607,301,404,301,twilight sparkle,camchao
994348.png,https://derpicdn.net/img/view/2015/10/4/994348.png,0,0.9852629303932192,536,288,846,598,310,310,twilight sparkle,queentigrel
994407.jpg,https://derpicdn.net/img/view/2015/10/4/994407.jpg,0,0.9923600554466248,132,127,886,881,754,754,twilight sparkle,xshrxshrxshr
997113.png,https://derpicdn.net/img/view/2015/10/8/997113.png,0,0.9965718388557434,396,251,742,597,346,346,twilight sparkle,0strolist
997452.png,https://derpicdn.net/img/view/2015/10/8/997452.png,0,0.9611120223999025,30,0,668,624,638,624,twilight sparkle,kodabomb
1000108.png,https://derpicdn.net/img/view/2015/10/11/1000108.png,0,0.9946022033691406,4,0,286,263,282,263,twilight sparkle,lulukana
1000535.png,https://derpicdn.net/img/view/2015/10/12/1000535.png,0,0.9952279925346376,0,0,682,664,682,664,twilight sparkle,jetjetj
1008103.png,https://derpicdn.net/img/view/2015/10/23/1008103.png,0,0.9885679483413696,3289,0,7903,4563,4614,4563,twilight sparkle,luckreza8
1008189.png,https://derpicdn.net/img/view/2015/10/23/1008189.png,0,0.9994721412658693,20,0,470,438,450,438,twilight sparkle,scarlet-spectrum
1008604.jpg,https://derpicdn.net/img/view/2015/10/24/1008604.jpg,0,0.9913503527641296,263,254,1223,1214,960,960,twilight sparkle,phoenix-fire-soul
1009234.png,https://derpicdn.net/img/view/2015/10/24/1009234.png,0,0.9967527389526368,198,10,634,446,436,436,twilight sparkle,lisa400
1010780.png,https://derpicdn.net/img/view/2015/10/28/1010780.png,0,0.9652214646339417,53,0,917,851,864,851,twilight sparkle,j-lin-mlp
1012088.png,https://derpicdn.net/img/view/2015/10/29/1012088.png,0,0.9917105436325072,924,356,1276,708,352,352,twilight sparkle,tiffanymarsou
1012351.png,https://derpicdn.net/img/view/2015/10/30/1012351.png,0,0.9964009523391724,834,13,1760,939,926,926,twilight sparkle,sketchmcreations
1012414.png,https://derpicdn.net/img/view/2015/10/30/1012414.png,0,0.9482421875,1417,130,4981,3000,3564,2870,twilight sparkle,kalleflaxx
1013052.png,https://derpicdn.net/img/view/2015/10/31/1013052.png,0,0.9996850490570068,222,7,480,265,258,258,twilight sparkle,canime
1014683.png,https://derpicdn.net/img/view/2015/11/2/1014683.png,0,0.9952314496040344,819,0,1569,722,750,722,twilight sparkle,sketchmcreations
1021014.png,https://derpicdn.net/img/view/2015/11/11/1021014.png,0,0.99520081281662,314,68,918,672,604,604,twilight sparkle,manmaru00
1021700.png,https://derpicdn.net/img/view/2015/11/12/1021700.png,0,0.9462724924087524,106,0,306,198,200,198,twilight sparkle,
1022994.png,https://derpicdn.net/img/view/2015/11/15/1022994.png,0,0.9503543972969056,0,0,360,411,360,411,twilight sparkle,
1024739.png,https://derpicdn.net/img/view/2015/11/17/1024739.png,0,0.9990637302398682,449,163,761,475,312,312,twilight sparkle,karmamoonshadow
1029522.png,https://derpicdn.net/img/view/2015/11/24/1029522.png,0,0.9040125608444214,69,79,417,427,348,348,twilight sparkle,scarlet-spectrum
1030936.png,https://derpicdn.net/img/view/2015/11/27/1030936.png,0,0.9805487990379332,455,0,947,487,492,487,twilight sparkle,lou1911
1031546.png,https://derpicdn.net/img/view/2015/11/28/1031546.png,0,0.9644871354103088,0,29,241,309,241,280,twilight sparkle,
1031546.png,https://derpicdn.net/img/view/2015/11/28/1031546.png,1,0.9079021215438844,25,5,249,229,224,224,twilight sparkle,
1033001.png,https://derpicdn.net/img/view/2015/11/29/1033001.png,0,0.9890345335006714,1139,351,2197,1409,1058,1058,twilight sparkle,mythilas
1040780.png,https://derpicdn.net/img/view/2015/12/10/1040780.png,0,0.9905297756195068,583,190,867,474,284,284,twilight sparkle,aleximusprime
1040780.png,https://derpicdn.net/img/view/2015/12/10/1040780.png,1,0.9583973288536072,191,136,575,520,384,384,twilight sparkle,aleximusprime
1041103.png,https://derpicdn.net/img/view/2015/12/10/1041103.png,0,0.9859627485275269,101,5,757,661,656,656,twilight sparkle,askthetwidash
1043133.png,https://derpicdn.net/img/view/2015/12/13/1043133.png,0,0.9854012727737428,0,336,2992,3528,2992,3192,twilight sparkle,bloodatius
1049654.png,https://derpicdn.net/img/view/2015/12/21/1049654.png,0,0.9099118113517758,156,149,2136,2129,1980,1980,twilight sparkle,ashtoneer
1052381.png,https://derpicdn.net/img/view/2015/12/25/1052381.png,0,0.9801735281944276,337,257,623,543,286,286,twilight sparkle,wynnchi
1052381.png,https://derpicdn.net/img/view/2015/12/25/1052381.png,1,0.9769387245178224,74,179,426,531,352,352,twilight sparkle,wynnchi
1053762.png,https://derpicdn.net/img/view/2015/12/27/1053762.png,0,0.9816737174987792,213,0,773,466,560,466,twilight sparkle,replacer808
1053993.png,https://derpicdn.net/img/view/2015/12/27/1053993.png,0,0.9598978161811828,48,0,392,342,344,342,twilight sparkle,crystalsonatica
1055466.png,https://derpicdn.net/img/view/2015/12/30/1055466.png,0,0.9543820023536682,161,3,589,431,428,428,twilight sparkle,krazykari|trollie trollenberg
1056239.png,https://derpicdn.net/img/view/2015/12/31/1056239.png,0,0.9743660092353821,899,403,1489,993,590,590,twilight sparkle,bymotika
105736.png,https://derpicdn.net/img/view/2012/9/24/105736.png,0,0.9871363043785096,428,100,764,436,336,336,twilight sparkle,ailatf
1059106.png,https://derpicdn.net/img/view/2016/1/3/1059106.png,0,0.9178271293640136,1666,354,4088,3070,2422,2716,twilight sparkle,sketchmcreations
1059107.png,https://derpicdn.net/img/view/2016/1/3/1059107.png,0,0.9830710291862488,67,0,687,593,620,593,twilight sparkle,lunar-white-wolf
1059538.png,https://derpicdn.net/img/view/2016/1/4/1059538.png,0,0.9982541799545288,75,0,2079,1979,2004,1979,twilight sparkle,1apeepa
1061562.png,https://derpicdn.net/img/view/2016/1/7/1061562.png,0,0.9987151026725768,38,6,292,260,254,254,twilight sparkle,php93
1064055.png,https://derpicdn.net/img/view/2016/1/11/1064055.png,0,0.9980513453483582,338,41,1196,899,858,858,twilight sparkle,riscke
106536.png,https://derpicdn.net/img/view/2012/9/25/106536.png,0,0.9920212030410768,512,0,794,272,282,272,twilight sparkle,raikoh
106536.png,https://derpicdn.net/img/view/2012/9/25/106536.png,1,0.988767683506012,85,0,379,274,294,274,twilight sparkle,raikoh
1067743.png,https://derpicdn.net/img/view/2016/1/16/1067743.png,0,0.9844934940338136,234,788,3922,4476,3688,3688,twilight sparkle,itv-canterlot
1069696.png,https://derpicdn.net/img/view/2016/1/19/1069696.png,0,0.971034586429596,151,15,453,317,302,302,twilight sparkle,dm29
1069696.png,https://derpicdn.net/img/view/2016/1/19/1069696.png,1,0.953239679336548,589,35,989,435,400,400,twilight sparkle,dm29
107010.png,https://derpicdn.net/img/view/2012/9/26/107010.png,0,0.9363126158714294,80,0,520,431,440,431,twilight sparkle,raikoh
1072915.png,https://derpicdn.net/img/view/2016/1/24/1072915.png,0,0.9833452701568604,357,0,1705,1413,1348,1413,twilight sparkle,teranen
1073768.png,https://derpicdn.net/img/view/2016/1/25/1073768.png,0,0.9987308979034424,234,0,722,429,488,429,twilight sparkle,melodicmarzipan
1074729.png,https://derpicdn.net/img/view/2016/1/27/1074729.png,0,0.9954376220703124,0,0,2621,2457,2621,2457,twilight sparkle,dashiesparkle
1076448.png,https://derpicdn.net/img/view/2016/1/30/1076448.png,0,0.9644690155982972,0,104,1449,1818,1449,1714,twilight sparkle,comfydove
1076962.png,https://derpicdn.net/img/view/2016/1/30/1076962.png,0,0.9099690914154052,216,318,652,754,436,436,twilight sparkle,sparkiss-pony
1082483.png,https://derpicdn.net/img/view/2016/2/7/1082483.png,0,0.9356962442398072,996,40,1728,772,732,732,twilight sparkle,91o42
1082576.png,https://derpicdn.net/img/view/2016/2/7/1082576.png,0,0.9609689712524414,81,500,301,720,220,220,twilight sparkle,theluckyangel
1083613.png,https://derpicdn.net/img/view/2016/2/9/1083613.png,0,0.9668158292770386,1024,0,2782,1637,1758,1637,twilight sparkle,zodiacnicola
1085082.png,https://derpicdn.net/img/view/2016/2/11/1085082.png,0,0.9663875102996826,55,10,421,376,366,366,twilight sparkle,poym
1085617.png,https://derpicdn.net/img/view/2016/2/11/1085617.png,0,0.9631538987159728,0,41,950,1035,950,994,twilight sparkle,variant
1087440.png,https://derpicdn.net/img/view/2016/2/14/1087440.png,0,0.968787968158722,472,1396,1218,2142,746,746,twilight sparkle,starrypon
1088160.png,https://derpicdn.net/img/view/2016/2/14/1088160.png,0,0.9942623972892758,237,0,587,329,350,329,twilight sparkle,crecious
1088731.png,https://derpicdn.net/img/view/2016/2/15/1088731.png,0,0.9997786879539492,230,0,708,469,478,469,twilight sparkle,girorogirl
1090609.png,https://derpicdn.net/img/view/2016/2/17/1090609.png,0,0.9898934364318848,261,0,711,449,450,449,twilight sparkle,zogzor
1095966.png,https://derpicdn.net/img/view/2016/2/24/1095966.png,0,0.9179773926734924,228,29,1180,981,952,952,twilight sparkle,blackbewhite2k7
1096400.png,https://derpicdn.net/img/view/2016/2/25/1096400.png,0,0.9502106308937072,48,1911,3304,5167,3256,3256,twilight sparkle,greenmachine987
1097210.png,https://derpicdn.net/img/view/2016/2/26/1097210.png,0,0.9940909147262572,350,91,820,561,470,470,twilight sparkle,sun_blacksun
1097421.png,https://derpicdn.net/img/view/2016/2/26/1097421.png,0,0.9543963074684144,249,21,561,333,312,312,twilight sparkle,orauraa
1098119.png,https://derpicdn.net/img/view/2016/2/27/1098119.png,0,0.9923883080482484,214,160,590,536,376,376,twilight sparkle,mymineawesome
1099674.png,https://derpicdn.net/img/view/2016/3/1/1099674.png,0,0.9938059449195862,190,0,1058,853,868,853,twilight sparkle,thunder chaser
1101690.png,https://derpicdn.net/img/view/2016/3/4/1101690.png,0,0.997320830821991,1090,0,2384,1204,1294,1204,twilight sparkle,ashtoneer
1101925.png,https://derpicdn.net/img/view/2016/3/4/1101925.png,0,0.9972029328346252,226,580,892,1246,666,666,twilight sparkle,luximus17
1102101.png,https://derpicdn.net/img/view/2016/3/5/1102101.png,0,0.9934229850769044,1172,646,1672,1146,500,500,twilight sparkle,lars99
1103421.png,https://derpicdn.net/img/view/2016/3/6/1103421.png,0,0.993479311466217,1578,0,3908,1992,2330,1992,twilight sparkle,osipush
1105015.png,https://derpicdn.net/img/view/2016/3/8/1105015.png,0,0.9975746273994446,2542,129,4472,2059,1930,1930,twilight sparkle,1nsp1r
1106072.jpg,https://derpicdn.net/img/view/2016/3/10/1106072.jpg,0,0.9302545189857484,108,14,598,514,490,500,twilight sparkle,
1106253.png,https://derpicdn.net/img/view/2016/3/10/1106253.png,0,0.9879295229911804,0,0,1474,1535,1474,1535,twilight sparkle,befishproductions
1106652.jpg,https://derpicdn.net/img/view/2016/3/11/1106652.jpg,0,0.984573245048523,436,19,1862,1445,1426,1426,twilight sparkle,unousaya
1107116.png,https://derpicdn.net/img/view/2016/3/12/1107116.png,0,0.9700778722763062,53,109,375,431,322,322,twilight sparkle,leslers
1109842.jpg,https://derpicdn.net/img/view/2016/3/16/1109842.jpg,0,0.9759238958358764,910,89,1650,829,740,740,twilight sparkle,fuzzyfox11
1111234.png,https://derpicdn.net/img/view/2016/3/18/1111234.png,0,0.9640964269638062,1042,420,1918,1296,876,876,twilight sparkle,klarapl
1112132.png,https://derpicdn.net/img/view/2016/3/19/1112132.png,1,0.9874371886253356,2190,161,3476,1447,1286,1286,twilight sparkle,saxopi
1114477.png,https://derpicdn.net/img/view/2016/3/22/1114477.png,0,0.9009125232696532,553,0,1011,424,458,424,twilight sparkle,bluesidearts
1115419.jpg,https://derpicdn.net/img/view/2016/3/23/1115419.jpg,0,0.9925653338432312,395,5,1157,767,762,762,twilight sparkle,chitsu
1120829.png,https://derpicdn.net/img/view/2016/3/31/1120829.png,0,0.9873362183570862,0,199,1641,2061,1641,1862,twilight sparkle,sketchmcreations
1122270.png,https://derpicdn.net/img/view/2016/4/2/1122270.png,0,0.9932978749275208,154,34,430,310,276,276,twilight sparkle,ultrard
1123381.png,https://derpicdn.net/img/view/2016/4/3/1123381.png,0,0.9975540041923524,0,3,307,313,307,310,twilight sparkle,cherivinca
1125345.png,https://derpicdn.net/img/view/2016/4/5/1125345.png,0,0.9680629968643188,547,3,1461,917,914,914,twilight sparkle,thefrrealdeal
1125430.png,https://derpicdn.net/img/view/2016/4/5/1125430.png,0,0.9067673683166504,71,114,1911,1954,1840,1840,twilight sparkle,sollace
1129081.png,https://derpicdn.net/img/view/2016/4/10/1129081.png,0,0.9668757915496826,0,180,3500,5138,3500,4958,twilight sparkle,pirill|djdavid98
1129481.png,https://derpicdn.net/img/view/2016/4/10/1129481.png,0,0.9775305390357972,1209,0,2553,1300,1344,1300,twilight sparkle,saphi-boo
1130924.png,https://derpicdn.net/img/view/2016/4/13/1130924.png,0,0.966489553451538,264,0,1532,1066,1268,1066,twilight sparkle,thegreatrouge
1131156.png,https://derpicdn.net/img/view/2016/4/13/1131156.png,0,0.9991533756256104,1119,333,1969,1183,850,850,twilight sparkle,artyjoyful
1131691.png,https://derpicdn.net/img/view/2016/4/14/1131691.png,1,0.9955973625183104,308,64,598,354,290,290,twilight sparkle,0biter
1133026.png,https://derpicdn.net/img/view/2016/4/16/1133026.png,0,0.97517329454422,11,0,2387,2303,2376,2303,twilight sparkle,aethon056
1135587.png,https://derpicdn.net/img/view/2016/4/19/1135587.png,0,0.9974378943443298,639,59,1755,1175,1116,1116,twilight sparkle,lonewolf3878
1138270.png,https://derpicdn.net/img/view/2016/4/23/1138270.png,0,0.9759481549263,1776,0,6000,4296,4224,4296,twilight sparkle,eagle1division
1139013.png,https://derpicdn.net/img/view/2016/4/24/1139013.png,0,0.943684458732605,164,0,782,598,618,598,twilight sparkle,dudey64
1140678.png,https://derpicdn.net/img/view/2016/4/26/1140678.png,0,0.9990431666374208,367,27,927,587,560,560,twilight sparkle,meb90
1146766.png,https://derpicdn.net/img/view/2016/5/5/1146766.png,1,0.9964719414711,1865,472,2895,1502,1030,1030,twilight sparkle,saphi-boo
1146979.png,https://derpicdn.net/img/view/2016/5/5/1146979.png,0,0.9623422622680664,267,83,885,701,618,618,twilight sparkle,cabbage-arts
1148010.png,https://derpicdn.net/img/view/2016/5/6/1148010.png,0,0.9883415102958679,128,0,410,266,282,266,twilight sparkle,shiiran
1149625.png,https://derpicdn.net/img/view/2016/5/8/1149625.png,0,0.9901237487792968,412,0,1020,536,608,536,twilight sparkle,siggie740
1149968.png,https://derpicdn.net/img/view/2016/5/9/1149968.png,0,0.9991353750228882,408,11,876,479,468,468,twilight sparkle,joey
1150611.png,https://derpicdn.net/img/view/2016/5/10/1150611.png,0,0.9048798084259032,1781,457,5793,4469,4012,4012,twilight sparkle,decprincess
1153203.png,https://derpicdn.net/img/view/2016/5/13/1153203.png,0,0.9679022431373596,433,43,1067,677,634,634,twilight sparkle,mississippikite
1153416.png,https://derpicdn.net/img/view/2016/5/14/1153416.png,0,0.9198416471481324,378,148,742,512,364,364,twilight sparkle,ultrard
115371.png,https://derpicdn.net/img/view/2012/10/6/115371.png,0,0.9963496327400208,0,0,1001,879,1001,879,twilight sparkle,nekocrispy
1153815.png,https://derpicdn.net/img/view/2016/5/14/1153815.png,0,0.9810168147087096,21,0,781,490,760,490,twilight sparkle,
1156792.png,https://derpicdn.net/img/view/2016/5/18/1156792.png,0,0.9815822243690492,0,55,3226,3511,3226,3456,twilight sparkle,nuumia
1159051.png,https://derpicdn.net/img/view/2016/5/21/1159051.png,0,0.9601089954376221,4527,242,8403,4118,3876,3876,twilight sparkle,decprincess
1159524.png,https://derpicdn.net/img/view/2016/5/21/1159524.png,0,0.9886271953582764,27,0,505,437,478,437,twilight sparkle,
1160415.png,https://derpicdn.net/img/view/2016/5/22/1160415.png,0,0.9779332876205444,106,37,932,863,826,826,twilight sparkle,twisted-sketch
1161308.png,https://derpicdn.net/img/view/2016/5/23/1161308.png,0,0.9978451132774352,617,0,1571,930,954,930,twilight sparkle,bluetech
1161380.png,https://derpicdn.net/img/view/2016/5/23/1161380.png,0,0.975278913974762,346,0,816,452,470,452,twilight sparkle,bluetech
1161446.png,https://derpicdn.net/img/view/2016/5/23/1161446.png,1,0.9453186988830566,910,415,1698,1203,788,788,twilight sparkle,riisusparkle
1162886.jpg,https://derpicdn.net/img/view/2016/5/25/1162886.jpg,0,0.9845673441886902,129,14,1215,1100,1086,1086,twilight sparkle,jennypaige
1168451.png,https://derpicdn.net/img/view/2016/6/2/1168451.png,0,0.9966675639152528,429,1,981,553,552,552,twilight sparkle,leffenkitty
1168592.png,https://derpicdn.net/img/view/2016/6/2/1168592.png,0,0.9519900679588318,19,0,865,844,846,844,twilight sparkle,sonica-michi
1169007.png,https://derpicdn.net/img/view/2016/6/3/1169007.png,0,0.9954416155815125,298,0,928,566,630,566,twilight sparkle,inurantchan
1169289.png,https://derpicdn.net/img/view/2016/6/3/1169289.png,0,0.9803233742713928,366,2,1544,1180,1178,1178,twilight sparkle,porygon2z
1169833.png,https://derpicdn.net/img/view/2016/6/4/1169833.png,0,0.96201890707016,301,5,941,645,640,640,twilight sparkle,jmw12
1170667.png,https://derpicdn.net/img/view/2016/6/5/1170667.png,0,0.9989282488822936,986,0,2590,1592,1604,1592,twilight sparkle,spellboundcanvas
1172236.png,https://derpicdn.net/img/view/2016/6/7/1172236.png,0,0.9958551526069641,67,0,617,527,550,527,twilight sparkle,yuyusunshine
1174931.png,https://derpicdn.net/img/view/2016/6/10/1174931.png,0,0.9871909618377686,379,81,901,603,522,522,twilight sparkle,alasou
1175558.jpg,https://derpicdn.net/img/view/2016/6/11/1175558.jpg,0,0.9997312426567078,232,127,526,421,294,294,twilight sparkle,trunchbull
1177331.png,https://derpicdn.net/img/view/2016/6/13/1177331.png,0,0.990746796131134,136,89,494,447,358,358,twilight sparkle,kourabiedes
1180274.png,https://derpicdn.net/img/view/2016/6/17/1180274.png,0,0.9890851974487304,2384,0,5818,3369,3434,3369,twilight sparkle,tardifice
1181113.png,https://derpicdn.net/img/view/2016/6/18/1181113.png,0,0.9986616969108582,403,35,1213,845,810,810,twilight sparkle,byspot
1181782.png,https://derpicdn.net/img/view/2016/6/19/1181782.png,0,0.9998648166656494,315,0,655,329,340,329,twilight sparkle,acesential
1183066.jpg,https://derpicdn.net/img/view/2016/6/20/1183066.jpg,0,0.9880444407463074,403,0,911,463,508,463,twilight sparkle,icefairy64
1183564.png,https://derpicdn.net/img/view/2016/6/21/1183564.png,0,0.9971695542335508,465,94,929,558,464,464,twilight sparkle,ressq
1187237.png,https://derpicdn.net/img/view/2016/6/26/1187237.png,0,0.9605555534362792,236,40,1106,910,870,870,twilight sparkle,shilzumi|焰鑰 熾泉
1187936.png,https://derpicdn.net/img/view/2016/6/27/1187936.png,0,0.9149591326713562,373,8,923,558,550,550,twilight sparkle,doodlinjaz
1188716.png,https://derpicdn.net/img/view/2016/6/28/1188716.png,0,0.9815884232521056,0,0,500,498,500,498,twilight sparkle,bigmoon206
119005.png,https://derpicdn.net/img/view/2012/10/10/119005.png,0,0.9922327995300292,546,48,1520,1022,974,974,twilight sparkle,danmakuman
1193970.png,https://derpicdn.net/img/view/2016/7/5/1193970.png,0,0.9228959679603576,1049,0,3153,1971,2104,1971,twilight sparkle,no-time-for-caution
1193972.png,https://derpicdn.net/img/view/2016/7/5/1193972.png,0,0.9580256342887878,61,158,2745,2842,2684,2684,twilight sparkle,no-time-for-caution
1197636.png,https://derpicdn.net/img/view/2016/7/10/1197636.png,0,0.9637499451637268,67,0,761,663,694,663,twilight sparkle,glumdusk
1204703.png,https://derpicdn.net/img/view/2016/7/19/1204703.png,0,0.9809553623199464,426,130,690,394,264,264,twilight sparkle,themexicanpunisher|dashiesparkle|beavernator
1205313.png,https://derpicdn.net/img/view/2016/7/20/1205313.png,0,0.9811478853225708,79,77,493,491,414,414,twilight sparkle,lintegrisse
1205313.png,https://derpicdn.net/img/view/2016/7/20/1205313.png,1,0.943092942237854,389,0,831,438,442,438,twilight sparkle,lintegrisse
1205424.png,https://derpicdn.net/img/view/2016/7/20/1205424.png,0,0.976533591747284,979,117,1649,787,670,670,twilight sparkle,tonydashie22
1208392.png,https://derpicdn.net/img/view/2016/7/24/1208392.png,0,0.9898385405540466,0,454,1524,2172,1524,1718,twilight sparkle,starlessnight22
1208667.png,https://derpicdn.net/img/view/2016/7/25/1208667.png,0,0.994456708431244,590,65,878,353,288,288,twilight sparkle,pinkiecitrine
1210270.png,https://derpicdn.net/img/view/2016/7/27/1210270.png,0,0.9539653658866882,225,135,873,783,648,648,twilight sparkle,tendergamer
1211073.png,https://derpicdn.net/img/view/2016/7/28/1211073.png,0,0.9948156476020812,433,69,1339,975,906,906,twilight sparkle,pucksterv
1215909.png,https://derpicdn.net/img/view/2016/8/3/1215909.png,0,0.9865407347679138,356,0,774,417,418,417,twilight sparkle,patty-plmh
1218100.png,https://derpicdn.net/img/view/2016/8/6/1218100.png,0,0.9822721481323242,486,339,750,603,264,264,twilight sparkle,inuhoshi-to-darkpen
1225859.png,https://derpicdn.net/img/view/2016/8/15/1225859.png,0,0.9992180466651917,1452,0,2832,1377,1380,1377,twilight sparkle,ruinedomega
1227462.png,https://derpicdn.net/img/view/2016/8/17/1227462.png,0,0.9609574675559998,1491,338,2581,1428,1090,1090,twilight sparkle,hfinder
1228115.png,https://derpicdn.net/img/view/2016/8/18/1228115.png,0,0.9993577599525452,2335,30,4107,1802,1772,1772,twilight sparkle,duskie-06
1229728.png,https://derpicdn.net/img/view/2016/8/20/1229728.png,0,0.9833937883377076,39,0,386,351,347,351,twilight sparkle,
1229778.png,https://derpicdn.net/img/view/2016/8/20/1229778.png,0,0.9868180155754088,0,0,409,402,409,402,twilight sparkle,
123012.jpg,https://derpicdn.net/img/view/2012/10/14/123012.jpg,0,0.9343527555465698,578,38,1286,746,708,708,twilight sparkle,shydeathkitty
1230129.png,https://derpicdn.net/img/view/2016/8/21/1230129.png,0,0.987690269947052,4,0,808,768,804,768,twilight sparkle,
1232857.png,https://derpicdn.net/img/view/2016/8/24/1232857.png,0,0.963165283203125,961,537,3435,3011,2474,2474,twilight sparkle,reginault
1233334.png,https://derpicdn.net/img/view/2016/8/25/1233334.png,0,0.902812659740448,4,0,352,305,348,305,twilight sparkle,kinda-l
1233384.png,https://derpicdn.net/img/view/2016/8/25/1233384.png,0,0.9397011995315552,362,512,5130,5280,4768,4768,twilight sparkle,slb94
1235209.png,https://derpicdn.net/img/view/2016/8/27/1235209.png,0,0.978354513645172,319,15,2349,2045,2030,2030,twilight sparkle,estories
1236056.png,https://derpicdn.net/img/view/2016/8/28/1236056.png,0,0.9753932952880859,236,10,722,496,486,486,twilight sparkle,empyu
1237158.png,https://derpicdn.net/img/view/2016/8/29/1237158.png,0,0.9766055941581726,172,0,1910,1695,1738,1695,twilight sparkle,starmoonlightfox
1239154.png,https://derpicdn.net/img/view/2016/9/1/1239154.png,0,0.9165745377540588,0,0,977,801,977,801,twilight sparkle,seriff-pilcrow
124489.png,https://derpicdn.net/img/view/2012/10/16/124489.png,0,0.993178129196167,25,0,477,450,452,450,twilight sparkle,theairgonaut
124504.png,https://derpicdn.net/img/view/2012/10/16/124504.png,0,0.9491877555847168,331,376,673,718,342,342,twilight sparkle,kittehkatbar
1245932.png,https://derpicdn.net/img/view/2016/9/10/1245932.png,0,0.9096331000328064,582,0,2600,2036,2018,2036,twilight sparkle,katkathasahathat
1247820.png,https://derpicdn.net/img/view/2016/9/12/1247820.png,0,0.985365092754364,441,106,1003,668,562,562,twilight sparkle,thecreativerey
1248001.png,https://derpicdn.net/img/view/2016/9/12/1248001.png,0,0.9785669445991516,64,0,4212,3992,4148,3992,twilight sparkle,pink1ejack
1250523.png,https://derpicdn.net/img/view/2016/9/16/1250523.png,0,0.9837656021118164,0,0,2064,2372,2064,2372,twilight sparkle,sketchmcreations
1252245.png,https://derpicdn.net/img/view/2016/9/18/1252245.png,0,0.9744420051574708,611,0,9201,7874,8590,7874,twilight sparkle,cyanlightning
1253917.png,https://derpicdn.net/img/view/2016/9/20/1253917.png,0,0.9475779533386228,89,0,412,337,323,337,twilight sparkle,
1255768.png,https://derpicdn.net/img/view/2016/9/22/1255768.png,0,0.9973137378692628,303,0,1151,804,848,804,twilight sparkle,atmosseven
1256934.png,https://derpicdn.net/img/view/2016/9/24/1256934.png,0,0.9286076426506042,120,0,494,366,374,366,twilight sparkle,snowfall-artistry
1258712.png,https://derpicdn.net/img/view/2016/9/26/1258712.png,0,0.999457597732544,0,43,903,983,903,940,twilight sparkle,sketchmcreations
1259735.png,https://derpicdn.net/img/view/2016/9/27/1259735.png,0,0.9996821880340576,400,219,658,477,258,258,twilight sparkle,alorix
1260953.png,https://derpicdn.net/img/view/2016/9/29/1260953.png,0,0.9970239400863647,517,28,833,344,316,316,twilight sparkle,odiz
1261011.png,https://derpicdn.net/img/view/2016/9/29/1261011.png,0,0.9460647702217102,102,82,840,819,738,737,twilight sparkle,
1262227.png,https://derpicdn.net/img/view/2016/10/1/1262227.png,0,0.968159019947052,2500,667,4760,2927,2260,2260,twilight sparkle,dashiesparkle
1262486.png,https://derpicdn.net/img/view/2016/10/1/1262486.png,0,0.9521262049674988,0,0,607,688,607,688,twilight sparkle,pastelhorses
1262559.png,https://derpicdn.net/img/view/2016/10/1/1262559.png,0,0.986997365951538,0,3,222,225,222,222,twilight sparkle,
1262611.png,https://derpicdn.net/img/view/2016/10/1/1262611.png,0,0.9008752703666688,276,0,1860,1080,1584,1080,twilight sparkle,
1262886.png,https://derpicdn.net/img/view/2016/10/1/1262886.png,0,0.984286904335022,0,0,532,521,532,521,twilight sparkle,estories
1263249.png,https://derpicdn.net/img/view/2016/10/2/1263249.png,0,0.9977389574050904,0,13,1517,1575,1517,1562,twilight sparkle,eagle1division
1263890.png,https://derpicdn.net/img/view/2016/10/3/1263890.png,0,0.9925817847251892,657,243,1791,1377,1134,1134,twilight sparkle,kmanalli
1263973.png,https://derpicdn.net/img/view/2016/10/3/1263973.png,0,0.9510436058044434,2,14,1666,1678,1664,1664,twilight sparkle,sketchmcreations
126450.png,https://derpicdn.net/img/view/2012/10/19/126450.png,0,0.9809613823890686,237,15,517,295,280,280,twilight sparkle,tt-n
1266168.png,https://derpicdn.net/img/view/2016/10/6/1266168.png,0,0.9745610356330872,0,6,614,698,614,692,twilight sparkle,
1267126.png,https://derpicdn.net/img/view/2016/10/7/1267126.png,0,0.9905016422271729,0,0,2303,2340,2303,2340,twilight sparkle,osipush
1271299.png,https://derpicdn.net/img/view/2016/10/12/1271299.png,0,0.9981022477149964,0,0,366,372,366,372,twilight sparkle,cinnajen
1273091.png,https://derpicdn.net/img/view/2016/10/15/1273091.png,0,0.9989076852798462,26,0,1136,1060,1110,1060,twilight sparkle,septicmelon
1273641.png,https://derpicdn.net/img/view/2016/10/15/1273641.png,0,0.992255926132202,3124,74,6736,3686,3612,3612,twilight sparkle,tardifice
1274400.png,https://derpicdn.net/img/view/2016/10/16/1274400.png,0,0.9003229141235352,68,47,325,321,257,274,twilight sparkle,
1276247.png,https://derpicdn.net/img/view/2016/10/18/1276247.png,0,0.9194266200065612,95,0,1765,1080,1670,1080,twilight sparkle,
1278139.png,https://derpicdn.net/img/view/2016/10/21/1278139.png,3,0.9606690406799316,402,40,1160,798,758,758,twilight sparkle,arifproject
1278139.png,https://derpicdn.net/img/view/2016/10/21/1278139.png,4,0.9575145840644836,1567,66,2231,730,664,664,twilight sparkle,arifproject
1278139.png,https://derpicdn.net/img/view/2016/10/21/1278139.png,5,0.9033027291297911,567,1469,1431,2333,864,864,twilight sparkle,arifproject
1279164.png,https://derpicdn.net/img/view/2016/10/22/1279164.png,0,0.982425570487976,531,185,1551,1205,1020,1020,twilight sparkle,asika-aida
1286157.png,https://derpicdn.net/img/view/2016/11/1/1286157.png,0,0.9892698526382446,22,19,670,667,648,648,twilight sparkle,tjpones
1287216.png,https://derpicdn.net/img/view/2016/11/2/1287216.png,0,0.978502094745636,380,138,838,596,458,458,twilight sparkle,camyllea
1287388.png,https://derpicdn.net/img/view/2016/11/2/1287388.png,0,0.950119972229004,661,1214,6062,6872,5401,5658,twilight sparkle,pink1ejack
1287421.png,https://derpicdn.net/img/view/2016/11/2/1287421.png,0,0.927424430847168,125,330,2567,2772,2442,2442,twilight sparkle,cloudyglow
1290621.png,https://derpicdn.net/img/view/2016/11/7/1290621.png,0,0.9916180968284608,620,146,2778,2304,2158,2158,twilight sparkle,cloudyglow
1291932.png,https://derpicdn.net/img/view/2016/11/9/1291932.png,0,0.9563646912574768,74,1,512,487,438,486,twilight sparkle,
1296211.png,https://derpicdn.net/img/view/2016/11/15/1296211.png,0,0.9518534541130066,343,0,2375,1996,2032,1996,twilight sparkle,vanillashineart
1297704.png,https://derpicdn.net/img/view/2016/11/17/1297704.png,0,0.9345046877861024,6707,2990,9237,5520,2530,2530,twilight sparkle,evilfrenzy
1297915.png,https://derpicdn.net/img/view/2016/11/17/1297915.png,0,0.9985774159431458,233,220,861,848,628,628,twilight sparkle,mailinya
1299359.png,https://derpicdn.net/img/view/2016/11/20/1299359.png,0,0.9980355501174928,224,327,680,783,456,456,twilight sparkle,whitehershey
1302869.png,https://derpicdn.net/img/view/2016/11/24/1302869.png,0,0.9695868492126464,0,0,1937,1936,1937,1936,twilight sparkle,theshadowstone
1302914.png,https://derpicdn.net/img/view/2016/11/24/1302914.png,0,0.9462085366249084,976,629,1584,1237,608,608,twilight sparkle,pedrohander
1303266.png,https://derpicdn.net/img/view/2016/11/25/1303266.png,0,0.9720192551612854,54,164,2030,2140,1976,1976,twilight sparkle,sketchmcreations
1305259.png,https://derpicdn.net/img/view/2016/11/28/1305259.png,0,0.9521973729133606,233,13,1389,1169,1156,1156,twilight sparkle,befishproductions
1305831.png,https://derpicdn.net/img/view/2016/11/29/1305831.png,0,0.9761883616447448,308,38,2347,2390,2039,2352,twilight sparkle,diegator007
1305838.png,https://derpicdn.net/img/view/2016/11/29/1305838.png,0,0.9902305006980896,0,18,1067,1118,1067,1100,twilight sparkle,tuppkam1
1309156.png,https://derpicdn.net/img/view/2016/12/3/1309156.png,0,0.9991222023963928,595,325,1159,889,564,564,twilight sparkle,murzik-teijiro
1312572.png,https://derpicdn.net/img/view/2016/12/8/1312572.png,0,0.9960592985153198,3298,0,6630,3216,3332,3216,twilight sparkle,luckreza8
1315864.png,https://derpicdn.net/img/view/2016/12/12/1315864.png,0,0.9563395977020264,100,28,700,628,600,600,twilight sparkle,liddieneko
1318842.png,https://derpicdn.net/img/view/2016/12/16/1318842.png,0,0.9870250225067142,82,0,1248,1145,1166,1145,twilight sparkle,platenjack
1320166.png,https://derpicdn.net/img/view/2016/12/18/1320166.png,0,0.9878727197647096,301,223,1269,1191,968,968,twilight sparkle,yakoshi
1320182.png,https://derpicdn.net/img/view/2016/12/18/1320182.png,0,0.9601026177406312,744,0,2790,1669,2046,1669,twilight sparkle,mcflurrylazermuffin
1321452.png,https://derpicdn.net/img/view/2016/12/20/1321452.png,0,0.9998421669006348,1906,0,3838,1891,1932,1891,twilight sparkle,deyrasd
1321577.png,https://derpicdn.net/img/view/2016/12/20/1321577.png,0,0.9972551465034484,683,385,1213,915,530,530,twilight sparkle,ravensunart
1323676.png,https://derpicdn.net/img/view/2016/12/23/1323676.png,0,0.9930459856987,140,0,481,354,341,354,twilight sparkle,brendahickey
1325047.png,https://derpicdn.net/img/view/2016/12/25/1325047.png,0,0.9659870266914368,404,454,914,964,510,510,twilight sparkle,vasillium
1326967.png,https://derpicdn.net/img/view/2016/12/28/1326967.png,0,0.9927090406417848,827,63,1739,975,912,912,twilight sparkle,percy-mcmurphy
1332730.png,https://derpicdn.net/img/view/2017/1/5/1332730.png,0,0.9815666079521179,164,131,856,823,692,692,twilight sparkle,huirou
1333136.png,https://derpicdn.net/img/view/2017/1/6/1333136.png,0,0.937343418598175,0,0,437,436,437,436,twilight sparkle,binkyt11
1335278.png,https://derpicdn.net/img/view/2017/1/9/1335278.png,0,0.9899755120277404,454,591,820,957,366,366,twilight sparkle,taligintou
1338446.png,https://derpicdn.net/img/view/2017/1/13/1338446.png,0,0.9995119571685792,476,0,1268,683,792,683,twilight sparkle,zogzor
1339302.png,https://derpicdn.net/img/view/2017/1/14/1339302.png,0,0.9777883291244508,0,0,351,396,351,396,twilight sparkle,stacyhirano34
1339531.png,https://derpicdn.net/img/view/2017/1/14/1339531.png,0,0.9963301420211792,177,0,779,598,602,598,twilight sparkle,cold-blooded-twilight
1339717.png,https://derpicdn.net/img/view/2017/1/15/1339717.png,0,0.9996243715286256,1100,12,1978,966,878,954,twilight sparkle,thexiiilightning
1341798.png,https://derpicdn.net/img/view/2017/1/18/1341798.png,1,0.990589201450348,2172,882,3404,2114,1232,1232,twilight sparkle,lunaticdawn
1346476.png,https://derpicdn.net/img/view/2017/1/23/1346476.png,0,0.960861086845398,856,0,2760,1760,1904,1760,twilight sparkle,jessy2015|minelvi
1347855.png,https://derpicdn.net/img/view/2017/1/25/1347855.png,0,0.9419490098953248,15,0,955,905,940,905,twilight sparkle,
134799.png,https://derpicdn.net/img/view/2012/10/28/134799.png,0,0.998303472995758,1100,844,4604,4348,3504,3504,twilight sparkle,mamandil
1348122.png,https://derpicdn.net/img/view/2017/1/26/1348122.png,0,0.9944804310798644,32,0,1096,1043,1064,1043,twilight sparkle,demonfox
1350810.png,https://derpicdn.net/img/view/2017/1/29/1350810.png,0,0.9835950136184692,14,31,752,720,738,689,twilight sparkle,
1355628.png,https://derpicdn.net/img/view/2017/2/5/1355628.png,0,0.9678253531455994,118,324,542,748,424,424,twilight sparkle,not-ordinary-pony
1356343.png,https://derpicdn.net/img/view/2017/2/6/1356343.png,0,0.9613828659057616,557,332,1563,1338,1006,1006,twilight sparkle,shogundun
1360893.png,https://derpicdn.net/img/view/2017/2/12/1360893.png,0,0.998179852962494,670,82,1572,984,902,902,twilight sparkle,merienvip
1361329.png,https://derpicdn.net/img/view/2017/2/12/1361329.png,0,0.9776884317398072,1022,120,1508,606,486,486,twilight sparkle,mrscroup
1362108.png,https://derpicdn.net/img/view/2017/2/13/1362108.png,0,0.9913227558135986,139,122,1711,1694,1572,1572,twilight sparkle,porygon2z
1362333.png,https://derpicdn.net/img/view/2017/2/14/1362333.png,0,0.9979261755943298,401,62,787,448,386,386,twilight sparkle,libbythekautz
1363001.png,https://derpicdn.net/img/view/2017/2/14/1363001.png,0,0.9101492762565612,2090,530,3120,1560,1030,1030,twilight sparkle,crosmirsketch
1363458.png,https://derpicdn.net/img/view/2017/2/15/1363458.png,0,0.937731385231018,312,502,4993,5476,4681,4974,twilight sparkle,nero-narmeril
1366798.png,https://derpicdn.net/img/view/2017/2/18/1366798.png,0,0.9961095452308656,158,0,770,597,612,597,twilight sparkle,eeviart
1370362.png,https://derpicdn.net/img/view/2017/2/22/1370362.png,0,0.9932538270950316,416,128,540,266,124,138,twilight sparkle,sehad
1371177.png,https://derpicdn.net/img/view/2017/2/23/1371177.png,0,0.9952661991119384,781,604,1259,1082,478,478,twilight sparkle,post-it
1372420.png,https://derpicdn.net/img/view/2017/2/25/1372420.png,0,0.9996759295463562,0,14,373,388,373,374,twilight sparkle,tigerfestivals
1372684.png,https://derpicdn.net/img/view/2017/2/25/1372684.png,1,0.9240263104438782,377,115,691,429,314,314,twilight sparkle,rocky_429
1378565.png,https://derpicdn.net/img/view/2017/3/4/1378565.png,0,0.9325274825096128,0,75,857,985,857,910,twilight sparkle,pucksterv
1379815.png,https://derpicdn.net/img/view/2017/3/5/1379815.png,0,0.9918172359466552,51,0,3011,2798,2960,2798,twilight sparkle,eagle1division
1379848.png,https://derpicdn.net/img/view/2017/3/5/1379848.png,0,0.9925554394721984,270,185,1060,975,790,790,twilight sparkle,ragurimo
1382203.png,https://derpicdn.net/img/view/2017/3/8/1382203.png,0,0.9983844757080078,403,29,1549,1175,1146,1146,twilight sparkle,chickenbrony
1382233.png,https://derpicdn.net/img/view/2017/3/8/1382233.png,0,0.9488065838813782,772,495,1482,1205,710,710,twilight sparkle,jazzerix
1382529.png,https://derpicdn.net/img/view/2017/3/8/1382529.png,0,0.9813902974128724,0,0,899,991,899,991,twilight sparkle,aelwyng
1383435.png,https://derpicdn.net/img/view/2017/3/10/1383435.png,0,0.9581314325332642,329,0,1719,1226,1390,1226,twilight sparkle,cluvry
1384092.png,https://derpicdn.net/img/view/2017/3/11/1384092.png,0,0.994553565979004,81,65,1749,1733,1668,1668,twilight sparkle,befishproductions
1384272.png,https://derpicdn.net/img/view/2017/3/11/1384272.png,0,0.9044315814971924,722,11,2058,1347,1336,1336,twilight sparkle,oolittlebratoo|scottishnumpty
1384304.png,https://derpicdn.net/img/view/2017/3/11/1384304.png,0,0.9168157577514648,258,417,804,963,546,546,twilight sparkle,sapphireliz
1385576.png,https://derpicdn.net/img/view/2017/3/12/1385576.png,0,0.9862715601921082,494,718,1290,1514,796,796,twilight sparkle,rappy-yum
1388386.png,https://derpicdn.net/img/view/2017/3/16/1388386.png,0,0.9740824103355408,81,491,2952,3276,2871,2785,twilight sparkle,linormusicbeatpone
1390122.png,https://derpicdn.net/img/view/2017/3/18/1390122.png,0,0.95670747756958,478,193,1024,739,546,546,twilight sparkle,derp-berry
1391202.png,https://derpicdn.net/img/view/2017/3/19/1391202.png,0,0.9997506737709044,470,32,916,478,446,446,twilight sparkle,zomgitsalaura
1391454.png,https://derpicdn.net/img/view/2017/3/19/1391454.png,0,0.9751595258712769,863,0,2713,1721,1850,1721,twilight sparkle,minteadraws|minelvi
139180.png,https://derpicdn.net/img/view/2012/11/2/139180.png,0,0.9810622930526732,20,0,688,571,668,571,twilight sparkle,tlatophat
1394443.png,https://derpicdn.net/img/view/2017/3/23/1394443.png,0,0.9164079427719116,109,0,425,302,316,302,twilight sparkle,
1397758.png,https://derpicdn.net/img/view/2017/3/27/1397758.png,0,0.9827059507369996,797,177,1559,939,762,762,twilight sparkle,lymesun
1398125.png,https://derpicdn.net/img/view/2017/3/28/1398125.png,0,0.980032742023468,1021,0,1697,676,676,676,twilight sparkle,rapidstrike
1398305.png,https://derpicdn.net/img/view/2017/3/28/1398305.png,0,0.993446946144104,0,0,3325,3741,3325,3741,twilight sparkle,luckreza8
1398668.png,https://derpicdn.net/img/view/2017/3/28/1398668.png,0,0.987497091293335,192,3,1026,837,834,834,twilight sparkle,pabbley
1401596.png,https://derpicdn.net/img/view/2017/4/1/1401596.png,0,0.996354877948761,288,51,1050,813,762,762,twilight sparkle,spirit-dude
1402601.png,https://derpicdn.net/img/view/2017/4/2/1402601.png,0,0.9621955752372742,9,0,821,722,812,722,twilight sparkle,starshame
1404972.png,https://derpicdn.net/img/view/2017/4/5/1404972.png,0,0.9194188714027404,18,0,1200,1239,1182,1239,twilight sparkle,faline-art
1408211.png,https://derpicdn.net/img/view/2017/4/10/1408211.png,0,0.9816745519638062,1,0,492,505,491,505,twilight sparkle,
1408268.png,https://derpicdn.net/img/view/2017/4/10/1408268.png,0,0.9762884378433228,124,180,498,554,374,374,twilight sparkle,jbond|longinius
1408977.png,https://derpicdn.net/img/view/2017/4/11/1408977.png,0,0.9684112071990968,983,0,1635,623,652,623,twilight sparkle,arcuswind
141016.png,https://derpicdn.net/img/view/2012/11/3/141016.png,0,0.9935402870178224,203,0,625,416,422,416,twilight sparkle,reikomuffin
1412447.png,https://derpicdn.net/img/view/2017/4/15/1412447.png,0,0.9969483613967896,845,0,3607,2644,2762,2644,twilight sparkle,keronianniroro
1413264.png,https://derpicdn.net/img/view/2017/4/16/1413264.png,0,0.9076829552650452,59,0,409,345,350,345,twilight sparkle,
1414644.png,https://derpicdn.net/img/view/2017/4/18/1414644.png,0,0.926003634929657,402,591,3472,3661,3070,3070,twilight sparkle,slb94
1415548.png,https://derpicdn.net/img/view/2017/4/18/1415548.png,0,0.9909767508506776,458,7,988,537,530,530,twilight sparkle,jeremeymcdude
1416873.png,https://derpicdn.net/img/view/2017/4/20/1416873.png,0,0.9901341795921326,59,32,347,320,288,288,twilight sparkle,tigerfestivals
1419005.png,https://derpicdn.net/img/view/2017/4/22/1419005.png,0,0.9985052943229676,718,43,1408,733,690,690,twilight sparkle,fluffleduckle
1423001.png,https://derpicdn.net/img/view/2017/4/27/1423001.png,0,0.9943752884864808,35,0,541,483,506,483,twilight sparkle,post-it
1424012.png,https://derpicdn.net/img/view/2017/4/29/1424012.png,0,0.9442360401153564,809,17,2455,1440,1646,1423,twilight sparkle,
1425426.png,https://derpicdn.net/img/view/2017/4/30/1425426.png,0,0.9254433512687684,275,248,533,506,258,258,twilight sparkle,saturdaymorningproj
1429945.png,https://derpicdn.net/img/view/2017/5/6/1429945.png,0,0.9945690631866456,1251,29,2831,1609,1580,1580,twilight sparkle,ruinedomega
1430666.png,https://derpicdn.net/img/view/2017/5/7/1430666.png,0,0.999559223651886,329,101,979,751,650,650,twilight sparkle,bbbhuey
1432004.png,https://derpicdn.net/img/view/2017/5/8/1432004.png,0,0.9078549146652222,0,280,7000,9532,7000,9252,twilight sparkle,tardifice
1435029.png,https://derpicdn.net/img/view/2017/5/13/1435029.png,0,0.9520940780639648,178,86,1730,1638,1552,1552,twilight sparkle,geomancing
1437015.png,https://derpicdn.net/img/view/2017/5/15/1437015.png,0,0.9993348717689514,341,445,1169,1273,828,828,twilight sparkle,katakiuchi4u
1441499.png,https://derpicdn.net/img/view/2017/5/20/1441499.png,0,0.9271687865257264,0,0,413,497,413,497,twilight sparkle,wcctnoam
1443505.png,https://derpicdn.net/img/view/2017/5/22/1443505.png,0,0.9976524114608764,153,22,885,754,732,732,twilight sparkle,jucamovi1992
1446008.png,https://derpicdn.net/img/view/2017/5/25/1446008.png,0,0.9470769166946412,568,44,1234,710,666,666,twilight sparkle,theimmortalwolf
1446280.png,https://derpicdn.net/img/view/2017/5/26/1446280.png,0,0.9090977311134338,201,19,599,417,398,398,twilight sparkle,trini-mite
1446466.png,https://derpicdn.net/img/view/2017/5/26/1446466.png,0,0.9374231696128844,84,53,758,727,674,674,twilight sparkle,askbubblelee|ambits
1449982.png,https://derpicdn.net/img/view/2017/5/30/1449982.png,0,0.9538835883140564,257,61,1041,845,784,784,twilight sparkle,ljdamz1119
1450550.png,https://derpicdn.net/img/view/2017/5/31/1450550.png,0,0.9083960056304932,240,0,1876,1080,1636,1080,twilight sparkle,
1452135.png,https://derpicdn.net/img/view/2017/6/2/1452135.png,0,0.9671290516853333,2528,165,5488,3125,2960,2960,twilight sparkle,estories
1452234.png,https://derpicdn.net/img/view/2017/6/2/1452234.png,0,0.9928772449493408,0,0,933,946,933,946,twilight sparkle,australian-senior
1452235.png,https://derpicdn.net/img/view/2017/6/2/1452235.png,0,0.98811274766922,0,0,919,936,919,936,twilight sparkle,australian-senior
1453056.png,https://derpicdn.net/img/view/2017/6/3/1453056.png,0,0.9920780658721924,8,0,480,451,472,451,twilight sparkle,
1453093.png,https://derpicdn.net/img/view/2017/6/3/1453093.png,0,0.955650806427002,3635,0,8800,4829,5165,4829,twilight sparkle,tardifice
1454719.png,https://derpicdn.net/img/view/2017/6/5/1454719.png,0,0.9888405203819276,929,251,1901,1223,972,972,twilight sparkle,otakuponi
1462951.png,https://derpicdn.net/img/view/2017/6/16/1462951.png,0,0.9886569380760192,39,0,451,376,412,376,twilight sparkle,akimi--chan|mediasmile666
1464596.png,https://derpicdn.net/img/view/2017/6/18/1464596.png,0,0.991006314754486,130,0,2944,2620,2814,2620,twilight sparkle,drfatalchunk
14656.jpg,https://derpicdn.net/img/view/2012/6/21/14656.jpg,0,0.9581977725028992,191,37,939,785,748,748,twilight sparkle,megasweet
1466130.png,https://derpicdn.net/img/view/2017/6/19/1466130.png,1,0.992476761341095,803,342,2029,1568,1226,1226,twilight sparkle,mintydrop2013
1476188.png,https://derpicdn.net/img/view/2017/7/1/1476188.png,0,0.959422767162323,102,0,544,401,442,401,twilight sparkle,
1480152.png,https://derpicdn.net/img/view/2017/7/6/1480152.png,0,0.9912328124046326,362,0,984,602,622,602,twilight sparkle,underwoodart
1482631.png,https://derpicdn.net/img/view/2017/7/10/1482631.png,0,0.998637855052948,731,36,1563,868,832,832,twilight sparkle,infinitewarlock
1485835.png,https://derpicdn.net/img/view/2017/7/14/1485835.png,0,0.9719284176826476,323,129,2400,2321,2077,2192,twilight sparkle,cheezedoodle96
1485945.png,https://derpicdn.net/img/view/2017/7/14/1485945.png,0,0.9029148817062378,191,0,697,439,506,439,twilight sparkle,jumperkit
1486747.png,https://derpicdn.net/img/view/2017/7/15/1486747.png,0,0.9860115051269532,95,128,1145,1178,1050,1050,twilight sparkle,zogzor
1489796.png,https://derpicdn.net/img/view/2017/7/19/1489796.png,0,0.9900136590003968,1951,75,6563,4687,4612,4612,twilight sparkle,pink1ejack
1491194.png,https://derpicdn.net/img/view/2017/7/21/1491194.png,0,0.9651728272438048,1,0,313,303,312,303,twilight sparkle,
1492221.png,https://derpicdn.net/img/view/2017/7/22/1492221.png,0,0.9789006114006042,58,105,868,915,810,810,twilight sparkle,pony-ellie-stuart
1492363.png,https://derpicdn.net/img/view/2017/7/22/1492363.png,0,0.9755184054374696,276,4,828,556,552,552,twilight sparkle,tortya
1493654.png,https://derpicdn.net/img/view/2017/7/24/1493654.png,0,0.9916156530380248,727,85,1209,567,482,482,twilight sparkle,iknowpony
1495730.png,https://derpicdn.net/img/view/2017/7/27/1495730.png,0,0.9530065655708312,1454,0,3098,1503,1644,1503,twilight sparkle,cloudyglow
1498715.png,https://derpicdn.net/img/view/2017/7/30/1498715.png,0,0.9960880875587464,380,130,778,528,398,398,twilight sparkle,klemm
1499358.png,https://derpicdn.net/img/view/2017/7/31/1499358.png,0,0.9908850193023682,1052,0,1918,856,866,856,twilight sparkle,evakulisreal
1501305.png,https://derpicdn.net/img/view/2017/8/2/1501305.png,0,0.9987031817436218,880,43,1566,729,686,686,twilight sparkle,strangiesleepy
1503164.png,https://derpicdn.net/img/view/2017/8/5/1503164.png,0,0.951193869113922,153,225,908,972,755,747,twilight sparkle,chametzkiwi
1504805.png,https://derpicdn.net/img/view/2017/8/7/1504805.png,0,0.985052764415741,540,339,928,727,388,388,twilight sparkle,phallen1
1510178.png,https://derpicdn.net/img/view/2017/8/14/1510178.png,0,0.9947153329849244,1254,240,2340,1326,1086,1086,twilight sparkle,joeycrick|theaceofspadez
1511548.png,https://derpicdn.net/img/view/2017/8/15/1511548.png,0,0.9710161089897156,967,0,3000,2037,2033,2037,twilight sparkle,uponia
1511739.png,https://derpicdn.net/img/view/2017/8/15/1511739.png,0,0.9796907901763916,301,73,657,429,356,356,twilight sparkle,astr0zone
1512454.png,https://derpicdn.net/img/view/2017/8/16/1512454.png,0,0.9781867861747742,805,1084,2363,2642,1558,1558,twilight sparkle,utauyan
1514703.png,https://derpicdn.net/img/view/2017/8/19/1514703.png,0,0.9535038471221924,899,44,1457,602,558,558,twilight sparkle,mr square|gashiboka
1516173.png,https://derpicdn.net/img/view/2017/8/21/1516173.png,0,0.9897671341896056,1275,0,4456,3352,3181,3352,twilight sparkle,jhayarr23
1516655.png,https://derpicdn.net/img/view/2017/8/21/1516655.png,0,0.9486165642738342,382,313,818,749,436,436,twilight sparkle,cannibalus
1519856.png,https://derpicdn.net/img/view/2017/8/26/1519856.png,0,0.9983523488044742,1813,146,2727,1060,914,914,twilight sparkle,supercoco142
1521654.png,https://derpicdn.net/img/view/2017/8/28/1521654.png,0,0.9225838184356692,0,0,1393,1389,1393,1389,twilight sparkle,djspark3
1524240.png,https://derpicdn.net/img/view/2017/8/31/1524240.png,0,0.9916983842849731,0,544,2385,3036,2385,2492,twilight sparkle,sunrise-shine-02
1524533.png,https://derpicdn.net/img/view/2017/8/31/1524533.png,0,0.9929819107055664,1244,257,1588,601,344,344,twilight sparkle,shad0w-galaxy
1527382.png,https://derpicdn.net/img/view/2017/9/4/1527382.png,0,0.993889570236206,0,0,1168,1148,1168,1148,twilight sparkle,jucamovi1992
1528038.png,https://derpicdn.net/img/view/2017/9/4/1528038.png,0,0.9901601672172546,295,0,705,407,410,407,twilight sparkle,
1528854.png,https://derpicdn.net/img/view/2017/9/5/1528854.png,0,0.9612286686897278,2487,1455,3976,3051,1489,1596,twilight sparkle,hornflakes
1534969.png,https://derpicdn.net/img/view/2017/9/14/1534969.png,0,0.9727697372436525,26,0,254,228,228,228,twilight sparkle,
1545599.png,https://derpicdn.net/img/view/2017/9/26/1545599.png,0,0.999433696269989,817,0,1799,1084,982,1084,twilight sparkle,davidsfire
1546127.png,https://derpicdn.net/img/view/2017/9/27/1546127.png,0,0.9862245917320251,0,0,601,610,601,610,twilight sparkle,
1546838.png,https://derpicdn.net/img/view/2017/9/28/1546838.png,0,0.9967487454414368,80,10,488,418,408,408,twilight sparkle,jucamovi1992
1553343.png,https://derpicdn.net/img/view/2017/10/6/1553343.png,0,0.9951148629188538,499,24,1173,698,674,674,twilight sparkle,cybershockstudios
1553551.png,https://derpicdn.net/img/view/2017/10/6/1553551.png,0,0.9948865175247192,169,51,785,667,616,616,twilight sparkle,batonya12561
1555264.png,https://derpicdn.net/img/view/2017/10/8/1555264.png,0,0.9654641151428224,782,325,1528,1071,746,746,twilight sparkle,bcrich40
1556387.png,https://derpicdn.net/img/view/2017/10/9/1556387.png,0,0.9578242897987366,1160,51,1600,493,440,442,twilight sparkle,jucamovi1992
1557820.png,https://derpicdn.net/img/view/2017/10/10/1557820.png,0,0.9943513274192808,808,85,1198,475,390,390,twilight sparkle,underpable
1559511.png,https://derpicdn.net/img/view/2017/10/12/1559511.png,0,0.9955612421035768,178,262,498,582,320,320,twilight sparkle,pika-chany
1559715.png,https://derpicdn.net/img/view/2017/10/13/1559715.png,0,0.9934737086296082,327,0,1849,1488,1522,1488,twilight sparkle,mlp-firefox5013
1559861.png,https://derpicdn.net/img/view/2017/10/13/1559861.png,0,0.9972711801528932,1406,0,3454,1992,2048,1992,twilight sparkle,sketchmcreations
1560768.png,https://derpicdn.net/img/view/2017/10/14/1560768.png,0,0.9571094512939452,0,375,2543,3017,2543,2642,twilight sparkle,sketchmcreations
1563853.png,https://derpicdn.net/img/view/2017/10/17/1563853.png,0,0.9369463324546814,3252,312,6250,3514,2998,3202,twilight sparkle,estories
1564332.png,https://derpicdn.net/img/view/2017/10/18/1564332.png,0,0.9390677809715272,176,0,1678,1080,1502,1080,twilight sparkle,
1564649.png,https://derpicdn.net/img/view/2017/10/18/1564649.png,0,0.9955431222915648,582,534,1330,1282,748,748,twilight sparkle,pewycert
1565554.png,https://derpicdn.net/img/view/2017/10/20/1565554.png,0,0.9892063140869141,275,372,1989,2086,1714,1714,twilight sparkle,tomfraggle
1567463.png,https://derpicdn.net/img/view/2017/10/22/1567463.png,0,0.955550491809845,0,0,443,459,443,459,twilight sparkle,
1567728.png,https://derpicdn.net/img/view/2017/10/22/1567728.png,0,0.9926276803016664,314,0,824,460,510,460,twilight sparkle,ejlightning007arts
1568679.png,https://derpicdn.net/img/view/2017/10/23/1568679.png,0,0.9862812757492064,55,134,1401,1459,1346,1325,twilight sparkle,kourma
1569343.png,https://derpicdn.net/img/view/2017/10/24/1569343.png,0,0.98250150680542,0,63,523,631,523,568,twilight sparkle,
1569444.png,https://derpicdn.net/img/view/2017/10/24/1569444.png,0,0.9499975442886353,249,68,1451,1270,1202,1202,twilight sparkle,secretgoombaman12345|lyracorn
1569815.png,https://derpicdn.net/img/view/2017/10/25/1569815.png,0,0.994584858417511,47,0,641,568,594,568,twilight sparkle,tcn1205
1574676.png,https://derpicdn.net/img/view/2017/10/31/1574676.png,0,0.973394811153412,2551,492,5753,3736,3202,3244,twilight sparkle,mundschenk85
1576471.png,https://derpicdn.net/img/view/2017/11/2/1576471.png,0,0.9241561293601992,952,306,1840,1194,888,888,twilight sparkle,anuadhi
1578150.png,https://derpicdn.net/img/view/2017/11/4/1578150.png,0,0.994021475315094,23,0,565,518,542,518,twilight sparkle,kittehkatbar
1580890.png,https://derpicdn.net/img/view/2017/11/7/1580890.png,0,0.9840828180313108,0,0,859,829,859,829,twilight sparkle,sentireaeris
1584338.png,https://derpicdn.net/img/view/2017/11/12/1584338.png,0,0.9969419836997986,1243,0,3019,1771,1776,1771,twilight sparkle,kimmyartmlp
1586066.png,https://derpicdn.net/img/view/2017/11/14/1586066.png,0,0.9973405003547668,551,0,1727,1156,1176,1156,twilight sparkle,arcuswind
1588547.png,https://derpicdn.net/img/view/2017/11/17/1588547.png,0,0.9504823684692384,328,0,1444,1099,1116,1099,twilight sparkle,katakiuchi4u
1589807.png,https://derpicdn.net/img/view/2017/11/19/1589807.png,0,0.9312816858291626,581,0,4769,3413,4188,3413,twilight sparkle,spacekingofspace|spottedlions
1589853.png,https://derpicdn.net/img/view/2017/11/19/1589853.png,0,0.9681059122085572,184,50,620,486,436,436,twilight sparkle,sokolas
1589912.png,https://derpicdn.net/img/view/2017/11/19/1589912.png,0,0.9824969172477722,533,602,1091,1160,558,558,twilight sparkle,weird--fish
1592873.png,https://derpicdn.net/img/view/2017/11/23/1592873.png,0,0.9973847270011902,568,0,1000,439,432,439,twilight sparkle,littleblackraencloud
1593103.png,https://derpicdn.net/img/view/2017/11/24/1593103.png,0,0.994439661502838,363,79,701,417,338,338,twilight sparkle,uniquecolorchaos
1593303.png,https://derpicdn.net/img/view/2017/11/24/1593303.png,0,0.9920212030410768,14,34,466,486,452,452,twilight sparkle,urbanqhoul
1595840.png,https://derpicdn.net/img/view/2017/11/27/1595840.png,0,0.9904776215553284,0,0,576,481,576,481,twilight sparkle,calypsovantas
1596784.png,https://derpicdn.net/img/view/2017/11/29/1596784.png,0,0.9852842092514038,159,124,4109,4074,3950,3950,twilight sparkle,decprincess
1596785.png,https://derpicdn.net/img/view/2017/11/29/1596785.png,0,0.9979548454284668,1948,0,5536,3479,3588,3479,twilight sparkle,decprincess
1598249.png,https://derpicdn.net/img/view/2017/12/1/1598249.png,0,0.9811204075813292,56,0,1072,720,1016,720,twilight sparkle,
1599871.png,https://derpicdn.net/img/view/2017/12/3/1599871.png,0,0.9883105158805848,1930,155,2718,943,788,788,twilight sparkle,alexayume
1600363.png,https://derpicdn.net/img/view/2017/12/4/1600363.png,0,0.9979403018951416,2516,112,6318,3914,3802,3802,twilight sparkle,decprincess
1606487.png,https://derpicdn.net/img/view/2017/12/13/1606487.png,0,0.9930923581123352,451,54,861,464,410,410,twilight sparkle,punzil504
1607972.png,https://derpicdn.net/img/view/2017/12/14/1607972.png,0,0.984404444694519,231,7,600,409,369,402,twilight sparkle,mystic2u
1608183.png,https://derpicdn.net/img/view/2017/12/15/1608183.png,0,0.9845936894416808,25,0,291,245,266,245,twilight sparkle,brendahickey
1608209.png,https://derpicdn.net/img/view/2017/12/15/1608209.png,0,0.9945859909057616,722,342,1772,1392,1050,1050,twilight sparkle,princrim
1609239.png,https://derpicdn.net/img/view/2017/12/16/1609239.png,0,0.9032132625579834,205,0,1143,720,938,720,twilight sparkle,
1610031.png,https://derpicdn.net/img/view/2017/12/17/1610031.png,0,0.9334071278572084,421,13,1285,877,864,864,twilight sparkle,mailner
1610303.png,https://derpicdn.net/img/view/2017/12/18/1610303.png,0,0.9873530268669128,207,132,681,606,474,474,twilight sparkle,rossignolet
1610303.png,https://derpicdn.net/img/view/2017/12/18/1610303.png,1,0.963491678237915,521,445,1031,955,510,510,twilight sparkle,rossignolet
1611495.png,https://derpicdn.net/img/view/2017/12/19/1611495.png,0,0.99955815076828,1741,333,2971,1563,1230,1230,twilight sparkle,sannykat
1612957.png,https://derpicdn.net/img/view/2017/12/21/1612957.png,0,0.9886281490325928,1010,791,1564,1345,554,554,twilight sparkle,dagmell
1612957.png,https://derpicdn.net/img/view/2017/12/21/1612957.png,1,0.985500991344452,414,608,1036,1230,622,622,twilight sparkle,dagmell
1613587.png,https://derpicdn.net/img/view/2017/12/22/1613587.png,0,0.976801872253418,443,0,800,334,357,334,twilight sparkle,janadashie
1613758.png,https://derpicdn.net/img/view/2017/12/23/1613758.png,0,0.987849771976471,337,0,3389,2943,3052,2943,twilight sparkle,deltahedgehog
1614485.png,https://derpicdn.net/img/view/2017/12/24/1614485.png,0,0.9964313507080078,874,338,1280,744,406,406,twilight sparkle,rossignolet
1614490.png,https://derpicdn.net/img/view/2017/12/24/1614490.png,0,0.9961923956871032,117,0,783,646,666,646,twilight sparkle,rossignolet
1614490.png,https://derpicdn.net/img/view/2017/12/24/1614490.png,1,0.9957491755485536,707,186,1197,676,490,490,twilight sparkle,rossignolet
1617056.png,https://derpicdn.net/img/view/2017/12/27/1617056.png,0,0.9857617616653442,2349,39,3829,1519,1480,1480,twilight sparkle,cloudyglow
1619236.png,https://derpicdn.net/img/view/2017/12/29/1619236.png,0,0.9431152939796448,1157,0,2931,1767,1774,1767,twilight sparkle,andoanimalia
1619785.png,https://derpicdn.net/img/view/2017/12/30/1619785.png,0,0.9967172145843506,438,212,1430,1204,992,992,twilight sparkle,flamevulture17
1625219.png,https://derpicdn.net/img/view/2018/1/6/1625219.png,0,0.9923949241638184,183,147,461,425,278,278,twilight sparkle,kota
1627711.png,https://derpicdn.net/img/view/2018/1/9/1627711.png,0,0.9145911931991576,423,136,771,484,348,348,twilight sparkle,basiliskfree
1629924.png,https://derpicdn.net/img/view/2018/1/11/1629924.png,0,0.9639445543289183,0,0,907,923,907,923,twilight sparkle,cbear624
1638326.png,https://derpicdn.net/img/view/2018/1/22/1638326.png,0,0.9527067542076112,756,0,1704,847,948,847,twilight sparkle,rariedash
1639715.png,https://derpicdn.net/img/view/2018/1/24/1639715.png,0,0.9978260397911072,149,0,553,384,404,384,twilight sparkle,seahawk270|sugar-loop|aqua-pony
1639715.png,https://derpicdn.net/img/view/2018/1/24/1639715.png,1,0.9531790614128112,1128,0,1574,394,446,394,twilight sparkle,seahawk270|sugar-loop|aqua-pony
1641695.png,https://derpicdn.net/img/view/2018/1/26/1641695.png,0,0.9994303584098816,2,0,508,470,506,470,twilight sparkle,vale-bandicoot96
1643224.png,https://derpicdn.net/img/view/2018/1/28/1643224.png,0,0.9422270059585572,695,317,1255,877,560,560,twilight sparkle,djspark3
1644124.png,https://derpicdn.net/img/view/2018/1/29/1644124.png,0,0.974685549736023,81,20,539,478,458,458,twilight sparkle,jykinturah
1645428.png,https://derpicdn.net/img/view/2018/1/31/1645428.png,0,0.9810030460357666,321,0,873,521,552,521,twilight sparkle,ashidaru
1645751.png,https://derpicdn.net/img/view/2018/2/1/1645751.png,0,0.9988136291503906,271,35,873,637,602,602,twilight sparkle,heddopen
1646764.png,https://derpicdn.net/img/view/2018/2/2/1646764.png,0,0.9080209136009216,93,34,979,920,886,886,twilight sparkle,rossignolet
1648715.png,https://derpicdn.net/img/view/2018/2/5/1648715.png,0,0.9839428067207336,51,46,337,332,286,286,twilight sparkle,kinkshame-machine
1649740.png,https://derpicdn.net/img/view/2018/2/6/1649740.png,0,0.9738221764564514,0,32,1949,2380,1949,2348,twilight sparkle,mindofor
1650868.png,https://derpicdn.net/img/view/2018/2/8/1650868.png,0,0.9640499949455258,140,0,2106,1939,1966,1939,twilight sparkle,andoanimalia
1651526.png,https://derpicdn.net/img/view/2018/2/9/1651526.png,0,0.951108694076538,223,68,1263,1108,1040,1040,twilight sparkle,andoanimalia
1654789.png,https://derpicdn.net/img/view/2018/2/13/1654789.png,0,0.989632487297058,743,582,1275,1114,532,532,twilight sparkle,rossignolet
1654875.png,https://derpicdn.net/img/view/2018/2/13/1654875.png,0,0.9731925725936892,654,1512,3690,4548,3036,3036,twilight sparkle,amarthgul
1657802.png,https://derpicdn.net/img/view/2018/2/16/1657802.png,0,0.9988676309585572,0,3,1375,1439,1375,1436,twilight sparkle,andoanimalia
1658887.png,https://derpicdn.net/img/view/2018/2/18/1658887.png,0,0.9906614422798156,316,16,756,456,440,440,twilight sparkle,
1659619.png,https://derpicdn.net/img/view/2018/2/18/1659619.png,0,0.9732294082641602,1144,55,1930,841,786,786,twilight sparkle,shad0w-galaxy
1661062.png,https://derpicdn.net/img/view/2018/2/20/1661062.png,0,0.994576632976532,1925,0,4059,2038,2134,2038,twilight sparkle,flutterguy317
1661105.png,https://derpicdn.net/img/view/2018/2/20/1661105.png,0,0.9261219501495358,31,201,335,505,304,304,twilight sparkle,farg2003
1661580.png,https://derpicdn.net/img/view/2018/2/20/1661580.png,0,0.9972258806228638,193,258,581,646,388,388,twilight sparkle,colochenni
1663282.png,https://derpicdn.net/img/view/2018/2/23/1663282.png,0,0.9844297766685486,1282,333,2294,1345,1012,1012,twilight sparkle,bunxl
1665345.png,https://derpicdn.net/img/view/2018/2/25/1665345.png,0,0.9995649456977844,463,177,1111,825,648,648,twilight sparkle,atomic8497
1665490.png,https://derpicdn.net/img/view/2018/2/25/1665490.png,0,0.9049683213233948,254,19,1008,773,754,754,twilight sparkle,kimjoman
1668183.png,https://derpicdn.net/img/view/2018/2/28/1668183.png,0,0.9907166957855223,619,170,2285,1836,1666,1666,twilight sparkle,hyperion-jack
1671325.png,https://derpicdn.net/img/view/2018/3/4/1671325.png,0,0.9045851826667786,436,1115,7000,7957,6564,6842,twilight sparkle,tardifice
1673238.png,https://derpicdn.net/img/view/2018/3/6/1673238.png,0,0.9138041734695436,156,0,1152,720,996,720,twilight sparkle,
1674022.png,https://derpicdn.net/img/view/2018/3/7/1674022.png,0,0.9643276929855348,51,91,501,530,450,439,twilight sparkle,
1674870.png,https://derpicdn.net/img/view/2018/3/9/1674870.png,0,0.98788183927536,1687,880,2463,1656,776,776,twilight sparkle,uunicornicc
1675048.png,https://derpicdn.net/img/view/2018/3/9/1675048.png,0,0.9790908694267272,0,0,661,701,661,701,twilight sparkle,
1675495.png,https://derpicdn.net/img/view/2018/3/9/1675495.png,0,0.9844615459442142,293,0,683,388,390,388,twilight sparkle,kipaki
1676203.png,https://derpicdn.net/img/view/2018/3/10/1676203.png,0,0.9797871112823486,163,14,643,494,480,480,twilight sparkle,woonborg
1676994.png,https://derpicdn.net/img/view/2018/3/11/1676994.png,0,0.9872188568115234,858,0,1676,760,818,760,twilight sparkle,skimea
1677615.png,https://derpicdn.net/img/view/2018/3/11/1677615.png,0,0.9555848240852356,117,0,429,247,312,247,twilight sparkle,
1678017.png,https://derpicdn.net/img/view/2018/3/12/1678017.png,0,0.9959881901741028,238,40,1664,1466,1426,1426,twilight sparkle,sinso2913
1682925.png,https://derpicdn.net/img/view/2018/3/17/1682925.png,0,0.940026581287384,0,94,619,780,619,686,twilight sparkle,1drfl_world_end
1684338.png,https://derpicdn.net/img/view/2018/3/18/1684338.png,0,0.9906413555145264,2807,2014,4109,3316,1302,1302,twilight sparkle,deyrasd|salemcat
1686965.png,https://derpicdn.net/img/view/2018/3/21/1686965.png,0,0.9724987149238586,308,0,748,433,440,433,twilight sparkle,saturdaymorningproj
1692517.png,https://derpicdn.net/img/view/2018/3/27/1692517.png,0,0.980554699897766,812,57,2760,2005,1948,1948,twilight sparkle,askometa
1692517.png,https://derpicdn.net/img/view/2018/3/27/1692517.png,1,0.9442861676216124,3157,191,4770,1881,1613,1690,twilight sparkle,askometa
1692771.png,https://derpicdn.net/img/view/2018/3/28/1692771.png,0,0.988505482673645,198,105,2602,2382,2404,2277,twilight sparkle,emera33
1694938.png,https://derpicdn.net/img/view/2018/3/31/1694938.png,0,0.9723387956619264,0,0,2879,2848,2879,2848,twilight sparkle,jhayarr23
1695103.png,https://derpicdn.net/img/view/2018/3/31/1695103.png,0,0.9467371702194214,80,0,726,618,646,618,twilight sparkle,1drfl_world_end
1695575.png,https://derpicdn.net/img/view/2018/3/31/1695575.png,0,0.9893059134483336,162,0,1080,1015,918,1015,twilight sparkle,latecustomer
1703955.png,https://derpicdn.net/img/view/2018/4/10/1703955.png,0,0.9671627283096312,1437,0,4675,3206,3238,3206,twilight sparkle,andoanimalia
1708591.png,https://derpicdn.net/img/view/2018/4/15/1708591.png,0,0.906121790409088,0,13,431,469,431,456,twilight sparkle,shiiazu
1710813.png,https://derpicdn.net/img/view/2018/4/18/1710813.png,0,0.9903905391693116,591,103,1225,737,634,634,twilight sparkle,miaoumaou
1711937.png,https://derpicdn.net/img/view/2018/4/19/1711937.png,0,0.9942806959152222,0,0,277,283,277,283,twilight sparkle,pegasisters82
1712405.png,https://derpicdn.net/img/view/2018/4/20/1712405.png,0,0.9896553158760072,261,0,1001,697,740,697,twilight sparkle,uunicornicc
1712486.png,https://derpicdn.net/img/view/2018/4/20/1712486.png,0,0.9769492745399476,139,53,605,519,466,466,twilight sparkle,snakeythingy
1713472.png,https://derpicdn.net/img/view/2018/4/21/1713472.png,0,0.9757694602012634,0,0,521,587,521,587,twilight sparkle,
1715522.png,https://derpicdn.net/img/view/2018/4/23/1715522.png,0,0.9841632843017578,196,0,782,551,586,551,twilight sparkle,
1716134.png,https://derpicdn.net/img/view/2018/4/24/1716134.png,0,0.9984041452407836,0,0,1385,1330,1385,1330,twilight sparkle,goatcanon
1716496.png,https://derpicdn.net/img/view/2018/4/25/1716496.png,0,0.982567012310028,39,0,563,500,524,500,twilight sparkle,neko-luvz
1717248.png,https://derpicdn.net/img/view/2018/4/26/1717248.png,0,0.9948630928993224,0,0,2933,2865,2933,2865,twilight sparkle,sketchmcreations
1721872.png,https://derpicdn.net/img/view/2018/5/1/1721872.png,0,0.998202919960022,46,453,644,1051,598,598,twilight sparkle,solareflares
1722722.png,https://derpicdn.net/img/view/2018/5/2/1722722.png,0,0.9508394598960876,105,95,699,689,594,594,twilight sparkle,php103
1722796.png,https://derpicdn.net/img/view/2018/5/3/1722796.png,0,0.9656627178192142,0,272,2851,3308,2851,3036,twilight sparkle,ejlightning007arts
1723145.png,https://derpicdn.net/img/view/2018/5/3/1723145.png,0,0.9986085891723632,2305,0,4555,2143,2250,2143,twilight sparkle,sinkbon
1723662.png,https://derpicdn.net/img/view/2018/5/4/1723662.png,0,0.9895471334457396,0,0,337,388,337,388,twilight sparkle,geisharozu
1724821.png,https://derpicdn.net/img/view/2018/5/5/1724821.png,0,0.9862282872200012,0,1,480,563,480,562,twilight sparkle,
1730602.png,https://derpicdn.net/img/view/2018/5/12/1730602.png,0,0.9711644053459167,0,0,1597,1713,1597,1713,twilight sparkle,paskanaakka
1731836.png,https://derpicdn.net/img/view/2018/5/13/1731836.png,0,0.9613774418830872,63,120,449,500,386,380,twilight sparkle,
1732382.png,https://derpicdn.net/img/view/2018/5/14/1732382.png,0,0.9849247336387634,0,8,250,438,250,430,twilight sparkle,
1733006.png,https://derpicdn.net/img/view/2018/5/15/1733006.png,0,0.998976707458496,153,5,815,667,662,662,twilight sparkle,lunapepper14
1734737.png,https://derpicdn.net/img/view/2018/5/17/1734737.png,0,0.9745829105377196,3579,0,6685,2417,3106,2417,twilight sparkle,caliazian
1734780.png,https://derpicdn.net/img/view/2018/5/17/1734780.png,0,0.9994630217552184,257,544,691,978,434,434,twilight sparkle,tingsan
1734780.png,https://derpicdn.net/img/view/2018/5/17/1734780.png,1,0.9467275738716124,566,538,1034,1006,468,468,twilight sparkle,tingsan
1735207.png,https://derpicdn.net/img/view/2018/5/18/1735207.png,0,0.9986057877540588,352,21,750,419,398,398,twilight sparkle,queenhiyoku
1735893.png,https://derpicdn.net/img/view/2018/5/18/1735893.png,0,0.9934212565422058,217,65,1043,891,826,826,twilight sparkle,deraniel
1735966.png,https://derpicdn.net/img/view/2018/5/18/1735966.png,0,0.9641464352607728,119,62,980,970,861,908,twilight sparkle,kody02
1736140.png,https://derpicdn.net/img/view/2018/5/19/1736140.png,0,0.9821404814720154,596,77,1260,741,664,664,twilight sparkle,thecheeseburger
1739554.png,https://derpicdn.net/img/view/2018/5/23/1739554.png,0,0.9986011981964112,933,80,1953,1100,1020,1020,twilight sparkle,robsa990
1739712.png,https://derpicdn.net/img/view/2018/5/23/1739712.png,0,0.9563102722167968,116,0,1012,872,896,872,twilight sparkle,kisynya193
1740229.png,https://derpicdn.net/img/view/2018/5/24/1740229.png,0,0.9735453128814696,0,0,455,444,455,444,twilight sparkle,talimingi
1743272.png,https://derpicdn.net/img/view/2018/5/27/1743272.png,0,0.9961168766021729,210,0,1064,805,854,805,twilight sparkle,zogzor
1743860.png,https://derpicdn.net/img/view/2018/5/28/1743860.png,0,0.9765561819076538,0,0,1280,1501,1280,1501,twilight sparkle,adorkabletwilightandfriends
1747479.png,https://derpicdn.net/img/view/2018/6/2/1747479.png,0,0.9990444779396056,193,801,1081,1689,888,888,twilight sparkle,sonicdramon
1748288.png,https://derpicdn.net/img/view/2018/6/2/1748288.png,0,0.9984909296035768,389,0,1725,1297,1336,1297,twilight sparkle,thecreativerey
1748296.png,https://derpicdn.net/img/view/2018/6/2/1748296.png,0,0.9969369769096376,2036,67,4241,2341,2205,2274,twilight sparkle,ironm17
1751497.png,https://derpicdn.net/img/view/2018/6/6/1751497.png,0,0.9985624551773072,682,12,1350,680,668,668,twilight sparkle,pucksterv
1756313.png,https://derpicdn.net/img/view/2018/6/12/1756313.png,0,0.9325432777404784,349,0,2479,2083,2130,2083,twilight sparkle,colorfulcolor233
1756463.png,https://derpicdn.net/img/view/2018/6/13/1756463.png,0,0.9967591762542723,58,0,1632,1195,1574,1195,twilight sparkle,moozua
1758291.png,https://derpicdn.net/img/view/2018/6/15/1758291.png,0,0.9832552075386048,21,104,927,1010,906,906,twilight sparkle,twinkepaint
1759034.png,https://derpicdn.net/img/view/2018/6/16/1759034.png,0,0.9983521699905396,1540,139,2758,1357,1218,1218,twilight sparkle,sollace
1760469.png,https://derpicdn.net/img/view/2018/6/18/1760469.png,0,0.9820603132247924,501,16,1055,570,554,554,twilight sparkle,hello-myzeroworld
1761814.png,https://derpicdn.net/img/view/2018/6/20/1761814.png,0,0.9635221362113952,117,1561,2257,3701,2140,2140,twilight sparkle,inkheartbrony
1762401.png,https://derpicdn.net/img/view/2018/6/20/1762401.png,0,0.956584930419922,152,0,644,461,492,461,twilight sparkle,xflutt
1765346.png,https://derpicdn.net/img/view/2018/6/25/1765346.png,0,0.9949074983596802,328,205,692,569,364,364,twilight sparkle,renciel
1765914.png,https://derpicdn.net/img/view/2018/6/25/1765914.png,0,0.9906314611434937,93,0,1357,1246,1264,1246,twilight sparkle,moonatik
1768010.png,https://derpicdn.net/img/view/2018/6/28/1768010.png,0,0.9320306777954102,86,0,1158,1035,1072,1035,twilight sparkle,artiks
1768619.png,https://derpicdn.net/img/view/2018/6/29/1768619.png,0,0.9611831903457642,32,0,980,846,948,846,twilight sparkle,imbirgiana
1778168.png,https://derpicdn.net/img/view/2018/7/11/1778168.png,0,0.9955340623855592,0,0,313,313,313,313,twilight sparkle,obscuredflower
1778785.png,https://derpicdn.net/img/view/2018/7/11/1778785.png,0,0.9902580380439758,82,0,690,514,608,514,twilight sparkle,catzino
1780144.png,https://derpicdn.net/img/view/2018/7/13/1780144.png,0,0.9937123656272888,0,0,997,985,997,985,twilight sparkle,jun1313
1783288.png,https://derpicdn.net/img/view/2018/7/17/1783288.png,1,0.9802817106246948,1045,38,1443,436,398,398,twilight sparkle,enifersuch
1783477.png,https://derpicdn.net/img/view/2018/7/17/1783477.png,0,0.9922330379486084,0,0,454,442,454,442,twilight sparkle,cinnamonaurora
1784375.png,https://derpicdn.net/img/view/2018/7/19/1784375.png,0,0.9981988668441772,778,2,1348,572,570,570,twilight sparkle,masteroshawott
1784905.png,https://derpicdn.net/img/view/2018/7/19/1784905.png,0,0.997399628162384,1201,1832,2945,3576,1744,1744,twilight sparkle,lavenderheartsmlp
1785090.png,https://derpicdn.net/img/view/2018/7/20/1785090.png,0,0.997604250907898,125,151,2063,2089,1938,1938,twilight sparkle,andoanimalia
1785288.png,https://derpicdn.net/img/view/2018/7/20/1785288.png,0,0.9852774143218994,85,375,4789,5079,4704,4704,twilight sparkle,dragonchaser123
1785298.png,https://derpicdn.net/img/view/2018/7/20/1785298.png,0,0.9594076871871948,425,0,1851,1080,1426,1080,twilight sparkle,rariedash
1785308.png,https://derpicdn.net/img/view/2018/7/20/1785308.png,0,0.9651604294776917,135,0,1176,1109,1041,1109,twilight sparkle,goatcanon
1785921.png,https://derpicdn.net/img/view/2018/7/21/1785921.png,0,0.9214763045310974,366,121,600,355,234,234,twilight sparkle,whitehershey
1786074.png,https://derpicdn.net/img/view/2018/7/21/1786074.png,0,0.9972864985466005,2763,0,6183,3299,3420,3299,twilight sparkle,parclytaxel
1786125.png,https://derpicdn.net/img/view/2018/7/21/1786125.png,0,0.9325547814369202,21,48,797,801,776,753,twilight sparkle,artiks
1788393.png,https://derpicdn.net/img/view/2018/7/24/1788393.png,0,0.9394579529762268,276,96,678,498,402,402,twilight sparkle,klemm
1788810.png,https://derpicdn.net/img/view/2018/7/24/1788810.png,0,0.9922256469726562,297,22,857,582,560,560,twilight sparkle,sugaryicecreammlp
1789067.png,https://derpicdn.net/img/view/2018/7/25/1789067.png,0,0.992217481136322,0,0,2025,1996,2025,1996,twilight sparkle,uunicornicc
1791095.png,https://derpicdn.net/img/view/2018/7/27/1791095.png,0,0.9722185134887696,16,0,892,683,876,683,twilight sparkle,
1793563.png,https://derpicdn.net/img/view/2018/7/30/1793563.png,0,0.93940407037735,76,43,652,619,576,576,twilight sparkle,baigak
1793906.png,https://derpicdn.net/img/view/2018/7/31/1793906.png,0,0.9961692690849304,742,181,1102,541,360,360,twilight sparkle,kiarawizard01
1794557.png,https://derpicdn.net/img/view/2018/7/31/1794557.png,0,0.9161680936813354,157,79,913,835,756,756,twilight sparkle,shujiwakahisaa
1795666.png,https://derpicdn.net/img/view/2018/8/2/1795666.png,0,0.9668456315994264,84,0,601,566,517,566,twilight sparkle,tkuroneko
1796406.png,https://derpicdn.net/img/view/2018/8/2/1796406.png,0,0.9985046982765198,99,0,1295,1151,1196,1151,twilight sparkle,andoanimalia
1797440.png,https://derpicdn.net/img/view/2018/8/4/1797440.png,0,0.9950782060623168,494,8,934,448,440,440,twilight sparkle,neothebean
1798622.png,https://derpicdn.net/img/view/2018/8/5/1798622.png,0,0.9944756031036376,1241,12,2657,1428,1416,1416,twilight sparkle,andoanimalia
1799212.png,https://derpicdn.net/img/view/2018/8/6/1799212.png,0,0.9567217230796814,299,200,1679,1862,1380,1662,twilight sparkle,electrochoc
1800117.png,https://derpicdn.net/img/view/2018/8/6/1800117.png,0,0.9934839010238647,272,84,708,520,436,436,twilight sparkle,twisted-sketch
1800591.png,https://derpicdn.net/img/view/2018/8/7/1800591.png,0,0.9973850250244141,633,406,1439,1212,806,806,twilight sparkle,artiks
1801160.png,https://derpicdn.net/img/view/2018/8/8/1801160.png,0,0.9908992648124696,70,596,272,798,202,202,twilight sparkle,nichroniclesvsart
1801916.png,https://derpicdn.net/img/view/2018/8/8/1801916.png,1,0.9350308775901794,232,309,952,1029,720,720,twilight sparkle,andoanimalia
1802768.png,https://derpicdn.net/img/view/2018/8/9/1802768.png,0,0.9988345503807068,428,67,718,357,290,290,twilight sparkle,da-exile
1802768.png,https://derpicdn.net/img/view/2018/8/9/1802768.png,1,0.9920699000358582,142,138,386,382,244,244,twilight sparkle,da-exile
1806139.png,https://derpicdn.net/img/view/2018/8/13/1806139.png,0,0.9818236827850342,1035,173,3813,2951,2778,2778,twilight sparkle,andoanimalia
1807233.png,https://derpicdn.net/img/view/2018/8/15/1807233.png,0,0.9717057943344116,76,46,670,640,594,594,twilight sparkle,
1808641.png,https://derpicdn.net/img/view/2018/8/16/1808641.png,0,0.9864910244941713,278,0,964,667,686,667,twilight sparkle,dusthiel
1812032.png,https://derpicdn.net/img/view/2018/8/21/1812032.png,0,0.9662922024726868,0,24,784,922,784,898,twilight sparkle,itstaylor-made
1812126.png,https://derpicdn.net/img/view/2018/8/21/1812126.png,0,0.9987418055534364,0,0,4692,4760,4692,4760,twilight sparkle,sinkbon
1812707.png,https://derpicdn.net/img/view/2018/8/21/1812707.png,0,0.9952112436294556,186,0,1998,1757,1812,1757,twilight sparkle,arcane-thunder
1813354.png,https://derpicdn.net/img/view/2018/8/22/1813354.png,0,0.981029212474823,1161,41,1955,835,794,794,twilight sparkle,perpendicular white
1815082.png,https://derpicdn.net/img/view/2018/8/24/1815082.png,0,0.9854705333709716,447,0,1705,1192,1258,1192,twilight sparkle,tuxisthename
1815398.png,https://derpicdn.net/img/view/2018/8/25/1815398.png,0,0.90989750623703,0,44,760,942,760,898,twilight sparkle,moonatik
1816319.png,https://derpicdn.net/img/view/2018/8/26/1816319.png,0,0.9834244847297668,83,53,2157,2127,2074,2074,twilight sparkle,sollace
181669.png,https://derpicdn.net/img/view/2012/12/13/181669.png,0,0.9996424913406372,0,18,391,410,391,392,twilight sparkle,jitterbugjive
181669.png,https://derpicdn.net/img/view/2012/12/13/181669.png,1,0.9955533146858216,495,583,853,941,358,358,twilight sparkle,jitterbugjive
181669.png,https://derpicdn.net/img/view/2012/12/13/181669.png,2,0.9931664466857908,399,0,795,384,396,384,twilight sparkle,jitterbugjive
1818235.png,https://derpicdn.net/img/view/2018/8/28/1818235.png,0,0.9737646579742432,0,0,3576,4033,3576,4033,twilight sparkle,andoanimalia
1818657.png,https://derpicdn.net/img/view/2018/8/28/1818657.png,0,0.9932327270507812,447,9,1023,585,576,576,twilight sparkle,spellboundcanvas
1818983.png,https://derpicdn.net/img/view/2018/8/28/1818983.png,0,0.9990032315254213,1335,28,2051,744,716,716,twilight sparkle,dippindott
1819291.png,https://derpicdn.net/img/view/2018/8/29/1819291.png,0,0.9451171755790708,83,1,457,375,374,374,twilight sparkle,poniilite
1822637.png,https://derpicdn.net/img/view/2018/9/2/1822637.png,0,0.9334620237350464,795,46,1499,750,704,704,twilight sparkle,mahexa
1822861.png,https://derpicdn.net/img/view/2018/9/2/1822861.png,0,0.9379914402961732,188,0,886,659,698,659,twilight sparkle,tohupo
1826060.png,https://derpicdn.net/img/view/2018/9/6/1826060.png,0,0.9983161687850952,823,0,1605,775,782,775,twilight sparkle,swiftriff
1826520.png,https://derpicdn.net/img/view/2018/9/6/1826520.png,0,0.9978930950164796,72,0,842,764,770,764,twilight sparkle,arloueu
1826978.png,https://derpicdn.net/img/view/2018/9/7/1826978.png,0,0.9850717782974244,83,41,745,703,662,662,twilight sparkle,ask-azalea-grey
1830512.png,https://derpicdn.net/img/view/2018/9/11/1830512.png,0,0.9970636367797852,64,71,380,387,316,316,twilight sparkle,casualcolt
1834907.png,https://derpicdn.net/img/view/2018/9/17/1834907.png,0,0.9974495768547058,1636,228,2288,880,652,652,twilight sparkle,sugarcup|laszlvfx
1836485.png,https://derpicdn.net/img/view/2018/9/19/1836485.png,0,0.995195746421814,1015,545,6275,5805,5260,5260,twilight sparkle,kuren247
1836739.png,https://derpicdn.net/img/view/2018/9/20/1836739.png,0,0.9131236672401428,1288,787,1768,1267,480,480,twilight sparkle,the-furry-railfan
1838430.png,https://derpicdn.net/img/view/2018/9/22/1838430.png,0,0.9863770008087158,753,0,2333,1439,1580,1439,twilight sparkle,lifesharbinger
1838469.png,https://derpicdn.net/img/view/2018/9/22/1838469.png,0,0.9436545372009276,426,66,1028,668,602,602,twilight sparkle,quetex
1838522.png,https://derpicdn.net/img/view/2018/9/22/1838522.png,0,0.9835214018821716,1607,111,2917,1421,1310,1310,twilight sparkle,cloudyglow
1843173.png,https://derpicdn.net/img/view/2018/9/28/1843173.png,0,0.9804206490516664,88,1,348,261,260,260,twilight sparkle,geoffrey mcdermott
1844873.png,https://derpicdn.net/img/view/2018/9/30/1844873.png,0,0.9889048933982848,0,0,512,533,512,533,twilight sparkle,
1855698.png,https://derpicdn.net/img/view/2018/10/13/1855698.png,0,0.93856543302536,325,0,1055,572,730,572,twilight sparkle,
1855986.png,https://derpicdn.net/img/view/2018/10/14/1855986.png,0,0.9941268563270568,1847,0,3623,1535,1776,1535,twilight sparkle,applec1234
1856148.png,https://derpicdn.net/img/view/2018/10/14/1856148.png,0,0.9920086860656738,740,206,1906,1372,1166,1166,twilight sparkle,orangejuicerus
1856215.png,https://derpicdn.net/img/view/2018/10/14/1856215.png,0,0.9795003533363342,0,0,3533,3551,3533,3551,twilight sparkle,estories
1859453.png,https://derpicdn.net/img/view/2018/10/18/1859453.png,0,0.9798076152801514,44,0,232,188,188,188,twilight sparkle,foxlove253
1864467.png,https://derpicdn.net/img/view/2018/10/24/1864467.png,0,0.9984611272811892,40,0,472,421,432,421,twilight sparkle,raindashesp
186454.png,https://derpicdn.net/img/view/2012/12/18/186454.png,0,0.9978163242340088,215,0,603,373,388,373,twilight sparkle,lamia
1864616.png,https://derpicdn.net/img/view/2018/10/24/1864616.png,0,0.9933598041534424,972,9,1668,705,696,696,twilight sparkle,namygaga
1866188.png,https://derpicdn.net/img/view/2018/10/26/1866188.png,0,0.9554154872894288,947,392,1933,1378,986,986,twilight sparkle,xkittyblue
1867493.png,https://derpicdn.net/img/view/2018/10/27/1867493.png,0,0.9912959337234496,110,325,1112,1200,1002,875,twilight sparkle,
1869078.png,https://derpicdn.net/img/view/2018/10/29/1869078.png,0,0.9932557344436646,429,0,3907,2400,3478,2400,twilight sparkle,
1879429.png,https://derpicdn.net/img/view/2018/11/10/1879429.png,0,0.9749531745910645,268,0,2558,2235,2290,2235,twilight sparkle,andoanimalia
1879719.png,https://derpicdn.net/img/view/2018/11/11/1879719.png,0,0.9371333122253418,610,0,3442,2160,2832,2160,twilight sparkle,apexpredator923
1879726.png,https://derpicdn.net/img/view/2018/11/11/1879726.png,0,0.998927652835846,761,303,1113,655,352,352,twilight sparkle,
1882574.png,https://derpicdn.net/img/view/2018/11/15/1882574.png,0,0.9697252511978148,241,0,795,529,554,529,twilight sparkle,cubbybatdoodles
1884047.png,https://derpicdn.net/img/view/2018/11/17/1884047.png,0,0.9906814694404602,542,0,1574,853,1032,853,twilight sparkle,
1884405.png,https://derpicdn.net/img/view/2018/11/17/1884405.png,0,0.9899146556854248,0,0,951,912,951,912,twilight sparkle,hollybright
1884415.png,https://derpicdn.net/img/view/2018/11/17/1884415.png,0,0.9967221021652222,380,0,606,210,226,210,twilight sparkle,acesential
1886040.png,https://derpicdn.net/img/view/2018/11/19/1886040.png,0,0.996761679649353,322,363,892,933,570,570,twilight sparkle,zakro
1886955.png,https://derpicdn.net/img/view/2018/11/20/1886955.png,0,0.9053536653518676,0,0,809,806,809,806,twilight sparkle,
1887650.png,https://derpicdn.net/img/view/2018/11/21/1887650.png,0,0.994468867778778,1692,0,3614,1817,1922,1817,twilight sparkle,shaslan
1890577.png,https://derpicdn.net/img/view/2018/11/25/1890577.png,0,0.9455652832984924,79,0,367,284,288,284,twilight sparkle,lannarainbows
1892343.png,https://derpicdn.net/img/view/2018/11/27/1892343.png,0,0.9293131828308104,138,0,988,822,850,822,twilight sparkle,silshadnic
1893351.png,https://derpicdn.net/img/view/2018/11/29/1893351.png,0,0.9839863181114196,525,183,1165,823,640,640,twilight sparkle,viejillox64art
1897156.png,https://derpicdn.net/img/view/2018/12/3/1897156.png,0,0.928648054599762,16,121,646,751,630,630,twilight sparkle,walkersky27
1898014.png,https://derpicdn.net/img/view/2018/12/4/1898014.png,0,0.9984467029571532,1557,98,3269,1810,1712,1712,twilight sparkle,arcane-thunder
1899124.png,https://derpicdn.net/img/view/2018/12/5/1899124.png,0,0.9585631489753724,138,323,2324,2509,2186,2186,twilight sparkle,php97
1900090.png,https://derpicdn.net/img/view/2018/12/6/1900090.png,0,0.9779077768325806,985,466,1447,928,462,462,twilight sparkle,
1900699.png,https://derpicdn.net/img/view/2018/12/7/1900699.png,0,0.9986686706542968,382,0,710,275,328,275,twilight sparkle,anontheanon
1901483.png,https://derpicdn.net/img/view/2018/12/7/1901483.png,0,0.9746254086494446,0,0,320,320,320,320,twilight sparkle,
1902248.png,https://derpicdn.net/img/view/2018/12/8/1902248.png,0,0.9931273460388184,769,0,1839,1058,1070,1058,twilight sparkle,larrykitty
1905190.png,https://derpicdn.net/img/view/2018/12/11/1905190.png,0,0.944876194000244,40,0,490,440,450,440,twilight sparkle,zutcha
1905826.png,https://derpicdn.net/img/view/2018/12/11/1905826.png,0,0.9990141987800598,0,0,3025,2802,3025,2802,twilight sparkle,andoanimalia
1906239.png,https://derpicdn.net/img/view/2018/12/12/1906239.png,0,0.9952539205551147,134,501,1538,1905,1404,1404,twilight sparkle,pilot231
1906255.png,https://derpicdn.net/img/view/2018/12/12/1906255.png,0,0.99763286113739,475,69,3073,2667,2598,2598,twilight sparkle,pilot231
1906452.png,https://derpicdn.net/img/view/2018/12/12/1906452.png,0,0.9626742601394652,0,0,677,671,677,671,twilight sparkle,salemcat
1911691.png,https://derpicdn.net/img/view/2018/12/18/1911691.png,0,0.9952312111854552,647,22,1541,916,894,894,twilight sparkle,renegade-157
1911866.png,https://derpicdn.net/img/view/2018/12/18/1911866.png,0,0.9932759404182434,443,0,1075,604,632,604,twilight sparkle,tastyrainbow
1917825.png,https://derpicdn.net/img/view/2018/12/24/1917825.png,0,0.9985462427139282,102,0,472,338,370,338,twilight sparkle,tokokami
1918165.png,https://derpicdn.net/img/view/2018/12/25/1918165.png,0,0.9900736212730408,182,18,1024,868,842,850,twilight sparkle,connorbal
1919142.png,https://derpicdn.net/img/view/2018/12/26/1919142.png,0,0.9982298612594604,548,1917,1582,2951,1034,1034,twilight sparkle,taaffeiite
1925312.png,https://derpicdn.net/img/view/2019/1/3/1925312.png,0,0.9933663010597228,592,0,1280,704,688,704,twilight sparkle,stella-drawz
1925488.png,https://derpicdn.net/img/view/2019/1/3/1925488.png,0,0.9285927414894104,69,0,1153,1036,1084,1036,twilight sparkle,tazmiliandevil
1928242.png,https://derpicdn.net/img/view/2019/1/6/1928242.png,0,0.9975935816764832,244,31,524,311,280,280,twilight sparkle,sepiakeys
1928369.png,https://derpicdn.net/img/view/2019/1/6/1928369.png,0,0.9981825351715088,271,420,641,790,370,370,twilight sparkle,lalou
1931709.png,https://derpicdn.net/img/view/2019/1/10/1931709.png,0,0.9989538192749025,455,0,929,462,474,462,twilight sparkle,purplewonderpower
1931957.png,https://derpicdn.net/img/view/2019/1/11/1931957.png,0,0.990716278553009,72,0,3154,2961,3082,2961,twilight sparkle,maneingreen
1932559.png,https://derpicdn.net/img/view/2019/1/11/1932559.png,0,0.9875380396842957,106,34,630,558,524,524,twilight sparkle,pearlyiridescence
1934247.png,https://derpicdn.net/img/view/2019/1/13/1934247.png,0,0.9814077615737916,995,1236,2033,2274,1038,1038,twilight sparkle,ailatf
1937625.png,https://derpicdn.net/img/view/2019/1/17/1937625.png,0,0.9946255683898926,214,65,720,540,506,475,twilight sparkle,
1938223.png,https://derpicdn.net/img/view/2019/1/18/1938223.png,0,0.9463879466056824,108,1096,2342,3330,2234,2234,twilight sparkle,toisanemoif
1939245.png,https://derpicdn.net/img/view/2019/1/19/1939245.png,0,0.9721611142158508,0,0,3347,3000,3347,3000,twilight sparkle,cloudyglow
1940934.png,https://derpicdn.net/img/view/2019/1/21/1940934.png,0,0.9814414381980896,23,0,575,541,552,541,twilight sparkle,
1944801.png,https://derpicdn.net/img/view/2019/1/26/1944801.png,0,0.9909668564796448,1062,462,2124,1524,1062,1062,twilight sparkle,
1946413.png,https://derpicdn.net/img/view/2019/1/28/1946413.png,0,0.9957560896873474,63,49,667,653,604,604,twilight sparkle,intfighter
1946959.png,https://derpicdn.net/img/view/2019/1/28/1946959.png,0,0.9836547374725342,72,0,1262,939,1190,939,twilight sparkle,
1947284.png,https://derpicdn.net/img/view/2019/1/29/1947284.png,0,0.9524677395820618,1141,194,1461,514,320,320,twilight sparkle,eqlipse
1948150.png,https://derpicdn.net/img/view/2019/1/29/1948150.png,0,0.9952738881111144,2083,0,4685,2448,2602,2448,twilight sparkle,andoanimalia
1948637.png,https://derpicdn.net/img/view/2019/1/30/1948637.png,0,0.9996621608734132,631,148,1055,572,424,424,twilight sparkle,miyathegoldenflower
1948637.png,https://derpicdn.net/img/view/2019/1/30/1948637.png,2,0.9966832399368286,751,1180,1061,1490,310,310,twilight sparkle,miyathegoldenflower
1949705.png,https://derpicdn.net/img/view/2019/1/31/1949705.png,0,0.9962469339370728,408,0,984,514,576,514,twilight sparkle,brainiac
1950481.png,https://derpicdn.net/img/view/2019/2/1/1950481.png,0,0.9809479117393494,31,1305,815,2089,784,784,twilight sparkle,mysteriousshine
1950481.png,https://derpicdn.net/img/view/2019/2/1/1950481.png,1,0.9729907512664796,272,2239,1060,3027,788,788,twilight sparkle,mysteriousshine
1950481.png,https://derpicdn.net/img/view/2019/2/1/1950481.png,2,0.9355104565620422,847,2132,1497,2782,650,650,twilight sparkle,mysteriousshine
1951521.png,https://derpicdn.net/img/view/2019/2/2/1951521.png,0,0.9524458050727844,850,0,1778,901,928,901,twilight sparkle,gihhbloonde
1953766.png,https://derpicdn.net/img/view/2019/2/4/1953766.png,0,0.9833458065986632,43,57,991,1005,948,948,twilight sparkle,deltahedgehog
1955033.png,https://derpicdn.net/img/view/2019/2/6/1955033.png,0,0.98292076587677,3246,0,6638,3328,3392,3328,twilight sparkle,estories
1955034.png,https://derpicdn.net/img/view/2019/2/6/1955034.png,0,0.9098096489906312,3264,0,6602,3297,3338,3297,twilight sparkle,estories
1956159.png,https://derpicdn.net/img/view/2019/2/7/1956159.png,0,0.9779341220855712,505,0,1979,1366,1474,1366,twilight sparkle,davidsfire
1960346.png,https://derpicdn.net/img/view/2019/2/12/1960346.png,0,0.9870288372039796,24,0,404,351,380,351,twilight sparkle,hc0
1965098.png,https://derpicdn.net/img/view/2019/2/18/1965098.png,0,0.9957138895988464,0,0,619,637,619,637,twilight sparkle,cranberry--zombie
1965305.png,https://derpicdn.net/img/view/2019/2/18/1965305.png,0,0.9780288338661194,46,54,2870,2878,2824,2824,twilight sparkle,qbellas
1965704.png,https://derpicdn.net/img/view/2019/2/19/1965704.png,0,0.9864963889122008,43,0,343,287,300,287,twilight sparkle,yujikyu
1967061.png,https://derpicdn.net/img/view/2019/2/20/1967061.png,0,0.9900639653205872,820,418,2656,2254,1836,1836,twilight sparkle,pink1ejack
1967321.png,https://derpicdn.net/img/view/2019/2/20/1967321.png,0,0.9887596964836121,318,44,868,594,550,550,twilight sparkle,zero_咸鱼日常被打击
1967323.png,https://derpicdn.net/img/view/2019/2/20/1967323.png,0,0.9878016114234924,840,64,1860,1084,1020,1020,twilight sparkle,zero_咸鱼日常被打击
1967923.png,https://derpicdn.net/img/view/2019/2/21/1967923.png,0,0.9913298487663268,226,0,934,702,708,702,twilight sparkle,twoshoesmcgee
1968232.png,https://derpicdn.net/img/view/2019/2/21/1968232.png,0,0.9552901983261108,52,3194,280,3422,228,228,twilight sparkle,sintakhra
1969549.png,https://derpicdn.net/img/view/2019/2/23/1969549.png,0,0.9525482654571532,0,75,1599,1683,1599,1608,twilight sparkle,etoz
1970537.png,https://derpicdn.net/img/view/2019/2/24/1970537.png,0,0.9776681661605836,766,257,1418,909,652,652,twilight sparkle,bakud
1970537.png,https://derpicdn.net/img/view/2019/2/24/1970537.png,1,0.942824363708496,409,74,1019,684,610,610,twilight sparkle,bakud
1973095.png,https://derpicdn.net/img/view/2019/2/27/1973095.png,0,0.9989510774612428,495,21,1607,1133,1112,1112,twilight sparkle,lightning stripe
1973853.png,https://derpicdn.net/img/view/2019/2/28/1973853.png,0,0.9838241934776306,242,97,903,809,661,712,twilight sparkle,
1974153.png,https://derpicdn.net/img/view/2019/3/1/1974153.png,0,0.9709401130676272,794,76,1032,314,238,238,twilight sparkle,ochideyiku
1974153.png,https://derpicdn.net/img/view/2019/3/1/1974153.png,1,0.9571728110313416,574,95,792,313,218,218,twilight sparkle,ochideyiku
1975164.png,https://derpicdn.net/img/view/2019/3/2/1975164.png,0,0.9995955228805542,1311,142,2555,1386,1244,1244,twilight sparkle,ghostlykittycat
1975164.png,https://derpicdn.net/img/view/2019/3/2/1975164.png,1,0.9868491888046264,97,352,1321,1576,1224,1224,twilight sparkle,ghostlykittycat
1975164.png,https://derpicdn.net/img/view/2019/3/2/1975164.png,2,0.9466143846511841,947,1341,1759,2153,812,812,twilight sparkle,ghostlykittycat
1975476.png,https://derpicdn.net/img/view/2019/3/2/1975476.png,0,0.9929429292678832,2034,576,3292,1834,1258,1258,twilight sparkle,isorrayi
1975506.png,https://derpicdn.net/img/view/2019/3/2/1975506.png,0,0.9948636293411256,1284,0,2548,1182,1264,1182,twilight sparkle,detpoot|biepbot
1976208.png,https://derpicdn.net/img/view/2019/3/3/1976208.png,0,0.965664565563202,626,35,2200,1697,1574,1662,twilight sparkle,etoz
1976231.png,https://derpicdn.net/img/view/2019/3/3/1976231.png,0,0.9569517374038696,310,0,1280,980,970,980,twilight sparkle,starling-sentry-yt
1978020.png,https://derpicdn.net/img/view/2019/3/5/1978020.png,0,0.9300447702407836,390,0,2514,1817,2124,1817,twilight sparkle,flushthebatsanta
1978518.png,https://derpicdn.net/img/view/2019/3/6/1978518.png,0,0.9916353225708008,267,0,1668,940,1401,940,twilight sparkle,
1979303.png,https://derpicdn.net/img/view/2019/3/7/1979303.png,0,0.9926538467407228,36,0,918,797,882,797,twilight sparkle,
1981172.png,https://derpicdn.net/img/view/2019/3/9/1981172.png,0,0.9985297322273254,307,0,1027,705,720,705,twilight sparkle,流水あるも
1981319.png,https://derpicdn.net/img/view/2019/3/9/1981319.png,0,0.9818121194839478,65,0,517,376,452,376,twilight sparkle,
1983830.png,https://derpicdn.net/img/view/2019/3/12/1983830.png,0,0.9828994274139404,0,4,391,510,391,506,twilight sparkle,
1984123.png,https://derpicdn.net/img/view/2019/3/13/1984123.png,0,0.9951470494270324,19,0,1377,1365,1358,1365,twilight sparkle,ponballoon
1985024.png,https://derpicdn.net/img/view/2019/3/14/1985024.png,0,0.9511287808418274,271,249,793,771,522,522,twilight sparkle,
1985332.png,https://derpicdn.net/img/view/2019/3/14/1985332.png,0,0.9796148538589478,284,34,605,360,321,326,twilight sparkle,
1986067.png,https://derpicdn.net/img/view/2019/3/15/1986067.png,0,0.9929131269454956,924,224,1658,958,734,734,twilight sparkle,al1-ce
1986381.png,https://derpicdn.net/img/view/2019/3/15/1986381.png,0,0.9980369806289672,679,180,1237,738,558,558,twilight sparkle,sketchyhowl
1986557.png,https://derpicdn.net/img/view/2019/3/15/1986557.png,0,0.9987578392028807,388,0,758,369,370,369,twilight sparkle,waterz-colrxz
1988874.png,https://derpicdn.net/img/view/2019/3/18/1988874.png,0,0.9777576923370358,29,24,381,376,352,352,twilight sparkle,
1989264.png,https://derpicdn.net/img/view/2019/3/18/1989264.png,0,0.9806095957756042,22,76,756,810,734,734,twilight sparkle,
1989952.png,https://derpicdn.net/img/view/2019/3/19/1989952.png,0,0.9884093403816224,22,25,1270,1273,1248,1248,twilight sparkle,sh3llysh00
1989973.png,https://derpicdn.net/img/view/2019/3/19/1989973.png,0,0.9876906871795654,794,0,2256,1408,1462,1408,twilight sparkle,cloudyglow
1989997.png,https://derpicdn.net/img/view/2019/3/19/1989997.png,0,0.9246239662170408,173,43,487,357,314,314,twilight sparkle,
1990173.png,https://derpicdn.net/img/view/2019/3/19/1990173.png,0,0.9864178299903872,27,55,737,765,710,710,twilight sparkle,
1990606.png,https://derpicdn.net/img/view/2019/3/20/1990606.png,0,0.9967170953750608,29,0,463,421,434,421,twilight sparkle,luckreza8
1990989.png,https://derpicdn.net/img/view/2019/3/20/1990989.png,0,0.9975270628929138,5,0,359,336,354,336,twilight sparkle,catzino
1992879.png,https://derpicdn.net/img/view/2019/3/23/1992879.png,0,0.9454087018966676,0,51,1375,1581,1375,1530,twilight sparkle,
1993383.png,https://derpicdn.net/img/view/2019/3/24/1993383.png,0,0.9914224147796632,462,0,1398,926,936,926,twilight sparkle,forgalorga
1993489.png,https://derpicdn.net/img/view/2019/3/24/1993489.png,0,0.9785298705101012,0,73,325,451,325,378,twilight sparkle,
1995682.png,https://derpicdn.net/img/view/2019/3/26/1995682.png,0,0.982617735862732,187,0,803,561,616,561,twilight sparkle,
1995781.png,https://derpicdn.net/img/view/2019/3/27/1995781.png,0,0.98314768075943,320,37,2498,2215,2178,2178,twilight sparkle,jellynut
1996137.png,https://derpicdn.net/img/view/2019/3/27/1996137.png,0,0.9989058971405028,855,134,2015,1294,1160,1160,twilight sparkle,lux-arume
1997051.png,https://derpicdn.net/img/view/2019/3/28/1997051.png,0,0.9856078624725342,0,0,656,722,656,722,twilight sparkle,itv-canterlot
1999030.png,https://derpicdn.net/img/view/2019/3/31/1999030.png,0,0.9113475680351256,34,0,334,294,300,294,twilight sparkle,redmanepony
2002316.png,https://derpicdn.net/img/view/2019/4/4/2002316.png,0,0.996052086353302,504,43,1528,1067,1024,1024,twilight sparkle,robsa990
2003950.png,https://derpicdn.net/img/view/2019/4/5/2003950.png,0,0.9430539011955258,55,55,459,459,404,404,twilight sparkle,kingkero
2005778.png,https://derpicdn.net/img/view/2019/4/7/2005778.png,0,0.9796923995018004,1098,1873,1560,2335,462,462,twilight sparkle,oinktweetstudios
2005778.png,https://derpicdn.net/img/view/2019/4/7/2005778.png,1,0.9752036333084106,1426,1816,1950,2340,524,524,twilight sparkle,oinktweetstudios
2005778.png,https://derpicdn.net/img/view/2019/4/7/2005778.png,2,0.9101656675338744,2745,1901,3247,2403,502,502,twilight sparkle,oinktweetstudios
2005922.png,https://derpicdn.net/img/view/2019/4/7/2005922.png,0,0.949272096157074,1303,0,5809,3973,4506,3973,twilight sparkle,evilfrenzy
2006967.png,https://derpicdn.net/img/view/2019/4/8/2006967.png,0,0.978568434715271,0,47,791,987,791,940,twilight sparkle,spellboundcanvas
2008205.png,https://derpicdn.net/img/view/2019/4/10/2008205.png,0,0.9980028867721558,105,0,721,591,616,591,twilight sparkle,スカイ
2008293.png,https://derpicdn.net/img/view/2019/4/10/2008293.png,0,0.9025291204452516,811,79,2044,1329,1233,1250,twilight sparkle,flushthebatsanta
2012169.png,https://derpicdn.net/img/view/2019/4/14/2012169.png,0,0.9855313301086426,285,33,825,573,540,540,twilight sparkle,tf-sential
2012362.png,https://derpicdn.net/img/view/2019/4/14/2012362.png,0,0.9843710064888,145,46,749,650,604,604,twilight sparkle,xxhidden-soulxx
2012912.png,https://derpicdn.net/img/view/2019/4/15/2012912.png,0,0.9550883173942566,310,0,1918,1427,1608,1427,twilight sparkle,spellboundcanvas
2013155.png,https://derpicdn.net/img/view/2019/4/15/2013155.png,0,0.9397426843643188,1456,338,2100,982,644,644,twilight sparkle,blackbewhite2k7
2014802.png,https://derpicdn.net/img/view/2019/4/17/2014802.png,0,0.9995532631874084,199,0,903,604,704,604,twilight sparkle,scenesonic
2014905.png,https://derpicdn.net/img/view/2019/4/17/2014905.png,0,0.9642706513404846,0,94,1024,1212,1024,1118,twilight sparkle,korsoo
2014935.png,https://derpicdn.net/img/view/2019/4/17/2014935.png,0,0.9835025668144226,3264,0,8999,5833,5735,5833,twilight sparkle,korsoo
2014936.png,https://derpicdn.net/img/view/2019/4/17/2014936.png,0,0.9644728302955629,0,325,7338,8879,7338,8554,twilight sparkle,korsoo
2015204.png,https://derpicdn.net/img/view/2019/4/17/2015204.png,0,0.995441436767578,2642,0,6818,4030,4176,4030,twilight sparkle,korsoo
2015225.png,https://derpicdn.net/img/view/2019/4/17/2015225.png,0,0.9946033358573914,4020,2,7802,3784,3782,3782,twilight sparkle,korsoo
2017084.png,https://derpicdn.net/img/view/2019/4/19/2017084.png,0,0.997718632221222,18,0,696,596,678,596,twilight sparkle,glitterstar2000
2018138.png,https://derpicdn.net/img/view/2019/4/20/2018138.png,0,0.992204487323761,0,0,594,642,594,642,twilight sparkle,
2018776.png,https://derpicdn.net/img/view/2019/4/21/2018776.png,0,0.95107239484787,58,0,648,581,590,581,twilight sparkle,
2019388.png,https://derpicdn.net/img/view/2019/4/22/2019388.png,0,0.9274085164070128,83,52,1668,1698,1585,1646,twilight sparkle,bloody--mascarade
2019692.png,https://derpicdn.net/img/view/2019/4/22/2019692.png,0,0.9927796125411988,400,84,1295,1061,895,977,twilight sparkle,sketchmcreations
2020622.png,https://derpicdn.net/img/view/2019/4/23/2020622.png,0,0.9793580770492554,57,0,683,624,626,624,twilight sparkle,
2024250.png,https://derpicdn.net/img/view/2019/4/27/2024250.png,0,0.949797511100769,507,39,1449,981,942,942,twilight sparkle,
2024519.png,https://derpicdn.net/img/view/2019/4/27/2024519.png,0,0.9764443039894104,29,3,509,499,480,496,twilight sparkle,
2025081.png,https://derpicdn.net/img/view/2019/4/28/2025081.png,0,0.9583530426025392,92,53,643,621,551,568,twilight sparkle,fallingferret
2026269.png,https://derpicdn.net/img/view/2019/4/29/2026269.png,0,0.9853929281234741,0,0,774,736,774,736,twilight sparkle,
2026280.png,https://derpicdn.net/img/view/2019/4/29/2026280.png,0,0.9211846590042114,0,15,369,467,369,452,twilight sparkle,
2026477.png,https://derpicdn.net/img/view/2019/4/29/2026477.png,0,0.9282104372978208,673,221,875,423,202,202,twilight sparkle,
2026833.png,https://derpicdn.net/img/view/2019/4/29/2026833.png,0,0.9758481979370116,0,51,792,1097,792,1046,twilight sparkle,t72b
2027740.png,https://derpicdn.net/img/view/2019/5/1/2027740.png,0,0.9585353136062622,0,15,248,269,248,254,twilight sparkle,colorfulbases
2027740.png,https://derpicdn.net/img/view/2019/5/1/2027740.png,1,0.905837059020996,58,59,300,299,242,240,twilight sparkle,colorfulbases
2031800.png,https://derpicdn.net/img/view/2019/5/5/2031800.png,0,0.99660325050354,1108,78,2520,1490,1412,1412,twilight sparkle,0blackster
2034235.png,https://derpicdn.net/img/view/2019/5/8/2034235.png,0,0.9853636026382446,152,31,2616,2495,2464,2464,twilight sparkle,andoanimalia
2038257.png,https://derpicdn.net/img/view/2019/5/13/2038257.png,0,0.9592450857162476,969,29,3447,2507,2478,2478,twilight sparkle,rainyvisualz
203926.jpg,https://derpicdn.net/img/view/2013/1/6/203926.jpg,0,0.9378920793533324,207,0,575,363,368,363,twilight sparkle,foxenawolf
2039625.png,https://derpicdn.net/img/view/2019/5/15/2039625.png,0,0.9809406995773317,106,23,784,701,678,678,twilight sparkle,sarcastic02
2040984.png,https://derpicdn.net/img/view/2019/5/17/2040984.png,0,0.9418236613273621,224,0,1102,878,878,878,twilight sparkle,endertony
2042719.png,https://derpicdn.net/img/view/2019/5/19/2042719.png,0,0.9624899625778198,269,966,1067,1764,798,798,twilight sparkle,mrkat7214
2045132.png,https://derpicdn.net/img/view/2019/5/21/2045132.png,0,0.9746208190917968,0,0,1450,1080,1450,1080,twilight sparkle,
2046.png,https://derpicdn.net/img/view/2012/1/24/2046.png,0,0.9746705293655396,59,0,453,377,394,377,twilight sparkle,atticus83
2047807.png,https://derpicdn.net/img/view/2019/5/24/2047807.png,0,0.9701691269874572,524,0,2804,2277,2280,2277,twilight sparkle,yinglongfujun
2048400.png,https://derpicdn.net/img/view/2019/5/25/2048400.png,0,0.9954938888549804,379,0,1145,638,766,638,twilight sparkle,malamol
2051463.png,https://derpicdn.net/img/view/2019/5/28/2051463.png,1,0.9927948117256165,27,0,967,907,940,907,twilight sparkle,taaffeiite
2051463.png,https://derpicdn.net/img/view/2019/5/28/2051463.png,2,0.9861565232276917,1737,0,2965,978,1228,978,twilight sparkle,taaffeiite
2052026.png,https://derpicdn.net/img/view/2019/5/28/2052026.png,0,0.99802428483963,1290,0,2038,697,748,697,twilight sparkle,cosmiickatie
2053737.png,https://derpicdn.net/img/view/2019/5/30/2053737.png,0,0.9760597944259644,138,438,2130,2430,1992,1992,twilight sparkle,skie-vinyl
2054072.png,https://derpicdn.net/img/view/2019/5/31/2054072.png,0,0.9837513566017152,405,0,1280,856,875,856,twilight sparkle,penpale-heart
2054189.png,https://derpicdn.net/img/view/2019/5/31/2054189.png,0,0.989881694316864,158,9,540,409,382,400,twilight sparkle,taaffeiite
2059588.png,https://derpicdn.net/img/view/2019/6/7/2059588.png,0,0.9281381964683532,578,276,1028,726,450,450,twilight sparkle,flyingpony
2059669.png,https://derpicdn.net/img/view/2019/6/7/2059669.png,0,0.9987300038337708,1118,0,2162,964,1044,964,twilight sparkle,empress-twilight
2060377.png,https://derpicdn.net/img/view/2019/6/8/2060377.png,0,0.9744212031364441,101,133,333,365,232,232,twilight sparkle,maykitz
206056.png,https://derpicdn.net/img/view/2013/1/8/206056.png,0,0.9885462522506714,599,110,1227,738,628,628,twilight sparkle,atryl
206056.png,https://derpicdn.net/img/view/2013/1/8/206056.png,1,0.9796015620231628,23,0,817,722,794,722,twilight sparkle,atryl
2061036.png,https://derpicdn.net/img/view/2019/6/8/2061036.png,0,0.9470627903938292,107,23,585,501,478,478,twilight sparkle,
2061243.png,https://derpicdn.net/img/view/2019/6/9/2061243.png,0,0.9902703166007996,73,0,583,469,510,469,twilight sparkle,shmoobeardraws
2063748.png,https://derpicdn.net/img/view/2019/6/12/2063748.png,0,0.9494343996047974,159,40,539,452,380,412,twilight sparkle,methynecros
2066230.png,https://derpicdn.net/img/view/2019/6/15/2066230.png,0,0.9211078882217408,10,0,514,561,504,561,twilight sparkle,growlixee
2068121.png,https://derpicdn.net/img/view/2019/6/17/2068121.png,0,0.9933858513832092,148,0,604,426,456,426,twilight sparkle,zutcha
2071629.png,https://derpicdn.net/img/view/2019/6/21/2071629.png,0,0.9716535806655884,3166,630,7895,5448,4729,4818,twilight sparkle,andoanimalia
2074266.png,https://derpicdn.net/img/view/2019/6/24/2074266.png,0,0.9799850583076476,50,0,874,853,824,853,twilight sparkle,
2075265.png,https://derpicdn.net/img/view/2019/6/25/2075265.png,0,0.9700756072998048,2804,190,5998,3384,3194,3194,twilight sparkle,andoanimalia
2075280.png,https://derpicdn.net/img/view/2019/6/25/2075280.png,0,0.9799441695213318,1777,642,2417,1282,640,640,twilight sparkle,wingcut
2075305.png,https://derpicdn.net/img/view/2019/6/25/2075305.png,0,0.9975882172584534,1660,0,3478,1693,1818,1693,twilight sparkle,pucksterv
2077668.png,https://derpicdn.net/img/view/2019/6/28/2077668.png,0,0.982216477394104,89,30,759,752,670,722,twilight sparkle,
2077672.png,https://derpicdn.net/img/view/2019/6/28/2077672.png,0,0.940723180770874,410,12,1296,938,886,926,twilight sparkle,
2080792.png,https://derpicdn.net/img/view/2019/7/2/2080792.png,0,0.9707053899765016,218,0,2654,2233,2436,2233,twilight sparkle,ekveviron
2081083.png,https://derpicdn.net/img/view/2019/7/2/2081083.png,0,0.9058427214622498,0,423,7000,8775,7000,8352,twilight sparkle,tardifice
2083803.png,https://derpicdn.net/img/view/2019/7/5/2083803.png,0,0.9922670125961304,269,80,843,654,574,574,twilight sparkle,renarde-louve
2084784.png,https://derpicdn.net/img/view/2019/7/6/2084784.png,0,0.9793851971626282,0,0,333,334,333,334,twilight sparkle,snowillusory
2087603.png,https://derpicdn.net/img/view/2019/7/9/2087603.png,0,0.9544261693954468,98,0,325,230,227,230,twilight sparkle,
2089232.png,https://derpicdn.net/img/view/2019/7/11/2089232.png,0,0.9994016885757446,781,19,1687,925,906,906,twilight sparkle,lilveon
2089717.png,https://derpicdn.net/img/view/2019/7/12/2089717.png,0,0.9725372195243835,0,61,818,893,818,832,twilight sparkle,pointdelta
2097120.png,https://derpicdn.net/img/view/2019/7/20/2097120.png,0,0.9718652963638306,0,64,560,626,560,562,twilight sparkle,
2098563.png,https://derpicdn.net/img/view/2019/7/22/2098563.png,0,0.9940779209136964,34,19,720,658,686,639,twilight sparkle,
2103226.png,https://derpicdn.net/img/view/2019/7/28/2103226.png,0,0.9963275194168092,602,761,2792,2951,2190,2190,twilight sparkle,niggerdrawfag
2103247.png,https://derpicdn.net/img/view/2019/7/28/2103247.png,0,0.9613256454467772,316,0,652,328,336,328,twilight sparkle,lawombat
2104937.png,https://derpicdn.net/img/view/2019/7/30/2104937.png,0,0.99791419506073,462,0,876,400,414,400,twilight sparkle,estories
2106018.png,https://derpicdn.net/img/view/2019/7/31/2106018.png,0,0.9958627223968506,1406,0,2896,1483,1490,1483,twilight sparkle,andoanimalia
2107199.png,https://derpicdn.net/img/view/2019/8/2/2107199.png,0,0.9975565075874328,494,1,1018,531,524,530,twilight sparkle,iknowpony
2108294.png,https://derpicdn.net/img/view/2019/8/3/2108294.png,0,0.9992467761039734,58,124,1302,1368,1244,1244,twilight sparkle,lakunae
2111458.png,https://derpicdn.net/img/view/2019/8/7/2111458.png,0,0.9962663054466248,60,0,1556,1483,1496,1483,twilight sparkle,katyusha
2111649.png,https://derpicdn.net/img/view/2019/8/7/2111649.png,0,0.9851504564285278,280,425,1072,1217,792,792,twilight sparkle,novaspark
2112848.png,https://derpicdn.net/img/view/2019/8/9/2112848.png,0,0.9956766963005066,19,0,595,548,576,548,twilight sparkle,emptyfaze
2113771.png,https://derpicdn.net/img/view/2019/8/10/2113771.png,0,0.9979088306427002,521,355,989,823,468,468,twilight sparkle,valiantstar00
2117317.png,https://derpicdn.net/img/view/2019/8/13/2117317.png,0,0.9771419763565063,770,0,1786,974,1016,974,twilight sparkle,littmosa
2118450.png,https://derpicdn.net/img/view/2019/8/15/2118450.png,0,0.998696267604828,23,0,365,333,342,333,twilight sparkle,incubugs
2119678.png,https://derpicdn.net/img/view/2019/8/16/2119678.png,0,0.9917425513267516,139,0,631,427,492,427,twilight sparkle,verawitch
2121519.png,https://derpicdn.net/img/view/2019/8/18/2121519.png,0,0.992822527885437,98,63,616,605,518,542,twilight sparkle,
2124815.png,https://derpicdn.net/img/view/2019/8/22/2124815.png,0,0.9771180152893066,1424,0,4595,3047,3171,3047,twilight sparkle,sketchmcreations
2125044.png,https://derpicdn.net/img/view/2019/8/23/2125044.png,0,0.969081461429596,148,0,848,669,700,669,twilight sparkle,
2126312.png,https://derpicdn.net/img/view/2019/8/24/2126312.png,0,0.989794671535492,0,0,820,846,820,846,twilight sparkle,
2126321.png,https://derpicdn.net/img/view/2019/8/24/2126321.png,0,0.9930368661880492,9,0,845,830,836,830,twilight sparkle,
2128156.png,https://derpicdn.net/img/view/2019/8/26/2128156.png,0,0.9941648244857788,555,25,2225,1695,1670,1670,twilight sparkle,brsajo
2128722.png,https://derpicdn.net/img/view/2019/8/27/2128722.png,0,0.9550939202308656,1217,399,1471,653,254,254,twilight sparkle,
2128722.png,https://derpicdn.net/img/view/2019/8/27/2128722.png,1,0.9042475819587708,798,441,1008,651,210,210,twilight sparkle,
2129031.png,https://derpicdn.net/img/view/2019/8/27/2129031.png,0,0.9372773170471193,68,53,884,869,816,816,twilight sparkle,lou
2130241.png,https://derpicdn.net/img/view/2019/8/28/2130241.png,0,0.9848204255104064,4015,0,7999,3818,3984,3818,twilight sparkle,andoanimalia
2131897.png,https://derpicdn.net/img/view/2019/8/30/2131897.png,0,0.9987095594406128,299,0,753,409,454,409,twilight sparkle,andelai
2133581.png,https://derpicdn.net/img/view/2019/9/1/2133581.png,0,0.9197537899017334,118,159,3240,3281,3122,3122,twilight sparkle,estories
2133600.png,https://derpicdn.net/img/view/2019/9/1/2133600.png,0,0.9615836143493652,1,0,1641,1770,1640,1770,twilight sparkle,paskanaakka
2134192.png,https://derpicdn.net/img/view/2019/9/2/2134192.png,0,0.9931731820106506,1666,678,2982,1994,1316,1316,twilight sparkle,twilytwilytwinkletwily
2134487.png,https://derpicdn.net/img/view/2019/9/2/2134487.png,0,0.9862791299819946,1069,241,1733,905,664,664,twilight sparkle,creepers4
2138012.png,https://derpicdn.net/img/view/2019/9/6/2138012.png,0,0.989453375339508,0,0,373,371,373,371,twilight sparkle,
2139108.png,https://derpicdn.net/img/view/2019/9/8/2139108.png,0,0.9932429194450378,10,22,290,302,280,280,twilight sparkle,raychelrage
2144218.png,https://derpicdn.net/img/view/2019/9/14/2144218.png,0,0.9978702068328856,203,107,649,553,446,446,twilight sparkle,chronocod
2144250.png,https://derpicdn.net/img/view/2019/9/14/2144250.png,0,0.9992771744728088,850,476,1410,1036,560,560,twilight sparkle,foudubulbe|sonofaskywalker
2144803.png,https://derpicdn.net/img/view/2019/9/15/2144803.png,0,0.9662052392959596,448,1021,1578,2151,1130,1130,twilight sparkle,seishinann
2146582.png,https://derpicdn.net/img/view/2019/9/17/2146582.png,0,0.9707774519920348,1103,0,3305,2053,2202,2053,twilight sparkle,kids-in-the-corner|those kids in the corner
2148215.png,https://derpicdn.net/img/view/2019/9/20/2148215.png,0,0.9601529240608216,117,2,599,484,482,482,twilight sparkle,nairua
2149450.png,https://derpicdn.net/img/view/2019/9/21/2149450.png,0,0.9866140484809875,320,217,1094,991,774,774,twilight sparkle,holymeh
2152674.png,https://derpicdn.net/img/view/2019/9/25/2152674.png,0,0.9759730100631714,273,206,695,628,422,422,twilight sparkle,manella-art
2153828.png,https://derpicdn.net/img/view/2019/9/26/2153828.png,0,0.925638735294342,387,0,1217,781,830,781,twilight sparkle,smirk
2156580.png,https://derpicdn.net/img/view/2019/9/30/2156580.png,0,0.9929061532020568,537,234,3000,2878,2463,2644,twilight sparkle,shad0w-galaxy
2161593.png,https://derpicdn.net/img/view/2019/10/6/2161593.png,0,0.982582986354828,14,0,206,184,192,184,twilight sparkle,axlearts
2161593.png,https://derpicdn.net/img/view/2019/10/6/2161593.png,1,0.9384449124336244,11,34,209,222,198,188,twilight sparkle,axlearts
2163442.png,https://derpicdn.net/img/view/2019/10/8/2163442.png,0,0.9942578077316284,377,142,715,480,338,338,twilight sparkle,cristpony
2166576.png,https://derpicdn.net/img/view/2019/10/12/2166576.png,0,0.9509806036949158,5,137,688,828,683,691,twilight sparkle,kimmyartmlp
2167837.png,https://derpicdn.net/img/view/2019/10/13/2167837.png,1,0.9217524528503418,109,545,1203,1639,1094,1094,twilight sparkle,darklight1315
2168999.png,https://derpicdn.net/img/view/2019/10/14/2168999.png,0,0.9786508679389954,219,79,573,433,354,354,twilight sparkle,malinaartsdrawings
2169208.png,https://derpicdn.net/img/view/2019/10/15/2169208.png,0,0.9729917645454408,75,82,441,448,366,366,twilight sparkle,
2169234.png,https://derpicdn.net/img/view/2019/10/15/2169234.png,0,0.9886413812637328,447,40,1216,846,769,806,twilight sparkle,
2170009.png,https://derpicdn.net/img/view/2019/10/15/2170009.png,0,0.9541365504264832,2,0,322,315,320,315,twilight sparkle,coffiicorgii
2170240.png,https://derpicdn.net/img/view/2019/10/16/2170240.png,0,0.977161705493927,222,29,554,361,332,332,twilight sparkle,
2170957.png,https://derpicdn.net/img/view/2019/10/16/2170957.png,0,0.9736673831939696,0,0,552,503,552,503,twilight sparkle,
2171981.png,https://derpicdn.net/img/view/2019/10/17/2171981.png,0,0.9831665754318236,472,454,662,644,190,190,twilight sparkle,mythril silver
2171981.png,https://derpicdn.net/img/view/2019/10/17/2171981.png,1,0.9730255007743835,615,261,953,599,338,338,twilight sparkle,mythril silver
2172882.png,https://derpicdn.net/img/view/2019/10/18/2172882.png,0,0.9946261048316956,495,188,1129,822,634,634,twilight sparkle,squeaky-belle
2174062.png,https://derpicdn.net/img/view/2019/10/20/2174062.png,0,0.9634721279144288,310,117,548,355,238,238,twilight sparkle,empyu
2175658.png,https://derpicdn.net/img/view/2019/10/21/2175658.png,0,0.9962757229804992,86,138,428,480,342,342,twilight sparkle,kaijuramune
2176909.png,https://derpicdn.net/img/view/2019/10/23/2176909.png,0,0.9920094609260559,2620,0,5270,2530,2650,2530,twilight sparkle,ejlightning007arts
2176910.png,https://derpicdn.net/img/view/2019/10/23/2176910.png,0,0.9337723255157472,2821,732,5457,3368,2636,2636,twilight sparkle,ejlightning007arts
2177882.png,https://derpicdn.net/img/view/2019/10/24/2177882.png,0,0.9917763471603394,0,7,531,691,531,684,twilight sparkle,
2180808.png,https://derpicdn.net/img/view/2019/10/28/2180808.png,0,0.9951209425926208,69,20,511,462,442,442,twilight sparkle,glazirka
2181943.png,https://derpicdn.net/img/view/2019/10/29/2181943.png,0,0.9936529397964478,0,0,249,258,249,258,twilight sparkle,ninetail-fox
2181943.png,https://derpicdn.net/img/view/2019/10/29/2181943.png,1,0.91018944978714,30,77,338,371,308,294,twilight sparkle,ninetail-fox
2182044.png,https://derpicdn.net/img/view/2019/10/29/2182044.png,0,0.9991667866706848,59,298,359,598,300,300,twilight sparkle,pixelkitties
2183014.png,https://derpicdn.net/img/view/2019/10/30/2183014.png,1,0.9787764549255372,185,0,1619,1434,1434,1434,twilight sparkle,etoz
2185610.png,https://derpicdn.net/img/view/2019/11/2/2185610.png,0,0.9922988414764404,633,144,925,450,292,306,twilight sparkle,teabucket
2185954.png,https://derpicdn.net/img/view/2019/11/2/2185954.png,0,0.9044576287269592,39,11,237,209,198,198,twilight sparkle,sasha-flyer
2185965.png,https://derpicdn.net/img/view/2019/11/2/2185965.png,0,0.9578397870063782,38,28,242,232,204,204,twilight sparkle,sasha-flyer
2185966.png,https://derpicdn.net/img/view/2019/11/2/2185966.png,0,0.9610862135887146,38,28,242,232,204,204,twilight sparkle,sasha-flyer
2187589.png,https://derpicdn.net/img/view/2019/11/4/2187589.png,0,0.9649843573570251,424,0,1020,563,596,563,twilight sparkle,danksailor
2187679.png,https://derpicdn.net/img/view/2019/11/4/2187679.png,0,0.969584047794342,180,54,404,278,224,224,twilight sparkle,equestria-prevails|ponychaos13
2190515.png,https://derpicdn.net/img/view/2019/11/8/2190515.png,0,0.9975349903106692,2785,1878,4311,3404,1526,1526,twilight sparkle,waffletheheadmare
2191290.png,https://derpicdn.net/img/view/2019/11/9/2191290.png,0,0.9344823956489564,0,97,1642,1817,1642,1720,twilight sparkle,pizzamovies
2192627.png,https://derpicdn.net/img/view/2019/11/10/2192627.png,0,0.9631524085998536,0,0,390,381,390,381,twilight sparkle,foxtribe
2192640.png,https://derpicdn.net/img/view/2019/11/10/2192640.png,0,0.9788025617599488,0,0,269,284,269,284,twilight sparkle,magical-horse
2193196.png,https://derpicdn.net/img/view/2019/11/11/2193196.png,0,0.9993425011634828,268,0,886,590,618,590,twilight sparkle,theadorableoshawott
2194805.png,https://derpicdn.net/img/view/2019/11/13/2194805.png,1,0.9493730664253236,7,48,335,376,328,328,twilight sparkle,tatsuo
2197840.png,https://derpicdn.net/img/view/2019/11/16/2197840.png,0,0.9489976167678832,75,101,457,483,382,382,twilight sparkle,
2201092.png,https://derpicdn.net/img/view/2019/11/20/2201092.png,0,0.9788584113121032,8,50,856,898,848,848,twilight sparkle,katya|cloudyglow
2203700.png,https://derpicdn.net/img/view/2019/11/23/2203700.png,0,0.9796565771102904,411,201,643,433,232,232,twilight sparkle,zukicure5gogo
2207722.png,https://derpicdn.net/img/view/2019/11/28/2207722.png,0,0.988313376903534,22,0,514,469,492,469,twilight sparkle,
2208990.png,https://derpicdn.net/img/view/2019/11/30/2208990.png,0,0.9597651958465576,71,4,543,476,472,472,twilight sparkle,loopdalamb
2209150.png,https://derpicdn.net/img/view/2019/11/30/2209150.png,0,0.9994298815727234,704,0,1888,1141,1184,1141,twilight sparkle,cornelia_nelson
2209845.png,https://derpicdn.net/img/view/2019/12/1/2209845.png,0,0.9977010488510132,677,276,1317,916,640,640,twilight sparkle,andelai
2210506.png,https://derpicdn.net/img/view/2019/12/2/2210506.png,0,0.9810839295387268,0,0,1180,1278,1180,1278,twilight sparkle,starshade
2213918.png,https://derpicdn.net/img/view/2019/12/6/2213918.png,0,0.9767029881477356,0,416,2919,3424,2919,3008,twilight sparkle,cloudyglow
2214575.png,https://derpicdn.net/img/view/2019/12/7/2214575.png,0,0.9714466333389282,314,235,850,771,536,536,twilight sparkle,fig
2216286.png,https://derpicdn.net/img/view/2019/12/9/2216286.png,0,0.973465621471405,307,31,1467,1191,1160,1160,twilight sparkle,karmaempress666|dragonempress666
2218142.png,https://derpicdn.net/img/view/2019/12/11/2218142.png,0,0.9443055987358092,0,37,2893,3363,2893,3326,twilight sparkle,estories
2220227.png,https://derpicdn.net/img/view/2019/12/14/2220227.png,0,0.9974128007888794,285,0,876,574,591,574,twilight sparkle,rainbow eevee
2221766.png,https://derpicdn.net/img/view/2019/12/16/2221766.png,0,0.9878965616226196,0,0,796,847,796,847,twilight sparkle,
2221767.png,https://derpicdn.net/img/view/2019/12/16/2221767.png,0,0.96529221534729,93,0,1259,938,1166,938,twilight sparkle,
2224417.png,https://derpicdn.net/img/view/2019/12/19/2224417.png,0,0.9882332682609558,501,0,1861,1240,1360,1240,twilight sparkle,sapphmod
2226338.jpg,https://derpicdn.net/img/view/2019/12/21/2226338.jpg,0,0.955280303955078,85,127,1019,1061,934,934,twilight sparkle,oberon826|tt_006
2226707.png,https://derpicdn.net/img/view/2019/12/22/2226707.png,0,0.98623925447464,15,80,643,708,628,628,twilight sparkle,filypaws
2226883.png,https://derpicdn.net/img/view/2019/12/22/2226883.png,0,0.9905145168304444,172,0,988,732,816,732,twilight sparkle,galacticflashd
223013.png,https://derpicdn.net/img/view/2013/1/25/223013.png,0,0.9792171716690063,84,0,484,388,400,388,twilight sparkle,pauuhanthothecat
2232769.png,https://derpicdn.net/img/view/2019/12/29/2232769.png,0,0.9302237033843994,987,526,2423,1962,1436,1436,twilight sparkle,pony-stark
2232856.png,https://derpicdn.net/img/view/2019/12/29/2232856.png,0,0.9993752241134644,468,70,1488,1090,1020,1020,twilight sparkle,cloud-dash|vera-li
2233677.png,https://derpicdn.net/img/view/2019/12/30/2233677.png,0,0.9816439151763916,126,0,836,708,710,708,twilight sparkle,scooterglue
2235357.jpg,https://derpicdn.net/img/view/2020/1/1/2235357.jpg,0,0.9836134910583496,0,57,673,747,673,690,twilight sparkle,nlhetfield
2235788.jpg,https://derpicdn.net/img/view/2020/1/1/2235788.jpg,0,0.9589009881019592,342,11,1326,995,984,984,twilight sparkle,fluffyrescent
2238132.jpg,https://derpicdn.net/img/view/2020/1/4/2238132.jpg,0,0.9612697958946228,0,0,837,877,837,877,twilight sparkle,friskyfrisks
2238795.png,https://derpicdn.net/img/view/2020/1/4/2238795.png,0,0.9951678514480592,245,0,989,665,744,665,twilight sparkle,kilka-chan-yana
2240383.png,https://derpicdn.net/img/view/2020/1/6/2240383.png,0,0.9755984544754028,10,42,553,632,543,590,twilight sparkle,
2242475.jpg,https://derpicdn.net/img/view/2020/1/9/2242475.jpg,0,0.9668636322021484,305,35,829,559,524,524,twilight sparkle,t0zona
2245764.png,https://derpicdn.net/img/view/2020/1/12/2245764.png,0,0.9946858882904052,77,0,499,401,422,401,twilight sparkle,neuro
2245823.png,https://derpicdn.net/img/view/2020/1/12/2245823.png,0,0.976164937019348,178,0,778,560,600,560,twilight sparkle,ilanta
224660.png,https://derpicdn.net/img/view/2013/1/26/224660.png,0,0.9587199687957764,1469,214,1991,736,522,522,twilight sparkle,animewave
2247007.png,https://derpicdn.net/img/view/2020/1/14/2247007.png,0,0.9915395975112916,39,0,751,682,712,682,twilight sparkle,sunshineshiny
2247686.png,https://derpicdn.net/img/view/2020/1/15/2247686.png,0,0.9128875732421876,25,289,445,709,420,420,twilight sparkle,thelionmedal
2247737.png,https://derpicdn.net/img/view/2020/1/15/2247737.png,0,0.9311978816986084,58,0,570,497,512,497,twilight sparkle,nijidashiey7
2250199.png,https://derpicdn.net/img/view/2020/1/18/2250199.png,0,0.9952292442321776,382,0,946,551,564,551,twilight sparkle,
2250267.png,https://derpicdn.net/img/view/2020/1/18/2250267.png,0,0.9724092483520508,160,218,364,422,204,204,twilight sparkle,wintershibe
225446.png,https://derpicdn.net/img/view/2013/1/27/225446.png,0,0.9714374542236328,1665,143,2163,641,498,498,twilight sparkle,zedrin
2256739.jpg,https://derpicdn.net/img/view/2020/1/25/2256739.jpg,0,0.9743348360061646,394,14,682,302,288,288,twilight sparkle,noodlefreak88
2256747.jpg,https://derpicdn.net/img/view/2020/1/25/2256747.jpg,0,0.991555392742157,633,134,1067,568,434,434,twilight sparkle,tohkatana
225794.png,https://derpicdn.net/img/view/2013/1/27/225794.png,0,0.9982153177261353,323,0,685,348,362,348,twilight sparkle,astrofiziks
2261157.png,https://derpicdn.net/img/view/2020/1/30/2261157.png,0,0.9621257185935974,1873,91,5037,3435,3164,3344,twilight sparkle,andoanimalia
2261673.jpg,https://derpicdn.net/img/view/2020/1/31/2261673.jpg,0,0.9889711737632751,324,83,570,329,246,246,twilight sparkle,krissgopher
2264750.jpg,https://derpicdn.net/img/view/2020/2/3/2264750.jpg,0,0.9900657534599304,680,487,1912,1719,1232,1232,twilight sparkle,
2267154.jpg,https://derpicdn.net/img/view/2020/2/6/2267154.jpg,1,0.9991033673286438,344,13,718,387,374,374,twilight sparkle,miyathegoldenflower
2267154.jpg,https://derpicdn.net/img/view/2020/2/6/2267154.jpg,2,0.9952533841133118,597,766,903,1072,306,306,twilight sparkle,miyathegoldenflower
2267770.png,https://derpicdn.net/img/view/2020/2/7/2267770.png,0,0.9465916752815248,0,754,3263,4172,3263,3418,twilight sparkle,cloudyglow
2270187.png,https://derpicdn.net/img/view/2020/2/10/2270187.png,0,0.9869367480278016,59,32,399,372,340,340,twilight sparkle,
2270188.png,https://derpicdn.net/img/view/2020/2/10/2270188.png,0,0.9800992608070374,0,0,796,817,796,817,twilight sparkle,
2271081.png,https://derpicdn.net/img/view/2020/2/11/2271081.png,0,0.9770162105560304,27,54,535,562,508,508,twilight sparkle,
2273742.png,https://derpicdn.net/img/view/2020/2/14/2273742.png,0,0.9957271218299866,505,686,981,1162,476,476,twilight sparkle,toonbat
2274060.jpg,https://derpicdn.net/img/view/2020/2/14/2274060.jpg,0,0.9720569849014282,46,0,698,652,652,652,twilight sparkle,cottonsweets
2275099.png,https://derpicdn.net/img/view/2020/2/15/2275099.png,0,0.9814226627349854,898,417,2166,1685,1268,1268,twilight sparkle,thehuskylord
227563.jpg,https://derpicdn.net/img/view/2013/1/29/227563.jpg,0,0.9610618352890016,194,0,998,801,804,801,twilight sparkle,
2277841.png,https://derpicdn.net/img/view/2020/2/18/2277841.png,0,0.96793931722641,197,0,650,408,453,408,twilight sparkle,sistervailory
227789.png,https://derpicdn.net/img/view/2013/1/30/227789.png,0,0.9801676869392396,0,0,260,255,260,255,twilight sparkle,lulubell
2278015.png,https://derpicdn.net/img/view/2020/2/19/2278015.png,1,0.9820811152458192,268,460,768,1012,500,552,twilight sparkle,mrleft
2278015.png,https://derpicdn.net/img/view/2020/2/19/2278015.png,2,0.9303196668624878,324,4,766,446,442,442,twilight sparkle,mrleft
2278389.png,https://derpicdn.net/img/view/2020/2/19/2278389.png,0,0.9909365177154541,65,0,1557,1356,1492,1356,twilight sparkle,
2281074.jpg,https://derpicdn.net/img/view/2020/2/22/2281074.jpg,0,0.9966396689414978,382,78,840,536,458,458,twilight sparkle,cosyosy
2281188.jpg,https://derpicdn.net/img/view/2020/2/22/2281188.jpg,0,0.9905815720558168,466,0,896,422,430,422,twilight sparkle,tf-sential
2281236.png,https://derpicdn.net/img/view/2020/2/22/2281236.png,0,0.9501616954803468,87,21,813,747,726,726,twilight sparkle,regkitty
2282818.png,https://derpicdn.net/img/view/2020/2/24/2282818.png,0,0.9947654604911804,341,35,681,375,340,340,twilight sparkle,tf-sential
2282833.png,https://derpicdn.net/img/view/2020/2/24/2282833.png,0,0.9931043386459352,333,650,891,1208,558,558,twilight sparkle,cloureed
2283871.png,https://derpicdn.net/img/view/2020/2/26/2283871.png,0,0.973319947719574,152,0,410,256,258,256,twilight sparkle,laptopdj
22840.png,https://derpicdn.net/img/view/2012/6/27/22840.png,0,0.99530029296875,899,0,1847,855,948,855,twilight sparkle,rizcifra
2284302.png,https://derpicdn.net/img/view/2020/2/26/2284302.png,0,0.9605918526649476,12,0,656,629,644,629,twilight sparkle,
2284527.png,https://derpicdn.net/img/view/2020/2/27/2284527.png,0,0.97822505235672,0,0,644,638,644,638,twilight sparkle,
2285058.jpg,https://derpicdn.net/img/view/2020/2/28/2285058.jpg,0,0.93341863155365,295,47,885,637,590,590,twilight sparkle,drtuo4
2286803.png,https://derpicdn.net/img/view/2020/3/1/2286803.png,0,0.9895905852317808,0,0,428,461,428,461,twilight sparkle,
2287650.png,https://derpicdn.net/img/view/2020/3/2/2287650.png,0,0.9803786277770996,0,17,423,559,423,542,twilight sparkle,
2287840.jpg,https://derpicdn.net/img/view/2020/3/2/2287840.jpg,0,0.9974979162216188,146,4,854,712,708,708,twilight sparkle,7v30
2289415.jpg,https://derpicdn.net/img/view/2020/3/4/2289415.jpg,0,0.9936287403106692,562,0,1412,831,850,831,twilight sparkle,moh_mlp2
2289823.png,https://derpicdn.net/img/view/2020/3/4/2289823.png,0,0.9673270583152772,524,0,3271,2830,2747,2830,twilight sparkle,andoanimalia
2290556.png,https://derpicdn.net/img/view/2020/3/5/2290556.png,0,0.9854618310928344,0,0,3013,2961,3013,2961,twilight sparkle,flutterstormreturns
2290812.jpg,https://derpicdn.net/img/view/2020/3/5/2290812.jpg,0,0.9994077086448668,648,31,1246,629,598,598,twilight sparkle,lrusu
2292678.png,https://derpicdn.net/img/view/2020/3/8/2292678.png,0,0.9886234998703004,0,0,607,610,607,610,twilight sparkle,
2293277.png,https://derpicdn.net/img/view/2020/3/9/2293277.png,0,0.9689731597900392,384,0,1260,899,876,899,twilight sparkle,
2293477.png,https://derpicdn.net/img/view/2020/3/9/2293477.png,0,0.9799825549125672,0,18,525,548,525,530,twilight sparkle,
2295220.png,https://derpicdn.net/img/view/2020/3/11/2295220.png,0,0.959771454334259,132,0,648,515,516,515,twilight sparkle,mysteriousshine
2295884.jpg,https://derpicdn.net/img/view/2020/3/12/2295884.jpg,0,0.9992086291313172,459,20,1287,848,828,828,twilight sparkle,zefirka
2297112.png,https://derpicdn.net/img/view/2020/3/14/2297112.png,0,0.9621022939682008,0,27,1159,1295,1159,1268,twilight sparkle,cloudyglow
2297159.png,https://derpicdn.net/img/view/2020/3/14/2297159.png,0,0.977199137210846,200,9,552,361,352,352,twilight sparkle,teacorgi
2298095.png,https://derpicdn.net/img/view/2020/3/15/2298095.png,0,0.991932213306427,12,194,422,604,410,410,twilight sparkle,delfinaluther
2298744.png,https://derpicdn.net/img/view/2020/3/16/2298744.png,0,0.998198628425598,699,28,1915,1244,1216,1216,twilight sparkle,santamouse23
2299717.png,https://derpicdn.net/img/view/2020/3/17/2299717.png,0,0.9955651164054872,2350,2826,4462,4938,2112,2112,twilight sparkle,chrzanek97|badumsquish
2299717.png,https://derpicdn.net/img/view/2020/3/17/2299717.png,1,0.922118604183197,4470,580,6532,2642,2062,2062,twilight sparkle,chrzanek97|badumsquish
230032.jpg,https://derpicdn.net/img/view/2013/2/1/230032.jpg,0,0.9990323781967164,158,68,584,494,426,426,twilight sparkle,pinkanon
2301797.jpg,https://derpicdn.net/img/view/2020/3/20/2301797.jpg,0,0.9807810783386228,0,38,420,458,420,420,twilight sparkle,forgalorga
2302361.png,https://derpicdn.net/img/view/2020/3/21/2302361.png,0,0.9994743466377258,276,60,674,458,398,398,twilight sparkle,bbluna
2303761.jpg,https://derpicdn.net/img/view/2020/3/22/2303761.jpg,0,0.9815634489059448,0,13,1081,1129,1081,1116,twilight sparkle,mylittleyuri|twi-shys
2304542.png,https://derpicdn.net/img/view/2020/3/23/2304542.png,0,0.9862462282180786,0,84,653,670,653,586,twilight sparkle,
2306193.jpg,https://derpicdn.net/img/view/2020/3/26/2306193.jpg,0,0.9235079288482666,0,295,1661,1991,1661,1696,twilight sparkle,kumakum
230633.png,https://derpicdn.net/img/view/2013/2/1/230633.png,0,0.9953469634056092,58,0,462,366,404,366,twilight sparkle,alasou
2307500.png,https://derpicdn.net/img/view/2020/3/27/2307500.png,0,0.9859504699707032,145,3,477,335,332,332,twilight sparkle,今日份的xyz
2308035.jpg,https://derpicdn.net/img/view/2020/3/28/2308035.jpg,0,0.9509539604187012,304,0,1054,724,750,724,twilight sparkle,klhpyro
2308535.png,https://derpicdn.net/img/view/2020/3/29/2308535.png,0,0.9904597997665404,5259,177,10873,5791,5614,5614,twilight sparkle,andoanimalia|ejlightning007arts
2308967.png,https://derpicdn.net/img/view/2020/3/29/2308967.png,0,0.9985747933387756,1501,0,4829,3203,3328,3203,twilight sparkle,uigsyvigvusy
2309032.png,https://derpicdn.net/img/view/2020/3/29/2309032.png,0,0.9773068428039552,389,0,1165,608,776,608,twilight sparkle,jhayarr23|sailortrekkie92
230991.png,https://derpicdn.net/img/view/2013/2/2/230991.png,0,0.994465708732605,2320,1963,3844,3487,1524,1524,twilight sparkle,pridark
2311337.png,https://derpicdn.net/img/view/2020/4/1/2311337.png,0,0.9819783568382264,1468,0,3730,2148,2262,2148,twilight sparkle,melisareb
2311338.png,https://derpicdn.net/img/view/2020/4/1/2311338.png,0,0.9746589064598083,1595,0,3691,2093,2096,2093,twilight sparkle,melisareb
2311710.png,https://derpicdn.net/img/view/2020/4/1/2311710.png,0,0.9915716052055359,209,0,607,388,398,388,twilight sparkle,
2312644.png,https://derpicdn.net/img/view/2020/4/2/2312644.png,0,0.986527144908905,367,18,813,464,446,446,twilight sparkle,sadtrooper
2315525.png,https://derpicdn.net/img/view/2020/4/6/2315525.png,0,0.9422072768211364,0,10,831,908,831,898,twilight sparkle,not-ordinary-pony
2316956.png,https://derpicdn.net/img/view/2020/4/8/2316956.png,0,0.9610882997512816,0,0,2163,2457,2163,2457,twilight sparkle,almostfictional
2317317.jpg,https://derpicdn.net/img/view/2020/4/8/2317317.jpg,0,0.9793462753295898,393,16,707,330,314,314,twilight sparkle,wiskdisc
2318275.png,https://derpicdn.net/img/view/2020/4/9/2318275.png,0,0.98872572183609,825,67,1400,659,575,592,twilight sparkle,ecoelus
2320909.png,https://derpicdn.net/img/view/2020/4/12/2320909.png,0,0.9834355711936952,69,4,783,718,714,714,twilight sparkle,gradiusfanatic
2322876.png,https://derpicdn.net/img/view/2020/4/15/2322876.png,0,0.9878997206687928,1539,147,4027,2635,2488,2488,twilight sparkle,jhayarr23
232315.png,https://derpicdn.net/img/view/2013/2/3/232315.png,0,0.949296236038208,394,0,784,382,390,382,twilight sparkle,30clock
2323668.png,https://derpicdn.net/img/view/2020/4/16/2323668.png,0,0.9984666109085084,909,177,1249,517,340,340,twilight sparkle,tsitra360
2326498.png,https://derpicdn.net/img/view/2020/4/19/2326498.png,0,0.9841991662979126,0,0,760,735,760,735,twilight sparkle,
2326500.png,https://derpicdn.net/img/view/2020/4/19/2326500.png,0,0.976617395877838,0,0,315,430,315,430,twilight sparkle,
2326503.png,https://derpicdn.net/img/view/2020/4/19/2326503.png,0,0.966006338596344,86,89,738,741,652,652,twilight sparkle,
2327293.png,https://derpicdn.net/img/view/2020/4/20/2327293.png,0,0.9505811929702759,1018,1099,1570,1651,552,552,twilight sparkle,bunnari
2328010.png,https://derpicdn.net/img/view/2020/4/21/2328010.png,0,0.9986971616744996,1680,105,2758,1183,1078,1078,twilight sparkle,sepiakeys
2328126.jpg,https://derpicdn.net/img/view/2020/4/21/2328126.jpg,0,0.9892399311065674,153,159,2713,2719,2560,2560,twilight sparkle,brilliant-luna
2329209.png,https://derpicdn.net/img/view/2020/4/23/2329209.png,0,0.9817208647727966,248,228,1398,1378,1150,1150,twilight sparkle,darkest-lunar-flower
2329374.png,https://derpicdn.net/img/view/2020/4/23/2329374.png,0,0.9948440790176392,124,22,753,666,629,644,twilight sparkle,agrol
2329965.png,https://derpicdn.net/img/view/2020/4/23/2329965.png,0,0.9990643858909608,96,0,384,279,288,279,twilight sparkle,oatmealdreamscape
2333375.png,https://derpicdn.net/img/view/2020/4/27/2333375.png,0,0.9899330735206604,177,0,719,524,542,524,twilight sparkle,an_anon_artist
2335149.png,https://derpicdn.net/img/view/2020/4/29/2335149.png,0,0.990257441997528,0,0,277,340,277,340,twilight sparkle,
2335274.jpg,https://derpicdn.net/img/view/2020/4/30/2335274.jpg,0,0.935426950454712,240,89,776,625,536,536,twilight sparkle,kittheredkitsune
2336199.jpg,https://derpicdn.net/img/view/2020/5/1/2336199.jpg,0,0.9984877109527588,991,1183,1279,1471,288,288,twilight sparkle,dearmary
2337398.png,https://derpicdn.net/img/view/2020/5/2/2337398.png,0,0.9894320964813232,120,42,500,472,380,430,twilight sparkle,
2338652.jpg,https://derpicdn.net/img/view/2020/5/3/2338652.jpg,0,0.916095495223999,1097,397,1919,1219,822,822,twilight sparkle,citi
2340095.jpg,https://derpicdn.net/img/view/2020/5/5/2340095.jpg,1,0.9887857437133788,1339,247,1887,795,548,548,twilight sparkle,emeraldgalaxy
2340095.jpg,https://derpicdn.net/img/view/2020/5/5/2340095.jpg,2,0.9347082376480104,855,330,1289,764,434,434,twilight sparkle,emeraldgalaxy
2340160.jpg,https://derpicdn.net/img/view/2020/5/5/2340160.jpg,0,0.989629864692688,1391,741,2105,1455,714,714,twilight sparkle,citi
2340160.jpg,https://derpicdn.net/img/view/2020/5/5/2340160.jpg,1,0.986766517162323,1326,1925,2020,2619,694,694,twilight sparkle,citi
2340160.jpg,https://derpicdn.net/img/view/2020/5/5/2340160.jpg,2,0.9781204462051392,1845,93,2441,689,596,596,twilight sparkle,citi
2341608.png,https://derpicdn.net/img/view/2020/5/7/2341608.png,0,0.9981213212013244,1351,313,1651,613,300,300,twilight sparkle,fantasia-bases|mlptmntdisneykauane
2341610.png,https://derpicdn.net/img/view/2020/5/7/2341610.png,0,0.9954996705055236,715,63,1195,543,480,480,twilight sparkle,mlptmntdisneykauane|fantasia-bases
2341610.png,https://derpicdn.net/img/view/2020/5/7/2341610.png,1,0.9909599423408508,440,412,842,814,402,402,twilight sparkle,mlptmntdisneykauane|fantasia-bases
2341997.png,https://derpicdn.net/img/view/2020/5/7/2341997.png,0,0.9757222533226012,395,0,747,327,352,327,twilight sparkle,somefrigginnerd
2343590.png,https://derpicdn.net/img/view/2020/5/9/2343590.png,0,0.9903256297111512,93,0,3000,3734,2907,3734,twilight sparkle,sollace
2345837.png,https://derpicdn.net/img/view/2020/5/11/2345837.png,0,0.999522864818573,10,0,402,359,392,359,twilight sparkle,alex-heberling
2346144.png,https://derpicdn.net/img/view/2020/5/12/2346144.png,0,0.9904848337173462,182,0,784,498,602,498,twilight sparkle,citrus-flamingo
2347823.png,https://derpicdn.net/img/view/2020/5/13/2347823.png,0,0.982264518737793,2804,0,7700,5266,4896,5266,twilight sparkle,andoanimalia
2347970.jpg,https://derpicdn.net/img/view/2020/5/14/2347970.jpg,0,0.9803885817527772,836,302,1654,1120,818,818,twilight sparkle,bubblerubble
2349007.png,https://derpicdn.net/img/view/2020/5/15/2349007.png,0,0.9908005595207214,0,0,474,498,474,498,twilight sparkle,
2349017.png,https://derpicdn.net/img/view/2020/5/15/2349017.png,0,0.9771401882171632,0,0,388,439,388,439,twilight sparkle,
2349827.png,https://derpicdn.net/img/view/2020/5/16/2349827.png,0,0.9849122762680054,62,43,705,705,643,662,twilight sparkle,
2349842.png,https://derpicdn.net/img/view/2020/5/16/2349842.png,0,0.987898290157318,48,32,288,272,240,240,twilight sparkle,
2351124.jpg,https://derpicdn.net/img/view/2020/5/17/2351124.jpg,0,0.9598049521446228,0,289,786,1079,786,790,twilight sparkle,citi
2352052.jpg,https://derpicdn.net/img/view/2020/5/18/2352052.jpg,0,0.9931861758232116,1642,8,2234,600,592,592,twilight sparkle,citi
2352052.jpg,https://derpicdn.net/img/view/2020/5/18/2352052.jpg,1,0.9701138734817504,173,145,819,791,646,646,twilight sparkle,citi
2352531.jpg,https://derpicdn.net/img/view/2020/5/19/2352531.jpg,0,0.9985493421554564,31,132,525,626,494,494,twilight sparkle,jellyys
2353097.png,https://derpicdn.net/img/view/2020/5/20/2353097.png,0,0.9417492747306824,0,0,585,550,585,550,twilight sparkle,sigmapegasi
2354234.png,https://derpicdn.net/img/view/2020/5/21/2354234.png,0,0.9904558062553406,119,216,511,608,392,392,twilight sparkle,cubbybatdoodles
2354535.png,https://derpicdn.net/img/view/2020/5/21/2354535.png,0,0.903120756149292,39,133,433,527,394,394,twilight sparkle,loudcatmakesnoises
235502.png,https://derpicdn.net/img/view/2013/2/6/235502.png,0,0.9961878061294556,607,485,937,815,330,330,twilight sparkle,andergrin
2355633.png,https://derpicdn.net/img/view/2020/5/22/2355633.png,0,0.9881188869476318,0,0,222,228,222,228,twilight sparkle,tsurime
2384.jpg,https://derpicdn.net/img/view/2012/1/25/2384.jpg,0,0.916608989238739,617,108,1061,552,444,444,twilight sparkle,atlur
239750.png,https://derpicdn.net/img/view/2013/2/11/239750.png,0,0.9976418018341064,487,59,873,445,386,386,twilight sparkle,tim-kangaroo
244377.jpg,https://derpicdn.net/img/view/2013/2/15/244377.jpg,0,0.9554078578948976,30,0,474,434,444,434,twilight sparkle,lil miss jay
245754.png,https://derpicdn.net/img/view/2013/2/16/245754.png,0,0.9895594716072084,83,0,383,285,300,285,twilight sparkle,nayobe
245780.png,https://derpicdn.net/img/view/2013/2/16/245780.png,0,0.9947096705436708,1194,1075,1816,1697,622,622,twilight sparkle,v-d-k
245818.png,https://derpicdn.net/img/view/2013/2/16/245818.png,0,0.9949723482131958,132,0,606,473,474,473,twilight sparkle,serendipity-kitty
246046.png,https://derpicdn.net/img/view/2013/2/17/246046.png,0,0.9253405928611756,0,0,287,241,287,241,twilight sparkle,
246866.png,https://derpicdn.net/img/view/2013/2/17/246866.png,0,0.9410183429718018,86,26,660,600,574,574,twilight sparkle,php94
248717.png,https://derpicdn.net/img/view/2013/2/19/248717.png,0,0.9987202882766724,3895,0,5749,1673,1854,1673,twilight sparkle,90sigma
249466.png,https://derpicdn.net/img/view/2013/2/20/249466.png,0,0.9986252188682556,0,0,376,387,376,387,twilight sparkle,ecokitty
257015.jpg,https://derpicdn.net/img/view/2013/2/27/257015.jpg,0,0.9057414531707764,201,0,587,362,386,362,twilight sparkle,
257345.png,https://derpicdn.net/img/view/2013/2/27/257345.png,0,0.994284451007843,1113,148,2389,1424,1276,1276,twilight sparkle,etiluos
259103.png,https://derpicdn.net/img/view/2013/3/1/259103.png,0,0.9946579933166504,89,18,815,744,726,726,twilight sparkle,iisaw
25976.png,https://derpicdn.net/img/view/2012/6/30/25976.png,0,0.995550811290741,481,0,851,327,370,327,twilight sparkle,solar-slash
25976.png,https://derpicdn.net/img/view/2012/6/30/25976.png,1,0.9921992421150208,234,320,536,622,302,302,twilight sparkle,solar-slash
26011.jpg,https://derpicdn.net/img/view/2012/6/30/26011.jpg,0,0.9892327189445496,382,338,742,698,360,360,twilight sparkle,conicer
265668.png,https://derpicdn.net/img/view/2013/3/8/265668.png,0,0.9644473195075988,377,0,875,496,498,496,twilight sparkle,empty-10
267645.png,https://derpicdn.net/img/view/2013/3/10/267645.png,0,0.9757168889045716,143,60,587,504,444,444,twilight sparkle,adailey
27310.png,https://derpicdn.net/img/view/2012/7/1/27310.png,0,0.9580515623092652,509,39,941,471,432,432,twilight sparkle,rustydooks|megasweet
273392.png,https://derpicdn.net/img/view/2013/3/18/273392.png,0,0.9768818020820618,1,0,366,388,365,388,twilight sparkle,loyaldis
279412.jpg,https://derpicdn.net/img/view/2013/3/25/279412.jpg,0,0.9299356937408448,145,53,345,253,200,200,twilight sparkle,chantylii
284472.png,https://derpicdn.net/img/view/2013/3/31/284472.png,0,0.9984392523765564,227,0,583,334,356,334,twilight sparkle,da-fuze
286808.png,https://derpicdn.net/img/view/2013/4/3/286808.png,0,0.9464711546897888,773,33,1104,377,331,344,twilight sparkle,pauuhanthothecat
289328.png,https://derpicdn.net/img/view/2013/4/6/289328.png,0,0.9691247940063475,211,92,549,430,338,338,twilight sparkle,joshydesu
289961.png,https://derpicdn.net/img/view/2013/4/6/289961.png,0,0.9775305390357972,2402,23,4500,2265,2098,2242,twilight sparkle,chir-miru
292395.png,https://derpicdn.net/img/view/2013/4/9/292395.png,0,0.9444583058357242,167,99,535,467,368,368,twilight sparkle,wicked-at-heart
294123.png,https://derpicdn.net/img/view/2013/4/10/294123.png,0,0.9836772084236144,0,0,274,261,274,261,twilight sparkle,weirdofish
299951.png,https://derpicdn.net/img/view/2013/4/16/299951.png,0,0.9786621332168579,40,0,866,562,826,562,twilight sparkle,sevour
304500.png,https://derpicdn.net/img/view/2013/4/21/304500.png,0,0.9911725521087646,790,0,2298,1438,1508,1438,twilight sparkle,etiluos
304871.png,https://derpicdn.net/img/view/2013/4/21/304871.png,0,0.994882345199585,655,435,1243,1023,588,588,twilight sparkle,rumblealex
309743.jpg,https://derpicdn.net/img/view/2013/4/27/309743.jpg,0,0.984463095664978,732,102,1714,1084,982,982,twilight sparkle,geomancing
311820.jpg,https://derpicdn.net/img/view/2013/4/29/311820.jpg,0,0.9912790656089784,978,270,2612,1904,1634,1634,twilight sparkle,neko-me
314234.png,https://derpicdn.net/img/view/2013/5/2/314234.png,0,0.9971874952316284,265,0,2949,2682,2684,2682,twilight sparkle,jcosneverexisted
323168.png,https://derpicdn.net/img/view/2013/5/12/323168.png,0,0.9964580535888672,268,0,674,402,406,402,twilight sparkle,
323238.png,https://derpicdn.net/img/view/2013/5/12/323238.png,0,0.9946517348289492,158,86,320,248,162,162,twilight sparkle,moonstruck-badger
323931.png,https://derpicdn.net/img/view/2013/5/13/323931.png,0,0.9982549548149108,645,68,1101,524,456,456,twilight sparkle,xonitum
324704.png,https://derpicdn.net/img/view/2013/5/14/324704.png,0,0.9575268626213074,124,0,488,359,364,359,twilight sparkle,dotoriii
327103.png,https://derpicdn.net/img/view/2013/5/17/327103.png,0,0.9871059656143188,847,193,1509,855,662,662,twilight sparkle,erockertorres
331973.png,https://derpicdn.net/img/view/2013/5/23/331973.png,0,0.9732922911643982,386,218,926,758,540,540,twilight sparkle,kittehkatbar
3370.png,https://derpicdn.net/img/view/2012/2/21/3370.png,0,0.9517182111740112,123,9,299,185,176,176,twilight sparkle,jessy
339762.png,https://derpicdn.net/img/view/2013/6/3/339762.png,0,0.9554672837257384,54,323,474,743,420,420,twilight sparkle,loyaldis
339863.jpg,https://derpicdn.net/img/view/2013/6/3/339863.jpg,0,0.9742526412010192,554,960,898,1304,344,344,twilight sparkle,polkin
343265.png,https://derpicdn.net/img/view/2013/6/8/343265.png,0,0.9495108127593994,285,0,2115,1753,1830,1753,twilight sparkle,jcosneverexisted
344694.png,https://derpicdn.net/img/view/2013/6/9/344694.png,0,0.9945691823959352,0,0,536,535,536,535,twilight sparkle,yanoda
344696.png,https://derpicdn.net/img/view/2013/6/9/344696.png,0,0.9974642395973206,1308,0,3000,1834,1692,1834,twilight sparkle,brisineo
344945.png,https://derpicdn.net/img/view/2013/6/10/344945.png,0,0.9990236759185792,536,0,1190,541,654,541,twilight sparkle,rumblealex
346424.jpg,https://derpicdn.net/img/view/2013/6/12/346424.jpg,0,0.9852955937385559,417,0,883,442,466,442,twilight sparkle,vannamelon
347563.jpg,https://derpicdn.net/img/view/2013/6/13/347563.jpg,0,0.982201874256134,197,342,677,822,480,480,twilight sparkle,grennadder
349884.png,https://derpicdn.net/img/view/2013/6/16/349884.png,0,0.9879070520401,105,28,469,392,364,364,twilight sparkle,tlatophat
349962.jpg,https://derpicdn.net/img/view/2013/6/16/349962.jpg,0,0.9920552372932434,359,30,579,250,220,220,twilight sparkle,nonananana
349962.jpg,https://derpicdn.net/img/view/2013/6/16/349962.jpg,1,0.9894946217536926,19,50,235,266,216,216,twilight sparkle,nonananana
349962.jpg,https://derpicdn.net/img/view/2013/6/16/349962.jpg,2,0.9589929580688475,183,59,401,277,218,218,twilight sparkle,nonananana
353943.png,https://derpicdn.net/img/view/2013/6/21/353943.png,0,0.9846954345703124,818,355,2968,2505,2150,2150,twilight sparkle,irishthorns
35746.png,https://derpicdn.net/img/view/2012/7/7/35746.png,0,0.912264347076416,504,0,922,413,418,413,twilight sparkle,ratofdrawn
360044.png,https://derpicdn.net/img/view/2013/6/29/360044.png,0,0.9879333972930908,1008,0,2000,1027,992,1027,twilight sparkle,djc631
3612.png,https://derpicdn.net/img/view/2012/2/28/3612.png,0,0.9971424341201782,602,72,862,332,260,260,twilight sparkle,jesrartes
363984.png,https://derpicdn.net/img/view/2013/7/4/363984.png,0,0.9267242550849916,723,393,1663,1333,940,940,twilight sparkle,odiz
364321.png,https://derpicdn.net/img/view/2013/7/4/364321.png,0,0.976400911808014,0,0,276,286,276,286,twilight sparkle,kwaken
366832.png,https://derpicdn.net/img/view/2013/7/7/366832.png,0,0.9367465972900392,0,0,550,554,550,554,twilight sparkle,
368634.png,https://derpicdn.net/img/view/2013/7/9/368634.png,0,0.9925004243850708,166,4,420,258,254,254,twilight sparkle,xnosidex
374396.png,https://derpicdn.net/img/view/2013/7/15/374396.png,0,0.9747473001480104,0,0,996,1125,996,1125,twilight sparkle,tourniquetmuffin
375720.png,https://derpicdn.net/img/view/2013/7/16/375720.png,0,0.9958664774894714,182,0,1196,883,1014,883,twilight sparkle,php92
3811.png,https://derpicdn.net/img/view/2012/3/21/3811.png,0,0.9911329746246338,544,8,1106,570,562,562,twilight sparkle,grumblepluck
381780.jpg,https://derpicdn.net/img/view/2013/7/23/381780.jpg,0,0.9952862858772278,95,18,509,432,414,414,twilight sparkle,orca
382605.png,https://derpicdn.net/img/view/2013/7/24/382605.png,0,0.9917551875114441,354,400,732,778,378,378,twilight sparkle,ohthatandy
384980.png,https://derpicdn.net/img/view/2013/7/29/384980.png,0,0.9455901980400084,0,426,2176,2698,2176,2272,twilight sparkle,zuko42
386.png,https://derpicdn.net/img/view/2012/1/15/386.png,0,0.9996668100357056,24,26,280,282,256,256,twilight sparkle,katsh|kathrynlayno
386800.jpg,https://derpicdn.net/img/view/2013/7/30/386800.jpg,0,0.9959781765937804,86,17,524,455,438,438,twilight sparkle,orca
387117.png,https://derpicdn.net/img/view/2013/7/31/387117.png,0,0.9302248954772948,286,22,722,458,436,436,twilight sparkle,ipun
396436.jpg,https://derpicdn.net/img/view/2013/8/10/396436.jpg,0,0.9936494827270508,197,272,1221,1296,1024,1024,twilight sparkle,agamnentzar
396448.png,https://derpicdn.net/img/view/2013/8/10/396448.png,0,0.9269352555274964,4040,1188,6068,3304,2028,2116,twilight sparkle,chainchomp2
397339.png,https://derpicdn.net/img/view/2013/8/11/397339.png,0,0.915306568145752,65,7,483,425,418,418,twilight sparkle,co0kie-cat
399166.png,https://derpicdn.net/img/view/2013/8/13/399166.png,0,0.983803391456604,0,0,404,424,404,424,twilight sparkle,zutcha
39956.jpg,https://derpicdn.net/img/view/2012/7/10/39956.jpg,0,0.954239010810852,106,23,550,467,444,444,twilight sparkle,steffy-beff
400105.jpg,https://derpicdn.net/img/view/2013/8/14/400105.jpg,0,0.9821069836616516,356,46,712,402,356,356,twilight sparkle,psychoon
400105.jpg,https://derpicdn.net/img/view/2013/8/14/400105.jpg,1,0.9230682849884032,199,105,507,413,308,308,twilight sparkle,psychoon
402823.png,https://derpicdn.net/img/view/2013/8/17/402823.png,0,0.9574611783027648,157,153,883,879,726,726,twilight sparkle,geomancing
403266.png,https://derpicdn.net/img/view/2013/8/18/403266.png,0,0.9995720982551576,260,5,838,583,578,578,twilight sparkle,hoyeechun
406483.jpg,https://derpicdn.net/img/view/2013/8/21/406483.jpg,1,0.98798805475235,827,1309,1621,2103,794,794,twilight sparkle,bluntwhiskey
406483.jpg,https://derpicdn.net/img/view/2013/8/21/406483.jpg,2,0.9804387092590332,1035,294,1787,1046,752,752,twilight sparkle,bluntwhiskey
409757.png,https://derpicdn.net/img/view/2013/8/25/409757.png,0,0.9357326626777648,172,40,534,402,362,362,twilight sparkle,hounan
412783.png,https://derpicdn.net/img/view/2013/8/28/412783.png,0,0.9836928248405457,3151,1003,5235,3087,2084,2084,twilight sparkle,maximillianveers
412891.png,https://derpicdn.net/img/view/2013/8/28/412891.png,0,0.993965208530426,330,0,880,526,550,526,twilight sparkle,aleximusprime
416208.png,https://derpicdn.net/img/view/2013/9/1/416208.png,0,0.9793867468833924,97,0,517,387,420,387,twilight sparkle,furreon
41868.jpg,https://derpicdn.net/img/view/2012/7/12/41868.jpg,0,0.9227420091629028,219,21,1237,1039,1018,1018,twilight sparkle,catscratchpaper
418853.png,https://derpicdn.net/img/view/2013/9/4/418853.png,0,0.9644198417663574,9,0,900,896,891,896,twilight sparkle,
420895.png,https://derpicdn.net/img/view/2013/9/6/420895.png,0,0.9213690161705016,0,0,481,453,481,453,twilight sparkle,pegasisters82
421312.png,https://derpicdn.net/img/view/2013/9/7/421312.png,0,0.9352880716323853,0,0,1007,1019,1007,1019,twilight sparkle,php94
428930.png,https://derpicdn.net/img/view/2013/9/16/428930.png,0,0.9870474934577942,5,34,309,338,304,304,twilight sparkle,grilledcat
430184.png,https://derpicdn.net/img/view/2013/9/18/430184.png,0,0.9974107146263124,126,0,838,634,712,634,twilight sparkle,draneas
430764.jpg,https://derpicdn.net/img/view/2013/9/19/430764.jpg,0,0.9975113272666932,779,0,1661,787,882,787,twilight sparkle,princesssilverglow
434880.jpg,https://derpicdn.net/img/view/2013/9/25/434880.jpg,0,0.9969789981842041,0,0,351,345,351,345,twilight sparkle,violetvampirevixen
436952.png,https://derpicdn.net/img/view/2013/9/28/436952.png,0,0.9823781251907348,1420,128,2174,882,754,754,twilight sparkle,fiddlearts
449598.jpg,https://derpicdn.net/img/view/2013/10/15/449598.jpg,0,0.9939935803413392,170,0,572,361,402,361,twilight sparkle,crade
450225.jpg,https://derpicdn.net/img/view/2013/10/16/450225.jpg,0,0.9981365203857422,300,16,688,404,388,388,twilight sparkle,flowersimh
453662.png,https://derpicdn.net/img/view/2013/10/21/453662.png,0,0.9505730271339417,432,104,758,430,326,326,twilight sparkle,xcopyen002
454094.png,https://derpicdn.net/img/view/2013/10/22/454094.png,0,0.9628934264183044,0,36,274,314,274,278,twilight sparkle,
459110.png,https://derpicdn.net/img/view/2013/10/28/459110.png,1,0.9474292397499084,1472,669,2358,1555,886,886,twilight sparkle,pastelflakes
459447.png,https://derpicdn.net/img/view/2013/10/29/459447.png,0,0.9016982316970824,312,0,668,353,356,353,twilight sparkle,key-of-kira
460180.png,https://derpicdn.net/img/view/2013/10/30/460180.png,0,0.923737108707428,38,0,940,893,902,893,twilight sparkle,negasun
462209.png,https://derpicdn.net/img/view/2013/11/2/462209.png,0,0.9904964566230774,55,0,1723,1667,1668,1667,twilight sparkle,estories
471417.png,https://derpicdn.net/img/view/2013/11/13/471417.png,0,0.999030351638794,1356,990,2394,2028,1038,1038,twilight sparkle,idontrunntoofast
47212.jpg,https://derpicdn.net/img/view/2012/7/17/47212.jpg,0,0.9992923736572266,55,26,429,400,374,374,twilight sparkle,mysticalpha
472212.png,https://derpicdn.net/img/view/2013/11/14/472212.png,0,0.9795328378677368,255,0,2285,1923,2030,1923,twilight sparkle,musicglare
472732.png,https://derpicdn.net/img/view/2013/11/14/472732.png,0,0.9880382418632508,0,0,4030,3728,4030,3728,twilight sparkle,the smiling pony
47415.jpg,https://derpicdn.net/img/view/2012/7/17/47415.jpg,0,0.9981899261474608,685,344,955,614,270,270,twilight sparkle,uc77
47459.png,https://derpicdn.net/img/view/2012/7/17/47459.png,0,0.9943118095397948,41,49,931,939,890,890,twilight sparkle,skutchi
475138.png,https://derpicdn.net/img/view/2013/11/18/475138.png,0,0.9287407398223876,23,0,606,570,583,570,twilight sparkle,
479871.jpg,https://derpicdn.net/img/view/2013/11/24/479871.jpg,0,0.9104994535446168,308,0,1542,1057,1234,1057,twilight sparkle,
480631.png,https://derpicdn.net/img/view/2013/11/24/480631.png,0,0.9486052989959716,210,0,680,468,470,468,twilight sparkle,magical disaster
481722.png,https://derpicdn.net/img/view/2013/11/25/481722.png,0,0.9488176107406616,0,0,919,931,919,931,twilight sparkle,docwario
481740.png,https://derpicdn.net/img/view/2013/11/25/481740.png,0,0.9911629557609558,298,0,700,363,402,363,twilight sparkle,mistydash
482437.png,https://derpicdn.net/img/view/2013/11/26/482437.png,0,0.9367401003837584,163,50,411,298,248,248,twilight sparkle,strangemoose
483879.png,https://derpicdn.net/img/view/2013/11/28/483879.png,0,0.9865306615829468,191,119,1305,1233,1114,1114,twilight sparkle,icy wings
484288.png,https://derpicdn.net/img/view/2013/11/28/484288.png,0,0.9966860413551332,405,90,765,450,360,360,twilight sparkle,haldirs
484533.png,https://derpicdn.net/img/view/2013/11/28/484533.png,0,0.9329039454460144,214,61,822,669,608,608,twilight sparkle,freefraq
49820.png,https://derpicdn.net/img/view/2012/7/19/49820.png,0,0.9120542407035828,12,77,284,375,272,298,twilight sparkle,php27
506492.png,https://derpicdn.net/img/view/2013/12/25/506492.png,0,0.9973546266555786,524,117,1914,1507,1390,1390,twilight sparkle,shyshyoctavia|silvy-winds
508767.png,https://derpicdn.net/img/view/2013/12/29/508767.png,0,0.9767817854881288,0,0,768,776,768,776,twilight sparkle,
508767.png,https://derpicdn.net/img/view/2013/12/29/508767.png,1,0.9004738330841064,61,44,960,974,899,930,twilight sparkle,
510438.png,https://derpicdn.net/img/view/2013/12/30/510438.png,0,0.9958156943321228,766,0,1611,903,845,903,twilight sparkle,meteor-spark
510444.png,https://derpicdn.net/img/view/2013/12/30/510444.png,0,0.9816990494728088,1779,0,4245,2178,2466,2178,twilight sparkle,90sigma
510515.png,https://derpicdn.net/img/view/2013/12/30/510515.png,0,0.9968714714050292,2914,588,5364,3038,2450,2450,twilight sparkle,baroquedavid
513797.png,https://derpicdn.net/img/view/2014/1/3/513797.png,0,0.976531982421875,94,25,1462,1393,1368,1368,twilight sparkle,shyshyoctavia
515018.png,https://derpicdn.net/img/view/2014/1/4/515018.png,0,0.9829742908477784,98,0,822,673,724,673,twilight sparkle,
515684.png,https://derpicdn.net/img/view/2014/1/5/515684.png,0,0.997224986553192,142,158,660,676,518,518,twilight sparkle,dolly|twizzle
517887.png,https://derpicdn.net/img/view/2014/1/7/517887.png,0,0.9935380220413208,672,74,1124,526,452,452,twilight sparkle,balaraika
518193.png,https://derpicdn.net/img/view/2014/1/7/518193.png,0,0.9944809675216676,609,303,1147,841,538,538,twilight sparkle,allocen
518256.png,https://derpicdn.net/img/view/2014/1/7/518256.png,0,0.9880452156066896,1100,282,1840,1022,740,740,twilight sparkle,graypaint
522092.png,https://derpicdn.net/img/view/2014/1/12/522092.png,0,0.9894325137138368,41,0,498,456,457,456,twilight sparkle,
522620.png,https://derpicdn.net/img/view/2014/1/12/522620.png,0,0.9496917724609376,260,19,966,725,706,706,twilight sparkle,inkytophat
527588.png,https://derpicdn.net/img/view/2014/1/18/527588.png,0,0.9228653311729432,567,0,1111,540,544,540,twilight sparkle,yajima
533932.png,https://derpicdn.net/img/view/2014/1/25/533932.png,0,0.983992636203766,0,0,488,298,488,298,twilight sparkle,
534306.png,https://derpicdn.net/img/view/2014/1/25/534306.png,0,0.997607946395874,0,0,1311,1269,1311,1269,twilight sparkle,e-pon
535072.png,https://derpicdn.net/img/view/2014/1/26/535072.png,0,0.9957788586616516,0,0,2185,2158,2185,2158,twilight sparkle,0nautile18e26
535557.png,https://derpicdn.net/img/view/2014/1/27/535557.png,0,0.9687504768371582,31,0,495,384,464,384,twilight sparkle,
535687.png,https://derpicdn.net/img/view/2014/1/27/535687.png,0,0.9993277788162231,27,0,323,284,296,284,twilight sparkle,dreamingnoctis
536652.png,https://derpicdn.net/img/view/2014/1/28/536652.png,0,0.9135729670524596,348,43,704,399,356,356,twilight sparkle,arurein
540298.png,https://derpicdn.net/img/view/2014/2/1/540298.png,0,0.9996976256370544,728,0,2086,1193,1358,1193,twilight sparkle,thisis913
543164.png,https://derpicdn.net/img/view/2014/2/4/543164.png,0,0.9989559650421144,804,0,1840,1006,1036,1006,twilight sparkle,orang111
544073.png,https://derpicdn.net/img/view/2014/2/5/544073.png,0,0.9235738515853882,1131,269,4511,3649,3380,3380,twilight sparkle,synch-anon|twiforce
545733.png,https://derpicdn.net/img/view/2014/2/7/545733.png,0,0.9945880770683287,6739,819,12901,6981,6162,6162,twilight sparkle,kysss90
546295.jpg,https://derpicdn.net/img/view/2014/2/8/546295.jpg,0,0.9993693232536316,626,0,1514,710,888,710,twilight sparkle,larsurus
547255.png,https://derpicdn.net/img/view/2014/2/9/547255.png,0,0.9583632946014404,253,0,719,492,466,492,twilight sparkle,
548833.png,https://derpicdn.net/img/view/2014/2/10/548833.png,0,0.9904544949531556,215,72,509,366,294,294,twilight sparkle,capt_hairball
549069.png,https://derpicdn.net/img/view/2014/2/11/549069.png,0,0.9966262578964232,1018,449,1490,921,472,472,twilight sparkle,reikomuffin
549069.png,https://derpicdn.net/img/view/2014/2/11/549069.png,1,0.9416679739952089,405,1177,873,1645,468,468,twilight sparkle,reikomuffin
549865.png,https://derpicdn.net/img/view/2014/2/12/549865.png,0,0.997395932674408,126,120,922,916,796,796,twilight sparkle,savannaeve
555536.jpg,https://derpicdn.net/img/view/2014/2/18/555536.jpg,0,0.9874582290649414,15,0,303,276,288,276,twilight sparkle,pasikon
556276.png,https://derpicdn.net/img/view/2014/2/19/556276.png,0,0.9990490078926086,185,0,623,416,438,416,twilight sparkle,rougebat
558097.jpg,https://derpicdn.net/img/view/2014/2/21/558097.jpg,0,0.9255132675170898,194,30,1042,878,848,848,twilight sparkle,akamei
55964.jpg,https://derpicdn.net/img/view/2012/7/25/55964.jpg,0,0.9237917065620422,9,0,441,413,432,413,twilight sparkle,uc77
559721.png,https://derpicdn.net/img/view/2014/2/23/559721.png,0,0.9537815451622008,0,0,1024,1280,1024,1280,twilight sparkle,slowlearner46
560153.jpg,https://derpicdn.net/img/view/2014/2/23/560153.jpg,0,0.9776862263679504,850,197,1464,811,614,614,twilight sparkle,gamermac
560359.png,https://derpicdn.net/img/view/2014/2/24/560359.png,0,0.9248684048652648,0,0,478,595,478,595,twilight sparkle,slowlearner46
560650.png,https://derpicdn.net/img/view/2014/2/24/560650.png,0,0.9466362595558168,516,319,802,605,286,286,twilight sparkle,madmax
561964.png,https://derpicdn.net/img/view/2014/2/26/561964.png,0,0.9352986812591552,504,30,966,492,462,462,twilight sparkle,ashourii
564248.png,https://derpicdn.net/img/view/2014/3/1/564248.png,0,0.969593346118927,306,55,706,455,400,400,twilight sparkle,lightningnickel
566589.png,https://derpicdn.net/img/view/2014/3/4/566589.png,0,0.9327802658081056,748,99,1476,827,728,728,twilight sparkle,toroitimu
568757.png,https://derpicdn.net/img/view/2014/3/7/568757.png,0,0.9686794877052308,316,55,732,471,416,416,twilight sparkle,senx
572243.png,https://derpicdn.net/img/view/2014/3/11/572243.png,0,0.9430184364318848,54,39,748,733,694,694,twilight sparkle,annie-aya
573044.png,https://derpicdn.net/img/view/2014/3/12/573044.png,0,0.9015259742736816,140,0,570,407,430,407,twilight sparkle,weepysheep
578528.png,https://derpicdn.net/img/view/2014/3/18/578528.png,0,0.9603139758110046,71,270,341,540,270,270,twilight sparkle,
578528.png,https://derpicdn.net/img/view/2014/3/18/578528.png,1,0.9462785124778748,95,0,363,249,268,249,twilight sparkle,
583174.png,https://derpicdn.net/img/view/2014/3/23/583174.png,0,0.9917629957199096,339,147,671,479,332,332,twilight sparkle,meb90
583398.png,https://derpicdn.net/img/view/2014/3/23/583398.png,0,0.9984198808670044,0,0,2507,2844,2507,2844,twilight sparkle,xpesifeindx
588949.png,https://derpicdn.net/img/view/2014/3/30/588949.png,0,0.9032363891601562,699,0,3551,2302,2852,2302,twilight sparkle,tim244
591121.png,https://derpicdn.net/img/view/2014/4/2/591121.png,0,0.9732593894004822,937,553,2457,2073,1520,1520,twilight sparkle,godoffury
593304.jpg,https://derpicdn.net/img/view/2014/4/5/593304.jpg,0,0.992656946182251,0,184,423,614,423,430,twilight sparkle,snapai
596657.jpg,https://derpicdn.net/img/view/2014/4/9/596657.jpg,0,0.9947364330291748,1519,53,2205,739,686,686,twilight sparkle,prisma-neko
596658.jpg,https://derpicdn.net/img/view/2014/4/9/596658.jpg,0,0.9961450099945068,1542,70,2196,724,654,654,twilight sparkle,prisma-neko
596660.jpg,https://derpicdn.net/img/view/2014/4/9/596660.jpg,0,0.9835100173950196,1559,79,2193,713,634,634,twilight sparkle,prisma-neko
597218.png,https://derpicdn.net/img/view/2014/4/10/597218.png,0,0.9975993037223816,3153,0,6323,2778,3170,2778,twilight sparkle,stillfire
597295.png,https://derpicdn.net/img/view/2014/4/10/597295.png,0,0.9170749187469482,9,430,345,766,336,336,twilight sparkle,hewison
599086.png,https://derpicdn.net/img/view/2014/4/13/599086.png,0,0.9630922079086304,53,131,453,531,400,400,twilight sparkle,christiancerda
599299.png,https://derpicdn.net/img/view/2014/4/13/599299.png,0,0.9484529495239258,247,0,531,279,284,279,twilight sparkle,sparkyfox
607241.png,https://derpicdn.net/img/view/2014/4/22/607241.png,0,0.996825098991394,1,0,513,464,512,464,twilight sparkle,aoringo
608532.png,https://derpicdn.net/img/view/2014/4/24/608532.png,0,0.9987578392028807,3355,0,6353,2917,2998,2917,twilight sparkle,parclytaxel
611539.png,https://derpicdn.net/img/view/2014/4/27/611539.png,0,0.9251585602760316,227,274,495,542,268,268,twilight sparkle,reina-kitsune
613607.png,https://derpicdn.net/img/view/2014/4/30/613607.png,0,0.979470193386078,0,5,453,479,453,474,twilight sparkle,
617400.png,https://derpicdn.net/img/view/2014/5/4/617400.png,0,0.9892958402633668,0,0,629,574,629,574,twilight sparkle,featherblot
620195.png,https://derpicdn.net/img/view/2014/5/7/620195.png,0,0.9591717720031738,138,0,518,367,380,367,twilight sparkle,dm29
621159.png,https://derpicdn.net/img/view/2014/5/8/621159.png,0,0.9923360347747804,638,299,932,593,294,294,twilight sparkle,adalbertus
623001.png,https://derpicdn.net/img/view/2014/5/10/623001.png,0,0.9769495129585266,44,0,958,700,914,700,twilight sparkle,
623562.png,https://derpicdn.net/img/view/2014/5/11/623562.png,0,0.9580349922180176,97,15,721,639,624,624,twilight sparkle,clouddg
625066.png,https://derpicdn.net/img/view/2014/5/12/625066.png,0,0.9806256294250488,134,9,955,800,821,791,twilight sparkle,flare-chaser
626405.png,https://derpicdn.net/img/view/2014/5/14/626405.png,0,0.9978766441345216,98,0,2914,2658,2816,2658,twilight sparkle,90sigma
626613.png,https://derpicdn.net/img/view/2014/5/14/626613.png,0,0.9678544998168944,7,32,1695,1720,1688,1688,twilight sparkle,porygon2z
627438.png,https://derpicdn.net/img/view/2014/5/15/627438.png,0,0.906624972820282,2708,0,5844,2994,3136,2994,twilight sparkle,mactavish1996
628154.jpg,https://derpicdn.net/img/view/2014/5/16/628154.jpg,0,0.9995353817939758,346,116,910,680,564,564,twilight sparkle,ayahana
629562.png,https://derpicdn.net/img/view/2014/5/17/629562.png,0,0.9986109733581544,677,0,1723,905,1046,905,twilight sparkle,lordzid
631132.png,https://derpicdn.net/img/view/2014/5/19/631132.png,0,0.9048433303833008,748,114,1366,732,618,618,twilight sparkle,sion
632451.png,https://derpicdn.net/img/view/2014/5/21/632451.png,0,0.9671599864959716,101,13,425,337,324,324,twilight sparkle,suzuii
63437.jpg,https://derpicdn.net/img/view/2012/7/31/63437.jpg,0,0.9987789392471312,265,106,747,588,482,482,twilight sparkle,
634898.jpg,https://derpicdn.net/img/view/2014/5/24/634898.jpg,2,0.9984140396118164,84,215,440,571,356,356,twilight sparkle,bakki
636773.png,https://derpicdn.net/img/view/2014/5/26/636773.png,0,0.9585681557655334,243,0,529,276,286,276,twilight sparkle,onikashi
637738.png,https://derpicdn.net/img/view/2014/5/27/637738.png,0,0.9359316229820251,89,42,793,746,704,704,twilight sparkle,hirurux
637921.png,https://derpicdn.net/img/view/2014/5/27/637921.png,0,0.9249148964881896,1352,58,1870,576,518,518,twilight sparkle,whatsapokemon
64066.png,https://derpicdn.net/img/view/2012/8/1/64066.png,0,0.9598038792610168,0,0,272,264,272,264,twilight sparkle,mn27
642221.jpg,https://derpicdn.net/img/view/2014/6/1/642221.jpg,0,0.9122613668441772,786,0,2746,1957,1960,1957,twilight sparkle,daikoku
643840.png,https://derpicdn.net/img/view/2014/6/3/643840.png,0,0.989931046962738,152,7,386,241,234,234,twilight sparkle,itena
644226.png,https://derpicdn.net/img/view/2014/6/3/644226.png,0,0.9849818348884584,246,0,482,234,236,234,twilight sparkle,divided-s
645748.png,https://derpicdn.net/img/view/2014/6/5/645748.png,0,0.9729688763618468,85,0,327,231,242,231,twilight sparkle,terukyu
647045.png,https://derpicdn.net/img/view/2014/6/7/647045.png,0,0.996202290058136,393,5,629,241,236,236,twilight sparkle,zombiedoggy
649528.png,https://derpicdn.net/img/view/2014/6/10/649528.png,0,0.9604644775390624,0,2,197,216,197,214,twilight sparkle,ilovesonik
651983.png,https://derpicdn.net/img/view/2014/6/13/651983.png,0,0.9964255094528198,47,102,313,368,266,266,twilight sparkle,placeholder
652533.png,https://derpicdn.net/img/view/2014/6/14/652533.png,0,0.9441848397254944,66,0,386,285,320,285,twilight sparkle,sketch-shepherd
654641.png,https://derpicdn.net/img/view/2014/6/16/654641.png,0,0.959908962249756,0,0,243,190,243,190,twilight sparkle,milkii-ways
66040.jpg,https://derpicdn.net/img/view/2012/8/3/66040.jpg,0,0.9411731362342834,186,0,322,109,136,109,twilight sparkle,ss2sonic
661974.jpg,https://derpicdn.net/img/view/2014/6/26/661974.jpg,0,0.9765967130661012,176,18,488,330,312,312,twilight sparkle,terpa-apret
662509.png,https://derpicdn.net/img/view/2014/6/27/662509.png,0,0.9960415959358216,0,92,526,628,526,536,twilight sparkle,oceanhorse00
666546.png,https://derpicdn.net/img/view/2014/7/3/666546.png,0,0.9879470467567444,273,81,1257,1065,984,984,twilight sparkle,dambitail
666646.png,https://derpicdn.net/img/view/2014/7/3/666646.png,0,0.9358203411102296,444,0,868,391,424,391,twilight sparkle,shacklefunk
66753.png,https://derpicdn.net/img/view/2012/8/4/66753.png,0,0.9765831828117372,3,0,535,498,532,498,twilight sparkle,kittehkatbar
667778.png,https://derpicdn.net/img/view/2014/7/5/667778.png,0,0.9803458452224731,0,1433,2873,4707,2873,3274,twilight sparkle,atomicmillennial
668696.png,https://derpicdn.net/img/view/2014/7/6/668696.png,0,0.9865001440048218,1765,246,2539,1020,774,774,twilight sparkle,alterhouse
668893.png,https://derpicdn.net/img/view/2014/7/6/668893.png,0,0.9911506772041321,283,42,865,624,582,582,twilight sparkle,tokiball12345
66938.png,https://derpicdn.net/img/view/2012/8/4/66938.png,0,0.98783540725708,192,31,434,273,242,242,twilight sparkle,frostadflakes
669476.png,https://derpicdn.net/img/view/2014/7/7/669476.png,0,0.9974368810653688,3035,1126,8155,6246,5120,5120,twilight sparkle,rune-blad3
670681.png,https://derpicdn.net/img/view/2014/7/8/670681.png,0,0.9988694787025452,1434,0,3396,1900,1962,1900,twilight sparkle,maximillianveers|kooner-cz
670908.png,https://derpicdn.net/img/view/2014/7/9/670908.png,0,0.9983007311820984,1624,0,4074,2114,2450,2114,twilight sparkle,theshadowstone
671763.png,https://derpicdn.net/img/view/2014/7/10/671763.png,0,0.9819117188453674,43,0,707,586,664,586,twilight sparkle,colorlesscupcake
673901.jpg,https://derpicdn.net/img/view/2014/7/13/673901.jpg,0,0.9867808818817142,194,0,522,328,328,328,twilight sparkle,unousaya
676463.png,https://derpicdn.net/img/view/2014/7/16/676463.png,0,0.9536725878715516,855,1331,1401,1877,546,546,twilight sparkle,aleximusprime
677287.png,https://derpicdn.net/img/view/2014/7/17/677287.png,0,0.9914230704307556,70,0,654,575,584,575,twilight sparkle,ledogawa
678745.png,https://derpicdn.net/img/view/2014/7/20/678745.png,0,0.997844696044922,0,1,2850,2949,2850,2948,twilight sparkle,90sigma
678936.png,https://derpicdn.net/img/view/2014/7/20/678936.png,0,0.973465621471405,260,42,576,358,316,316,twilight sparkle,milktea-art
679943.png,https://derpicdn.net/img/view/2014/7/21/679943.png,0,0.9803853631019592,0,80,3244,3646,3244,3566,twilight sparkle,theshadowstone
681207.png,https://derpicdn.net/img/view/2014/7/22/681207.png,0,0.9731993079185486,142,0,522,366,380,366,twilight sparkle,kaji-tanii
681279.png,https://derpicdn.net/img/view/2014/7/23/681279.png,0,0.9786994457244872,710,0,1128,390,418,390,twilight sparkle,anonponymk7
682189.png,https://derpicdn.net/img/view/2014/7/24/682189.png,0,0.9995391964912416,157,0,941,708,784,708,twilight sparkle,thekattyart
686688.png,https://derpicdn.net/img/view/2014/7/30/686688.png,0,0.9995114207267758,0,0,568,572,568,572,twilight sparkle,tidalwav-3
687747.png,https://derpicdn.net/img/view/2014/7/31/687747.png,0,0.9126651883125304,326,0,1826,1080,1500,1080,twilight sparkle,nekokevin
687760.jpg,https://derpicdn.net/img/view/2014/7/31/687760.jpg,0,0.9996079802513124,283,1,675,393,392,392,twilight sparkle,panda no tatemono
688474.jpg,https://derpicdn.net/img/view/2014/8/1/688474.jpg,0,0.9369145035743712,643,981,1437,1775,794,794,twilight sparkle,sfear222
689833.png,https://derpicdn.net/img/view/2014/8/3/689833.png,0,0.9944515824317932,268,0,814,489,546,489,twilight sparkle,shenhibiki|zinnthos
693961.png,https://derpicdn.net/img/view/2014/8/7/693961.png,0,0.9900379180908204,100,0,370,261,270,261,twilight sparkle,boycoffee
694834.png,https://derpicdn.net/img/view/2014/8/8/694834.png,0,0.952396810054779,145,0,563,391,418,391,twilight sparkle,looji
702353.jpg,https://derpicdn.net/img/view/2014/8/18/702353.jpg,0,0.993250012397766,225,0,1489,1222,1264,1222,twilight sparkle,zaininn
703172.png,https://derpicdn.net/img/view/2014/8/19/703172.png,0,0.9489519596099854,117,0,1181,1044,1064,1044,twilight sparkle,irregular-entity
703553.png,https://derpicdn.net/img/view/2014/8/19/703553.png,0,0.9537589550018308,184,0,682,453,498,453,twilight sparkle,nitronic
712024.png,https://derpicdn.net/img/view/2014/8/31/712024.png,0,0.9754326343536376,0,15,1250,1317,1250,1302,twilight sparkle,mrs1989
712880.png,https://derpicdn.net/img/view/2014/9/1/712880.png,0,0.9935770630836488,7,0,837,769,830,769,twilight sparkle,fantasyglow
713632.png,https://derpicdn.net/img/view/2014/9/2/713632.png,0,0.9924065470695496,501,7,957,463,456,456,twilight sparkle,rwko
714001.png,https://derpicdn.net/img/view/2014/9/3/714001.png,0,0.9165346026420592,359,0,2000,1728,1641,1728,twilight sparkle,aleximusprime
716186.png,https://derpicdn.net/img/view/2014/9/6/716186.png,0,0.9412434101104736,188,0,650,448,462,448,twilight sparkle,kaji-tanii
716982.png,https://derpicdn.net/img/view/2014/9/7/716982.png,0,0.9665817022323608,103,1315,1395,2607,1292,1292,twilight sparkle,zacatron94
719154.png,https://derpicdn.net/img/view/2014/9/10/719154.png,0,0.9722599387168884,405,0,861,446,456,446,twilight sparkle,magicbeach
719475.png,https://derpicdn.net/img/view/2014/9/10/719475.png,0,0.9997097849845886,264,0,712,381,448,381,twilight sparkle,luckyorigamistars
720663.png,https://derpicdn.net/img/view/2014/9/12/720663.png,0,0.9907136559486388,463,156,933,626,470,470,twilight sparkle,marik azemus34
723088.png,https://derpicdn.net/img/view/2014/9/16/723088.png,0,0.992222249507904,40,0,3400,3351,3360,3351,twilight sparkle,bobsicle0
726528.png,https://derpicdn.net/img/view/2014/9/21/726528.png,0,0.9970169067382812,32,6,896,870,864,864,twilight sparkle,zacatron94
728045.png,https://derpicdn.net/img/view/2014/9/23/728045.png,0,0.9975170493125916,190,11,578,399,388,388,twilight sparkle,rflzqt
730252.png,https://derpicdn.net/img/view/2014/9/27/730252.png,0,0.9938428997993468,0,0,381,393,381,393,twilight sparkle,coggler
730481.png,https://derpicdn.net/img/view/2014/9/27/730481.png,0,0.9792217016220092,1293,126,1993,826,700,700,twilight sparkle,nessacity
736793.png,https://derpicdn.net/img/view/2014/10/6/736793.png,0,0.9625440835952759,201,64,689,552,488,488,twilight sparkle,clouddg
737287.png,https://derpicdn.net/img/view/2014/10/6/737287.png,0,0.9913547039031982,46,57,2116,2127,2070,2070,twilight sparkle,akorrn
737623.png,https://derpicdn.net/img/view/2014/10/7/737623.png,0,0.9875662326812744,0,0,720,707,720,707,twilight sparkle,jwj991120
739351.png,https://derpicdn.net/img/view/2014/10/9/739351.png,0,0.9993050098419192,203,1,845,643,642,642,twilight sparkle,staggeredline
740211.png,https://derpicdn.net/img/view/2014/10/10/740211.png,0,0.9869863390922546,175,65,585,475,410,410,twilight sparkle,superjewishgoat
740770.png,https://derpicdn.net/img/view/2014/10/11/740770.png,0,0.9572943449020386,321,29,1215,923,894,894,twilight sparkle,jorobro
743257.png,https://derpicdn.net/img/view/2014/10/15/743257.png,0,0.9934053421020508,363,0,933,518,570,518,twilight sparkle,dreamilicious
747689.png,https://derpicdn.net/img/view/2014/10/21/747689.png,0,0.9981223940849304,170,0,494,302,324,302,twilight sparkle,he4rtofcourage
750031.png,https://derpicdn.net/img/view/2014/10/25/750031.png,0,0.9478830695152284,163,147,393,377,230,230,twilight sparkle,kiguren
750728.png,https://derpicdn.net/img/view/2014/10/26/750728.png,0,0.9932532906532288,145,4,579,438,434,434,twilight sparkle,miroslav46
752725.png,https://derpicdn.net/img/view/2014/10/28/752725.png,0,0.9200062155723572,0,0,6438,7954,6438,7954,twilight sparkle,byteslice
752988.png,https://derpicdn.net/img/view/2014/10/29/752988.png,0,0.9435593485832214,343,16,851,524,508,508,twilight sparkle,azul-j
75358.png,https://derpicdn.net/img/view/2012/8/15/75358.png,0,0.99021315574646,530,0,3788,3195,3258,3195,twilight sparkle,mehoep
754249.png,https://derpicdn.net/img/view/2014/10/30/754249.png,0,0.9817491173744202,373,66,749,442,376,376,twilight sparkle,mercurycraft7
755757.png,https://derpicdn.net/img/view/2014/11/2/755757.png,0,0.9917087554931641,11,0,309,286,298,286,twilight sparkle,equestria-pony
756211.png,https://derpicdn.net/img/view/2014/11/2/756211.png,0,0.9986754655838012,3944,429,8273,4901,4329,4472,twilight sparkle,decprincess
759160.png,https://derpicdn.net/img/view/2014/11/6/759160.png,0,0.9981616139411926,176,0,772,580,596,580,twilight sparkle,wolfy-pony
76245.png,https://derpicdn.net/img/view/2012/8/17/76245.png,0,0.9842609167099,0,954,4518,5347,4518,4393,twilight sparkle,uxyd
764626.png,https://derpicdn.net/img/view/2014/11/14/764626.png,0,0.9967305660247804,236,0,650,405,414,405,twilight sparkle,dotkwa
767595.png,https://derpicdn.net/img/view/2014/11/19/767595.png,0,0.9980907440185548,1376,0,2698,1193,1322,1193,twilight sparkle,empyu
768637.png,https://derpicdn.net/img/view/2014/11/21/768637.png,0,0.9933751225471495,2922,251,7296,4625,4374,4374,twilight sparkle,decprincess
768830.png,https://derpicdn.net/img/view/2014/11/21/768830.png,0,0.9851216673851012,134,41,950,857,816,816,twilight sparkle,novaspark
773597.png,https://derpicdn.net/img/view/2014/11/28/773597.png,0,0.9996813535690308,558,42,948,432,390,390,twilight sparkle,dclzexon
774340.png,https://derpicdn.net/img/view/2014/11/29/774340.png,0,0.9560170769691468,11,0,855,813,844,813,twilight sparkle,
777765.png,https://derpicdn.net/img/view/2014/12/4/777765.png,0,0.9857898354530334,573,55,1691,1173,1118,1118,twilight sparkle,legoguy9875
779491.png,https://derpicdn.net/img/view/2014/12/6/779491.png,0,0.9983797073364258,189,53,639,503,450,450,twilight sparkle,gela-g-i-s-gela
781889.jpg,https://derpicdn.net/img/view/2014/12/10/781889.jpg,0,0.9766774177551272,837,240,1291,694,454,454,twilight sparkle,nidrog|endnidhoggson
786486.png,https://derpicdn.net/img/view/2014/12/17/786486.png,0,0.953264594078064,429,67,935,573,506,506,twilight sparkle,downpourpony
786688.png,https://derpicdn.net/img/view/2014/12/17/786688.png,0,0.9997933506965636,0,143,795,975,795,832,twilight sparkle,benjik
786688.png,https://derpicdn.net/img/view/2014/12/17/786688.png,1,0.9975112676620485,1157,353,1941,1137,784,784,twilight sparkle,benjik
787786.png,https://derpicdn.net/img/view/2014/12/19/787786.png,0,0.9953579306602478,202,74,724,596,522,522,twilight sparkle,mintybit
788181.png,https://derpicdn.net/img/view/2014/12/19/788181.png,0,0.9944402575492859,239,2,2097,1860,1858,1858,twilight sparkle,dombrus
79176.png,https://derpicdn.net/img/view/2012/8/21/79176.png,0,0.9919148087501526,229,0,829,516,600,516,twilight sparkle,
799024.jpg,https://derpicdn.net/img/view/2015/1/4/799024.jpg,0,0.9603301882743835,232,0,1278,934,1046,934,twilight sparkle,mrbrunoh1
799741.png,https://derpicdn.net/img/view/2015/1/5/799741.png,0,0.995915949344635,225,0,2557,2317,2332,2317,twilight sparkle,dashiesparkle
800278.png,https://derpicdn.net/img/view/2015/1/5/800278.png,0,0.997146725654602,2570,0,4966,2157,2396,2157,twilight sparkle,illumnious
803290.png,https://derpicdn.net/img/view/2015/1/10/803290.png,0,0.9891216158866882,258,50,794,586,536,536,twilight sparkle,empyu
804296.png,https://derpicdn.net/img/view/2015/1/11/804296.png,0,0.9920769929885864,123,0,751,614,628,614,twilight sparkle,empty-10
806483.png,https://derpicdn.net/img/view/2015/1/14/806483.png,0,0.9145301580429076,1955,87,3837,1969,1882,1882,twilight sparkle,sprakle|caliazian
806567.png,https://derpicdn.net/img/view/2015/1/14/806567.png,0,0.908119022846222,269,81,641,453,372,372,twilight sparkle,rflzqt
807437.png,https://derpicdn.net/img/view/2015/1/16/807437.png,0,0.9976346492767334,215,13,495,293,280,280,twilight sparkle,duop-qoub
808906.png,https://derpicdn.net/img/view/2015/1/18/808906.png,0,0.9989110827445984,222,0,770,505,548,505,twilight sparkle,wolfy-pony
809303.png,https://derpicdn.net/img/view/2015/1/18/809303.png,0,0.9887865781784058,311,160,741,590,430,430,twilight sparkle,svelen
810556.png,https://derpicdn.net/img/view/2015/1/20/810556.png,0,0.9871375560760498,1505,0,3107,1767,1602,1767,twilight sparkle,porygon2z
811437.png,https://derpicdn.net/img/view/2015/1/21/811437.png,0,0.9502800703048706,2901,0,5387,2143,2486,2143,twilight sparkle,strachattack
812206.png,https://derpicdn.net/img/view/2015/1/22/812206.png,0,0.9644784927368164,126,0,880,743,754,743,twilight sparkle,drawntildawn
816257.png,https://derpicdn.net/img/view/2015/1/28/816257.png,0,0.9905529022216796,50,3,424,377,374,374,twilight sparkle,vavacung
819260.jpg,https://derpicdn.net/img/view/2015/2/1/819260.jpg,0,0.9915891289711,396,288,802,694,406,406,twilight sparkle,flak--k
821003.png,https://derpicdn.net/img/view/2015/2/4/821003.png,0,0.9758184552192688,34,103,532,599,498,496,twilight sparkle,tailzkipzigona
822778.png,https://derpicdn.net/img/view/2015/2/6/822778.png,0,0.9955045580863952,126,41,536,451,410,410,twilight sparkle,moenkin
825001.png,https://derpicdn.net/img/view/2015/2/9/825001.png,0,0.9859402775764464,102,0,400,285,298,285,twilight sparkle,cro-cro
825484.png,https://derpicdn.net/img/view/2015/2/10/825484.png,0,0.986536979675293,451,60,841,450,390,390,twilight sparkle,empyu
825659.png,https://derpicdn.net/img/view/2015/2/10/825659.png,0,0.9853075742721558,188,52,818,682,630,630,twilight sparkle,baldmoose
826665.png,https://derpicdn.net/img/view/2015/2/12/826665.png,0,0.9824883341789246,606,5,1746,1145,1140,1140,twilight sparkle,alexander56910
826848.png,https://derpicdn.net/img/view/2015/2/12/826848.png,0,0.959625780582428,275,0,800,530,525,530,twilight sparkle,dattebayo681
828244.png,https://derpicdn.net/img/view/2015/2/14/828244.png,0,0.9948219060897828,230,0,440,194,210,194,twilight sparkle,shellsweet
832495.jpg,https://derpicdn.net/img/view/2015/2/19/832495.jpg,0,0.9680884480476379,59,0,423,364,364,364,twilight sparkle,notatoron
832508.png,https://derpicdn.net/img/view/2015/2/19/832508.png,0,0.9893176555633544,151,0,2871,2623,2720,2623,twilight sparkle,slb94
832791.jpg,https://derpicdn.net/img/view/2015/2/20/832791.jpg,0,0.9874584078788756,552,0,872,278,320,278,twilight sparkle,obcor
839215.png,https://derpicdn.net/img/view/2015/2/28/839215.png,0,0.9932931065559388,201,19,525,343,324,324,twilight sparkle,yajima
842959.png,https://derpicdn.net/img/view/2015/3/5/842959.png,0,0.9898847341537476,340,432,2738,2830,2398,2398,twilight sparkle,scobionicle99
843776.png,https://derpicdn.net/img/view/2015/3/6/843776.png,0,0.9728161692619324,6,112,448,554,442,442,twilight sparkle,area
845445.jpg,https://derpicdn.net/img/view/2015/3/8/845445.jpg,0,0.9940307736396792,144,0,554,373,410,373,twilight sparkle,princrim
845851.png,https://derpicdn.net/img/view/2015/3/9/845851.png,0,0.9856075048446656,169,245,563,639,394,394,twilight sparkle,lana-jay
851644.png,https://derpicdn.net/img/view/2015/3/17/851644.png,0,0.9800310730934144,430,537,1082,1189,652,652,twilight sparkle,freepaints
853155.jpg,https://derpicdn.net/img/view/2015/3/19/853155.jpg,0,0.969318687915802,39,0,489,419,450,419,twilight sparkle,chocone
853803.jpg,https://derpicdn.net/img/view/2015/3/20/853803.jpg,0,0.9948408007621764,1869,148,3000,1306,1131,1158,twilight sparkle,mrbrunoh1
853803.jpg,https://derpicdn.net/img/view/2015/3/20/853803.jpg,1,0.9027427434921264,0,0,2655,2161,2655,2161,twilight sparkle,mrbrunoh1
854225.png,https://derpicdn.net/img/view/2015/3/21/854225.png,0,0.9924226403236388,154,1,924,771,770,770,twilight sparkle,acharmingpony
855654.png,https://derpicdn.net/img/view/2015/3/23/855654.png,0,0.9940176010131836,313,18,771,476,458,458,twilight sparkle,suenden-hund
857299.png,https://derpicdn.net/img/view/2015/3/26/857299.png,0,0.9980379939079284,126,0,2766,2593,2640,2593,twilight sparkle,slb94
860000.jpg,https://derpicdn.net/img/view/2015/3/29/860000.jpg,0,0.9994884729385376,591,46,1851,1306,1260,1260,twilight sparkle,drawponies
860609.jpg,https://derpicdn.net/img/view/2015/3/30/860609.jpg,0,0.9435452222824096,199,0,720,564,521,564,twilight sparkle,
863305.png,https://derpicdn.net/img/view/2015/4/2/863305.png,0,0.9354128241539,845,0,1833,975,988,975,twilight sparkle,meotashie
868466.png,https://derpicdn.net/img/view/2015/4/8/868466.png,0,0.9990346431732178,125,0,2801,2591,2676,2591,twilight sparkle,amberony
869145.jpg,https://derpicdn.net/img/view/2015/4/8/869145.jpg,0,0.9029530882835388,184,229,634,679,450,450,twilight sparkle,akurion
869636.png,https://derpicdn.net/img/view/2015/4/9/869636.png,0,0.9699095487594604,0,193,972,1200,972,1007,twilight sparkle,3d thread|creatorofpony
871353.png,https://derpicdn.net/img/view/2015/4/11/871353.png,0,0.9365130066871644,140,24,666,550,526,526,twilight sparkle,fj-c
872671.png,https://derpicdn.net/img/view/2015/4/12/872671.png,0,0.9569586515426636,350,35,884,569,534,534,twilight sparkle,elzielai
873093.png,https://derpicdn.net/img/view/2015/4/13/873093.png,0,0.9807524681091307,391,0,1401,905,1010,905,twilight sparkle,novaspark
874139.png,https://derpicdn.net/img/view/2015/4/14/874139.png,0,0.9131107330322266,34,92,1436,1494,1402,1402,twilight sparkle,thecheeseburger
875842.jpg,https://derpicdn.net/img/view/2015/4/17/875842.jpg,0,0.9877300262451172,560,163,1996,1599,1436,1436,twilight sparkle,馬文
878547.png,https://derpicdn.net/img/view/2015/4/20/878547.png,0,0.9776561260223388,490,342,784,636,294,294,twilight sparkle,empyu
881661.png,https://derpicdn.net/img/view/2015/4/24/881661.png,0,0.9994640350341796,278,0,648,365,370,365,twilight sparkle,malifikyse
882326.png,https://derpicdn.net/img/view/2015/4/25/882326.png,0,0.994384765625,52,0,1364,768,1312,768,twilight sparkle,
883947.png,https://derpicdn.net/img/view/2015/4/27/883947.png,0,0.9879938960075378,29,0,679,621,650,621,twilight sparkle,inviizzible
884100.png,https://derpicdn.net/img/view/2015/4/27/884100.png,0,0.9835726618766784,2,0,596,568,594,568,twilight sparkle,kazziepones
884503.png,https://derpicdn.net/img/view/2015/4/28/884503.png,0,0.9073225855827332,1961,86,3551,1742,1590,1656,twilight sparkle,porygon2z
884556.png,https://derpicdn.net/img/view/2015/4/28/884556.png,0,0.9994947910308838,140,69,936,865,796,796,twilight sparkle,a4r91n
884688.png,https://derpicdn.net/img/view/2015/4/28/884688.png,0,0.9971888661384584,215,1005,1149,1939,934,934,twilight sparkle,zigidi94
892001.png,https://derpicdn.net/img/view/2015/5/9/892001.png,0,0.999112606048584,0,0,416,397,416,397,twilight sparkle,polarbearycute
893798.png,https://derpicdn.net/img/view/2015/5/11/893798.png,0,0.9595152735710144,142,18,530,406,388,388,twilight sparkle,koviry
898707.png,https://derpicdn.net/img/view/2015/5/17/898707.png,0,0.9804486632347108,0,0,510,497,510,497,twilight sparkle,strangiesleepy
899922.png,https://derpicdn.net/img/view/2015/5/19/899922.png,1,0.999001681804657,745,4,955,214,210,210,twilight sparkle,dvixie
899922.png,https://derpicdn.net/img/view/2015/5/19/899922.png,3,0.98303484916687,434,155,602,323,168,168,twilight sparkle,dvixie
902273.jpg,https://derpicdn.net/img/view/2015/5/23/902273.jpg,0,0.915717840194702,69,59,847,837,778,778,twilight sparkle,cyanyeh
903013.png,https://derpicdn.net/img/view/2015/5/24/903013.png,0,0.968560516834259,1146,1335,1768,1957,622,622,twilight sparkle,segraece
906032.png,https://derpicdn.net/img/view/2015/5/29/906032.png,0,0.984055757522583,0,126,2532,2766,2532,2640,twilight sparkle,slb94
910418.png,https://derpicdn.net/img/view/2015/6/5/910418.png,0,0.9819037318229676,1416,514,1874,972,458,458,twilight sparkle,tsuukiusa
91237.jpg,https://derpicdn.net/img/view/2012/9/6/91237.jpg,0,0.9944086670875548,514,139,742,367,228,228,twilight sparkle,brianblackberry
916507.png,https://derpicdn.net/img/view/2015/6/14/916507.png,0,0.9452086687088012,0,0,331,337,331,337,twilight sparkle,gingerfoxy
922334.png,https://derpicdn.net/img/view/2015/6/23/922334.png,0,0.9726712703704834,896,1589,1434,2127,538,538,twilight sparkle,
922755.png,https://derpicdn.net/img/view/2015/6/24/922755.png,0,0.9837750792503356,65,56,517,508,452,452,twilight sparkle,partylikeanartist
925043.png,https://derpicdn.net/img/view/2015/6/27/925043.png,0,0.9626945257186892,0,0,482,457,482,457,twilight sparkle,
925459.png,https://derpicdn.net/img/view/2015/6/28/925459.png,0,0.9724308252334596,0,561,400,991,400,430,twilight sparkle,xanthor
926436.png,https://derpicdn.net/img/view/2015/6/29/926436.png,0,0.9991000294685364,403,95,693,385,290,290,twilight sparkle,deusexequus
926859.png,https://derpicdn.net/img/view/2015/6/30/926859.png,0,0.9941415190696716,173,0,1173,955,1000,955,twilight sparkle,scarlet-spectrum
927447.png,https://derpicdn.net/img/view/2015/7/1/927447.png,0,0.9839795827865601,651,117,3361,2827,2710,2710,twilight sparkle,90sigma
927479.png,https://derpicdn.net/img/view/2015/7/1/927479.png,0,0.9231472611427308,955,180,3341,2566,2386,2386,twilight sparkle,rivalcat
929994.png,https://derpicdn.net/img/view/2015/7/4/929994.png,0,0.9990959167480468,729,282,973,526,244,244,twilight sparkle,itstaylor-made
929994.png,https://derpicdn.net/img/view/2015/7/4/929994.png,1,0.9866315722465516,345,265,691,611,346,346,twilight sparkle,itstaylor-made
929994.png,https://derpicdn.net/img/view/2015/7/4/929994.png,2,0.9853700995445251,150,0,536,313,386,313,twilight sparkle,itstaylor-made
932506.png,https://derpicdn.net/img/view/2015/7/8/932506.png,0,0.9688601493835448,760,0,1554,790,794,790,twilight sparkle,kaylathehedgehog
933702.png,https://derpicdn.net/img/view/2015/7/9/933702.png,0,0.9981865882873536,49,11,1395,1357,1346,1346,twilight sparkle,mandydax|pananovich
933702.png,https://derpicdn.net/img/view/2015/7/9/933702.png,1,0.995254397392273,0,1650,1511,3242,1511,1592,twilight sparkle,mandydax|pananovich
935790.png,https://derpicdn.net/img/view/2015/7/12/935790.png,0,0.9731820225715636,178,0,1804,1080,1626,1080,twilight sparkle,
936548.png,https://derpicdn.net/img/view/2015/7/13/936548.png,0,0.9521239399909972,20,0,240,203,220,203,twilight sparkle,pegasisters82
938793.png,https://derpicdn.net/img/view/2015/7/17/938793.png,0,0.988225519657135,725,127,1859,1261,1134,1134,twilight sparkle,mark-terron
947550.png,https://derpicdn.net/img/view/2015/7/30/947550.png,0,0.9916610121726992,994,98,1988,1092,994,994,twilight sparkle,nayolfa
948185.jpg,https://derpicdn.net/img/view/2015/8/1/948185.jpg,0,0.9923120141029358,309,18,645,354,336,336,twilight sparkle,ikuvaito
952495.png,https://derpicdn.net/img/view/2015/8/6/952495.png,0,0.9789758920669556,45,0,831,786,786,786,twilight sparkle,dilandau203
953593.jpg,https://derpicdn.net/img/view/2015/8/8/953593.jpg,0,0.9957051873207092,787,0,1345,453,558,453,twilight sparkle,ukingu
953593.jpg,https://derpicdn.net/img/view/2015/8/8/953593.jpg,1,0.907154381275177,0,0,572,563,572,563,twilight sparkle,ukingu
956180.png,https://derpicdn.net/img/view/2015/8/12/956180.png,0,0.996780514717102,7,0,319,297,312,297,twilight sparkle,ezidze|shizow
956180.png,https://derpicdn.net/img/view/2015/8/12/956180.png,1,0.9914408922195436,613,87,889,363,276,276,twilight sparkle,ezidze|shizow
959463.png,https://derpicdn.net/img/view/2015/8/17/959463.png,0,0.9810056686401368,189,0,729,536,540,536,twilight sparkle,shyamette
961167.png,https://derpicdn.net/img/view/2015/8/19/961167.png,0,0.9633246064186096,359,0,845,470,486,470,twilight sparkle,thegreatrouge
961758.png,https://derpicdn.net/img/view/2015/8/20/961758.png,0,0.9686697125434875,56,146,876,966,820,820,twilight sparkle,phoeberia
965450.png,https://derpicdn.net/img/view/2015/8/25/965450.png,0,0.9993065595626832,1516,0,3432,1833,1916,1833,twilight sparkle,illumnious
967381.png,https://derpicdn.net/img/view/2015/8/28/967381.png,0,0.9293302893638612,49,0,801,688,752,688,twilight sparkle,awallpaperbrony
969877.png,https://derpicdn.net/img/view/2015/8/31/969877.png,0,0.9917526245117188,180,0,2406,2152,2226,2152,twilight sparkle,rainbowrage12
971376.png,https://derpicdn.net/img/view/2015/9/2/971376.png,0,0.9350562691688538,0,0,364,345,364,345,twilight sparkle,avizo-23
975972.png,https://derpicdn.net/img/view/2015/9/9/975972.png,0,0.9780770540237428,12,23,2302,2313,2290,2290,twilight sparkle,reginault
977337.png,https://derpicdn.net/img/view/2015/9/11/977337.png,0,0.9842249155044556,405,122,1029,746,624,624,twilight sparkle,
977880.jpg,https://derpicdn.net/img/view/2015/9/12/977880.jpg,0,0.9884562492370604,430,39,2252,1861,1822,1822,twilight sparkle,pembroke
979053.png,https://derpicdn.net/img/view/2015/9/13/979053.png,0,0.9903526902198792,75,0,1101,967,1026,967,twilight sparkle,scarletcurl
980454.png,https://derpicdn.net/img/view/2015/9/15/980454.png,0,0.9834774732589722,256,0,964,553,708,553,twilight sparkle,unnamed-doctor
982221.png,https://derpicdn.net/img/view/2015/9/18/982221.png,0,0.9987034797668456,573,58,835,320,262,262,twilight sparkle,jd86
98288.png,https://derpicdn.net/img/view/2012/9/15/98288.png,0,0.999648094177246,292,0,732,427,440,427,twilight sparkle,redintravenous
984451.png,https://derpicdn.net/img/view/2015/9/21/984451.png,0,0.9415978789329528,30,157,2496,2623,2466,2466,twilight sparkle,emera33
986410.png,https://derpicdn.net/img/view/2015/9/23/986410.png,0,0.9975809454917908,34,5,486,457,452,452,twilight sparkle,paleblank
989925.png,https://derpicdn.net/img/view/2015/9/28/989925.png,0,0.9918023347854614,525,38,1067,580,542,542,twilight sparkle,gray--day
990785.png,https://derpicdn.net/img/view/2015/9/29/990785.png,0,0.9734445810317992,237,94,655,512,418,418,twilight sparkle,patty-plmh
990874.png,https://derpicdn.net/img/view/2015/9/29/990874.png,0,0.997597873210907,365,21,639,295,274,274,twilight sparkle,sightlesskitten
990908.jpg,https://derpicdn.net/img/view/2015/9/29/990908.jpg,0,0.950554132461548,232,877,666,1311,434,434,twilight sparkle,plainoasis
992995.png,https://derpicdn.net/img/view/2015/10/2/992995.png,0,0.9779036641120912,0,0,606,531,606,531,twilight sparkle,empyu
1002340.png,https://derpicdn.net/img/view/2015/10/15/1002340.png,0,0.9893275499343872,174,0,952,746,778,746,twilight sparkle,baldmoose
100339.png,https://derpicdn.net/img/view/2012/9/17/100339.png,0,0.9536103010177612,172,5,890,723,718,718,twilight sparkle,eruvon
1005427.jpg,https://derpicdn.net/img/view/2015/10/18/1005427.jpg,0,0.9824276566505432,720,146,2198,1624,1478,1478,twilight sparkle,lrusu
1006426.png,https://derpicdn.net/img/view/2015/10/20/1006426.png,0,0.9853289127349854,180,0,426,214,246,214,twilight sparkle,twilightmeep
1006792.png,https://derpicdn.net/img/view/2015/10/21/1006792.png,0,0.9962437748908995,0,0,782,642,782,642,twilight sparkle,conskyiaryo
1007229.png,https://derpicdn.net/img/view/2015/10/22/1007229.png,0,0.9270865321159364,266,92,964,790,698,698,twilight sparkle,bobdude0
1008028.png,https://derpicdn.net/img/view/2015/10/23/1008028.png,0,0.9826365113258362,283,344,505,566,222,222,twilight sparkle,
1009702.png,https://derpicdn.net/img/view/2015/10/25/1009702.png,0,0.9983336329460144,258,6,648,396,390,390,twilight sparkle,leralopatina767
1010952.png,https://derpicdn.net/img/view/2015/10/28/1010952.png,0,0.9972797632217408,510,17,806,313,296,296,twilight sparkle,princegalaxies
1013029.png,https://derpicdn.net/img/view/2015/10/31/1013029.png,0,0.9828329086303712,4,0,2960,2767,2956,2767,twilight sparkle,sairoch
1014009.png,https://derpicdn.net/img/view/2015/11/1/1014009.png,0,0.9537094831466676,493,192,1001,700,508,508,twilight sparkle,boneswolbach|dashiemlpfim|caliazian
1018002.jpg,https://derpicdn.net/img/view/2015/11/7/1018002.jpg,0,0.9831980466842652,905,190,1675,960,770,770,twilight sparkle,hayley1432
101962.png,https://derpicdn.net/img/view/2012/9/19/101962.png,0,0.9926918148994446,35,13,313,291,278,278,twilight sparkle,kevinbolk
1019860.png,https://derpicdn.net/img/view/2015/11/9/1019860.png,0,0.9961655139923096,427,42,892,532,465,490,twilight sparkle,
102490.png,https://derpicdn.net/img/view/2012/9/20/102490.png,0,0.9944830536842346,43,20,2603,2580,2560,2560,twilight sparkle,mrcbleck
1031130.png,https://derpicdn.net/img/view/2015/11/27/1031130.png,0,0.9665743112564088,325,304,669,648,344,344,twilight sparkle,lelka-philka
1031492.png,https://derpicdn.net/img/view/2015/11/28/1031492.png,0,0.9925771951675416,219,0,505,274,286,274,twilight sparkle,
103594.jpg,https://derpicdn.net/img/view/2012/9/21/103594.jpg,0,0.9972940683364868,0,441,218,697,218,256,twilight sparkle,lavender-ice
1039946.jpg,https://derpicdn.net/img/view/2015/12/8/1039946.jpg,1,0.9988343119621276,787,0,1285,455,498,455,twilight sparkle,sinaherib
1043209.png,https://derpicdn.net/img/view/2015/12/13/1043209.png,0,0.9819504618644714,0,0,885,927,885,927,twilight sparkle,kylami
1045648.jpg,https://derpicdn.net/img/view/2015/12/16/1045648.jpg,0,0.9740436673164368,542,0,3150,2160,2608,2160,twilight sparkle,dashiesparkle|spntax
1046621.png,https://derpicdn.net/img/view/2015/12/18/1046621.png,0,0.9829822778701782,207,0,551,315,344,315,twilight sparkle,adiwan
1047937.png,https://derpicdn.net/img/view/2015/12/19/1047937.png,0,0.9109466075897216,0,0,1171,1140,1171,1140,twilight sparkle,asika-aida
1048050.png,https://derpicdn.net/img/view/2015/12/19/1048050.png,0,0.9821112155914308,43,59,900,965,857,906,twilight sparkle,paulyt7
1049137.png,https://derpicdn.net/img/view/2015/12/20/1049137.png,0,0.9582318663597108,3856,0,6945,2800,3089,2800,twilight sparkle,mactavish1996|kruszyna25
1049253.png,https://derpicdn.net/img/view/2015/12/20/1049253.png,0,0.9976395964622498,312,0,1102,755,790,755,twilight sparkle,jdash
1050427.png,https://derpicdn.net/img/view/2015/12/22/1050427.png,0,0.9536683559417723,184,45,624,485,440,440,twilight sparkle,cosmocatcrafts
1055984.png,https://derpicdn.net/img/view/2015/12/30/1055984.png,0,0.986690878868103,0,0,799,836,799,836,twilight sparkle,lolitalonis
105617.png,https://derpicdn.net/img/view/2012/9/24/105617.png,0,0.9739159345626832,0,15,481,507,481,492,twilight sparkle,foxxy-arts
1058059.png,https://derpicdn.net/img/view/2016/1/2/1058059.png,0,0.9718085527420044,498,179,1104,785,606,606,twilight sparkle,mp-printer
1061655.png,https://derpicdn.net/img/view/2016/1/7/1061655.png,0,0.9699084758758544,850,266,1434,850,584,584,twilight sparkle,
1063274.png,https://derpicdn.net/img/view/2016/1/10/1063274.png,0,0.9854039549827576,1066,51,1966,951,900,900,twilight sparkle,marsminer
1064981.jpg,https://derpicdn.net/img/view/2016/1/12/1064981.jpg,0,0.9844336509704592,48,170,528,650,480,480,twilight sparkle,moviedragon009v2
1065055.png,https://derpicdn.net/img/view/2016/1/12/1065055.png,0,0.9815491437911988,3755,262,5097,1604,1342,1342,twilight sparkle,starnight5
1067191.png,https://derpicdn.net/img/view/2016/1/15/1067191.png,0,0.9867180585861206,640,295,912,567,272,272,twilight sparkle,amura-of-jupiter
1069771.png,https://derpicdn.net/img/view/2016/1/19/1069771.png,0,0.993388831615448,67,185,431,549,364,364,twilight sparkle,riouku
1069771.png,https://derpicdn.net/img/view/2016/1/19/1069771.png,1,0.9923104643821716,410,246,710,546,300,300,twilight sparkle,riouku
1069868.png,https://derpicdn.net/img/view/2016/1/19/1069868.png,0,0.9403128027915956,345,0,895,542,550,542,twilight sparkle,lovepuma69
1070915.png,https://derpicdn.net/img/view/2016/1/21/1070915.png,0,0.999372124671936,568,188,1438,1058,870,870,twilight sparkle,spirit-dude
1077241.png,https://derpicdn.net/img/view/2016/1/31/1077241.png,0,0.96290922164917,425,0,995,533,570,533,twilight sparkle,thealjavis
1078627.png,https://derpicdn.net/img/view/2016/2/2/1078627.png,0,0.9739458560943604,9,24,423,393,414,369,twilight sparkle,
1079251.png,https://derpicdn.net/img/view/2016/2/3/1079251.png,0,0.9332471489906312,245,0,735,454,490,454,twilight sparkle,brendahickey
108021.png,https://derpicdn.net/img/view/2012/9/27/108021.png,0,0.9963397979736328,56,0,484,396,428,396,twilight sparkle,dshou
1080917.png,https://derpicdn.net/img/view/2016/2/5/1080917.png,0,0.9974213242530824,0,0,774,781,774,781,twilight sparkle,gps-005
1082219.png,https://derpicdn.net/img/view/2016/2/7/1082219.png,0,0.9764898419380188,264,0,650,372,386,372,twilight sparkle,juicyfruit
1084411.png,https://derpicdn.net/img/view/2016/2/10/1084411.png,0,0.9849628210067748,114,21,384,291,270,270,twilight sparkle,miss-cats
1089982.png,https://derpicdn.net/img/view/2016/2/16/1089982.png,0,0.9718673825263976,185,89,539,443,354,354,twilight sparkle,rock-il
1092014.png,https://derpicdn.net/img/view/2016/2/19/1092014.png,0,0.9982748031616212,757,248,1725,1216,968,968,twilight sparkle,moemneop
1092076.png,https://derpicdn.net/img/view/2016/2/19/1092076.png,0,0.918154001235962,269,0,1707,1366,1438,1366,twilight sparkle,graytyphoon
1096369.png,https://derpicdn.net/img/view/2016/2/25/1096369.png,0,0.9856765270233154,20,11,366,357,346,346,twilight sparkle,penstrokepony
1098358.png,https://derpicdn.net/img/view/2016/2/28/1098358.png,0,0.9920638799667358,2354,0,4800,2486,2446,2486,twilight sparkle,digiradiance|reginault
1102681.png,https://derpicdn.net/img/view/2016/3/5/1102681.png,0,0.9985879063606262,635,203,1255,823,620,620,twilight sparkle,ilovesunsetshimmer99|davidsfire|dashiemlpfim|oblivionfall
1103337.png,https://derpicdn.net/img/view/2016/3/6/1103337.png,0,0.9931715130805968,753,0,1289,509,536,509,twilight sparkle,chromaskunk
1103406.png,https://derpicdn.net/img/view/2016/3/6/1103406.png,0,0.9376372694969176,6231,2403,8679,4869,2448,2466,twilight sparkle,kimberlythehedgie
1104763.png,https://derpicdn.net/img/view/2016/3/8/1104763.png,0,0.9549769163131714,994,364,1698,1068,704,704,twilight sparkle,puffpink
1111345.png,https://derpicdn.net/img/view/2016/3/18/1111345.png,0,0.9983603954315186,1315,45,2285,1015,970,970,twilight sparkle,slyblue7
1112126.png,https://derpicdn.net/img/view/2016/3/19/1112126.png,0,0.9501706957817078,916,150,1780,1014,864,864,twilight sparkle,trinixtri
1113829.png,https://derpicdn.net/img/view/2016/3/21/1113829.png,0,0.9909599423408508,1280,0,2974,1953,1694,1953,twilight sparkle,porygon2z
1115704.jpg,https://derpicdn.net/img/view/2016/3/24/1115704.jpg,0,0.9964222311973572,786,183,1204,601,418,418,twilight sparkle,lya
1116375.png,https://derpicdn.net/img/view/2016/3/25/1116375.png,0,0.9956191778182985,477,324,1107,954,630,630,twilight sparkle,dedrainer
1118249.png,https://derpicdn.net/img/view/2016/3/27/1118249.png,0,0.9051166772842408,567,0,3000,2986,2433,2986,twilight sparkle,bunxl
1119150.png,https://derpicdn.net/img/view/2016/3/28/1119150.png,0,0.9789657592773438,3552,259,6526,3233,2974,2974,twilight sparkle,tardifice
1121207.png,https://derpicdn.net/img/view/2016/3/31/1121207.png,0,0.943200945854187,453,0,1465,821,1012,821,twilight sparkle,
1124386.png,https://derpicdn.net/img/view/2016/4/4/1124386.png,0,0.9825901389122008,14,0,414,322,400,322,twilight sparkle,nataliaokita1
1124386.png,https://derpicdn.net/img/view/2016/4/4/1124386.png,1,0.9633439183235168,442,148,730,436,288,288,twilight sparkle,nataliaokita1
1125933.png,https://derpicdn.net/img/view/2016/4/6/1125933.png,0,0.9893755912780762,0,5,1787,1941,1787,1936,twilight sparkle,bunxl
1128969.png,https://derpicdn.net/img/view/2016/4/10/1128969.png,0,0.9823386669158936,146,387,390,631,244,244,twilight sparkle,dusthiel
1130294.png,https://derpicdn.net/img/view/2016/4/12/1130294.png,0,0.99855375289917,384,0,902,486,518,486,twilight sparkle,ponballoon
1132528.png,https://derpicdn.net/img/view/2016/4/15/1132528.png,0,0.9870770573616028,2167,0,4411,2170,2244,2170,twilight sparkle,cloudyglow
1134356.jpg,https://derpicdn.net/img/view/2016/4/17/1134356.jpg,0,0.9711710810661316,203,0,1767,1200,1564,1200,twilight sparkle,nebula210
1138214.png,https://derpicdn.net/img/view/2016/4/23/1138214.png,0,0.9983799457550048,486,1,900,433,414,432,twilight sparkle,php27
1138218.png,https://derpicdn.net/img/view/2016/4/23/1138218.png,0,0.9977647066116332,147,9,502,377,355,368,twilight sparkle,
1138220.png,https://derpicdn.net/img/view/2016/4/23/1138220.png,0,0.9629569053649902,99,0,370,283,271,283,twilight sparkle,
1148247.png,https://derpicdn.net/img/view/2016/5/7/1148247.png,0,0.9967173933982848,2062,60,2906,904,844,844,twilight sparkle,techarmsbu
1150146.png,https://derpicdn.net/img/view/2016/5/9/1150146.png,0,0.916156768798828,131,0,969,814,838,814,twilight sparkle,greenfinger
1151417.png,https://derpicdn.net/img/view/2016/5/11/1151417.png,0,0.9741665124893188,0,474,3377,4110,3377,3636,twilight sparkle,dashiesparkle
1151483.png,https://derpicdn.net/img/view/2016/5/11/1151483.png,0,0.99477356672287,2795,212,5255,2672,2460,2460,twilight sparkle,estories
1152770.png,https://derpicdn.net/img/view/2016/5/13/1152770.png,0,0.9789569973945618,142,7,816,681,674,674,twilight sparkle,deannaphantom13
1156201.png,https://derpicdn.net/img/view/2016/5/17/1156201.png,0,0.928835928440094,704,79,1320,695,616,616,twilight sparkle,rapidstrike
1157002.png,https://derpicdn.net/img/view/2016/5/18/1157002.png,0,0.9838154911994934,25,16,491,508,466,492,twilight sparkle,pastelhorses
1159035.png,https://derpicdn.net/img/view/2016/5/21/1159035.png,0,0.9143007397651672,3711,247,7515,4051,3804,3804,twilight sparkle,decprincess
1159269.png,https://derpicdn.net/img/view/2016/5/21/1159269.png,0,0.9961729645729064,457,9,1119,671,662,662,twilight sparkle,
1163326.jpg,https://derpicdn.net/img/view/2016/5/26/1163326.jpg,0,0.9434316158294678,1050,509,2260,1719,1210,1210,twilight sparkle,viwrastupr
1164950.png,https://derpicdn.net/img/view/2016/5/28/1164950.png,0,0.9855754971504213,4,23,402,421,398,398,twilight sparkle,
1167408.png,https://derpicdn.net/img/view/2016/5/31/1167408.png,0,0.911027729511261,1710,173,2108,571,398,398,twilight sparkle,rockmedved
1167517.png,https://derpicdn.net/img/view/2016/6/1/1167517.png,0,0.9810490608215332,18,81,662,687,644,606,twilight sparkle,
1168482.png,https://derpicdn.net/img/view/2016/6/2/1168482.png,0,0.9994316697120668,64,0,2140,2065,2076,2065,twilight sparkle,estories
1169202.png,https://derpicdn.net/img/view/2016/6/3/1169202.png,0,0.9995608925819396,507,0,1115,584,608,584,twilight sparkle,fancoral
1169810.png,https://derpicdn.net/img/view/2016/6/4/1169810.png,0,0.978046715259552,0,0,596,649,596,649,twilight sparkle,ultimatenightcore
1173548.jpg,https://derpicdn.net/img/view/2016/6/8/1173548.jpg,0,0.9351537823677064,373,53,1119,799,746,746,twilight sparkle,rangaku
1174336.png,https://derpicdn.net/img/view/2016/6/9/1174336.png,0,0.9467465281486512,143,0,993,814,850,814,twilight sparkle,theroyalprincesses
1175852.png,https://derpicdn.net/img/view/2016/6/11/1175852.png,0,0.9844390749931335,37,71,379,413,342,342,twilight sparkle,australian-senior
11778.png,https://derpicdn.net/img/view/2012/6/20/11778.png,0,0.97639662027359,427,29,1095,697,668,668,twilight sparkle,aphexangel
1178895.png,https://derpicdn.net/img/view/2016/6/15/1178895.png,0,0.9948425889015198,1122,717,1918,1513,796,796,twilight sparkle,pucksterv
1181965.jpg,https://derpicdn.net/img/view/2016/6/19/1181965.jpg,0,0.9934044480323792,520,0,1588,1052,1068,1052,twilight sparkle,the-hare
1183831.png,https://derpicdn.net/img/view/2016/6/21/1183831.png,0,0.9989485144615172,188,68,786,666,598,598,twilight sparkle,
1184561.png,https://derpicdn.net/img/view/2016/6/22/1184561.png,0,0.9700257778167723,680,45,1002,367,322,322,twilight sparkle,biakela
1185223.png,https://derpicdn.net/img/view/2016/6/23/1185223.png,0,0.9427568316459656,341,272,1561,1492,1220,1220,twilight sparkle,patapon13
11855.png,https://derpicdn.net/img/view/2012/6/20/11855.png,0,0.96966552734375,204,227,460,483,256,256,twilight sparkle,giuliabeck
1187.png,https://derpicdn.net/img/view/2012/1/22/1187.png,0,0.9889670610427856,0,0,640,703,640,703,twilight sparkle,br0ny
1187638.png,https://derpicdn.net/img/view/2016/6/27/1187638.png,0,0.9626139998435974,417,320,1163,1066,746,746,twilight sparkle,cocoamintwhimsy|britishmindslave
1188619.png,https://derpicdn.net/img/view/2016/6/28/1188619.png,0,0.9962149858474731,257,0,635,373,378,373,twilight sparkle,mcponyponypony
1190675.png,https://derpicdn.net/img/view/2016/7/1/1190675.png,0,0.9859795570373536,100,0,854,719,754,719,twilight sparkle,tellastar
1193108.png,https://derpicdn.net/img/view/2016/7/4/1193108.png,0,0.991871178150177,254,0,720,518,466,518,twilight sparkle,
1193985.png,https://derpicdn.net/img/view/2016/7/5/1193985.png,0,0.9866214990615844,0,0,1322,1303,1322,1303,twilight sparkle,swirlypuffartz
1195807.png,https://derpicdn.net/img/view/2016/7/7/1195807.png,0,0.9809280037879944,664,104,1174,614,510,510,twilight sparkle,theshadowstone|antylavx
1197456.png,https://derpicdn.net/img/view/2016/7/10/1197456.png,0,0.9976041316986084,514,189,730,405,216,216,twilight sparkle,aidapone
1201493.png,https://derpicdn.net/img/view/2016/7/15/1201493.png,0,0.9991976618766784,1929,122,2443,636,514,514,twilight sparkle,woogiegirl
1201493.png,https://derpicdn.net/img/view/2016/7/15/1201493.png,1,0.9940769076347352,1071,0,1785,712,714,712,twilight sparkle,woogiegirl
1202449.png,https://derpicdn.net/img/view/2016/7/16/1202449.png,0,0.9956893324851992,34,89,454,509,420,420,twilight sparkle,jazzerix
1205976.png,https://derpicdn.net/img/view/2016/7/21/1205976.png,0,0.9962358474731444,334,0,2194,1834,1860,1834,twilight sparkle,estories
1208085.png,https://derpicdn.net/img/view/2016/7/24/1208085.png,0,0.9934116005897522,177,0,471,262,294,262,twilight sparkle,
1208271.png,https://derpicdn.net/img/view/2016/7/24/1208271.png,0,0.9444013833999634,137,13,761,637,624,624,twilight sparkle,starsketchmeh
1210543.png,https://derpicdn.net/img/view/2016/7/27/1210543.png,0,0.932475745677948,204,89,694,579,490,490,twilight sparkle,nelly250
1212862.png,https://derpicdn.net/img/view/2016/7/30/1212862.png,0,0.9745501279830932,5,36,413,408,408,372,twilight sparkle,
1216355.png,https://derpicdn.net/img/view/2016/8/3/1216355.png,0,0.9665117263793944,73,178,485,590,412,412,twilight sparkle,nolycs
1216355.png,https://derpicdn.net/img/view/2016/8/3/1216355.png,1,0.947551727294922,363,129,749,515,386,386,twilight sparkle,nolycs
1216587.png,https://derpicdn.net/img/view/2016/8/4/1216587.png,0,0.9849631190299988,239,391,499,651,260,260,twilight sparkle,blackgryph0n|inuhoshi-to-darkpen
1217774.png,https://derpicdn.net/img/view/2016/8/5/1217774.png,0,0.9964185357093812,4,0,754,717,750,717,twilight sparkle,gyroc
1218323.png,https://derpicdn.net/img/view/2016/8/6/1218323.png,0,0.9988669157028198,16,77,852,913,836,836,twilight sparkle,ashtoneer
1219215.png,https://derpicdn.net/img/view/2016/8/7/1219215.png,1,0.988848090171814,352,150,968,766,616,616,twilight sparkle,squipycheetah
1219303.png,https://derpicdn.net/img/view/2016/8/7/1219303.png,0,0.9350996613502502,295,7,1367,1079,1072,1072,twilight sparkle,midnightsix3
1219991.png,https://derpicdn.net/img/view/2016/8/8/1219991.png,0,0.9691213965415956,0,131,1346,1591,1346,1460,twilight sparkle,bojo
1222279.png,https://derpicdn.net/img/view/2016/8/11/1222279.png,0,0.9559208154678344,0,0,2845,2876,2845,2876,twilight sparkle,trildar
1222981.png,https://derpicdn.net/img/view/2016/8/12/1222981.png,0,0.9417663812637328,84,389,560,865,476,476,twilight sparkle,neonblaze909
1226171.png,https://derpicdn.net/img/view/2016/8/15/1226171.png,0,0.9095394015312196,266,57,964,755,698,698,twilight sparkle,xxthatsmytypexx
1226624.png,https://derpicdn.net/img/view/2016/8/16/1226624.png,0,0.9582560062408448,2007,0,5795,3102,3788,3102,twilight sparkle,livehotsun
1229637.png,https://derpicdn.net/img/view/2016/8/20/1229637.png,0,0.9828413724899292,216,0,1298,768,1082,768,twilight sparkle,
1229705.png,https://derpicdn.net/img/view/2016/8/20/1229705.png,0,0.9572550654411316,0,0,288,308,288,308,twilight sparkle,
1229751.png,https://derpicdn.net/img/view/2016/8/20/1229751.png,0,0.9310224056243896,0,0,273,292,273,292,twilight sparkle,
1233483.png,https://derpicdn.net/img/view/2016/8/25/1233483.png,0,0.9835811257362366,73,622,3575,4124,3502,3502,twilight sparkle,gebos97531
1235212.png,https://derpicdn.net/img/view/2016/8/27/1235212.png,0,0.9865852594375608,63,54,1935,1926,1872,1872,twilight sparkle,estories
1238909.png,https://derpicdn.net/img/view/2016/9/1/1238909.png,0,0.9589253067970276,2721,214,4349,1880,1628,1666,twilight sparkle,spophia
1241641.png,https://derpicdn.net/img/view/2016/9/4/1241641.png,0,0.9923619627952576,10,0,956,881,946,881,twilight sparkle,neonblaze909
1244005.png,https://derpicdn.net/img/view/2016/9/7/1244005.png,0,0.9022557735443116,0,0,1514,1371,1514,1371,twilight sparkle,katkathasahathat
1244406.png,https://derpicdn.net/img/view/2016/9/8/1244406.png,0,0.9645160436630248,140,0,762,586,622,586,twilight sparkle,pegasisdraws
124503.png,https://derpicdn.net/img/view/2012/10/16/124503.png,0,0.9610416293144226,897,719,4365,4187,3468,3468,twilight sparkle,kuren247
1247739.png,https://derpicdn.net/img/view/2016/9/12/1247739.png,0,0.9934605360031128,0,23,1195,1411,1195,1388,twilight sparkle,megarainbowdash2000
1250287.png,https://derpicdn.net/img/view/2016/9/16/1250287.png,0,0.9970291256904602,1312,0,3744,2318,2432,2318,twilight sparkle,sketchmcreations
1250783.png,https://derpicdn.net/img/view/2016/9/16/1250783.png,0,0.9945799112319946,1757,791,2751,1785,994,994,twilight sparkle,karanakia
1252512.png,https://derpicdn.net/img/view/2016/9/18/1252512.png,0,0.9915043711662292,188,32,764,608,576,576,twilight sparkle,shiropoint
1259609.png,https://derpicdn.net/img/view/2016/9/27/1259609.png,0,0.9747310876846312,0,161,1024,1357,1024,1196,twilight sparkle,edie-tedie
1261577.png,https://derpicdn.net/img/view/2016/9/30/1261577.png,0,0.9135836362838744,400,145,2176,1921,1776,1776,twilight sparkle,eagle1division
1263773.png,https://derpicdn.net/img/view/2016/10/3/1263773.png,0,0.9184398651123048,2941,361,4627,2047,1686,1686,twilight sparkle,alka-pony2
1265228.png,https://derpicdn.net/img/view/2016/10/5/1265228.png,0,0.9677862524986268,506,9,902,405,396,396,twilight sparkle,stephancrowns
1265920.png,https://derpicdn.net/img/view/2016/10/6/1265920.png,0,0.9686011075973512,1170,0,2652,1355,1482,1355,twilight sparkle,lunarkisa
1267147.png,https://derpicdn.net/img/view/2016/10/7/1267147.png,0,0.9906201362609864,1234,0,3236,1993,2002,1993,twilight sparkle,estories
1269565.png,https://derpicdn.net/img/view/2016/10/10/1269565.png,0,0.9919133186340332,34,0,914,514,880,514,twilight sparkle,
1270368.png,https://derpicdn.net/img/view/2016/10/11/1270368.png,0,0.9337446093559264,0,34,408,492,408,458,twilight sparkle,iknowpony
1270698.png,https://derpicdn.net/img/view/2016/10/11/1270698.png,0,0.9975273609161376,541,57,1067,583,526,526,twilight sparkle,puddingskitty
1271014.png,https://derpicdn.net/img/view/2016/10/12/1271014.png,0,0.9546576738357544,0,662,791,1490,791,828,twilight sparkle,
1272512.png,https://derpicdn.net/img/view/2016/10/14/1272512.png,0,0.9452497959136964,172,0,1106,875,934,875,twilight sparkle,
1274582.png,https://derpicdn.net/img/view/2016/10/16/1274582.png,0,0.9491691589355468,77,74,2187,2184,2110,2110,twilight sparkle,cloudyglow
1274634.png,https://derpicdn.net/img/view/2016/10/16/1274634.png,0,0.9893867373466492,1,3,525,527,524,524,twilight sparkle,despotshy
1278533.png,https://derpicdn.net/img/view/2016/10/22/1278533.png,0,0.972680389881134,647,0,1555,826,908,826,twilight sparkle,orcakisses
1279563.png,https://derpicdn.net/img/view/2016/10/23/1279563.png,0,0.9315137267112732,327,293,2589,2555,2262,2262,twilight sparkle,spirit-dude
1282712.png,https://derpicdn.net/img/view/2016/10/27/1282712.png,1,0.9963089227676392,655,0,953,261,298,261,twilight sparkle,celestialprism18
1283293.png,https://derpicdn.net/img/view/2016/10/28/1283293.png,0,0.9597482085227966,53,0,553,468,500,468,twilight sparkle,timorikawa
1286765.png,https://derpicdn.net/img/view/2016/11/2/1286765.png,0,0.9542840719223022,67,0,621,511,554,511,twilight sparkle,oreomonsterr
1287027.png,https://derpicdn.net/img/view/2016/11/2/1287027.png,0,0.9834777116775512,324,0,928,577,604,577,twilight sparkle,iknowpony
1289342.png,https://derpicdn.net/img/view/2016/11/5/1289342.png,0,0.9769957065582277,0,23,535,567,535,544,twilight sparkle,chibadeer
1292694.png,https://derpicdn.net/img/view/2016/11/10/1292694.png,0,0.9348079562187196,688,232,6174,5718,5486,5486,twilight sparkle,cyanlightning
1293539.png,https://derpicdn.net/img/view/2016/11/11/1293539.png,0,0.9118700623512268,342,55,866,579,524,524,twilight sparkle,xbi
1296330.png,https://derpicdn.net/img/view/2016/11/15/1296330.png,0,0.9905213117599488,878,0,1872,980,994,980,twilight sparkle,underpable
1296576.png,https://derpicdn.net/img/view/2016/11/15/1296576.png,0,0.9146888256072998,51,0,663,512,612,512,twilight sparkle,stuflox
1296774.png,https://derpicdn.net/img/view/2016/11/16/1296774.png,0,0.9892014861106871,35,4,287,268,252,264,twilight sparkle,
1298182.png,https://derpicdn.net/img/view/2016/11/18/1298182.png,0,0.996040940284729,929,209,1277,557,348,348,twilight sparkle,stuflox
1301287.png,https://derpicdn.net/img/view/2016/11/22/1301287.png,0,0.9886781573295592,90,0,1704,1607,1614,1607,twilight sparkle,porygon2z
1304136.png,https://derpicdn.net/img/view/2016/11/26/1304136.png,0,0.9359003901481628,84,0,978,701,894,701,twilight sparkle,chametzkiwi
1304178.png,https://derpicdn.net/img/view/2016/11/26/1304178.png,0,0.9993332028388976,2346,0,4844,2169,2498,2169,twilight sparkle,deratrox
1304991.png,https://derpicdn.net/img/view/2016/11/27/1304991.png,0,0.9919451475143432,48,143,2198,2293,2150,2150,twilight sparkle,estories
1306277.png,https://derpicdn.net/img/view/2016/11/29/1306277.png,0,0.9962178468704224,1467,0,4027,2370,2560,2370,twilight sparkle,sorata-daidouji
1315310.png,https://derpicdn.net/img/view/2016/12/11/1315310.png,0,0.9241583943367004,262,30,796,564,534,534,twilight sparkle,themagicfantasy
1319931.png,https://derpicdn.net/img/view/2016/12/18/1319931.png,0,0.9958570599555968,1425,339,3135,2049,1710,1710,twilight sparkle,uliks-uliks
1324148.png,https://derpicdn.net/img/view/2016/12/24/1324148.png,0,0.9910353422164916,64,0,428,352,364,352,twilight sparkle,
1324992.png,https://derpicdn.net/img/view/2016/12/25/1324992.png,0,0.9933045506477356,312,127,1314,1129,1002,1002,twilight sparkle,miss-cats
1330546.png,https://derpicdn.net/img/view/2017/1/2/1330546.png,0,0.9925536513328552,629,19,951,341,322,322,twilight sparkle,butteredpawpcorn
1330590.png,https://derpicdn.net/img/view/2017/1/2/1330590.png,0,0.9362185001373292,6,0,350,284,344,284,twilight sparkle,katkathasahathat
1334075.png,https://derpicdn.net/img/view/2017/1/7/1334075.png,0,0.9922332167625428,1947,123,4483,2659,2536,2536,twilight sparkle,crimson
1337742.png,https://derpicdn.net/img/view/2017/1/12/1337742.png,0,0.9901562333106996,1124,0,1788,652,664,652,twilight sparkle,maiachlte|loyalstray
1337742.png,https://derpicdn.net/img/view/2017/1/12/1337742.png,1,0.9012613892555236,426,80,1248,902,822,822,twilight sparkle,maiachlte|loyalstray
1342762.png,https://derpicdn.net/img/view/2017/1/19/1342762.png,0,0.9311866760253906,13,0,981,962,968,962,twilight sparkle,chokuru
1347412.png,https://derpicdn.net/img/view/2017/1/25/1347412.png,0,0.9996190667152404,659,109,1255,705,596,596,twilight sparkle,joey
1349808.png,https://derpicdn.net/img/view/2017/1/28/1349808.png,0,0.9989911913871764,1130,0,3964,2367,2834,2367,twilight sparkle,pucksterv
1353618.png,https://derpicdn.net/img/view/2017/2/2/1353618.png,0,0.9843775629997252,0,0,739,677,739,677,twilight sparkle,tamalesyatole
135503.png,https://derpicdn.net/img/view/2012/10/29/135503.png,0,0.9931194186210632,352,15,622,285,270,270,twilight sparkle,arcticwaters
1355929.png,https://derpicdn.net/img/view/2017/2/5/1355929.png,0,0.9973726868629456,43,0,1001,952,958,952,twilight sparkle,waywardpufik
1356912.png,https://derpicdn.net/img/view/2017/2/6/1356912.png,0,0.9962284564971924,386,216,672,502,286,286,twilight sparkle,crecious
135713.png,https://derpicdn.net/img/view/2012/10/29/135713.png,0,0.9557865262031556,132,421,388,677,256,256,twilight sparkle,arcticwaters
1357715.png,https://derpicdn.net/img/view/2017/2/7/1357715.png,0,0.9967387318611144,0,27,1982,2139,1982,2112,twilight sparkle,sugar-loop
1358339.png,https://derpicdn.net/img/view/2017/2/8/1358339.png,0,0.9925448894500732,778,1321,10642,11185,9864,9864,twilight sparkle,cyanlightning
1359502.png,https://derpicdn.net/img/view/2017/2/10/1359502.png,0,0.9953916072845459,180,35,948,803,768,768,twilight sparkle,akapiiart
1360599.png,https://derpicdn.net/img/view/2017/2/12/1360599.png,0,0.9829844832420348,13,0,637,575,624,575,twilight sparkle,pastelhorses
1364963.png,https://derpicdn.net/img/view/2017/2/16/1364963.png,0,0.9647755622863772,123,89,347,313,224,224,twilight sparkle,bloominglove
1364969.png,https://derpicdn.net/img/view/2017/2/16/1364969.png,0,0.9568966627120972,729,0,2977,1765,2248,1765,twilight sparkle,melodycloud14
1365509.png,https://derpicdn.net/img/view/2017/2/17/1365509.png,0,0.9177361130714417,164,0,946,772,782,772,twilight sparkle,nekro-led
1367431.png,https://derpicdn.net/img/view/2017/2/19/1367431.png,0,0.9850454926490784,0,60,482,550,482,490,twilight sparkle,stacyhirano34
1368344.png,https://derpicdn.net/img/view/2017/2/20/1368344.png,0,0.9903352856636048,1297,321,2127,1151,830,830,twilight sparkle,laszlvfx|starlessnight22
1371126.png,https://derpicdn.net/img/view/2017/2/23/1371126.png,0,0.9993904829025269,117,32,537,452,420,420,twilight sparkle,not-ordinary-pony
1373830.png,https://derpicdn.net/img/view/2017/2/26/1373830.png,0,0.9791194796562196,56,115,800,860,744,745,twilight sparkle,spirit-dude
137948.png,https://derpicdn.net/img/view/2012/10/31/137948.png,0,0.9966627955436708,313,0,893,543,580,543,twilight sparkle,camellia
1380962.png,https://derpicdn.net/img/view/2017/3/6/1380962.png,0,0.9723883867263794,377,161,1169,953,792,792,twilight sparkle,kiarawizard01
1383342.png,https://derpicdn.net/img/view/2017/3/10/1383342.png,0,0.9403024911880492,179,433,919,1173,740,740,twilight sparkle,stillwaterspony
1383705.png,https://derpicdn.net/img/view/2017/3/10/1383705.png,0,0.9858326315879822,285,85,977,777,692,692,twilight sparkle,not-ordinary-pony
1386776.png,https://derpicdn.net/img/view/2017/3/14/1386776.png,0,0.9995067119598388,482,178,768,464,286,286,twilight sparkle,elementofsuprise
1386776.png,https://derpicdn.net/img/view/2017/3/14/1386776.png,1,0.9959741234779358,269,103,605,439,336,336,twilight sparkle,elementofsuprise
138741.jpg,https://derpicdn.net/img/view/2012/11/1/138741.jpg,0,0.9822495579719543,87,434,521,868,434,434,twilight sparkle,twilite-sparkleplz
1388397.png,https://derpicdn.net/img/view/2017/3/16/1388397.png,0,0.9929284453392028,30,0,1634,1600,1604,1600,twilight sparkle,doctor-g
1392523.png,https://derpicdn.net/img/view/2017/3/20/1392523.png,0,0.9901881217956544,2344,0,3318,968,974,968,twilight sparkle,notsafeforhoofs
1392523.png,https://derpicdn.net/img/view/2017/3/20/1392523.png,1,0.9791656732559204,1302,1321,2138,2157,836,836,twilight sparkle,notsafeforhoofs
1399999.png,https://derpicdn.net/img/view/2017/3/30/1399999.png,0,0.9013816118240356,1439,0,2758,1354,1319,1354,twilight sparkle,brony-works
1400239.png,https://derpicdn.net/img/view/2017/3/31/1400239.png,0,0.98531311750412,35,120,689,774,654,654,twilight sparkle,
140186.png,https://derpicdn.net/img/view/2012/11/2/140186.png,0,0.9838564395904541,1412,0,2882,1342,1470,1342,twilight sparkle,punchingshark
1402997.png,https://derpicdn.net/img/view/2017/4/3/1402997.png,0,0.9997469782829284,34,72,496,534,462,462,twilight sparkle,australian-senior
1403267.png,https://derpicdn.net/img/view/2017/4/3/1403267.png,0,0.9820098280906676,240,21,440,221,200,200,twilight sparkle,cloudyglow|unicornsmile
1404005.png,https://derpicdn.net/img/view/2017/4/4/1404005.png,0,0.9446024894714355,594,0,1344,739,750,739,twilight sparkle,blenderpony
1407621.png,https://derpicdn.net/img/view/2017/4/9/1407621.png,0,0.979013204574585,162,0,718,484,556,484,twilight sparkle,minelvi|montyowl
1408814.png,https://derpicdn.net/img/view/2017/4/11/1408814.png,0,0.9970459938049316,493,4,801,312,308,308,twilight sparkle,acespade777
1411841.png,https://derpicdn.net/img/view/2017/4/15/1411841.png,0,0.9934597611427308,427,54,891,518,464,464,twilight sparkle,epesi
1414554.png,https://derpicdn.net/img/view/2017/4/17/1414554.png,0,0.9269735813140868,0,4,207,224,207,220,twilight sparkle,
1417388.png,https://derpicdn.net/img/view/2017/4/21/1417388.png,0,0.9875510931015016,74,311,3378,3156,3304,2845,twilight sparkle,sketchmcreations
1418337.png,https://derpicdn.net/img/view/2017/4/22/1418337.png,0,0.9387235641479492,61,158,453,550,392,392,twilight sparkle,biakela
1420014.png,https://derpicdn.net/img/view/2017/4/23/1420014.png,0,0.9756923913955688,122,34,1194,1106,1072,1072,twilight sparkle,sentireaeris
1420038.png,https://derpicdn.net/img/view/2017/4/23/1420038.png,0,0.9932803511619568,668,0,992,310,324,310,twilight sparkle,goat train
1420435.png,https://derpicdn.net/img/view/2017/4/24/1420435.png,0,0.9276059865951538,220,0,1778,1090,1558,1090,twilight sparkle,
1421430.png,https://derpicdn.net/img/view/2017/4/25/1421430.png,0,0.9607564210891724,331,238,965,872,634,634,twilight sparkle,australian-senior
1423509.png,https://derpicdn.net/img/view/2017/4/28/1423509.png,0,0.9899958968162536,143,0,777,627,634,627,twilight sparkle,ohmudak_wip
1424004.png,https://derpicdn.net/img/view/2017/4/29/1424004.png,0,0.9311547279357908,138,0,2126,1440,1988,1440,twilight sparkle,
1424009.png,https://derpicdn.net/img/view/2017/4/29/1424009.png,0,0.9386798143386841,645,0,1625,891,980,891,twilight sparkle,
1425067.png,https://derpicdn.net/img/view/2017/4/30/1425067.png,0,0.9932881593704224,342,18,716,392,374,374,twilight sparkle,zaron
1425342.png,https://derpicdn.net/img/view/2017/4/30/1425342.png,0,0.9720516800880432,133,0,700,564,567,564,twilight sparkle,pinapplekid
1425857.png,https://derpicdn.net/img/view/2017/4/30/1425857.png,0,0.9600506424903872,292,0,674,352,382,352,twilight sparkle,believeinshadows
1432848.png,https://derpicdn.net/img/view/2017/5/9/1432848.png,0,0.9914547204971312,0,30,895,936,895,906,twilight sparkle,davidsfire
1433424.png,https://derpicdn.net/img/view/2017/5/10/1433424.png,0,0.9783931374549866,165,159,2537,2308,2372,2149,twilight sparkle,arifproject
1438533.png,https://derpicdn.net/img/view/2017/5/17/1438533.png,0,0.9953309893608092,681,0,1360,692,679,692,twilight sparkle,
1445123.png,https://derpicdn.net/img/view/2017/5/24/1445123.png,0,0.9816395044326782,774,772,2182,2180,1408,1408,twilight sparkle,check3256
1448235.png,https://derpicdn.net/img/view/2017/5/28/1448235.png,0,0.9791814088821412,0,0,629,597,629,597,twilight sparkle,
1452134.png,https://derpicdn.net/img/view/2017/6/2/1452134.png,0,0.9970911741256714,0,285,2821,3301,2821,3016,twilight sparkle,estories
1464633.png,https://derpicdn.net/img/view/2017/6/18/1464633.png,0,0.9616992473602296,0,0,1661,1863,1661,1863,twilight sparkle,mrcbleck
1466857.png,https://derpicdn.net/img/view/2017/6/20/1466857.png,0,0.9483185410499572,1700,0,3540,1735,1840,1735,twilight sparkle,porygon2z
1467252.png,https://derpicdn.net/img/view/2017/6/20/1467252.png,0,0.9474859237670898,127,403,2807,3083,2680,2680,twilight sparkle,fennrick
1467349.png,https://derpicdn.net/img/view/2017/6/21/1467349.png,0,0.9944729208946228,176,0,2840,2369,2664,2369,twilight sparkle,rubez2525
1468770.png,https://derpicdn.net/img/view/2017/6/22/1468770.png,0,0.9677584767341614,2709,541,3789,1621,1080,1080,twilight sparkle,bigmk
1471831.png,https://derpicdn.net/img/view/2017/6/26/1471831.png,0,0.9783097505569458,1249,875,1771,1399,522,524,twilight sparkle,mashoart
1473873.png,https://derpicdn.net/img/view/2017/6/29/1473873.png,0,0.98090261220932,1,184,697,880,696,696,twilight sparkle,
1473965.png,https://derpicdn.net/img/view/2017/6/29/1473965.png,0,0.9721943736076356,250,2,850,602,600,600,twilight sparkle,weirdcloud
1474155.png,https://derpicdn.net/img/view/2017/6/29/1474155.png,0,0.9869998097419742,105,300,541,736,436,436,twilight sparkle,
1474155.png,https://derpicdn.net/img/view/2017/6/29/1474155.png,1,0.94902765750885,631,126,1159,654,528,528,twilight sparkle,
1474426.png,https://derpicdn.net/img/view/2017/6/29/1474426.png,0,0.9990220069885254,1046,97,1600,673,554,576,twilight sparkle,torusthescribe
1476430.png,https://derpicdn.net/img/view/2017/7/1/1476430.png,0,0.9957507848739624,203,184,567,548,364,364,twilight sparkle,sketch-shepherd
1476430.png,https://derpicdn.net/img/view/2017/7/1/1476430.png,1,0.9901989698410034,529,53,947,471,418,418,twilight sparkle,sketch-shepherd
1477.jpg,https://derpicdn.net/img/view/2012/1/22/1477.jpg,0,0.9748869538307192,41,0,385,329,344,329,twilight sparkle,mysticalpha
1477.jpg,https://derpicdn.net/img/view/2012/1/22/1477.jpg,1,0.9542942047119141,999,0,1297,285,298,285,twilight sparkle,mysticalpha
1478279.png,https://derpicdn.net/img/view/2017/7/4/1478279.png,0,0.9914500117301941,3208,229,5686,2731,2478,2502,twilight sparkle,unfiltered-n
1480755.png,https://derpicdn.net/img/view/2017/7/7/1480755.png,0,0.9835779666900636,1567,0,5179,3714,3612,3714,twilight sparkle,estories
1480769.png,https://derpicdn.net/img/view/2017/7/7/1480769.png,0,0.927582859992981,0,0,2995,5069,2995,5069,twilight sparkle,estories
1480786.png,https://derpicdn.net/img/view/2017/7/7/1480786.png,0,0.9958507418632508,1963,0,5037,2942,3074,2942,twilight sparkle,estories
1480891.png,https://derpicdn.net/img/view/2017/7/7/1480891.png,0,0.995735764503479,264,130,3098,2964,2834,2834,twilight sparkle,estories
1482697.png,https://derpicdn.net/img/view/2017/7/10/1482697.png,0,0.9843669533729552,95,18,927,850,832,832,twilight sparkle,orcakisses
1484503.png,https://derpicdn.net/img/view/2017/7/12/1484503.png,0,0.9945945143699646,2003,0,4080,1892,2077,1892,twilight sparkle,djdavid98
1485074.png,https://derpicdn.net/img/view/2017/7/13/1485074.png,0,0.9673632383346558,0,182,860,1168,860,986,twilight sparkle,moondreamer16
1485404.png,https://derpicdn.net/img/view/2017/7/13/1485404.png,0,0.972914695739746,227,97,1447,1337,1220,1240,twilight sparkle,anonbelle
1496581.png,https://derpicdn.net/img/view/2017/7/28/1496581.png,1,0.9176111221313475,18,1495,1031,2511,1013,1016,twilight sparkle,
1501645.png,https://derpicdn.net/img/view/2017/8/3/1501645.png,0,0.9873670935630798,456,0,1794,1196,1338,1196,twilight sparkle,binkyt11
1502132.png,https://derpicdn.net/img/view/2017/8/3/1502132.png,0,0.9961071610450744,121,435,821,1135,700,700,twilight sparkle,
1504114.png,https://derpicdn.net/img/view/2017/8/6/1504114.png,0,0.966585338115692,41,788,2641,3318,2600,2530,twilight sparkle,are-you-jealous
1504925.png,https://derpicdn.net/img/view/2017/8/7/1504925.png,0,0.9809495210647584,3143,137,4881,1875,1738,1738,twilight sparkle,lman225
1507023.png,https://derpicdn.net/img/view/2017/8/10/1507023.png,0,0.9275258779525756,139,73,455,389,316,316,twilight sparkle,emily-826
1510055.png,https://derpicdn.net/img/view/2017/8/13/1510055.png,0,0.9962038397789,851,348,3505,3002,2654,2654,twilight sparkle,estories
1514664.png,https://derpicdn.net/img/view/2017/8/19/1514664.png,0,0.9842984080314636,0,27,623,679,623,652,twilight sparkle,
1520840.png,https://derpicdn.net/img/view/2017/8/27/1520840.png,0,0.9957433342933656,238,102,800,664,562,562,twilight sparkle,moonlightfan
1523560.png,https://derpicdn.net/img/view/2017/8/30/1523560.png,0,0.9961255192756652,498,0,1024,505,526,505,twilight sparkle,ra1nb0wk1tty
15237.png,https://derpicdn.net/img/view/2012/6/22/15237.png,0,0.9949139356613159,167,570,809,1212,642,642,twilight sparkle,larsurus
1526290.png,https://derpicdn.net/img/view/2017/9/2/1526290.png,0,0.9981816411018372,500,258,782,540,282,282,twilight sparkle,
1527171.png,https://derpicdn.net/img/view/2017/9/3/1527171.png,0,0.9407582879066468,32,63,586,564,554,501,twilight sparkle,
1527849.png,https://derpicdn.net/img/view/2017/9/4/1527849.png,0,0.99785715341568,420,403,906,889,486,486,twilight sparkle,
1534099.png,https://derpicdn.net/img/view/2017/9/12/1534099.png,0,0.9847633838653564,306,0,2716,2339,2410,2339,twilight sparkle,hornflakes
1536776.png,https://derpicdn.net/img/view/2017/9/16/1536776.png,0,0.9899100065231324,0,0,537,589,537,589,twilight sparkle,
1539549.png,https://derpicdn.net/img/view/2017/9/19/1539549.png,0,0.9815755486488342,315,0,1253,897,938,897,twilight sparkle,
1540806.png,https://derpicdn.net/img/view/2017/9/21/1540806.png,0,0.9961038827896118,395,0,813,400,418,400,twilight sparkle,j-pinkie
1540967.png,https://derpicdn.net/img/view/2017/9/21/1540967.png,0,0.9982303380966188,1181,0,2713,1397,1532,1397,twilight sparkle,crash9902
1542112.png,https://derpicdn.net/img/view/2017/9/22/1542112.png,0,0.9983416199684144,1373,0,2851,1434,1478,1434,twilight sparkle,cloudyglow
1545371.png,https://derpicdn.net/img/view/2017/9/26/1545371.png,0,0.9079543352127076,0,8,988,800,988,792,twilight sparkle,
1548919.png,https://derpicdn.net/img/view/2017/10/1/1548919.png,0,0.9192928075790404,0,0,621,546,621,546,twilight sparkle,
1550606.png,https://derpicdn.net/img/view/2017/10/2/1550606.png,0,0.9845318794250488,180,108,550,478,370,370,twilight sparkle,koteikow|fusionsofponies
1550871.png,https://derpicdn.net/img/view/2017/10/3/1550871.png,0,0.9831466674804688,1608,360,2202,954,594,594,twilight sparkle,tici9090
1552712.png,https://derpicdn.net/img/view/2017/10/5/1552712.png,0,0.9704237580299376,843,0,3785,3186,2942,3186,twilight sparkle,hendro107
1554361.png,https://derpicdn.net/img/view/2017/10/7/1554361.png,0,0.989800751209259,78,0,1196,742,1118,742,twilight sparkle,
1554953.png,https://derpicdn.net/img/view/2017/10/8/1554953.png,0,0.9753869771957396,1559,0,2731,1120,1172,1120,twilight sparkle,befishproductions
1555330.png,https://derpicdn.net/img/view/2017/10/8/1555330.png,0,0.9871811866760254,133,8,725,650,592,642,twilight sparkle,
1555333.png,https://derpicdn.net/img/view/2017/10/8/1555333.png,0,0.9869168996810912,111,0,1493,1080,1382,1080,twilight sparkle,
1557236.png,https://derpicdn.net/img/view/2017/10/10/1557236.png,0,0.9997527003288268,108,0,652,530,544,530,twilight sparkle,puddingskitty
1557310.png,https://derpicdn.net/img/view/2017/10/10/1557310.png,0,0.9969744682312012,1018,0,3086,1933,2068,1933,twilight sparkle,ghost3641
1558083.png,https://derpicdn.net/img/view/2017/10/11/1558083.png,0,0.9594003558158876,123,0,987,824,864,824,twilight sparkle,fantasyflixart
1559374.png,https://derpicdn.net/img/view/2017/10/12/1559374.png,0,0.9961724877357484,618,0,2250,1593,1632,1593,twilight sparkle,skyflys
1564085.png,https://derpicdn.net/img/view/2017/10/18/1564085.png,0,0.9975839257240297,172,40,1926,1794,1754,1754,twilight sparkle,tomfraggle
1567752.png,https://derpicdn.net/img/view/2017/10/22/1567752.png,0,0.9255607724189758,3194,0,6408,3168,3214,3168,twilight sparkle,craftybrony
1568959.png,https://derpicdn.net/img/view/2017/10/24/1568959.png,0,0.9861880540847778,0,64,345,383,345,319,twilight sparkle,
1572433.png,https://derpicdn.net/img/view/2017/10/29/1572433.png,0,0.9951524138450624,3600,0,7569,4128,3969,4128,twilight sparkle,craftybrony
1573398.png,https://derpicdn.net/img/view/2017/10/30/1573398.png,0,0.9946956634521484,0,0,472,480,472,480,twilight sparkle,
1580030.png,https://derpicdn.net/img/view/2017/11/6/1580030.png,0,0.990414261817932,0,140,1412,1594,1412,1454,twilight sparkle,sykobelle
1583174.png,https://derpicdn.net/img/view/2017/11/10/1583174.png,0,0.9617509841918944,0,91,2531,2811,2531,2720,twilight sparkle,dusk2k
1583846.png,https://derpicdn.net/img/view/2017/11/11/1583846.png,0,0.974480390548706,181,0,1175,885,994,885,twilight sparkle,calliegreen
1586085.png,https://derpicdn.net/img/view/2017/11/14/1586085.png,0,0.9690913558006288,51,0,337,279,286,279,twilight sparkle,tailzkip
1588532.png,https://derpicdn.net/img/view/2017/11/17/1588532.png,0,0.9930208325386048,4279,1171,7331,4223,3052,3052,twilight sparkle,ejlightning007arts
1589110.png,https://derpicdn.net/img/view/2017/11/18/1589110.png,0,0.9596573710441588,1452,0,4016,2403,2564,2403,twilight sparkle,cloudyglow
1590878.png,https://derpicdn.net/img/view/2017/11/20/1590878.png,0,0.9162650108337402,199,0,804,637,605,637,twilight sparkle,shootingstaryt
1591077.png,https://derpicdn.net/img/view/2017/11/21/1591077.png,0,0.992712676525116,465,86,775,396,310,310,twilight sparkle,jayrockin
1591077.png,https://derpicdn.net/img/view/2017/11/21/1591077.png,1,0.9628748893737792,195,0,493,290,298,290,twilight sparkle,jayrockin
1596101.png,https://derpicdn.net/img/view/2017/11/28/1596101.png,0,0.9641020894050598,234,0,905,718,671,718,twilight sparkle,threetwotwo32232
1599165.png,https://derpicdn.net/img/view/2017/12/2/1599165.png,0,0.9722282290458679,248,0,822,534,574,534,twilight sparkle,maxiehack
1599681.png,https://derpicdn.net/img/view/2017/12/3/1599681.png,0,0.9970871210098268,382,92,876,586,494,494,twilight sparkle,renhet
159983.png,https://derpicdn.net/img/view/2012/11/22/159983.png,0,0.9341539144515992,455,0,990,617,535,617,twilight sparkle,
1600325.png,https://derpicdn.net/img/view/2017/12/4/1600325.png,0,0.99474036693573,154,153,1296,1295,1142,1142,twilight sparkle,not-ordinary-pony
1600364.png,https://derpicdn.net/img/view/2017/12/4/1600364.png,0,0.9903995990753174,2591,0,5323,2490,2732,2490,twilight sparkle,craftybrony
1603850.png,https://derpicdn.net/img/view/2017/12/9/1603850.png,1,0.9153487086296082,663,100,1015,452,352,352,twilight sparkle,hakar-kerarmor
1606708.png,https://derpicdn.net/img/view/2017/12/13/1606708.png,0,0.9531744718551636,8,16,624,632,616,616,twilight sparkle,puddingskinmcgee
1608185.png,https://derpicdn.net/img/view/2017/12/15/1608185.png,0,0.9824429154396056,0,0,198,197,198,197,twilight sparkle,brendahickey
160930.png,https://derpicdn.net/img/view/2012/11/23/160930.png,0,0.9969903826713562,8,557,162,711,154,154,twilight sparkle,racoonsan|innuendo88
160951.png,https://derpicdn.net/img/view/2012/11/23/160951.png,0,0.9889779686927797,0,0,7087,7457,7087,7457,twilight sparkle,quanno3
1611611.png,https://derpicdn.net/img/view/2017/12/20/1611611.png,0,0.9956206679344176,22,20,358,356,336,336,twilight sparkle,razorbladetheunicron
1611883.png,https://derpicdn.net/img/view/2017/12/20/1611883.png,0,0.995184600353241,923,443,2523,2043,1600,1600,twilight sparkle,denahzi
161255.png,https://derpicdn.net/img/view/2012/11/24/161255.png,0,0.9799133539199828,483,6,719,242,236,236,twilight sparkle,aliasforrent
1613190.png,https://derpicdn.net/img/view/2017/12/22/1613190.png,0,0.9982424974441528,883,0,2508,1739,1625,1739,twilight sparkle,paskanaakka
16140.jpg,https://derpicdn.net/img/view/2012/6/23/16140.jpg,0,0.9981055259704592,141,0,743,585,602,585,twilight sparkle,buttercupsaiyan
1616370.png,https://derpicdn.net/img/view/2017/12/26/1616370.png,0,0.9930499196052552,4304,1196,7306,4198,3002,3002,twilight sparkle,ejlightning007arts
16173.jpg,https://derpicdn.net/img/view/2012/6/23/16173.jpg,0,0.9827999472618104,169,55,709,595,540,540,twilight sparkle,lhconceptpony
1619676.png,https://derpicdn.net/img/view/2017/12/30/1619676.png,0,0.9943273663520812,867,1071,1321,1525,454,454,twilight sparkle,evakulisreal
1621184.png,https://derpicdn.net/img/view/2018/1/1/1621184.png,0,0.9434624910354614,283,0,688,402,405,402,twilight sparkle,razorbladetheunicron
1621207.png,https://derpicdn.net/img/view/2018/1/1/1621207.png,0,0.9651216864585876,164,0,534,331,370,331,twilight sparkle,pixelpatter116
1623418.png,https://derpicdn.net/img/view/2018/1/3/1623418.png,0,0.99384605884552,628,419,2324,2115,1696,1696,twilight sparkle,coldtrail
1624021.png,https://derpicdn.net/img/view/2018/1/4/1624021.png,0,0.9978281855583192,0,610,364,998,364,388,twilight sparkle,mynder
1627960.png,https://derpicdn.net/img/view/2018/1/9/1627960.png,0,0.995824933052063,0,1,364,365,364,364,twilight sparkle,retromochi
1628159.png,https://derpicdn.net/img/view/2018/1/9/1628159.png,0,0.9975292086601256,728,455,1380,1107,652,652,twilight sparkle,miyathegoldenflower
1629582.png,https://derpicdn.net/img/view/2018/1/11/1629582.png,0,0.9975626468658448,23,145,947,1069,924,924,twilight sparkle,polyaplanets
1630197.png,https://derpicdn.net/img/view/2018/1/12/1630197.png,0,0.9822941422462464,0,0,472,474,472,474,twilight sparkle,
1631204.png,https://derpicdn.net/img/view/2018/1/13/1631204.png,0,0.9664465188980104,102,255,3712,3865,3610,3610,twilight sparkle,rolin11
1632574.png,https://derpicdn.net/img/view/2018/1/15/1632574.png,0,0.9942339658737184,1276,0,2866,1518,1590,1518,twilight sparkle,andoanimalia
1634076.png,https://derpicdn.net/img/view/2018/1/17/1634076.png,0,0.9908766150474548,452,37,738,323,286,286,twilight sparkle,carouselunique
1637014.png,https://derpicdn.net/img/view/2018/1/20/1637014.png,0,0.9887998104095459,726,0,3758,2864,3032,2864,twilight sparkle,cloudyglow
1637253.png,https://derpicdn.net/img/view/2018/1/21/1637253.png,0,0.9131479263305664,0,81,2188,2299,2188,2218,twilight sparkle,andoanimalia
1638856.png,https://derpicdn.net/img/view/2018/1/23/1638856.png,0,0.9350723028182985,577,154,1249,826,672,672,twilight sparkle,sweethearts11
1639004.png,https://derpicdn.net/img/view/2018/1/23/1639004.png,0,0.9649296402931212,607,296,1173,862,566,566,twilight sparkle,derpsonhooves
1645097.png,https://derpicdn.net/img/view/2018/1/31/1645097.png,0,0.9885784983634948,0,118,3494,3774,3494,3656,twilight sparkle,jhayarr23
1645151.png,https://derpicdn.net/img/view/2018/1/31/1645151.png,0,0.9739698171615601,531,64,833,366,302,302,twilight sparkle,tf-sential
1645288.png,https://derpicdn.net/img/view/2018/1/31/1645288.png,0,0.9631204009056092,124,9,3956,3841,3832,3832,twilight sparkle,luckreza8
1648184.png,https://derpicdn.net/img/view/2018/2/4/1648184.png,0,0.9819092750549316,41,0,1651,804,1610,804,twilight sparkle,
1648308.png,https://derpicdn.net/img/view/2018/2/4/1648308.png,0,0.9905719161033628,116,0,682,512,566,512,twilight sparkle,sv37
1652736.png,https://derpicdn.net/img/view/2018/2/10/1652736.png,0,0.9377962946891784,651,0,1920,804,1269,804,twilight sparkle,
1654490.png,https://derpicdn.net/img/view/2018/2/12/1654490.png,0,0.9756174683570862,429,43,829,443,400,400,twilight sparkle,lynchristina
1660922.png,https://derpicdn.net/img/view/2018/2/20/1660922.png,0,0.9947184920310974,348,10,2012,1674,1664,1664,twilight sparkle,pridark
1661068.png,https://derpicdn.net/img/view/2018/2/20/1661068.png,0,0.99797260761261,0,0,2526,2634,2526,2634,twilight sparkle,rainbowrage12
1662907.png,https://derpicdn.net/img/view/2018/2/22/1662907.png,0,0.9414620399475098,57,1,317,261,260,260,twilight sparkle,urbanqhoul
1665174.png,https://derpicdn.net/img/view/2018/2/25/1665174.png,0,0.9888928532600404,76,69,1784,1777,1708,1708,twilight sparkle,andoanimalia
1667392.png,https://derpicdn.net/img/view/2018/2/27/1667392.png,0,0.9701873660087584,155,81,1505,1431,1350,1350,twilight sparkle,sergeant16bit
1667772.png,https://derpicdn.net/img/view/2018/2/28/1667772.png,0,0.99288147687912,492,77,900,489,408,412,twilight sparkle,dm29
1670013.png,https://derpicdn.net/img/view/2018/3/2/1670013.png,0,0.9982160925865172,25,117,895,987,870,870,twilight sparkle,vcm1824
1670190.png,https://derpicdn.net/img/view/2018/3/3/1670190.png,0,0.9700164198875428,584,0,1698,1076,1114,1076,twilight sparkle,bunxl
1670939.png,https://derpicdn.net/img/view/2018/3/3/1670939.png,0,0.9886596202850342,268,5,1162,899,894,894,twilight sparkle,ggchristian
1671522.png,https://derpicdn.net/img/view/2018/3/4/1671522.png,0,0.9904056191444396,298,0,938,608,640,608,twilight sparkle,
1672972.png,https://derpicdn.net/img/view/2018/3/6/1672972.png,0,0.9967080354690552,274,66,1030,822,756,756,twilight sparkle,sketchmcreations
1674156.png,https://derpicdn.net/img/view/2018/3/7/1674156.png,1,0.992770791053772,18,95,532,609,514,514,twilight sparkle,aaservantsheartuniverse
1676043.png,https://derpicdn.net/img/view/2018/3/10/1676043.png,0,0.9744953513145448,11,0,487,455,476,455,twilight sparkle,
1681718.png,https://derpicdn.net/img/view/2018/3/16/1681718.png,0,0.9742815494537354,228,309,614,695,386,386,twilight sparkle,rossignolet
1684920.png,https://derpicdn.net/img/view/2018/3/19/1684920.png,1,0.9216193556785583,149,813,2063,2727,1914,1914,twilight sparkle,dashiesparkle
1687139.png,https://derpicdn.net/img/view/2018/3/22/1687139.png,0,0.9680399298667908,0,0,580,645,580,645,twilight sparkle,pastelhorses|tjpones
1687649.png,https://derpicdn.net/img/view/2018/3/22/1687649.png,0,0.996098518371582,543,0,1243,532,700,532,twilight sparkle,ponygaben
1689163.png,https://derpicdn.net/img/view/2018/3/24/1689163.png,0,0.9723849296569824,124,0,1014,903,890,903,twilight sparkle,
1689699.png,https://derpicdn.net/img/view/2018/3/25/1689699.png,0,0.9674845933914183,80,77,988,985,908,908,twilight sparkle,k9core
1690153.png,https://derpicdn.net/img/view/2018/3/25/1690153.png,0,0.9891194105148317,0,0,1280,1015,1280,1015,twilight sparkle,
1690155.png,https://derpicdn.net/img/view/2018/3/25/1690155.png,0,0.991689920425415,92,0,1748,1080,1656,1080,twilight sparkle,
1690190.png,https://derpicdn.net/img/view/2018/3/25/1690190.png,0,0.9815967082977296,176,0,1054,784,878,784,twilight sparkle,asg
1694270.png,https://derpicdn.net/img/view/2018/3/30/1694270.png,0,0.9446504712104796,87,115,343,371,256,256,twilight sparkle,theperfecta
1694375.png,https://derpicdn.net/img/view/2018/3/30/1694375.png,0,0.9569258093833924,448,49,786,387,338,338,twilight sparkle,squeakshimi
1694618.png,https://derpicdn.net/img/view/2018/3/30/1694618.png,0,0.9988073706626892,1221,806,2129,1714,908,908,twilight sparkle,theartistsora
1696150.png,https://derpicdn.net/img/view/2018/4/1/1696150.png,0,0.983832597732544,87,16,1397,1326,1310,1310,twilight sparkle,jykinturah
1699763.png,https://derpicdn.net/img/view/2018/4/5/1699763.png,0,0.9867494106292723,562,0,1450,832,888,832,twilight sparkle,
1700894.png,https://derpicdn.net/img/view/2018/4/6/1700894.png,1,0.9867130517959596,896,79,1156,339,260,260,twilight sparkle,
1701109.png,https://derpicdn.net/img/view/2018/4/6/1701109.png,0,0.971464455127716,193,0,1147,720,954,720,twilight sparkle,
1710193.png,https://derpicdn.net/img/view/2018/4/17/1710193.png,0,0.9846460223197936,529,759,917,1147,388,388,twilight sparkle,fireheartsk
1710203.png,https://derpicdn.net/img/view/2018/4/17/1710203.png,0,0.9995692372322084,310,282,848,820,538,538,twilight sparkle,fireheartsk
1710422.png,https://derpicdn.net/img/view/2018/4/17/1710422.png,0,0.9955015778541564,175,0,609,430,434,430,twilight sparkle,waterz-colrxz
1713767.png,https://derpicdn.net/img/view/2018/4/21/1713767.png,0,0.9705072045326232,773,1093,1681,2001,908,908,twilight sparkle,
1714412.png,https://derpicdn.net/img/view/2018/4/22/1714412.png,0,0.9724566340446472,196,0,380,176,184,176,twilight sparkle,
1714746.png,https://derpicdn.net/img/view/2018/4/22/1714746.png,0,0.9170310497283936,780,266,2136,1622,1356,1356,twilight sparkle,athan
1717750.png,https://derpicdn.net/img/view/2018/4/26/1717750.png,0,0.9658864736557008,0,200,3928,4600,3928,4400,twilight sparkle,estories
1718311.png,https://derpicdn.net/img/view/2018/4/27/1718311.png,0,0.99754536151886,577,0,1431,821,854,821,twilight sparkle,neyonic
1719029.png,https://derpicdn.net/img/view/2018/4/28/1719029.png,0,0.987480401992798,5,39,579,613,574,574,twilight sparkle,threetwotwo32232
1723376.png,https://derpicdn.net/img/view/2018/5/3/1723376.png,0,0.9794954657554626,187,0,683,494,496,494,twilight sparkle,imaplatypus
1723964.png,https://derpicdn.net/img/view/2018/5/4/1723964.png,0,0.9928169846534728,0,69,921,1033,921,964,twilight sparkle,scalestroke315
1725724.png,https://derpicdn.net/img/view/2018/5/6/1725724.png,0,0.9614969491958618,410,70,858,518,448,448,twilight sparkle,rossignolet
1725724.png,https://derpicdn.net/img/view/2018/5/6/1725724.png,1,0.9110991954803468,226,583,408,765,182,182,twilight sparkle,rossignolet
1728282.png,https://derpicdn.net/img/view/2018/5/9/1728282.png,0,0.933225393295288,692,95,1862,1265,1170,1170,twilight sparkle,angelbeedrawings
1729262.png,https://derpicdn.net/img/view/2018/5/10/1729262.png,0,0.9570055603981018,0,0,950,990,950,990,twilight sparkle,ghosttown1195
1729818.png,https://derpicdn.net/img/view/2018/5/11/1729818.png,0,0.9885580539703368,225,0,583,310,358,310,twilight sparkle,
1731930.png,https://derpicdn.net/img/view/2018/5/13/1731930.png,0,0.9551497101783752,243,0,1239,943,996,943,twilight sparkle,azure-art-wave
1735236.png,https://derpicdn.net/img/view/2018/5/18/1735236.png,0,0.9993633031845092,393,130,3349,3086,2956,2956,twilight sparkle,parclytaxel
1738146.png,https://derpicdn.net/img/view/2018/5/21/1738146.png,0,0.999423325061798,29,0,431,392,402,392,twilight sparkle,deraniel
1741413.png,https://derpicdn.net/img/view/2018/5/26/1741413.png,0,0.9976131916046144,80,0,722,597,642,597,twilight sparkle,kotowataczekolada
174257.jpg,https://derpicdn.net/img/view/2012/12/6/174257.jpg,0,0.9928008317947388,93,0,633,481,540,481,twilight sparkle,mysteryrose
1743579.png,https://derpicdn.net/img/view/2018/5/28/1743579.png,0,0.9972047209739684,294,77,560,343,266,266,twilight sparkle,ofruittango
1743826.png,https://derpicdn.net/img/view/2018/5/28/1743826.png,0,0.9752509593963624,443,0,851,368,408,368,twilight sparkle,envygirl95
1744024.png,https://derpicdn.net/img/view/2018/5/28/1744024.png,0,0.9868451952934264,938,0,1480,525,542,525,twilight sparkle,sintakhra
1745884.png,https://derpicdn.net/img/view/2018/5/31/1745884.png,0,0.982690691947937,96,0,570,447,474,447,twilight sparkle,
1746025.png,https://derpicdn.net/img/view/2018/5/31/1746025.png,0,0.9155919551849364,2294,7,5000,2859,2706,2852,twilight sparkle,dashiesparkle
1746880.png,https://derpicdn.net/img/view/2018/6/1/1746880.png,0,0.9194365739822388,0,27,474,615,474,588,twilight sparkle,
1750976.png,https://derpicdn.net/img/view/2018/6/6/1750976.png,0,0.9734163284301758,276,143,522,389,246,246,twilight sparkle,cckittycreative
1751298.png,https://derpicdn.net/img/view/2018/6/6/1751298.png,0,0.9360354542732242,110,0,876,576,766,576,twilight sparkle,beanswithsauce
1754525.png,https://derpicdn.net/img/view/2018/6/10/1754525.png,0,0.9991919994354248,1345,96,3107,1858,1762,1762,twilight sparkle,famousmari5
1755324.png,https://derpicdn.net/img/view/2018/6/11/1755324.png,0,0.9498386979103088,313,0,1424,1080,1111,1080,twilight sparkle,
1756024.png,https://derpicdn.net/img/view/2018/6/12/1756024.png,0,0.9917948842048644,310,72,646,408,336,336,twilight sparkle,catofrage
1759477.png,https://derpicdn.net/img/view/2018/6/17/1759477.png,0,0.974575400352478,692,554,1490,1352,798,798,twilight sparkle,nightpaint12
1759477.png,https://derpicdn.net/img/view/2018/6/17/1759477.png,1,0.9008762240409852,1338,191,2268,1121,930,930,twilight sparkle,nightpaint12
1765473.png,https://derpicdn.net/img/view/2018/6/25/1765473.png,0,0.9997889399528505,382,0,744,347,362,347,twilight sparkle,sigmatura
1769215.png,https://derpicdn.net/img/view/2018/6/30/1769215.png,0,0.9856836795806884,145,0,1935,1594,1790,1594,twilight sparkle,8bitgalaxy
177036.png,https://derpicdn.net/img/view/2012/12/9/177036.png,0,0.9751821160316468,0,70,844,931,844,861,twilight sparkle,
1770525.png,https://derpicdn.net/img/view/2018/7/1/1770525.png,0,0.9903379678726196,406,0,934,512,528,512,twilight sparkle,infinitewarlock
1772109.png,https://derpicdn.net/img/view/2018/7/3/1772109.png,0,0.937002956867218,1451,696,1927,1172,476,476,twilight sparkle,renka2802|tigra0118
1772438.png,https://derpicdn.net/img/view/2018/7/4/1772438.png,0,0.9881505370140076,1473,238,3995,2760,2522,2522,twilight sparkle,andoanimalia
1775266.png,https://derpicdn.net/img/view/2018/7/7/1775266.png,0,0.9827675223350524,0,0,709,758,709,758,twilight sparkle,akashasi
1775382.png,https://derpicdn.net/img/view/2018/7/7/1775382.png,0,0.9298726916313172,1268,0,3156,1817,1888,1817,twilight sparkle,andoanimalia
1775862.png,https://derpicdn.net/img/view/2018/7/8/1775862.png,0,0.9956057667732242,96,0,1300,1006,1204,1006,twilight sparkle,firepetalfox
1776777.png,https://derpicdn.net/img/view/2018/7/9/1776777.png,0,0.9877499938011168,0,0,1371,1673,1371,1673,twilight sparkle,rozzertrask
1778371.png,https://derpicdn.net/img/view/2018/7/11/1778371.png,0,0.9834089875221252,1403,0,4335,2890,2932,2890,twilight sparkle,moon-rose-rosie
1779127.png,https://derpicdn.net/img/view/2018/7/12/1779127.png,0,0.9265611171722412,109,30,729,650,620,620,twilight sparkle,caek|colorlesscupcake
1780489.png,https://derpicdn.net/img/view/2018/7/14/1780489.png,0,0.9980326890945436,148,0,684,534,536,534,twilight sparkle,luulyh
1784789.png,https://derpicdn.net/img/view/2018/7/19/1784789.png,0,0.9729918241500854,111,3,591,483,480,480,twilight sparkle,parallel black
1786360.png,https://derpicdn.net/img/view/2018/7/21/1786360.png,0,0.9986478686332704,895,0,1385,457,490,457,twilight sparkle,bcrich40
1789150.png,https://derpicdn.net/img/view/2018/7/25/1789150.png,0,0.9990099668502808,920,1058,1592,1730,672,672,twilight sparkle,milkychocoberry
1791201.png,https://derpicdn.net/img/view/2018/7/27/1791201.png,0,0.9988191723823548,1807,685,2875,1753,1068,1068,twilight sparkle,ejlightning007arts
1793383.png,https://derpicdn.net/img/view/2018/7/30/1793383.png,0,0.9915421009063721,3348,638,6704,3994,3356,3356,twilight sparkle,dragonchaser123
1793386.png,https://derpicdn.net/img/view/2018/7/30/1793386.png,0,0.9914064407348632,620,0,1810,1000,1190,1000,twilight sparkle,yognaughtsteve
1795984.png,https://derpicdn.net/img/view/2018/8/2/1795984.png,0,0.9949419498443604,574,0,916,315,342,315,twilight sparkle,
1796334.png,https://derpicdn.net/img/view/2018/8/2/1796334.png,0,0.9920704364776612,0,43,1908,2003,1908,1960,twilight sparkle,paulysentry
1796459.png,https://derpicdn.net/img/view/2018/8/3/1796459.png,0,0.9932699203491212,255,123,733,601,478,478,twilight sparkle,baigak
1796516.png,https://derpicdn.net/img/view/2018/8/3/1796516.png,0,0.9933357238769532,32,0,496,425,464,425,twilight sparkle,mysticcoral
1796663.png,https://derpicdn.net/img/view/2018/8/3/1796663.png,0,0.9979212284088136,0,45,1663,1787,1663,1742,twilight sparkle,sketchmcreations
1799210.png,https://derpicdn.net/img/view/2018/8/6/1799210.png,0,0.9840527176856996,1301,212,3277,2282,1976,2070,twilight sparkle,electrochoc
1799375.png,https://derpicdn.net/img/view/2018/8/6/1799375.png,0,0.9903548955917358,2359,0,7800,5535,5441,5535,twilight sparkle,surprisepi
1800317.png,https://derpicdn.net/img/view/2018/8/7/1800317.png,0,0.9772912859916688,252,146,2054,1948,1802,1802,twilight sparkle,sintakhra
1801113.png,https://derpicdn.net/img/view/2018/8/8/1801113.png,0,0.9877877831459044,613,0,4869,3954,4256,3954,twilight sparkle,hoofwaffe
1804180.png,https://derpicdn.net/img/view/2018/8/11/1804180.png,0,0.9699993133544922,0,0,1206,1079,1206,1079,twilight sparkle,
1808167.png,https://derpicdn.net/img/view/2018/8/16/1808167.png,0,0.9430481791496276,834,118,2500,1784,1666,1666,twilight sparkle,fedairkid
1809326.png,https://derpicdn.net/img/view/2018/8/17/1809326.png,0,0.9869967699050904,0,0,576,618,576,618,twilight sparkle,crystalmagic6
1809803.png,https://derpicdn.net/img/view/2018/8/18/1809803.png,0,0.9915659427642822,0,0,704,769,704,769,twilight sparkle,0bloodyscene
1812568.png,https://derpicdn.net/img/view/2018/8/21/1812568.png,0,0.9984169602394104,12,0,1752,1405,1740,1405,twilight sparkle,cinnamontee
1812773.png,https://derpicdn.net/img/view/2018/8/21/1812773.png,0,0.9944862723350524,0,8,571,608,571,600,twilight sparkle,spellboundcanvas
181429.png,https://derpicdn.net/img/view/2012/12/13/181429.png,0,0.9418846964836121,255,116,453,314,198,198,twilight sparkle,starlight-gaze
1814321.png,https://derpicdn.net/img/view/2018/8/23/1814321.png,0,0.9419822692871094,159,0,807,588,648,588,twilight sparkle,pencils
1816584.png,https://derpicdn.net/img/view/2018/8/26/1816584.png,0,0.9790282845497132,0,0,906,1057,906,1057,twilight sparkle,nitei
1817192.png,https://derpicdn.net/img/view/2018/8/26/1817192.png,0,0.9962678551673888,477,0,1067,576,590,576,twilight sparkle,artiks
1820207.png,https://derpicdn.net/img/view/2018/8/30/1820207.png,0,0.9824997782707214,2484,0,5500,2635,3016,2635,twilight sparkle,sketchmcreations
1820723.png,https://derpicdn.net/img/view/2018/8/30/1820723.png,0,0.9393129944801332,507,22,1197,712,690,690,twilight sparkle,
1822562.png,https://derpicdn.net/img/view/2018/9/2/1822562.png,0,0.9381758570671082,280,127,1392,1239,1112,1112,twilight sparkle,crecious
1822699.png,https://derpicdn.net/img/view/2018/9/2/1822699.png,0,0.9973666071891784,133,0,461,325,328,325,twilight sparkle,nootaz
1823542.png,https://derpicdn.net/img/view/2018/9/3/1823542.png,0,0.9930148124694824,374,23,890,539,516,516,twilight sparkle,blackjack42
1828182.png,https://derpicdn.net/img/view/2018/9/9/1828182.png,0,0.9860996007919312,342,0,870,517,528,517,twilight sparkle,gmt-gabir
1830671.png,https://derpicdn.net/img/view/2018/9/12/1830671.png,0,0.975444495677948,98,0,968,858,870,858,twilight sparkle,sannykat
1833450.png,https://derpicdn.net/img/view/2018/9/15/1833450.png,0,0.9362977743148804,110,0,1294,932,1184,932,twilight sparkle,
1834276.png,https://derpicdn.net/img/view/2018/9/16/1834276.png,0,0.9979878067970276,716,11,1700,995,984,984,twilight sparkle,avastin4
1834432.png,https://derpicdn.net/img/view/2018/9/16/1834432.png,0,0.9966429471969604,79,0,1259,1165,1180,1165,twilight sparkle,shitigal-artust
1834536.png,https://derpicdn.net/img/view/2018/9/17/1834536.png,0,0.9447934031486512,1142,0,1576,425,434,425,twilight sparkle,
1834708.png,https://derpicdn.net/img/view/2018/9/17/1834708.png,0,0.9774963855743408,0,0,433,445,433,445,twilight sparkle,
1836875.png,https://derpicdn.net/img/view/2018/9/20/1836875.png,0,0.9814825654029846,1751,138,4737,3124,2986,2986,twilight sparkle,sketchmcreations
1839956.png,https://derpicdn.net/img/view/2018/9/24/1839956.png,0,0.9989829063415528,4024,102,7347,3692,3323,3590,twilight sparkle,illumnious
1844992.png,https://derpicdn.net/img/view/2018/9/30/1844992.png,0,0.9305339455604552,193,0,1241,1001,1048,1001,twilight sparkle,post-it
1849782.png,https://derpicdn.net/img/view/2018/10/6/1849782.png,0,0.9487437605857848,56,0,900,816,844,816,twilight sparkle,
1850117.png,https://derpicdn.net/img/view/2018/10/7/1850117.png,0,0.9777395725250244,492,540,1518,1566,1026,1026,twilight sparkle,lifesharbinger
1850567.png,https://derpicdn.net/img/view/2018/10/7/1850567.png,0,0.9361855983734132,126,3,406,261,280,258,twilight sparkle,
1852857.png,https://derpicdn.net/img/view/2018/10/10/1852857.png,0,0.9635518193244934,92,0,1584,1080,1492,1080,twilight sparkle,spinostud
1854269.png,https://derpicdn.net/img/view/2018/10/12/1854269.png,0,0.962635338306427,263,0,1536,1292,1273,1292,twilight sparkle,
1854588.png,https://derpicdn.net/img/view/2018/10/12/1854588.png,0,0.9966002106666564,2060,970,2798,1708,738,738,twilight sparkle,vixenwolf123
1854620.png,https://derpicdn.net/img/view/2018/10/12/1854620.png,0,0.9410131573677064,603,855,1459,1711,856,856,twilight sparkle,zsparkonequus
1855723.png,https://derpicdn.net/img/view/2018/10/13/1855723.png,0,0.9943199157714844,202,0,842,608,640,608,twilight sparkle,
1856218.png,https://derpicdn.net/img/view/2018/10/14/1856218.png,0,0.9966542720794678,3435,0,6669,3114,3234,3114,twilight sparkle,estories
1856219.png,https://derpicdn.net/img/view/2018/10/14/1856219.png,0,0.9822034239768982,5205,2280,8825,5900,3620,3620,twilight sparkle,estories
1856655.png,https://derpicdn.net/img/view/2018/10/14/1856655.png,0,0.9820188879966736,49,0,338,324,289,324,twilight sparkle,
1858158.png,https://derpicdn.net/img/view/2018/10/16/1858158.png,0,0.9903420209884644,0,0,463,490,463,490,twilight sparkle,
1860870.png,https://derpicdn.net/img/view/2018/10/19/1860870.png,0,0.9976004362106324,1202,1063,3450,3311,2248,2248,twilight sparkle,fluffyxai
1861516.png,https://derpicdn.net/img/view/2018/10/20/1861516.png,0,0.9941002726554872,2257,233,2913,889,656,656,twilight sparkle,zsparkonequus
1861516.png,https://derpicdn.net/img/view/2018/10/20/1861516.png,1,0.9851321578025818,1349,2231,2045,2927,696,696,twilight sparkle,zsparkonequus
1861516.png,https://derpicdn.net/img/view/2018/10/20/1861516.png,2,0.9654109477996826,153,2222,887,2956,734,734,twilight sparkle,zsparkonequus
1861516.png,https://derpicdn.net/img/view/2018/10/20/1861516.png,3,0.9644264578819276,3341,40,4173,872,832,832,twilight sparkle,zsparkonequus
1863628.png,https://derpicdn.net/img/view/2018/10/23/1863628.png,0,0.998343825340271,81,1177,1213,2309,1132,1132,twilight sparkle,cloureed
1867480.png,https://derpicdn.net/img/view/2018/10/27/1867480.png,0,0.957455575466156,48,0,532,438,484,438,twilight sparkle,
1867757.png,https://derpicdn.net/img/view/2018/10/27/1867757.png,0,0.9883607625961304,85,0,801,629,716,629,twilight sparkle,
1868079.png,https://derpicdn.net/img/view/2018/10/28/1868079.png,0,0.9762875437736512,118,0,1000,827,882,827,twilight sparkle,notaletolivefor|lorenz3
1869626.png,https://derpicdn.net/img/view/2018/10/29/1869626.png,0,0.9983161687850952,605,17,1207,619,602,602,twilight sparkle,棘有棘無棘棘
1872319.png,https://derpicdn.net/img/view/2018/11/1/1872319.png,0,0.9763378500938416,0,0,281,333,281,333,twilight sparkle,m-00nlight
1874467.png,https://derpicdn.net/img/view/2018/11/4/1874467.png,0,0.9503003358840942,99,64,391,356,292,292,twilight sparkle,scape-goats
1877696.png,https://derpicdn.net/img/view/2018/11/8/1877696.png,0,0.9905330538749696,13,0,1221,720,1208,720,twilight sparkle,
1877981.png,https://derpicdn.net/img/view/2018/11/8/1877981.png,0,0.9729361534118652,3486,123,4016,653,530,530,twilight sparkle,uunicornicc
1877981.png,https://derpicdn.net/img/view/2018/11/8/1877981.png,1,0.922872006893158,66,649,640,1223,574,574,twilight sparkle,uunicornicc
187819.png,https://derpicdn.net/img/view/2012/12/19/187819.png,0,0.9534932374954224,718,63,1318,663,600,600,twilight sparkle,shelltoon
1879725.png,https://derpicdn.net/img/view/2018/11/11/1879725.png,0,0.994330644607544,729,290,1119,680,390,390,twilight sparkle,
1879868.png,https://derpicdn.net/img/view/2018/11/11/1879868.png,0,0.932913303375244,3442,781,6294,3633,2852,2852,twilight sparkle,cirillaq
1881576.png,https://derpicdn.net/img/view/2018/11/13/1881576.png,0,0.953633725643158,61,159,1229,1327,1168,1168,twilight sparkle,zsparkonequus
1882873.png,https://derpicdn.net/img/view/2018/11/15/1882873.png,0,0.999642848968506,31,0,361,320,330,320,twilight sparkle,usattesa
1884363.png,https://derpicdn.net/img/view/2018/11/17/1884363.png,0,0.9944117665290833,1307,273,2000,971,693,698,twilight sparkle,scobionicle99
1886135.png,https://derpicdn.net/img/view/2018/11/19/1886135.png,0,0.9572737216949464,622,243,1216,837,594,594,twilight sparkle,cubbybatdoodles
1887904.png,https://derpicdn.net/img/view/2018/11/21/1887904.png,0,0.9954925179481506,394,0,844,428,450,428,twilight sparkle,bitshift
1889612.png,https://derpicdn.net/img/view/2018/11/24/1889612.png,0,0.9966782927513124,168,48,632,512,464,464,twilight sparkle,ridgessky
1890025.png,https://derpicdn.net/img/view/2018/11/24/1890025.png,0,0.9108852744102478,822,1242,1924,2344,1102,1102,twilight sparkle,radiativespingear
1891753.png,https://derpicdn.net/img/view/2018/11/26/1891753.png,0,0.962263822555542,66,72,194,200,128,128,twilight sparkle,autumnbramble
1893233.png,https://derpicdn.net/img/view/2018/11/28/1893233.png,0,0.9976562261581421,6,0,590,548,584,548,twilight sparkle,gleamydreams
1895335.png,https://derpicdn.net/img/view/2018/12/1/1895335.png,0,0.9968255162239076,475,0,1721,1209,1246,1209,twilight sparkle,etoz
1895749.png,https://derpicdn.net/img/view/2018/12/1/1895749.png,0,0.9987152814865112,474,300,1086,912,612,612,twilight sparkle,taxar
1900682.png,https://derpicdn.net/img/view/2018/12/6/1900682.png,0,0.9898620843887328,413,187,657,431,244,244,twilight sparkle,anontheanon
1900691.png,https://derpicdn.net/img/view/2018/12/7/1900691.png,0,0.99972802400589,407,0,727,280,320,280,twilight sparkle,anontheanon
1900692.png,https://derpicdn.net/img/view/2018/12/7/1900692.png,0,0.9996713399887084,332,0,678,289,346,289,twilight sparkle,anontheanon
1900820.png,https://derpicdn.net/img/view/2018/12/7/1900820.png,0,0.9877793192863464,0,3191,1744,4960,1744,1769,twilight sparkle,
1900820.png,https://derpicdn.net/img/view/2018/12/7/1900820.png,1,0.9715630412101746,315,1640,1507,2832,1192,1192,twilight sparkle,
1901854.png,https://derpicdn.net/img/view/2018/12/8/1901854.png,1,0.9499260187149048,557,146,849,438,292,292,twilight sparkle,starloo
1906575.png,https://derpicdn.net/img/view/2018/12/12/1906575.png,0,0.9912618398666382,3,0,645,552,642,552,twilight sparkle,
1907803.png,https://derpicdn.net/img/view/2018/12/14/1907803.png,0,0.989454448223114,0,0,599,598,599,598,twilight sparkle,
1912146.png,https://derpicdn.net/img/view/2018/12/18/1912146.png,0,0.9946949481964112,132,12,882,762,750,750,twilight sparkle,cloudyglow
1913061.png,https://derpicdn.net/img/view/2018/12/19/1913061.png,0,0.980696976184845,290,95,604,409,314,314,twilight sparkle,conphettey
1913679.png,https://derpicdn.net/img/view/2018/12/20/1913679.png,0,0.9997645020484924,590,0,1162,563,572,563,twilight sparkle,erroremma
1920511.png,https://derpicdn.net/img/view/2018/12/28/1920511.png,0,0.9934547543525696,102,0,1842,1080,1740,1080,twilight sparkle,szczerbix
1925100.png,https://derpicdn.net/img/view/2019/1/2/1925100.png,0,0.949030339717865,0,0,583,579,583,579,twilight sparkle,euphoriapony
1926793.png,https://derpicdn.net/img/view/2019/1/5/1926793.png,0,0.9923139214515686,5365,0,11203,5573,5838,5573,twilight sparkle,sinkbon
1926851.png,https://derpicdn.net/img/view/2019/1/5/1926851.png,0,0.9959835410118104,133,8,573,448,440,440,twilight sparkle,kakyoim
1928322.png,https://derpicdn.net/img/view/2019/1/6/1928322.png,0,0.9554909467697144,0,61,515,579,515,518,twilight sparkle,
1930031.png,https://derpicdn.net/img/view/2019/1/8/1930031.png,0,0.9938938021659852,214,12,1462,1260,1248,1248,twilight sparkle,shad0w-galaxy
1936351.png,https://derpicdn.net/img/view/2019/1/15/1936351.png,0,0.9828004837036132,1040,0,3274,2149,2234,2149,twilight sparkle,dashiesparkle
1937137.png,https://derpicdn.net/img/view/2019/1/16/1937137.png,0,0.9811055660247804,432,0,1018,495,586,495,twilight sparkle,
1937455.png,https://derpicdn.net/img/view/2019/1/17/1937455.png,0,0.9994139671325684,564,66,962,464,398,398,twilight sparkle,metal-kitty
1937455.png,https://derpicdn.net/img/view/2019/1/17/1937455.png,1,0.9991648197174072,24,95,400,471,376,376,twilight sparkle,metal-kitty
193860.png,https://derpicdn.net/img/view/2012/12/26/193860.png,0,0.9969027042388916,106,0,340,231,234,231,twilight sparkle,chiakitasso
1939171.png,https://derpicdn.net/img/view/2019/1/19/1939171.png,0,0.973441481590271,1980,3,4856,2879,2876,2876,twilight sparkle,estories
1939172.png,https://derpicdn.net/img/view/2019/1/19/1939172.png,0,0.9539986252784728,3194,216,6666,3688,3472,3472,twilight sparkle,estories
1939173.png,https://derpicdn.net/img/view/2019/1/19/1939173.png,0,0.9814021587371826,200,198,2786,2784,2586,2586,twilight sparkle,estories
1942807.png,https://derpicdn.net/img/view/2019/1/23/1942807.png,0,0.997864305973053,177,0,589,395,412,395,twilight sparkle,chef j
1946195.png,https://derpicdn.net/img/view/2019/1/27/1946195.png,0,0.9733662009239196,130,0,702,644,572,644,twilight sparkle,
1948102.png,https://derpicdn.net/img/view/2019/1/29/1948102.png,0,0.9430111646652222,991,0,4847,3202,3856,3202,twilight sparkle,tomfraggle
1948106.png,https://derpicdn.net/img/view/2019/1/29/1948106.png,0,0.9975821375846864,172,40,1926,1794,1754,1754,twilight sparkle,tomfraggle
1948777.png,https://derpicdn.net/img/view/2019/1/30/1948777.png,0,0.9920541644096376,189,0,1531,1091,1342,1091,twilight sparkle,zeka10000
1949120.png,https://derpicdn.net/img/view/2019/1/31/1949120.png,0,0.927985429763794,475,76,871,472,396,396,twilight sparkle,
1949279.png,https://derpicdn.net/img/view/2019/1/31/1949279.png,0,0.9809683561325072,35,11,581,557,546,546,twilight sparkle,zaphy1415926
1949637.png,https://derpicdn.net/img/view/2019/1/31/1949637.png,0,0.9722100496292114,294,0,956,591,662,591,twilight sparkle,
1950682.png,https://derpicdn.net/img/view/2019/2/1/1950682.png,0,0.9998214840888976,896,113,1514,731,618,618,twilight sparkle,deltahedgehog
1950682.png,https://derpicdn.net/img/view/2019/2/1/1950682.png,1,0.9953896999359132,509,94,1103,688,594,594,twilight sparkle,deltahedgehog
1951508.png,https://derpicdn.net/img/view/2019/2/2/1951508.png,0,0.9230005145072936,43,71,973,1001,930,930,twilight sparkle,nocturnal-moonlight
1962006.png,https://derpicdn.net/img/view/2019/2/14/1962006.png,0,0.9944086670875548,559,279,1687,1407,1128,1128,twilight sparkle,larrykitty
1963054.png,https://derpicdn.net/img/view/2019/2/15/1963054.png,0,0.9893000721931458,0,68,746,820,746,752,twilight sparkle,gintoki23
1963656.png,https://derpicdn.net/img/view/2019/2/16/1963656.png,0,0.9893640875816344,421,0,1441,902,1020,902,twilight sparkle,rainbow eevee
1963791.png,https://derpicdn.net/img/view/2019/2/16/1963791.png,0,0.928787112236023,33,0,1147,1089,1114,1089,twilight sparkle,tentinythimbles
1963843.png,https://derpicdn.net/img/view/2019/2/16/1963843.png,0,0.974639892578125,1541,466,2681,1606,1140,1140,twilight sparkle,loveslove
1965436.png,https://derpicdn.net/img/view/2019/2/18/1965436.png,0,0.9844596385955808,134,27,708,635,574,608,twilight sparkle,
1965454.png,https://derpicdn.net/img/view/2019/2/18/1965454.png,0,0.9672229290008544,101,0,631,565,530,565,twilight sparkle,
1966293.png,https://derpicdn.net/img/view/2019/2/19/1966293.png,0,0.9508469700813292,86,0,308,217,222,217,twilight sparkle,
1966604.png,https://derpicdn.net/img/view/2019/2/20/1966604.png,0,0.9806779026985168,333,39,723,429,390,390,twilight sparkle,
1968720.png,https://derpicdn.net/img/view/2019/2/22/1968720.png,0,0.9990354776382446,481,400,927,846,446,446,twilight sparkle,tf-sential
1968720.png,https://derpicdn.net/img/view/2019/2/22/1968720.png,1,0.9894684553146362,43,112,345,414,302,302,twilight sparkle,tf-sential
1970095.png,https://derpicdn.net/img/view/2019/2/23/1970095.png,0,0.9811516404151917,14,0,632,614,618,614,twilight sparkle,
197102.png,https://derpicdn.net/img/view/2012/12/29/197102.png,0,0.9828897714614868,382,0,1280,915,898,915,twilight sparkle,foxy-noxy
1972475.png,https://derpicdn.net/img/view/2019/2/26/1972475.png,0,0.9361557960510254,200,0,1918,1591,1718,1591,twilight sparkle,n0kkun
1972676.png,https://derpicdn.net/img/view/2019/2/27/1972676.png,0,0.9928359389305116,231,59,609,437,378,378,twilight sparkle,danton-y17
1973457.png,https://derpicdn.net/img/view/2019/2/28/1973457.png,0,0.9880719780921936,1027,152,1935,1060,908,908,twilight sparkle,andypriceart|koolfrood
1973457.png,https://derpicdn.net/img/view/2019/2/28/1973457.png,1,0.9740522503852844,422,208,1278,1064,856,856,twilight sparkle,andypriceart|koolfrood
1974203.png,https://derpicdn.net/img/view/2019/3/1/1974203.png,0,0.9889710545539856,75,16,801,742,726,726,twilight sparkle,
1974278.png,https://derpicdn.net/img/view/2019/3/1/1974278.png,0,0.9991866946220398,28,38,606,616,578,578,twilight sparkle,bunnini
1975767.png,https://derpicdn.net/img/view/2019/3/2/1975767.png,0,0.9907240867614746,113,41,781,709,668,668,twilight sparkle,
1976277.png,https://derpicdn.net/img/view/2019/3/3/1976277.png,0,0.9857362508773804,0,0,476,560,476,560,twilight sparkle,
1976869.png,https://derpicdn.net/img/view/2019/3/3/1976869.png,0,0.9565997123718262,206,65,970,829,764,764,twilight sparkle,icywindthepony
1978513.png,https://derpicdn.net/img/view/2019/3/6/1978513.png,0,0.9963014125823976,492,0,1408,844,916,844,twilight sparkle,
1979081.png,https://derpicdn.net/img/view/2019/3/6/1979081.png,0,0.9867637157440186,126,19,884,797,758,778,twilight sparkle,
1980684.png,https://derpicdn.net/img/view/2019/3/8/1980684.png,1,0.951161801815033,531,136,727,332,196,196,twilight sparkle,
1981200.png,https://derpicdn.net/img/view/2019/3/9/1981200.png,0,0.9710565209388732,750,358,1346,954,596,596,twilight sparkle,whalepornoz
1981239.png,https://derpicdn.net/img/view/2019/3/9/1981239.png,0,0.9961470365524292,1817,57,3287,1527,1470,1470,twilight sparkle,robsa990
1981511.png,https://derpicdn.net/img/view/2019/3/9/1981511.png,0,0.98666912317276,0,0,857,823,857,823,twilight sparkle,
1982137.png,https://derpicdn.net/img/view/2019/3/10/1982137.png,0,0.9972437620162964,581,13,1341,773,760,760,twilight sparkle,schokocream
1982837.png,https://derpicdn.net/img/view/2019/3/11/1982837.png,0,0.9799546599388124,601,74,1393,866,792,792,twilight sparkle,lifesharbinger
1983831.png,https://derpicdn.net/img/view/2019/3/12/1983831.png,0,0.9906318187713624,174,17,770,613,596,596,twilight sparkle,
1984662.png,https://derpicdn.net/img/view/2019/3/13/1984662.png,0,0.9849669337272644,280,0,1252,929,972,929,twilight sparkle,
1984894.png,https://derpicdn.net/img/view/2019/3/14/1984894.png,0,0.9690387845039368,482,0,1120,621,638,621,twilight sparkle,
1985105.png,https://derpicdn.net/img/view/2019/3/14/1985105.png,0,0.9740854501724244,434,503,1142,1211,708,708,twilight sparkle,inersdraco
1985258.png,https://derpicdn.net/img/view/2019/3/14/1985258.png,0,0.9834941625595092,42,0,872,788,830,788,twilight sparkle,
1985330.png,https://derpicdn.net/img/view/2019/3/14/1985330.png,0,0.9368549585342408,693,110,1577,939,884,829,twilight sparkle,
1985331.png,https://derpicdn.net/img/view/2019/3/14/1985331.png,0,0.9773730039596558,50,22,308,280,258,258,twilight sparkle,
1988878.png,https://derpicdn.net/img/view/2019/3/18/1988878.png,0,0.927873969078064,481,50,893,486,412,436,twilight sparkle,
1989683.png,https://derpicdn.net/img/view/2019/3/19/1989683.png,0,0.9947274923324584,402,0,798,387,396,387,twilight sparkle,
1990972.png,https://derpicdn.net/img/view/2019/3/20/1990972.png,0,0.990058660507202,343,27,907,591,564,564,twilight sparkle,eudaemonix
1991165.png,https://derpicdn.net/img/view/2019/3/21/1991165.png,0,0.9994105696678162,0,11,680,711,680,700,twilight sparkle,eudaemonix
1991167.png,https://derpicdn.net/img/view/2019/3/21/1991167.png,0,0.9046703577041626,67,0,969,1029,902,1029,twilight sparkle,eudaemonix
1991232.png,https://derpicdn.net/img/view/2019/3/21/1991232.png,0,0.9145779013633728,294,12,965,660,671,648,twilight sparkle,
1993565.png,https://derpicdn.net/img/view/2019/3/24/1993565.png,0,0.9962237477302552,128,94,2098,2064,1970,1970,twilight sparkle,winter-scarf
1994688.png,https://derpicdn.net/img/view/2019/3/25/1994688.png,0,0.9091936349868774,83,117,871,915,788,798,twilight sparkle,
1996294.png,https://derpicdn.net/img/view/2019/3/27/1996294.png,0,0.9882739186286926,376,3,816,467,440,464,twilight sparkle,
1996296.png,https://derpicdn.net/img/view/2019/3/27/1996296.png,0,0.9482401013374328,456,82,1326,938,870,856,twilight sparkle,
1996969.png,https://derpicdn.net/img/view/2019/3/28/1996969.png,0,0.9897381663322448,212,0,684,400,472,400,twilight sparkle,crystal-bloomyt|pegasski
1999809.png,https://derpicdn.net/img/view/2019/4/1/1999809.png,0,0.9867001175880432,473,179,951,657,478,478,twilight sparkle,lukewarmluke
2001679.png,https://derpicdn.net/img/view/2019/4/3/2001679.png,0,0.9521535634994508,254,398,1340,1484,1086,1086,twilight sparkle,softinen
20018.png,https://derpicdn.net/img/view/2012/6/25/20018.png,0,0.9671250581741332,82,11,488,417,406,406,twilight sparkle,sirachanotsauce|somepony
2002725.png,https://derpicdn.net/img/view/2019/4/4/2002725.png,0,0.9474660754203796,1288,0,5810,3977,4522,3977,twilight sparkle,evilfrenzy
2003032.png,https://derpicdn.net/img/view/2019/4/4/2003032.png,0,0.9915885925292968,227,559,583,915,356,356,twilight sparkle,meekcheep
2003677.png,https://derpicdn.net/img/view/2019/4/5/2003677.png,0,0.9923080205917358,152,283,490,621,338,338,twilight sparkle,wolfkice
2004463.png,https://derpicdn.net/img/view/2019/4/6/2004463.png,0,0.9774115681648254,537,196,2467,2126,1930,1930,twilight sparkle,shkura2011
2004629.png,https://derpicdn.net/img/view/2019/4/6/2004629.png,0,0.9883983135223388,120,63,1018,961,898,898,twilight sparkle,
200522.png,https://derpicdn.net/img/view/2013/1/2/200522.png,0,0.994933009147644,187,0,467,275,280,275,twilight sparkle,blup-chan
2007462.png,https://derpicdn.net/img/view/2019/4/9/2007462.png,0,0.9820774793624878,0,0,628,723,628,723,twilight sparkle,
2008494.png,https://derpicdn.net/img/view/2019/4/10/2008494.png,0,0.9520410895347596,50,1,444,365,394,364,twilight sparkle,verona-5i
2009596.png,https://derpicdn.net/img/view/2019/4/12/2009596.png,1,0.9847224950790404,945,85,2479,1619,1534,1534,twilight sparkle,phucknuckl
2009596.png,https://derpicdn.net/img/view/2019/4/12/2009596.png,2,0.977196216583252,2178,2444,3522,3836,1344,1392,twilight sparkle,phucknuckl
2010917.png,https://derpicdn.net/img/view/2019/4/13/2010917.png,0,0.9822105169296264,171,47,1094,995,923,948,twilight sparkle,
2013891.png,https://derpicdn.net/img/view/2019/4/16/2013891.png,0,0.9934624433517456,186,6,1980,1763,1794,1757,twilight sparkle,
2015219.png,https://derpicdn.net/img/view/2019/4/17/2015219.png,0,0.9842167496681212,17,814,3931,4728,3914,3914,twilight sparkle,korsoo
2015712.png,https://derpicdn.net/img/view/2019/4/18/2015712.png,0,0.9879319667816162,737,0,4985,3988,4248,3988,twilight sparkle,korsoo
2016790.png,https://derpicdn.net/img/view/2019/4/19/2016790.png,0,0.949475646018982,52,3,759,833,707,830,twilight sparkle,
2017697.png,https://derpicdn.net/img/view/2019/4/20/2017697.png,0,0.902420163154602,258,0,1718,1080,1460,1080,twilight sparkle,
2019209.png,https://derpicdn.net/img/view/2019/4/21/2019209.png,0,0.9804278612136841,0,0,1840,1080,1840,1080,twilight sparkle,
2019889.png,https://derpicdn.net/img/view/2019/4/22/2019889.png,0,0.9715026617050172,92,22,776,706,684,684,twilight sparkle,
2019913.png,https://derpicdn.net/img/view/2019/4/22/2019913.png,0,0.9956159591674804,0,0,3276,3490,3276,3490,twilight sparkle,deathnyan|disneymarvel96
2020484.png,https://derpicdn.net/img/view/2019/4/23/2020484.png,0,0.9253677129745485,75,0,1773,1080,1698,1080,twilight sparkle,
2020623.png,https://derpicdn.net/img/view/2019/4/23/2020623.png,0,0.9414821863174438,0,0,641,655,641,655,twilight sparkle,
2022604.png,https://derpicdn.net/img/view/2019/4/25/2022604.png,0,0.9730456471443176,0,0,339,405,339,405,twilight sparkle,
2023138.png,https://derpicdn.net/img/view/2019/4/26/2023138.png,0,0.9901981949806212,1139,129,2647,1637,1508,1508,twilight sparkle,ashidaru
2023387.png,https://derpicdn.net/img/view/2019/4/26/2023387.png,0,0.9814817905426024,96,79,540,523,444,444,twilight sparkle,cappie
2023583.png,https://derpicdn.net/img/view/2019/4/26/2023583.png,0,0.9965655207633972,2501,332,3859,1690,1358,1358,twilight sparkle,gouransion
2023983.png,https://derpicdn.net/img/view/2019/4/27/2023983.png,0,0.911054790019989,26,0,798,795,772,795,twilight sparkle,vaderpl
2024446.png,https://derpicdn.net/img/view/2019/4/27/2024446.png,0,0.9809535145759584,23,0,936,896,913,896,twilight sparkle,
2024447.png,https://derpicdn.net/img/view/2019/4/27/2024447.png,0,0.9671480059623718,197,56,1054,976,857,920,twilight sparkle,
2024895.png,https://derpicdn.net/img/view/2019/4/28/2024895.png,0,0.952180027961731,487,333,6209,6055,5722,5722,twilight sparkle,fallingferret
2024986.png,https://derpicdn.net/img/view/2019/4/28/2024986.png,0,0.9293615221977234,0,10,387,468,387,458,twilight sparkle,
2026282.png,https://derpicdn.net/img/view/2019/4/29/2026282.png,0,0.9660207629203796,36,36,322,322,286,286,twilight sparkle,
2026569.png,https://derpicdn.net/img/view/2019/4/29/2026569.png,0,0.9671826362609864,255,0,3237,2550,2982,2550,twilight sparkle,takaneko13
2027665.png,https://derpicdn.net/img/view/2019/5/1/2027665.png,0,0.9908598065376282,1000,98,2420,1518,1420,1420,twilight sparkle,mrlolcats17
2028387.png,https://derpicdn.net/img/view/2019/5/1/2028387.png,0,0.9781971573829652,15,110,559,654,544,544,twilight sparkle,cloudyglow|phucknuckl
2028690.png,https://derpicdn.net/img/view/2019/5/2/2028690.png,0,0.9735527634620668,1104,119,3396,2411,2292,2292,twilight sparkle,ev04kaa
203174.png,https://derpicdn.net/img/view/2013/1/5/203174.png,0,0.99393492937088,215,57,449,291,234,234,twilight sparkle,lionalliance
2034559.png,https://derpicdn.net/img/view/2019/5/9/2034559.png,0,0.9984723329544068,52,8,560,516,508,508,twilight sparkle,emz2015|php62
2038637.png,https://derpicdn.net/img/view/2019/5/14/2038637.png,0,0.9696711301803588,92,5,490,403,398,398,twilight sparkle,samsx22
2044514.png,https://derpicdn.net/img/view/2019/5/20/2044514.png,0,0.9990055561065674,1337,128,3481,2272,2144,2144,twilight sparkle,vvolllovv
2046324.png,https://derpicdn.net/img/view/2019/5/22/2046324.png,0,0.9981462359428406,719,35,3311,2627,2592,2592,twilight sparkle,vvolllovv
204769.png,https://derpicdn.net/img/view/2013/1/7/204769.png,0,0.9806256294250488,20,11,220,211,200,200,twilight sparkle,lulubell
2049679.png,https://derpicdn.net/img/view/2019/5/26/2049679.png,0,0.9878519177436828,370,0,1222,886,852,886,twilight sparkle,
2051306.png,https://derpicdn.net/img/view/2019/5/28/2051306.png,0,0.9889534711837769,44,0,552,479,508,479,twilight sparkle,quanno3|statoose
2052899.png,https://derpicdn.net/img/view/2019/5/29/2052899.png,0,0.95323246717453,926,0,1798,833,872,833,twilight sparkle,mwerrycult
2053328.png,https://derpicdn.net/img/view/2019/5/30/2053328.png,0,0.950345814228058,0,80,5707,6258,5707,6178,twilight sparkle,vvolllovv
2054877.png,https://derpicdn.net/img/view/2019/6/1/2054877.png,0,0.9183143377304076,0,82,692,790,692,708,twilight sparkle,voidsucre
20554.jpg,https://derpicdn.net/img/view/2012/6/25/20554.jpg,1,0.9537844657897948,2573,89,3213,729,640,640,twilight sparkle,bunnimation
2061655.png,https://derpicdn.net/img/view/2019/6/9/2061655.png,0,0.9504020810127258,0,40,459,514,459,474,twilight sparkle,rainbow eevee
2064952.png,https://derpicdn.net/img/view/2019/6/14/2064952.png,0,0.9996095299720764,321,425,797,901,476,476,twilight sparkle,chaosmalefic
2064959.png,https://derpicdn.net/img/view/2019/6/14/2064959.png,0,0.9176378846168518,1136,2107,2512,3483,1376,1376,twilight sparkle,chaosmalefic
2074539.png,https://derpicdn.net/img/view/2019/6/24/2074539.png,0,0.9948770403862,125,0,1761,1533,1636,1533,twilight sparkle,sazanamibd
2076216.png,https://derpicdn.net/img/view/2019/6/27/2076216.png,0,0.9983320236206056,309,6,743,440,434,434,twilight sparkle,chaosmalefic
2076307.png,https://derpicdn.net/img/view/2019/6/27/2076307.png,0,0.9816928505897522,0,0,795,791,795,791,twilight sparkle,
2077662.png,https://derpicdn.net/img/view/2019/6/28/2077662.png,0,0.9039790630340576,0,16,514,530,514,514,twilight sparkle,
2077816.png,https://derpicdn.net/img/view/2019/6/28/2077816.png,0,0.975533664226532,434,393,1396,1355,962,962,twilight sparkle,coldtrail
2078418.png,https://derpicdn.net/img/view/2019/6/29/2078418.png,0,0.9244505763053894,167,213,529,575,362,362,twilight sparkle,blanishna|bbbhuey
2078583.png,https://derpicdn.net/img/view/2019/6/29/2078583.png,0,0.9271003603935242,0,0,406,394,406,394,twilight sparkle,
2078876.png,https://derpicdn.net/img/view/2019/6/29/2078876.png,0,0.942826807498932,1139,536,1977,1374,838,838,twilight sparkle,wingcut
2079555.png,https://derpicdn.net/img/view/2019/6/30/2079555.png,0,0.9914357662200928,59,16,967,924,908,908,twilight sparkle,
2079719.png,https://derpicdn.net/img/view/2019/6/30/2079719.png,0,0.9567986726760864,220,0,903,616,683,616,twilight sparkle,
2086430.png,https://derpicdn.net/img/view/2019/7/8/2086430.png,0,0.9512094855308532,37,25,526,521,489,496,twilight sparkle,
2087448.png,https://derpicdn.net/img/view/2019/7/9/2087448.png,0,0.9991406202316284,409,109,1057,757,648,648,twilight sparkle,
2089839.png,https://derpicdn.net/img/view/2019/7/12/2089839.png,0,0.9972438216209412,1406,343,1856,793,450,450,twilight sparkle,nightmaremoons
2089839.png,https://derpicdn.net/img/view/2019/7/12/2089839.png,1,0.9963045716285706,380,324,850,794,470,470,twilight sparkle,nightmaremoons
2089839.png,https://derpicdn.net/img/view/2019/7/12/2089839.png,2,0.9533810615539552,1580,1090,2098,1608,518,518,twilight sparkle,nightmaremoons
2094753.png,https://derpicdn.net/img/view/2019/7/18/2094753.png,0,0.9746193885803224,0,0,494,491,494,491,twilight sparkle,bartholomaei
2095301.png,https://derpicdn.net/img/view/2019/7/18/2095301.png,0,0.9960350394248962,0,114,1685,1932,1685,1818,twilight sparkle,andoanimalia
2102078.png,https://derpicdn.net/img/view/2019/7/27/2102078.png,0,0.9670541882514954,1275,533,2233,1491,958,958,twilight sparkle,janji009
2105183.png,https://derpicdn.net/img/view/2019/7/30/2105183.png,0,0.9796334505081176,0,0,1045,1079,1045,1079,twilight sparkle,junkiesnewb
2107261.png,https://derpicdn.net/img/view/2019/8/2/2107261.png,0,0.9423161149024964,214,0,1500,1080,1286,1080,twilight sparkle,
2107722.png,https://derpicdn.net/img/view/2019/8/3/2107722.png,0,0.9981181621551514,14,0,252,235,238,235,twilight sparkle,pillowrabbit
2112186.png,https://derpicdn.net/img/view/2019/8/8/2112186.png,0,0.9953293204307556,1,0,889,845,888,845,twilight sparkle,
2116156.png,https://derpicdn.net/img/view/2019/8/12/2116156.png,0,0.9993597269058228,308,421,2086,2199,1778,1778,twilight sparkle,worstsousaphonehorse
2117557.png,https://derpicdn.net/img/view/2019/8/14/2117557.png,0,0.991111159324646,36,1,878,843,842,842,twilight sparkle,vanillaswirl6
2118204.png,https://derpicdn.net/img/view/2019/8/14/2118204.png,0,0.9997281432151794,145,0,989,781,844,781,twilight sparkle,poofindi
2122716.png,https://derpicdn.net/img/view/2019/8/20/2122716.png,0,0.994372010231018,388,242,802,656,414,414,twilight sparkle,majupaju
2122716.png,https://derpicdn.net/img/view/2019/8/20/2122716.png,1,0.980391800403595,1063,210,1463,610,400,400,twilight sparkle,majupaju
2122897.png,https://derpicdn.net/img/view/2019/8/20/2122897.png,0,0.9265742897987366,273,43,1647,1417,1374,1374,twilight sparkle,novaspark
2125959.png,https://derpicdn.net/img/view/2019/8/24/2125959.png,0,0.9969088435173036,450,411,1674,1635,1224,1224,twilight sparkle,3000
2126316.png,https://derpicdn.net/img/view/2019/8/24/2126316.png,0,0.9627310037612916,162,0,1034,851,872,851,twilight sparkle,
2129994.png,https://derpicdn.net/img/view/2019/8/28/2129994.png,0,0.9952613711357116,19,217,235,433,216,216,twilight sparkle,
2129994.png,https://derpicdn.net/img/view/2019/8/28/2129994.png,1,0.9481871128082277,216,253,386,423,170,170,twilight sparkle,
2130074.png,https://derpicdn.net/img/view/2019/8/28/2130074.png,0,0.990575909614563,1940,130,3102,1292,1162,1162,twilight sparkle,mylittlegodzilla
2130080.png,https://derpicdn.net/img/view/2019/8/28/2130080.png,0,0.9882879853248596,1933,125,3109,1301,1176,1176,twilight sparkle,mylittlegodzilla
2135623.png,https://derpicdn.net/img/view/2019/9/3/2135623.png,0,0.9838342070579528,984,629,2184,1829,1200,1200,twilight sparkle,venommocity
2137925.png,https://derpicdn.net/img/view/2019/9/6/2137925.png,0,0.9466791749000548,50,0,626,560,576,560,twilight sparkle,kittehkatbar
2138007.png,https://derpicdn.net/img/view/2019/9/6/2138007.png,0,0.9816097617149352,0,0,346,385,346,385,twilight sparkle,
2138154.png,https://derpicdn.net/img/view/2019/9/7/2138154.png,0,0.9862870573997498,0,0,461,522,461,522,twilight sparkle,
2141014.png,https://derpicdn.net/img/view/2019/9/10/2141014.png,0,0.946880340576172,22,5,202,185,180,180,twilight sparkle,goodmode
2142353.png,https://derpicdn.net/img/view/2019/9/12/2142353.png,0,0.9773579239845276,0,13,545,607,545,594,twilight sparkle,
2143821.png,https://derpicdn.net/img/view/2019/9/14/2143821.png,1,0.9517508149147034,1050,603,1666,1219,616,616,twilight sparkle,chubbypug
2143877.png,https://derpicdn.net/img/view/2019/9/14/2143877.png,0,0.9470984935760498,10,53,3162,3205,3152,3152,twilight sparkle,estories
2144013.png,https://derpicdn.net/img/view/2019/9/14/2144013.png,0,0.9990607500076294,432,0,876,432,444,432,twilight sparkle,cutecarrots
2144072.png,https://derpicdn.net/img/view/2019/9/14/2144072.png,0,0.9676761031150818,3605,414,6919,3728,3314,3314,twilight sparkle,estories
2144073.png,https://derpicdn.net/img/view/2019/9/14/2144073.png,0,0.955794394016266,13,152,3117,3256,3104,3104,twilight sparkle,estories
2144161.png,https://derpicdn.net/img/view/2019/9/14/2144161.png,0,0.9989021420478821,777,170,3647,3040,2870,2870,twilight sparkle,estories
2144203.png,https://derpicdn.net/img/view/2019/9/14/2144203.png,0,0.9162995219230652,985,70,4029,3114,3044,3044,twilight sparkle,estories
2147470.png,https://derpicdn.net/img/view/2019/9/19/2147470.png,0,0.9669060707092284,747,73,2401,1727,1654,1654,twilight sparkle,boogiebirch
2148623.png,https://derpicdn.net/img/view/2019/9/20/2148623.png,0,0.9891749620437622,328,81,620,373,292,292,twilight sparkle,
2150112.png,https://derpicdn.net/img/view/2019/9/22/2150112.png,0,0.981749415397644,185,0,563,377,378,377,twilight sparkle,lucinda250
2152219.png,https://derpicdn.net/img/view/2019/9/24/2152219.png,0,0.9977657794952391,464,253,948,737,484,484,twilight sparkle,starmischief
2157483.png,https://derpicdn.net/img/view/2019/10/1/2157483.png,0,0.9369507431983948,479,119,3577,3217,3098,3098,twilight sparkle,estories
215795.png,https://derpicdn.net/img/view/2013/1/18/215795.png,0,0.951211154460907,83,25,705,612,622,587,twilight sparkle,pixelkitties
2162070.png,https://derpicdn.net/img/view/2019/10/6/2162070.png,1,0.9574769735336304,632,175,858,401,226,226,twilight sparkle,caroo
2163152.png,https://derpicdn.net/img/view/2019/10/8/2163152.png,0,0.998823344707489,928,446,2308,1826,1380,1380,twilight sparkle,an14deru
2165652.png,https://derpicdn.net/img/view/2019/10/11/2165652.png,0,0.9642259478569032,547,0,1453,832,906,832,twilight sparkle,rainbow eevee
2166832.png,https://derpicdn.net/img/view/2019/10/13/2166832.png,0,0.996699869632721,161,197,1903,1939,1742,1742,twilight sparkle,paskanaakka
2167748.png,https://derpicdn.net/img/view/2019/10/13/2167748.png,0,0.9872586131095886,239,152,759,672,520,520,twilight sparkle,emiiambar
2169232.png,https://derpicdn.net/img/view/2019/10/15/2169232.png,0,0.9862573146820068,0,38,725,940,725,902,twilight sparkle,
2169235.png,https://derpicdn.net/img/view/2019/10/15/2169235.png,0,0.9705901741981506,14,57,841,897,827,840,twilight sparkle,
2171556.png,https://derpicdn.net/img/view/2019/10/17/2171556.png,0,0.9641208648681641,11,0,594,622,583,622,twilight sparkle,
2173770.png,https://derpicdn.net/img/view/2019/10/19/2173770.png,0,0.9768316745758056,413,7,905,499,492,492,twilight sparkle,castelainmlp
2174212.png,https://derpicdn.net/img/view/2019/10/20/2174212.png,0,0.9746650457382202,256,478,708,930,452,452,twilight sparkle,notadeliciouspotato
2178043.png,https://derpicdn.net/img/view/2019/10/24/2178043.png,0,0.9346538782119752,118,0,1008,847,890,847,twilight sparkle,
2178354.png,https://derpicdn.net/img/view/2019/10/25/2178354.png,0,0.9510411024093628,303,147,597,441,294,294,twilight sparkle,cindydreamlight
2179588.png,https://derpicdn.net/img/view/2019/10/26/2179588.png,0,0.9878489971160888,24,0,928,861,904,861,twilight sparkle,
2180105.png,https://derpicdn.net/img/view/2019/10/27/2180105.png,0,0.9971756935119628,166,2630,656,3120,490,490,twilight sparkle,mcsplosion
2180105.png,https://derpicdn.net/img/view/2019/10/27/2180105.png,1,0.9962670803070068,0,1702,859,2744,859,1042,twilight sparkle,mcsplosion
2180105.png,https://derpicdn.net/img/view/2019/10/27/2180105.png,2,0.9889472126960754,0,477,868,1385,868,908,twilight sparkle,mcsplosion
2180105.png,https://derpicdn.net/img/view/2019/10/27/2180105.png,3,0.9777697324752808,939,1854,1787,2702,848,848,twilight sparkle,mcsplosion
2180105.png,https://derpicdn.net/img/view/2019/10/27/2180105.png,4,0.976220965385437,1918,160,2480,822,562,662,twilight sparkle,mcsplosion
2183173.png,https://derpicdn.net/img/view/2019/10/30/2183173.png,0,0.94443941116333,336,87,936,687,600,600,twilight sparkle,jeanne-droue
2183781.png,https://derpicdn.net/img/view/2019/10/31/2183781.png,0,0.9831665754318236,175,0,1499,1320,1324,1320,twilight sparkle,avrameow
2185960.png,https://derpicdn.net/img/view/2019/11/2/2185960.png,0,0.9625657200813292,0,0,182,178,182,178,twilight sparkle,sasha-flyer
2186549.png,https://derpicdn.net/img/view/2019/11/3/2186549.png,0,0.9971317648887634,0,552,781,1344,781,792,twilight sparkle,chibadeer
2186549.png,https://derpicdn.net/img/view/2019/11/3/2186549.png,1,0.9722625017166138,696,547,1528,1379,832,832,twilight sparkle,chibadeer
2188316.png,https://derpicdn.net/img/view/2019/11/5/2188316.png,0,0.993623435497284,158,0,626,454,468,454,twilight sparkle,
2189063.png,https://derpicdn.net/img/view/2019/11/6/2189063.png,0,0.9992323517799376,989,0,2027,982,1038,982,twilight sparkle,damlanil
2189063.png,https://derpicdn.net/img/view/2019/11/6/2189063.png,1,0.9920246005058287,2027,1574,2477,2024,450,450,twilight sparkle,damlanil
2194170.png,https://derpicdn.net/img/view/2019/11/12/2194170.png,0,0.9858509302139282,289,111,593,415,304,304,twilight sparkle,star-gaze-pony
2194304.png,https://derpicdn.net/img/view/2019/11/13/2194304.png,0,0.99595445394516,0,0,748,673,748,673,twilight sparkle,rainbowtashie
2195324.png,https://derpicdn.net/img/view/2019/11/14/2195324.png,0,0.9114389419555664,792,205,1356,769,564,564,twilight sparkle,carnival-tricks
2196343.png,https://derpicdn.net/img/view/2019/11/15/2196343.png,0,0.9978142976760864,816,185,1556,925,740,740,twilight sparkle,richi
2196343.png,https://derpicdn.net/img/view/2019/11/15/2196343.png,1,0.9714198112487792,239,207,871,839,632,632,twilight sparkle,richi
2197834.png,https://derpicdn.net/img/view/2019/11/16/2197834.png,0,0.982774257659912,0,0,759,766,759,766,twilight sparkle,
2197834.png,https://derpicdn.net/img/view/2019/11/16/2197834.png,1,0.9186669588088988,196,31,952,787,756,756,twilight sparkle,
2197838.png,https://derpicdn.net/img/view/2019/11/16/2197838.png,0,0.9922072887420654,0,0,631,656,631,656,twilight sparkle,
219789.png,https://derpicdn.net/img/view/2013/1/21/219789.png,0,0.997823178768158,70,5,334,269,264,264,twilight sparkle,snow angel
2200487.png,https://derpicdn.net/img/view/2019/11/19/2200487.png,0,0.9955025911331176,33,42,373,382,340,340,twilight sparkle,
2200490.png,https://derpicdn.net/img/view/2019/11/19/2200490.png,0,0.9751452803611756,0,0,717,755,717,755,twilight sparkle,
2202259.png,https://derpicdn.net/img/view/2019/11/21/2202259.png,0,0.9720891118049622,0,102,634,736,634,634,twilight sparkle,yuzuko|yzkxxx0069
2203160.png,https://derpicdn.net/img/view/2019/11/23/2203160.png,0,0.9393918514251708,513,908,3869,3915,3356,3007,twilight sparkle,sketchmcreations
2205806.png,https://derpicdn.net/img/view/2019/11/26/2205806.png,0,0.9550923109054564,108,27,512,455,404,428,twilight sparkle,
2207243.png,https://derpicdn.net/img/view/2019/11/27/2207243.png,0,0.966291069984436,381,154,1345,1128,964,974,twilight sparkle,yukkuripalehorse
22092.jpg,https://derpicdn.net/img/view/2012/6/26/22092.jpg,0,0.9584550261497498,80,3,558,503,478,500,twilight sparkle,imanika
2211998.png,https://derpicdn.net/img/view/2019/12/4/2211998.png,0,0.94276762008667,0,45,608,757,608,712,twilight sparkle,
221497.jpg,https://derpicdn.net/img/view/2013/1/23/221497.jpg,0,0.9585936069488524,500,12,800,342,300,330,twilight sparkle,advanceddefense
2217553.png,https://derpicdn.net/img/view/2019/12/10/2217553.png,0,0.9363641738891602,33,0,900,961,867,961,twilight sparkle,geonine
2217656.png,https://derpicdn.net/img/view/2019/12/10/2217656.png,0,0.9796055555343628,399,53,915,569,516,516,twilight sparkle,
22210.jpg,https://derpicdn.net/img/view/2012/6/26/22210.jpg,0,0.998502254486084,445,0,905,443,460,443,twilight sparkle,megasweet
2221664.png,https://derpicdn.net/img/view/2019/12/15/2221664.png,0,0.9914852976799012,13,0,673,603,660,603,twilight sparkle,
2221743.png,https://derpicdn.net/img/view/2019/12/16/2221743.png,0,0.9102222323417664,0,10,654,734,654,724,twilight sparkle,
2221765.png,https://derpicdn.net/img/view/2019/12/16/2221765.png,0,0.9603890776634216,204,0,1120,765,916,765,twilight sparkle,
2222505.png,https://derpicdn.net/img/view/2019/12/16/2222505.png,0,0.9816738367080688,0,47,823,1059,823,1012,twilight sparkle,
2226472.png,https://derpicdn.net/img/view/2019/12/21/2226472.png,0,0.9964860677719116,132,46,520,434,388,388,twilight sparkle,crecious
2229564.png,https://derpicdn.net/img/view/2019/12/25/2229564.png,0,0.9940212965011596,182,27,806,651,624,624,twilight sparkle,moon-potion
2232051.png,https://derpicdn.net/img/view/2019/12/28/2232051.png,0,0.943506360054016,0,0,197,199,197,199,twilight sparkle,applejack-lover-fan
2232558.png,https://derpicdn.net/img/view/2019/12/29/2232558.png,0,0.9751618504524232,0,85,738,873,738,788,twilight sparkle,
223366.jpg,https://derpicdn.net/img/view/2013/1/25/223366.jpg,0,0.9731938242912292,40,0,436,375,396,375,twilight sparkle,pixelkitties
2238602.jpg,https://derpicdn.net/img/view/2020/1/4/2238602.jpg,0,0.986480176448822,810,1077,1124,1391,314,314,twilight sparkle,weird--fish
2240750.png,https://derpicdn.net/img/view/2020/1/7/2240750.png,0,0.9889385104179382,145,0,1330,939,1185,939,twilight sparkle,
2240751.png,https://derpicdn.net/img/view/2020/1/7/2240751.png,0,0.9800285696983336,147,0,744,601,597,601,twilight sparkle,
2246952.png,https://derpicdn.net/img/view/2020/1/14/2246952.png,0,0.9973322153091432,197,0,737,514,540,514,twilight sparkle,yuriio-nice
2248405.png,https://derpicdn.net/img/view/2020/1/15/2248405.png,0,0.9913376569747924,2,0,446,398,444,398,twilight sparkle,sketchsartblog
2249080.png,https://derpicdn.net/img/view/2020/1/16/2249080.png,0,0.9649145603179932,346,0,1636,1220,1290,1220,twilight sparkle,renarde-louve
2249126.png,https://derpicdn.net/img/view/2020/1/16/2249126.png,0,0.9954851269721984,220,0,756,501,536,501,twilight sparkle,smirk
2251457.png,https://derpicdn.net/img/view/2020/1/19/2251457.png,0,0.9937923550605774,59,0,675,560,616,560,twilight sparkle,koloredkat
2255976.png,https://derpicdn.net/img/view/2020/1/24/2255976.png,0,0.9776347279548644,0,0,717,754,717,754,twilight sparkle,dentist73548
2262371.png,https://derpicdn.net/img/view/2020/2/1/2262371.png,0,0.9606749415397644,83,108,899,924,816,816,twilight sparkle,
2262943.png,https://derpicdn.net/img/view/2020/2/1/2262943.png,0,0.9692615270614624,0,19,581,605,581,586,twilight sparkle,
2262944.png,https://derpicdn.net/img/view/2020/2/1/2262944.png,0,0.9894348978996276,26,0,814,753,788,753,twilight sparkle,
2264718.jpg,https://derpicdn.net/img/view/2020/2/3/2264718.jpg,0,0.9989124536514282,223,101,487,365,264,264,twilight sparkle,texasuberalles
2268925.png,https://derpicdn.net/img/view/2020/2/8/2268925.png,0,0.9901688694953918,0,38,751,852,751,814,twilight sparkle,
2268973.png,https://derpicdn.net/img/view/2020/2/8/2268973.png,0,0.9805071353912354,119,34,904,854,785,820,twilight sparkle,
2268976.png,https://derpicdn.net/img/view/2020/2/8/2268976.png,0,0.9606956243515016,96,10,334,248,238,238,twilight sparkle,
2269329.png,https://derpicdn.net/img/view/2020/2/9/2269329.png,0,0.9957437515258788,155,81,523,449,368,368,twilight sparkle,brendalobinha
2269608.png,https://derpicdn.net/img/view/2020/2/9/2269608.png,1,0.9845101237297058,1223,606,2393,1776,1170,1170,twilight sparkle,renarde-louve
2269934.png,https://derpicdn.net/img/view/2020/2/9/2269934.png,0,0.9867420792579652,222,65,686,529,464,464,twilight sparkle,renarde-louve
2270183.png,https://derpicdn.net/img/view/2020/2/10/2270183.png,0,0.9771420359611512,20,0,928,861,908,861,twilight sparkle,
2270951.png,https://derpicdn.net/img/view/2020/2/11/2270951.png,0,0.9019914269447328,464,49,1226,811,762,762,twilight sparkle,
2271084.png,https://derpicdn.net/img/view/2020/2/11/2271084.png,0,0.9674792289733888,113,32,565,484,452,452,twilight sparkle,
227271.png,https://derpicdn.net/img/view/2013/1/29/227271.png,0,0.9814897775650024,266,0,500,250,234,250,twilight sparkle,
2273245.png,https://derpicdn.net/img/view/2020/2/13/2273245.png,0,0.9630811810493468,239,0,1000,814,761,814,twilight sparkle,sketchmcreations|katya
2276525.png,https://derpicdn.net/img/view/2020/2/17/2276525.png,0,0.9824002385139464,0,0,621,766,621,766,twilight sparkle,
2276525.png,https://derpicdn.net/img/view/2020/2/17/2276525.png,1,0.9790267944335938,0,0,621,856,621,856,twilight sparkle,
2276527.png,https://derpicdn.net/img/view/2020/2/17/2276527.png,0,0.9887238144874572,0,0,662,841,662,841,twilight sparkle,
2276543.png,https://derpicdn.net/img/view/2020/2/17/2276543.png,0,0.9934256076812744,16,0,682,637,666,637,twilight sparkle,
2277032.jpg,https://derpicdn.net/img/view/2020/2/17/2277032.jpg,1,0.9297944903373718,526,23,934,431,408,408,twilight sparkle,princebluemoon3
227811.png,https://derpicdn.net/img/view/2013/1/30/227811.png,0,0.9504657983779908,22,0,228,200,206,200,twilight sparkle,
2281155.png,https://derpicdn.net/img/view/2020/2/22/2281155.png,0,0.9885877370834352,326,124,812,610,486,486,twilight sparkle,imaplatypus
2281946.png,https://derpicdn.net/img/view/2020/2/23/2281946.png,0,0.9334142804145812,658,264,1020,626,362,362,twilight sparkle,agrol
2283236.png,https://derpicdn.net/img/view/2020/2/25/2283236.png,0,0.9859656691551208,542,0,974,432,432,432,twilight sparkle,foxpocx
2283979.jpg,https://derpicdn.net/img/view/2020/2/26/2283979.jpg,0,0.9452515840530396,221,34,717,606,496,572,twilight sparkle,
2284333.png,https://derpicdn.net/img/view/2020/2/26/2284333.png,0,0.9650063514709472,610,0,1506,671,896,671,twilight sparkle,skylairo
2285740.png,https://derpicdn.net/img/view/2020/2/28/2285740.png,0,0.9836786389350892,1804,276,2558,1030,754,754,twilight sparkle,zettaidullahan
2286380.jpg,https://derpicdn.net/img/view/2020/2/29/2286380.jpg,0,0.9994462728500366,353,50,821,518,468,468,twilight sparkle,brilliant-luna
2286416.png,https://derpicdn.net/img/view/2020/2/29/2286416.png,0,0.9028743505477904,62,0,425,425,363,425,twilight sparkle,
228692.png,https://derpicdn.net/img/view/2013/1/30/228692.png,0,0.9937683343887328,547,216,893,562,346,346,twilight sparkle,reakkorshrike
2288084.png,https://derpicdn.net/img/view/2020/3/2/2288084.png,0,0.9857572317123412,0,100,286,396,286,296,twilight sparkle,avui
2288270.jpg,https://derpicdn.net/img/view/2020/3/2/2288270.jpg,1,0.9847635626792908,367,62,625,320,258,258,twilight sparkle,transformartive
2288270.jpg,https://derpicdn.net/img/view/2020/3/2/2288270.jpg,2,0.9695776700973512,447,259,669,481,222,222,twilight sparkle,transformartive
2291913.png,https://derpicdn.net/img/view/2020/3/7/2291913.png,0,0.9237595200538636,174,0,1426,1060,1252,1060,twilight sparkle,liefsong
2293259.png,https://derpicdn.net/img/view/2020/3/9/2293259.png,0,0.9781137704849244,37,0,803,691,766,691,twilight sparkle,
2293628.png,https://derpicdn.net/img/view/2020/3/9/2293628.png,0,0.9689215421676636,503,970,857,1324,354,354,twilight sparkle,velgarn
2293746.jpg,https://derpicdn.net/img/view/2020/3/9/2293746.jpg,0,0.9696800112724304,1593,1462,2480,2508,887,1046,twilight sparkle,adamarc1
2293746.jpg,https://derpicdn.net/img/view/2020/3/9/2293746.jpg,1,0.9534541964530944,291,14,1547,1270,1256,1256,twilight sparkle,adamarc1
2293877.png,https://derpicdn.net/img/view/2020/3/9/2293877.png,0,0.9867489337921144,630,629,966,965,336,336,twilight sparkle,kozachokzrotom
2294332.png,https://derpicdn.net/img/view/2020/3/10/2294332.png,0,0.9984819293022156,455,0,994,564,539,564,twilight sparkle,gradiusfanatic
2294775.png,https://derpicdn.net/img/view/2020/3/11/2294775.png,0,0.9763303995132446,186,91,638,543,452,452,twilight sparkle,sensh-ii
2294782.png,https://derpicdn.net/img/view/2020/3/11/2294782.png,0,0.9987391829490662,56,175,478,597,422,422,twilight sparkle,sensh-ii
2295547.png,https://derpicdn.net/img/view/2020/3/12/2295547.png,0,0.9754951000213624,338,0,1090,645,752,645,twilight sparkle,ynery
2295800.jpg,https://derpicdn.net/img/view/2020/3/12/2295800.jpg,0,0.9226365089416504,0,0,1550,1441,1550,1441,twilight sparkle,shinycyan
2298387.png,https://derpicdn.net/img/view/2020/3/15/2298387.png,0,0.9942899346351624,68,32,946,910,878,878,twilight sparkle,lucas_gaxiola
2298853.jpg,https://derpicdn.net/img/view/2020/3/16/2298853.jpg,0,0.9805563688278198,374,40,836,502,462,462,twilight sparkle,thethunderpony|kaminarihouse
2299381.png,https://derpicdn.net/img/view/2020/3/17/2299381.png,0,0.966483235359192,0,471,578,1133,578,662,twilight sparkle,feather flare
2303562.png,https://derpicdn.net/img/view/2020/3/22/2303562.png,0,0.995749831199646,511,0,711,181,200,181,twilight sparkle,froggers1995
2303562.png,https://derpicdn.net/img/view/2020/3/22/2303562.png,1,0.9947924613952636,171,0,405,196,234,196,twilight sparkle,froggers1995
2304778.png,https://derpicdn.net/img/view/2020/3/24/2304778.png,0,0.9899227619171144,1334,1221,1964,1851,630,630,twilight sparkle,90sigma|kysss90|seahawk270|kingdark0001|mlp-lolada|andoanimalia
2305038.png,https://derpicdn.net/img/view/2020/3/24/2305038.png,0,0.9009583592414856,102,0,1120,974,1018,974,twilight sparkle,angelinarichter
2305052.png,https://derpicdn.net/img/view/2020/3/24/2305052.png,0,0.9325385093688964,77,36,611,570,534,534,twilight sparkle,erinisanxious
2306737.png,https://derpicdn.net/img/view/2020/3/26/2306737.png,0,0.9790111184120178,0,0,3942,3584,3942,3584,twilight sparkle,ejlightning007arts
2307106.jpg,https://derpicdn.net/img/view/2020/3/27/2307106.jpg,0,0.9855130314826964,1099,364,1689,954,590,590,twilight sparkle,meadowmood
2307975.png,https://derpicdn.net/img/view/2020/3/28/2307975.png,0,0.9625739455223083,0,0,3643,3817,3643,3817,twilight sparkle,andoanimalia
2308175.png,https://derpicdn.net/img/view/2020/3/28/2308175.png,0,0.9485823512077332,107,355,3577,3825,3470,3470,twilight sparkle,andoanimalia
2308399.png,https://derpicdn.net/img/view/2020/3/28/2308399.png,0,0.9132197499275208,435,234,1680,1506,1245,1272,twilight sparkle,katya|andoanimalia
2308917.png,https://derpicdn.net/img/view/2020/3/29/2308917.png,0,0.9085662961006165,2092,97,5684,3689,3592,3592,twilight sparkle,andoanimalia
2310100.png,https://derpicdn.net/img/view/2020/3/30/2310100.png,0,0.9970378279685974,172,0,570,383,398,383,twilight sparkle,everlastingderp
2311514.png,https://derpicdn.net/img/view/2020/4/1/2311514.png,0,0.985496997833252,0,26,459,550,459,524,twilight sparkle,
2311515.png,https://derpicdn.net/img/view/2020/4/1/2311515.png,0,0.9795212745666504,0,32,509,604,509,572,twilight sparkle,
2312803.png,https://derpicdn.net/img/view/2020/4/3/2312803.png,0,0.9985441565513612,160,55,630,525,470,470,twilight sparkle,thurder2020
2313944.png,https://derpicdn.net/img/view/2020/4/4/2313944.png,0,0.999632716178894,120,23,576,479,456,456,twilight sparkle,darlyjay
2313944.png,https://derpicdn.net/img/view/2020/4/4/2313944.png,1,0.9931705594062804,1227,0,1951,614,724,614,twilight sparkle,darlyjay
2314061.png,https://derpicdn.net/img/view/2020/4/4/2314061.png,0,0.9953503608703612,0,0,467,463,467,463,twilight sparkle,zingey
2319386.png,https://derpicdn.net/img/view/2020/4/11/2319386.png,0,0.9825258851051332,881,33,1513,665,632,632,twilight sparkle,gradiusfanatic
2319386.png,https://derpicdn.net/img/view/2020/4/11/2319386.png,1,0.9465239644050598,349,57,1045,753,696,696,twilight sparkle,gradiusfanatic
2320361.jpg,https://derpicdn.net/img/view/2020/4/12/2320361.jpg,0,0.9933597445487976,394,76,1258,940,864,864,twilight sparkle,chedx
2321686.png,https://derpicdn.net/img/view/2020/4/13/2321686.png,0,0.9776831865310668,57,101,885,929,828,828,twilight sparkle,haiiro-ko
2322048.jpg,https://derpicdn.net/img/view/2020/4/14/2322048.jpg,0,0.9959902167320251,508,0,786,256,278,256,twilight sparkle,whitearabmare
2324258.jpg,https://derpicdn.net/img/view/2020/4/16/2324258.jpg,0,0.9956536889076232,91,15,439,363,348,348,twilight sparkle,zansolabsol
2324306.png,https://derpicdn.net/img/view/2020/4/17/2324306.png,0,0.9275006055831908,177,0,1491,1251,1314,1251,twilight sparkle,porcelanowyokular
2326497.png,https://derpicdn.net/img/view/2020/4/19/2326497.png,0,0.98370361328125,1,0,859,733,858,733,twilight sparkle,
2326502.png,https://derpicdn.net/img/view/2020/4/19/2326502.png,0,0.9963577389717102,0,0,388,404,388,404,twilight sparkle,
232685.png,https://derpicdn.net/img/view/2013/2/3/232685.png,0,0.9501008391380308,2818,210,5841,3236,3023,3026,twilight sparkle,dentist73548
2327498.jpg,https://derpicdn.net/img/view/2020/4/20/2327498.jpg,0,0.9052001237869264,450,457,1052,1059,602,602,twilight sparkle,cottonbudfilly
2327685.png,https://derpicdn.net/img/view/2020/4/21/2327685.png,0,0.9902124404907228,184,0,3794,3379,3610,3379,twilight sparkle,ejlightning007arts
2328254.png,https://derpicdn.net/img/view/2020/4/21/2328254.png,0,0.9631050229072572,50,0,601,614,551,614,twilight sparkle,cosmicwaltz
2330994.jpg,https://derpicdn.net/img/view/2020/4/25/2330994.jpg,0,0.9991436004638672,497,293,1103,899,606,606,twilight sparkle,pfeffaroo
2331980.png,https://derpicdn.net/img/view/2020/4/26/2331980.png,0,0.9542821645736694,902,260,1308,666,406,406,twilight sparkle,vladimir-olegovych
2331980.png,https://derpicdn.net/img/view/2020/4/26/2331980.png,1,0.9501627683639526,0,98,474,588,474,490,twilight sparkle,vladimir-olegovych
2332039.png,https://derpicdn.net/img/view/2020/4/26/2332039.png,0,0.9953776597976683,98,0,662,529,564,529,twilight sparkle,handgunboi
2333222.png,https://derpicdn.net/img/view/2020/4/27/2333222.png,0,0.9729304313659668,25,7,527,509,502,502,twilight sparkle,
2334403.png,https://derpicdn.net/img/view/2020/4/29/2334403.png,0,0.956385612487793,188,0,1688,1080,1500,1080,twilight sparkle,
2336364.jpg,https://derpicdn.net/img/view/2020/5/1/2336364.jpg,0,0.97050541639328,21,70,441,490,420,420,twilight sparkle,maytee
2338115.jpg,https://derpicdn.net/img/view/2020/5/3/2338115.jpg,0,0.9997956156730652,328,148,704,524,376,376,twilight sparkle,snowballflo
2338115.jpg,https://derpicdn.net/img/view/2020/5/3/2338115.jpg,1,0.999075412750244,605,485,851,731,246,246,twilight sparkle,snowballflo
2339496.png,https://derpicdn.net/img/view/2020/5/4/2339496.png,0,0.9867780208587646,209,0,689,475,480,475,twilight sparkle,ilquira
2341613.png,https://derpicdn.net/img/view/2020/5/7/2341613.png,0,0.9990524649620056,473,65,759,351,286,286,twilight sparkle,mlptmntdisneykauane
2344733.png,https://derpicdn.net/img/view/2020/5/10/2344733.png,0,0.983243465423584,36,20,466,450,430,430,twilight sparkle,
2344735.png,https://derpicdn.net/img/view/2020/5/10/2344735.png,0,0.9651433825492859,24,99,854,937,830,838,twilight sparkle,
2348440.png,https://derpicdn.net/img/view/2020/5/14/2348440.png,0,0.9987409114837646,252,179,528,455,276,276,twilight sparkle,saturdaymorningproj
2349011.png,https://derpicdn.net/img/view/2020/5/15/2349011.png,0,0.9901821613311768,0,0,410,417,410,417,twilight sparkle,
2349830.png,https://derpicdn.net/img/view/2020/5/16/2349830.png,0,0.9866153597831726,0,4,446,466,446,462,twilight sparkle,
2349832.png,https://derpicdn.net/img/view/2020/5/16/2349832.png,0,0.9856988191604614,101,0,807,620,706,620,twilight sparkle,
235063.jpg,https://derpicdn.net/img/view/2013/2/6/235063.jpg,0,0.9980591535568236,277,9,625,357,348,348,twilight sparkle,serge-stiles
2350883.jpg,https://derpicdn.net/img/view/2020/5/17/2350883.jpg,0,0.9891190528869628,0,349,2466,2985,2466,2636,twilight sparkle,alexbefest
2352554.png,https://derpicdn.net/img/view/2020/5/19/2352554.png,0,0.9749717116355896,89,0,933,701,844,701,twilight sparkle,tatianabeyzer
2353160.jpg,https://derpicdn.net/img/view/2020/5/20/2353160.jpg,0,0.9703077673912048,58,18,396,356,338,338,twilight sparkle,rockin_candies
2353575.png,https://derpicdn.net/img/view/2020/5/20/2353575.png,0,0.9701469540596008,435,434,1191,1190,756,756,twilight sparkle,varwing
2353575.png,https://derpicdn.net/img/view/2020/5/20/2353575.png,1,0.9054203033447266,1661,556,2299,1194,638,638,twilight sparkle,varwing
2353642.jpg,https://derpicdn.net/img/view/2020/5/20/2353642.jpg,0,0.9989469051361084,995,387,1867,1259,872,872,twilight sparkle,scarletskitty12
2354678.jpg,https://derpicdn.net/img/view/2020/5/21/2354678.jpg,0,0.9065264463424684,0,0,798,730,798,730,twilight sparkle,mesqrit
2354693.jpg,https://derpicdn.net/img/view/2020/5/21/2354693.jpg,0,0.9858024716377258,0,127,2900,3177,2900,3050,twilight sparkle,toisanemoif
2355130.jpg,https://derpicdn.net/img/view/2020/5/22/2355130.jpg,0,0.9885653853416444,913,897,1805,1789,892,892,twilight sparkle,brilliant-luna
2355241.png,https://derpicdn.net/img/view/2020/5/22/2355241.png,0,0.9133891463279724,251,0,1727,1429,1476,1429,twilight sparkle,aliceg|gorgoalice
235537.png,https://derpicdn.net/img/view/2013/2/6/235537.png,0,0.9994479417800904,270,0,1682,1340,1412,1340,twilight sparkle,
237866.png,https://derpicdn.net/img/view/2013/2/9/237866.png,0,0.9601479172706604,88,214,662,788,574,574,twilight sparkle,quennyqueen
245116.png,https://derpicdn.net/img/view/2013/2/16/245116.png,0,0.9625228047370912,33,57,253,277,220,220,twilight sparkle,mangneto
245936.png,https://derpicdn.net/img/view/2013/2/16/245936.png,0,0.9717670679092408,122,188,618,684,496,496,twilight sparkle,crispych0colate
245949.png,https://derpicdn.net/img/view/2013/2/16/245949.png,0,0.9630807638168336,362,0,2492,1440,2130,1440,twilight sparkle,foxy-noxy
246005.png,https://derpicdn.net/img/view/2013/2/17/246005.png,0,0.9247483015060424,461,57,1779,1375,1318,1318,twilight sparkle,gonedreamer
246042.png,https://derpicdn.net/img/view/2013/2/17/246042.png,0,0.9926550984382628,768,182,2062,1476,1294,1294,twilight sparkle,animatedjames
246380.png,https://derpicdn.net/img/view/2013/2/17/246380.png,0,0.9859870672225952,663,122,1509,968,846,846,twilight sparkle,killryde
247227.png,https://derpicdn.net/img/view/2013/2/18/247227.png,0,0.9751889109611512,162,27,484,349,322,322,twilight sparkle,willdrawforfood1
250489.png,https://derpicdn.net/img/view/2013/2/21/250489.png,0,0.9964489340782166,440,171,864,595,424,424,twilight sparkle,inmydefence
253716.png,https://derpicdn.net/img/view/2013/2/24/253716.png,0,0.9636176228523254,0,118,293,444,293,326,twilight sparkle,mixermike622
254017.png,https://derpicdn.net/img/view/2013/2/24/254017.png,0,0.9775617122650146,289,114,663,488,374,374,twilight sparkle,kittehkatbar
255353.png,https://derpicdn.net/img/view/2013/2/25/255353.png,0,0.9956834316253662,540,210,1334,1004,794,794,twilight sparkle,pklove-chan
255415.png,https://derpicdn.net/img/view/2013/2/25/255415.png,0,0.9376882314682008,314,33,1040,759,726,726,twilight sparkle,strangiesleepy
256048.png,https://derpicdn.net/img/view/2013/2/26/256048.png,0,0.99354350566864,1697,430,2845,1578,1148,1148,twilight sparkle,pastelflakes
261209.png,https://derpicdn.net/img/view/2013/3/3/261209.png,0,0.9579640626907348,229,34,566,386,337,352,twilight sparkle,raimbownyan
261685.jpg,https://derpicdn.net/img/view/2013/3/3/261685.jpg,0,0.977211594581604,0,16,261,277,261,261,twilight sparkle,
261685.jpg,https://derpicdn.net/img/view/2013/3/3/261685.jpg,1,0.9253164529800416,46,0,288,221,242,221,twilight sparkle,
262653.png,https://derpicdn.net/img/view/2013/3/4/262653.png,0,0.9849240183830258,2193,80,5999,3886,3806,3806,twilight sparkle,joemasterpencil
263138.png,https://derpicdn.net/img/view/2013/3/5/263138.png,0,0.9885938763618468,897,0,1635,708,738,708,twilight sparkle,theparagon
263558.png,https://derpicdn.net/img/view/2013/3/5/263558.png,0,0.9856746196746826,200,253,562,615,362,362,twilight sparkle,severus
265625.png,https://derpicdn.net/img/view/2013/3/8/265625.png,0,0.9680986404418944,0,0,424,457,424,457,twilight sparkle,pyoo-kee-pony
266238.png,https://derpicdn.net/img/view/2013/3/9/266238.png,0,0.9989632368087769,406,222,694,510,288,288,twilight sparkle,ponygoggles
266743.png,https://derpicdn.net/img/view/2013/3/9/266743.png,0,0.9707736968994141,686,152,1038,504,352,352,twilight sparkle,renaifoxi
2698.png,https://derpicdn.net/img/view/2012/1/29/2698.png,0,0.9814459681510924,237,72,755,590,518,518,twilight sparkle,reikomuffin
274829.png,https://derpicdn.net/img/view/2013/3/20/274829.png,0,0.9334123730659484,206,0,508,268,302,268,twilight sparkle,
275774.png,https://derpicdn.net/img/view/2013/3/21/275774.png,0,0.9965965151786804,0,100,522,644,522,544,twilight sparkle,aeritus
278152.png,https://derpicdn.net/img/view/2013/3/24/278152.png,0,0.9113591909408568,60,2,284,226,224,224,twilight sparkle,fearingfun|lemoncherrybabe
279363.png,https://derpicdn.net/img/view/2013/3/25/279363.png,0,0.9883056282997132,667,188,1115,636,448,448,twilight sparkle,nos-talgia
286794.png,https://derpicdn.net/img/view/2013/4/3/286794.png,0,0.9951261878013612,338,0,760,392,422,392,twilight sparkle,kysss90
2890.png,https://derpicdn.net/img/view/2012/2/2/2890.png,0,0.9749060273170472,451,1,1024,601,573,600,twilight sparkle,karzahnii
289719.png,https://derpicdn.net/img/view/2013/4/6/289719.png,0,0.9739977121353148,479,99,911,531,432,432,twilight sparkle,hoyeechun
290166.png,https://derpicdn.net/img/view/2013/4/6/290166.png,0,0.974160373210907,0,117,2751,2973,2751,2856,twilight sparkle,the smiling pony
292775.jpg,https://derpicdn.net/img/view/2013/4/9/292775.jpg,0,0.99576735496521,201,23,473,295,272,272,twilight sparkle,discommunicator
294268.png,https://derpicdn.net/img/view/2013/4/11/294268.png,0,0.9557031393051147,1389,34,2607,1252,1218,1218,twilight sparkle,aquagalaxy
295899.png,https://derpicdn.net/img/view/2013/4/12/295899.png,0,0.9674052596092224,23,18,250,250,227,232,twilight sparkle,darkomegamk2
299959.png,https://derpicdn.net/img/view/2013/4/16/299959.png,0,0.9914878606796264,215,0,597,381,382,381,twilight sparkle,yellowbooze|yellow-jelly
3042.jpg,https://derpicdn.net/img/view/2012/2/15/3042.jpg,0,0.9905606508255004,27,0,631,538,604,538,twilight sparkle,raikoh
310092.png,https://derpicdn.net/img/view/2013/4/27/310092.png,0,0.9744822382926941,80,20,586,526,506,506,twilight sparkle,loyaldis
310317.png,https://derpicdn.net/img/view/2013/4/28/310317.png,0,0.9529209136962892,0,0,2633,2789,2633,2789,twilight sparkle,spier17
31736.jpg,https://derpicdn.net/img/view/2012/7/4/31736.jpg,0,0.9903534650802612,268,214,582,528,314,314,twilight sparkle,fadri
320327.jpg,https://derpicdn.net/img/view/2013/5/9/320327.jpg,0,0.9504379034042358,485,142,819,476,334,334,twilight sparkle,
320668.png,https://derpicdn.net/img/view/2013/5/9/320668.png,0,0.9363464117050172,615,0,1545,909,930,909,twilight sparkle,starshinecelestialis
326511.png,https://derpicdn.net/img/view/2013/5/16/326511.png,0,0.9890982508659364,0,0,2312,2168,2312,2168,twilight sparkle,lixr
330357.png,https://derpicdn.net/img/view/2013/5/21/330357.png,0,0.999087929725647,197,0,555,343,358,343,twilight sparkle,rainbowdrool
33987.jpg,https://derpicdn.net/img/view/2012/7/6/33987.jpg,0,0.9977681636810304,316,0,762,422,446,422,twilight sparkle,ruger181|trollie trollenberg
34584.jpg,https://derpicdn.net/img/view/2012/7/6/34584.jpg,0,0.9004804491996765,106,127,758,779,652,652,twilight sparkle,gsphere
349692.png,https://derpicdn.net/img/view/2013/6/16/349692.png,0,0.9994242787361144,242,2,572,332,330,330,twilight sparkle,fairiegirl101
349771.png,https://derpicdn.net/img/view/2013/6/16/349771.png,0,0.9730514287948608,0,29,612,665,612,636,twilight sparkle,lourita-shine
353644.jpg,https://derpicdn.net/img/view/2013/6/21/353644.jpg,0,0.9989060163497924,0,266,842,1142,842,876,twilight sparkle,punk-pegasus
356632.jpg,https://derpicdn.net/img/view/2013/6/25/356632.jpg,0,0.9920432567596436,368,140,764,536,396,396,twilight sparkle,darkminou
3570.jpg,https://derpicdn.net/img/view/2012/2/26/3570.jpg,0,0.9376980066299438,247,46,571,370,324,324,twilight sparkle,uc77
357624.jpg,https://derpicdn.net/img/view/2013/6/26/357624.jpg,0,0.999014675617218,274,17,648,391,374,374,twilight sparkle,gabbstuff
358275.png,https://derpicdn.net/img/view/2013/6/27/358275.png,0,0.9930149912834167,19,0,295,276,276,276,twilight sparkle,ari0th
364174.png,https://derpicdn.net/img/view/2013/7/4/364174.png,0,0.9884971976280212,0,0,3075,2771,3075,2771,twilight sparkle,xpesifeindx
367089.png,https://derpicdn.net/img/view/2013/7/8/367089.png,0,0.983166754245758,3524,0,7348,3364,3824,3364,twilight sparkle,dentist73548-floozy
36725.png,https://derpicdn.net/img/view/2012/7/8/36725.png,0,0.9855544567108154,489,217,1567,1295,1078,1078,twilight sparkle,johnjoseco|electronvolt
367715.png,https://derpicdn.net/img/view/2013/7/8/367715.png,0,0.9924774765968324,406,61,2104,1759,1698,1698,twilight sparkle,flutterflyraptor
37335.png,https://derpicdn.net/img/view/2012/7/8/37335.png,0,0.9759635925292968,1369,296,2015,942,646,646,twilight sparkle,nianara
377246.png,https://derpicdn.net/img/view/2013/7/18/377246.png,0,0.9056040644645692,3836,58,6428,2650,2592,2592,twilight sparkle,spectty
379196.png,https://derpicdn.net/img/view/2013/7/20/379196.png,0,0.980089783668518,80,0,402,309,322,309,twilight sparkle,mt
3807.png,https://derpicdn.net/img/view/2012/3/21/3807.png,0,0.9927622079849244,146,0,1284,1130,1138,1130,twilight sparkle,grumblepluck
3807.png,https://derpicdn.net/img/view/2012/3/21/3807.png,1,0.9828376173973083,1200,0,2380,1173,1180,1173,twilight sparkle,grumblepluck
382933.png,https://derpicdn.net/img/view/2013/7/24/382933.png,0,0.9906100630760192,67,0,1795,1080,1728,1080,twilight sparkle,
383120.png,https://derpicdn.net/img/view/2013/7/24/383120.png,0,0.9668689966201782,0,39,298,375,298,336,twilight sparkle,
383533.png,https://derpicdn.net/img/view/2013/7/25/383533.png,0,0.9983893632888794,2212,0,4656,2392,2444,2392,twilight sparkle,luuandherdraws
386026.png,https://derpicdn.net/img/view/2013/7/30/386026.png,0,0.9458047151565552,443,211,705,473,262,262,twilight sparkle,datahmedz
387.png,https://derpicdn.net/img/view/2012/1/15/387.png,0,0.939396321773529,1774,641,2486,1353,712,712,twilight sparkle,rankao
388470.png,https://derpicdn.net/img/view/2013/8/1/388470.png,0,0.9859917163848876,481,132,1329,980,848,848,twilight sparkle,fikakorv
389538.png,https://derpicdn.net/img/view/2013/8/2/389538.png,0,0.9934743046760559,297,59,2000,1835,1703,1776,twilight sparkle,natipie
39161.png,https://derpicdn.net/img/view/2012/7/10/39161.png,0,0.9429511427879332,446,225,1702,1481,1256,1256,twilight sparkle,tygerbug
392008.png,https://derpicdn.net/img/view/2013/8/5/392008.png,0,0.9988218545913696,250,0,796,541,546,541,twilight sparkle,foxxarius
394127.png,https://derpicdn.net/img/view/2013/8/7/394127.png,0,0.9907327890396118,781,268,1795,1282,1014,1014,twilight sparkle,saturdaymorningproj
394442.png,https://derpicdn.net/img/view/2013/8/8/394442.png,0,0.9986948370933532,506,73,1300,867,794,794,twilight sparkle,musicglare
398599.jpg,https://derpicdn.net/img/view/2013/8/12/398599.jpg,0,0.9890292882919312,52,3,468,419,416,416,twilight sparkle,soranoumi
400974.png,https://derpicdn.net/img/view/2013/8/15/400974.png,0,0.9951995611190796,1322,0,2602,1161,1280,1161,twilight sparkle,silentmatten
4058.png,https://derpicdn.net/img/view/2012/5/21/4058.png,0,0.9908708930015564,200,1,532,333,332,332,twilight sparkle,snus-kun
407423.jpg,https://derpicdn.net/img/view/2013/8/22/407423.jpg,0,0.9699828624725342,119,114,509,504,390,390,twilight sparkle,woking
410169.png,https://derpicdn.net/img/view/2013/8/25/410169.png,0,0.9874131083488464,0,149,746,967,746,818,twilight sparkle,demonreapergirl
412530.png,https://derpicdn.net/img/view/2013/8/27/412530.png,0,0.9971764087677002,296,0,986,666,690,666,twilight sparkle,aleximusprime
41276.png,https://derpicdn.net/img/view/2012/7/12/41276.png,0,0.9792160391807556,24,0,504,475,480,475,twilight sparkle,fajeh
414336.png,https://derpicdn.net/img/view/2013/8/30/414336.png,1,0.9758639335632324,244,44,608,408,364,364,twilight sparkle,hip-indeed
415288.png,https://derpicdn.net/img/view/2013/8/31/415288.png,0,0.9176079034805298,48,54,590,596,542,542,twilight sparkle,pegacornss
415961.png,https://derpicdn.net/img/view/2013/9/1/415961.png,0,0.9987733960151672,19,0,295,262,276,262,twilight sparkle,looseknot
416315.png,https://derpicdn.net/img/view/2013/9/1/416315.png,0,0.9308822751045228,87,2,717,632,630,630,twilight sparkle,aquadiamonds
416899.png,https://derpicdn.net/img/view/2013/9/2/416899.png,0,0.9699695706367492,1443,0,1688,235,245,235,twilight sparkle,bluntwhiskey
418864.png,https://derpicdn.net/img/view/2013/9/4/418864.png,0,0.9938656091690063,0,0,833,822,833,822,twilight sparkle,
419125.png,https://derpicdn.net/img/view/2013/9/4/419125.png,0,0.9985108971595764,218,42,660,484,442,442,twilight sparkle,djscrwu
419695.png,https://derpicdn.net/img/view/2013/9/5/419695.png,0,0.9882098436355592,3,0,581,542,578,542,twilight sparkle,comikazia
420577.png,https://derpicdn.net/img/view/2013/9/6/420577.png,0,0.962105929851532,0,196,515,728,515,532,twilight sparkle,jcking101
420577.png,https://derpicdn.net/img/view/2013/9/6/420577.png,1,0.9535634517669678,487,0,979,465,492,465,twilight sparkle,jcking101
422240.png,https://derpicdn.net/img/view/2013/9/8/422240.png,0,0.9631484746932985,251,15,797,561,546,546,twilight sparkle,azure-doodle
423252.png,https://derpicdn.net/img/view/2013/9/9/423252.png,0,0.9749133586883544,271,179,631,539,360,360,twilight sparkle,datponypl
429995.png,https://derpicdn.net/img/view/2013/9/18/429995.png,0,0.9095537066459656,238,109,510,381,272,272,twilight sparkle,ohthatandy
435721.jpg,https://derpicdn.net/img/view/2013/9/26/435721.jpg,0,0.9400919675827026,132,7,453,377,321,370,twilight sparkle,naoma-hiru
440510.png,https://derpicdn.net/img/view/2013/10/3/440510.png,0,0.964277982711792,330,2,798,470,468,468,twilight sparkle,sweethd
441393.png,https://derpicdn.net/img/view/2013/10/4/441393.png,0,0.9910469651222228,578,431,854,707,276,276,twilight sparkle,adalbertus
445275.png,https://derpicdn.net/img/view/2013/10/10/445275.png,0,0.9566192626953124,353,133,557,337,204,204,twilight sparkle,arvaus
450760.png,https://derpicdn.net/img/view/2013/10/17/450760.png,0,0.9747921228408812,0,0,3074,3653,3074,3653,twilight sparkle,maximillianveers
453199.png,https://derpicdn.net/img/view/2013/10/20/453199.png,0,0.9345309138298036,469,243,1035,809,566,566,twilight sparkle,v-d-k
455955.png,https://derpicdn.net/img/view/2013/10/25/455955.png,0,0.9984773993492126,288,626,708,1046,420,420,twilight sparkle,katurkeyg
458016.png,https://derpicdn.net/img/view/2013/10/27/458016.png,0,0.9756357073783876,455,0,891,384,436,384,twilight sparkle,desolateshadow30
468809.png,https://derpicdn.net/img/view/2013/11/10/468809.png,0,0.9830313920974731,555,490,1441,1376,886,886,twilight sparkle,tomat-in-cup
470555.jpg,https://derpicdn.net/img/view/2013/11/12/470555.jpg,0,0.9794796705245972,51,106,635,690,584,584,twilight sparkle,
47747.png,https://derpicdn.net/img/view/2012/7/18/47747.png,0,0.9765982627868652,399,190,823,614,424,424,twilight sparkle,reina-kitsune
478934.png,https://derpicdn.net/img/view/2013/11/23/478934.png,0,0.9375056028366088,218,0,542,305,324,305,twilight sparkle,yajima
4792.png,https://derpicdn.net/img/view/2012/6/17/4792.png,0,0.9942918419837952,133,0,553,403,420,403,twilight sparkle,ikuntyphoon
481548.png,https://derpicdn.net/img/view/2013/11/25/481548.png,0,0.9994546175003052,50,0,548,423,498,423,twilight sparkle,tehflah
481747.jpg,https://derpicdn.net/img/view/2013/11/25/481747.jpg,0,0.9500900506973268,1172,0,1592,388,420,388,twilight sparkle,grennadder
484298.png,https://derpicdn.net/img/view/2013/11/28/484298.png,0,0.9937761425971984,739,0,1363,614,624,614,twilight sparkle,jazzybrony
484871.png,https://derpicdn.net/img/view/2013/11/29/484871.png,0,0.9839092493057252,0,479,323,809,323,330,twilight sparkle,aplexpony
484871.png,https://derpicdn.net/img/view/2013/11/29/484871.png,1,0.9832024574279784,23,23,381,381,358,358,twilight sparkle,aplexpony
487680.png,https://derpicdn.net/img/view/2013/12/2/487680.png,0,0.9915393590927124,57,0,599,535,542,535,twilight sparkle,trippinmars
48837.png,https://derpicdn.net/img/view/2012/7/19/48837.png,0,0.9746423363685608,139,62,585,508,446,446,twilight sparkle,lustrous-dreams
489225.png,https://derpicdn.net/img/view/2013/12/4/489225.png,0,0.922328531742096,0,564,3066,3820,3066,3256,twilight sparkle,masem
489488.png,https://derpicdn.net/img/view/2013/12/4/489488.png,0,0.9731478095054626,35,55,315,335,280,280,twilight sparkle,yokkishai
491346.png,https://derpicdn.net/img/view/2013/12/7/491346.png,0,0.9485827088356018,1295,289,2219,1213,924,924,twilight sparkle,malwinters
493087.png,https://derpicdn.net/img/view/2013/12/8/493087.png,0,0.9980809092521667,166,99,558,491,392,392,twilight sparkle,kubota
495252.png,https://derpicdn.net/img/view/2013/12/12/495252.png,0,0.9358562231063844,216,119,396,299,180,180,twilight sparkle,drunkzombies
497979.png,https://derpicdn.net/img/view/2013/12/15/497979.png,0,0.9461459517478944,4,0,672,612,668,612,twilight sparkle,fauxsquared
500313.jpg,https://derpicdn.net/img/view/2013/12/18/500313.jpg,0,0.9601539373397828,429,44,620,254,191,210,twilight sparkle,
500313.jpg,https://derpicdn.net/img/view/2013/12/18/500313.jpg,1,0.954774022102356,0,0,490,413,490,413,twilight sparkle,
503546.png,https://derpicdn.net/img/view/2013/12/22/503546.png,0,0.9930304884910583,396,35,696,335,300,300,twilight sparkle,foxenawolf
504979.jpg,https://derpicdn.net/img/view/2013/12/24/504979.jpg,0,0.9469122886657716,427,331,921,825,494,494,twilight sparkle,gamermac
50638.jpg,https://derpicdn.net/img/view/2012/7/20/50638.jpg,0,0.9611065983772278,94,0,440,306,346,306,twilight sparkle,
50638.jpg,https://derpicdn.net/img/view/2012/7/20/50638.jpg,1,0.9285574555397034,511,29,857,375,346,346,twilight sparkle,
506885.png,https://derpicdn.net/img/view/2013/12/26/506885.png,0,0.9592047333717346,250,138,658,546,408,408,twilight sparkle,haxorus31
506940.png,https://derpicdn.net/img/view/2013/12/26/506940.png,0,0.9645904898643494,18,0,460,438,442,438,twilight sparkle,pegacornss
508547.png,https://derpicdn.net/img/view/2013/12/28/508547.png,0,0.977432906627655,0,0,718,680,718,680,twilight sparkle,
510317.jpg,https://derpicdn.net/img/view/2013/12/30/510317.jpg,0,0.9913986921310424,77,0,1245,1047,1168,1047,twilight sparkle,marble-soda
510829.png,https://derpicdn.net/img/view/2013/12/31/510829.png,0,0.9958704113960266,34,134,368,468,334,334,twilight sparkle,shotaconyhin
510829.png,https://derpicdn.net/img/view/2013/12/31/510829.png,1,0.9452849030494692,374,101,714,441,340,340,twilight sparkle,shotaconyhin
511559.png,https://derpicdn.net/img/view/2014/1/1/511559.png,0,0.9186654686927797,1297,116,4239,3058,2942,2942,twilight sparkle,php50|ask-artila
512773.png,https://derpicdn.net/img/view/2014/1/2/512773.png,0,0.962851881980896,471,0,989,461,518,461,twilight sparkle,themightycoolblender
514144.png,https://derpicdn.net/img/view/2014/1/3/514144.png,0,0.9666683077812196,54,0,607,568,553,568,twilight sparkle,freezyfoop
515546.jpg,https://derpicdn.net/img/view/2014/1/5/515546.jpg,0,0.996885061264038,329,4,871,546,542,542,twilight sparkle,gamermac
517766.png,https://derpicdn.net/img/view/2014/1/7/517766.png,0,0.9945178031921388,85,43,507,465,422,422,twilight sparkle,
519339.png,https://derpicdn.net/img/view/2014/1/9/519339.png,0,0.9909129738807678,11,0,193,169,182,169,twilight sparkle,gomenalex
519940.png,https://derpicdn.net/img/view/2014/1/9/519940.png,0,0.995404064655304,0,16,413,458,413,442,twilight sparkle,mirululu
529.png,https://derpicdn.net/img/view/2012/1/16/529.png,0,0.998771607875824,2099,0,3929,1744,1830,1744,twilight sparkle,the smiling pony
532063.png,https://derpicdn.net/img/view/2014/1/23/532063.png,0,0.9012234210968018,83,0,417,316,334,316,twilight sparkle,tami-kitten
532229.png,https://derpicdn.net/img/view/2014/1/23/532229.png,0,0.9962722063064576,382,33,972,623,590,590,twilight sparkle,inkytophat
532438.png,https://derpicdn.net/img/view/2014/1/23/532438.png,0,0.9979802370071412,329,410,881,962,552,552,twilight sparkle,etiluos
537869.png,https://derpicdn.net/img/view/2014/1/29/537869.png,0,0.996997892856598,594,0,990,386,396,386,twilight sparkle,dennelx3
538028.png,https://derpicdn.net/img/view/2014/1/29/538028.png,0,0.9975482821464542,503,110,825,432,322,322,twilight sparkle,jamescorck
540.jpg,https://derpicdn.net/img/view/2012/1/16/540.jpg,0,0.998020589351654,313,183,919,789,606,606,twilight sparkle,nightairbeats
544951.jpg,https://derpicdn.net/img/view/2014/2/6/544951.jpg,0,0.9893605709075928,372,0,2884,2000,2512,2000,twilight sparkle,diego-spike
546053.jpg,https://derpicdn.net/img/view/2014/2/7/546053.jpg,0,0.9397696256637572,0,124,879,1034,879,910,twilight sparkle,d-lowell
546053.jpg,https://derpicdn.net/img/view/2014/2/7/546053.jpg,1,0.9227691292762756,687,0,1650,906,963,906,twilight sparkle,d-lowell
546557.png,https://derpicdn.net/img/view/2014/2/8/546557.png,0,0.97416889667511,225,137,1731,1643,1506,1506,twilight sparkle,law44444
556745.png,https://derpicdn.net/img/view/2014/2/20/556745.png,0,0.9952749609947203,759,238,1071,550,312,312,twilight sparkle,mr-tiaa
556912.png,https://derpicdn.net/img/view/2014/2/20/556912.png,0,0.9956267476081848,3961,854,8957,5930,4996,5076,twilight sparkle,agentx66
557110.png,https://derpicdn.net/img/view/2014/2/20/557110.png,0,0.9507719278335572,424,5,836,417,412,412,twilight sparkle,silver1kunai
559719.png,https://derpicdn.net/img/view/2014/2/23/559719.png,0,0.9987863898277284,2427,12,5451,3036,3024,3024,twilight sparkle,1apeepa
559720.png,https://derpicdn.net/img/view/2014/2/23/559720.png,0,0.9842436909675598,1678,433,5000,4085,3322,3652,twilight sparkle,budgeriboo|becool362
561963.png,https://derpicdn.net/img/view/2014/2/26/561963.png,0,0.9976457953453064,282,149,926,793,644,644,twilight sparkle,ashourii
562607.png,https://derpicdn.net/img/view/2014/2/27/562607.png,0,0.999363899230957,290,58,638,428,348,370,twilight sparkle,heartinarosebud
565720.png,https://derpicdn.net/img/view/2014/3/3/565720.png,0,0.9944537281990052,394,99,882,587,488,488,twilight sparkle,zodiacnicola
56657.jpg,https://derpicdn.net/img/view/2012/7/25/56657.jpg,0,0.9808192849159241,454,0,932,472,478,472,twilight sparkle,ctulhu666
567447.png,https://derpicdn.net/img/view/2014/3/5/567447.png,0,0.9441217184066772,0,0,1487,1974,1487,1974,twilight sparkle,cezzlo
567585.png,https://derpicdn.net/img/view/2014/3/5/567585.png,0,0.9922342896461488,191,0,3285,3065,3094,3065,twilight sparkle,mactavish1996
567731.png,https://derpicdn.net/img/view/2014/3/6/567731.png,0,0.9733200669288636,13,0,757,653,744,653,twilight sparkle,
568000.png,https://derpicdn.net/img/view/2014/3/6/568000.png,0,0.9891206622123718,537,118,1007,588,470,470,twilight sparkle,flam3zero
569202.png,https://derpicdn.net/img/view/2014/3/8/569202.png,0,0.9883548617362976,55,0,457,393,402,393,twilight sparkle,zerocandy
569416.png,https://derpicdn.net/img/view/2014/3/8/569416.png,0,0.9984155297279358,65,105,397,437,332,332,twilight sparkle,flam3zero
569685.png,https://derpicdn.net/img/view/2014/3/8/569685.png,0,0.9957519173622132,2261,0,5040,2855,2779,2855,twilight sparkle,90sigma
585232.png,https://derpicdn.net/img/view/2014/3/26/585232.png,0,0.9639462232589722,2930,99,8976,6145,6046,6046,twilight sparkle,mokrosuhibrijac
585438.png,https://derpicdn.net/img/view/2014/3/26/585438.png,0,0.9904152154922484,23,0,551,474,528,474,twilight sparkle,hikariviny
58976.png,https://derpicdn.net/img/view/2012/7/27/58976.png,0,0.9995861649513244,248,0,692,406,444,406,twilight sparkle,redintravenous
591248.png,https://derpicdn.net/img/view/2014/4/2/591248.png,0,0.997775375843048,536,255,1126,845,590,590,twilight sparkle,casynuf
593089.png,https://derpicdn.net/img/view/2014/4/5/593089.png,0,0.9603643417358398,104,0,522,387,418,387,twilight sparkle,nonananana
59733.png,https://derpicdn.net/img/view/2012/7/28/59733.png,0,0.9901582598686218,176,17,638,479,462,462,twilight sparkle,ratofdrawn
598419.png,https://derpicdn.net/img/view/2014/4/12/598419.png,0,0.9766908884048462,349,70,761,482,412,412,twilight sparkle,names-tailz
600297.png,https://derpicdn.net/img/view/2014/4/14/600297.png,0,0.9933115839958192,269,0,747,477,478,477,twilight sparkle,lamia
603608.png,https://derpicdn.net/img/view/2014/4/18/603608.png,0,0.9931652545928956,1153,0,2459,1288,1306,1288,twilight sparkle,segfaultd
611540.png,https://derpicdn.net/img/view/2014/4/27/611540.png,0,0.9227399826049804,1208,0,2282,1022,1074,1022,twilight sparkle,matrosha123
611686.png,https://derpicdn.net/img/view/2014/4/27/611686.png,0,0.9891920685768129,625,276,1087,738,462,462,twilight sparkle,sibsy
611885.png,https://derpicdn.net/img/view/2014/4/28/611885.png,0,0.9120368957519532,0,11,820,865,820,854,twilight sparkle,senx
615060.png,https://derpicdn.net/img/view/2014/5/2/615060.png,0,0.981296956539154,639,0,1857,1106,1218,1106,twilight sparkle,tourniquetmuffin
615682.png,https://derpicdn.net/img/view/2014/5/2/615682.png,0,0.995313823223114,0,25,569,605,569,580,twilight sparkle,isa-isa-chan
616130.png,https://derpicdn.net/img/view/2014/5/3/616130.png,0,0.9972023367881776,393,405,563,575,170,170,twilight sparkle,deusexequus
616130.png,https://derpicdn.net/img/view/2014/5/3/616130.png,2,0.9908735156059264,570,579,750,783,180,204,twilight sparkle,deusexequus
616130.png,https://derpicdn.net/img/view/2014/5/3/616130.png,3,0.9869692921638488,113,787,315,989,202,202,twilight sparkle,deusexequus
616130.png,https://derpicdn.net/img/view/2014/5/3/616130.png,4,0.983158528804779,398,193,592,387,194,194,twilight sparkle,deusexequus
616130.png,https://derpicdn.net/img/view/2014/5/3/616130.png,6,0.9562091827392578,434,12,610,188,176,176,twilight sparkle,deusexequus
616130.png,https://derpicdn.net/img/view/2014/5/3/616130.png,7,0.94203120470047,557,399,741,583,184,184,twilight sparkle,deusexequus
616130.png,https://derpicdn.net/img/view/2014/5/3/616130.png,8,0.9402070045471193,226,382,422,578,196,196,twilight sparkle,deusexequus
616130.png,https://derpicdn.net/img/view/2014/5/3/616130.png,9,0.9089499711990356,579,793,750,975,171,182,twilight sparkle,deusexequus
617091.png,https://derpicdn.net/img/view/2014/5/4/617091.png,0,0.9294488430023192,416,0,974,540,558,540,twilight sparkle,sonigoku
617373.png,https://derpicdn.net/img/view/2014/5/4/617373.png,0,0.9920327067375184,497,185,997,685,500,500,twilight sparkle,kirajoleen
617816.jpg,https://derpicdn.net/img/view/2014/5/4/617816.jpg,0,0.9651898145675659,458,0,2104,1493,1646,1493,twilight sparkle,stupck
623269.png,https://derpicdn.net/img/view/2014/5/10/623269.png,0,0.9724861979484558,209,252,899,942,690,690,twilight sparkle,shrineheart
624089.png,https://derpicdn.net/img/view/2014/5/11/624089.png,0,0.930213451385498,10,754,2272,3299,2262,2545,twilight sparkle,emooy13
624103.png,https://derpicdn.net/img/view/2014/5/11/624103.png,0,0.9226649403572084,13,763,2272,3299,2259,2536,twilight sparkle,emooy13
624849.png,https://derpicdn.net/img/view/2014/5/12/624849.png,0,0.9871202707290648,304,8,848,552,544,544,twilight sparkle,
628167.jpg,https://derpicdn.net/img/view/2014/5/16/628167.jpg,0,0.9461825489997864,599,0,2001,1330,1402,1330,twilight sparkle,sycoartworks
628727.png,https://derpicdn.net/img/view/2014/5/17/628727.png,0,0.9456923007965088,67,72,457,462,390,390,twilight sparkle,crazy-luna
629580.png,https://derpicdn.net/img/view/2014/5/18/629580.png,0,0.9108120799064636,384,27,778,421,394,394,twilight sparkle,ultrathehedgetoaster
630439.png,https://derpicdn.net/img/view/2014/5/18/630439.png,0,0.9325684905052184,163,0,697,499,534,499,twilight sparkle,looji
631451.png,https://derpicdn.net/img/view/2014/5/19/631451.png,0,0.99786639213562,24,186,466,628,442,442,twilight sparkle,hansuoddie
631451.png,https://derpicdn.net/img/view/2014/5/19/631451.png,1,0.9667374491691588,378,0,914,534,536,534,twilight sparkle,hansuoddie
632562.png,https://derpicdn.net/img/view/2014/5/21/632562.png,0,0.9975302219390868,80,0,4970,4442,4890,4442,twilight sparkle,estories
633615.jpg,https://derpicdn.net/img/view/2014/5/22/633615.jpg,0,0.966989278793335,1764,160,3634,2030,1870,1870,twilight sparkle,faye-raven
633964.jpg,https://derpicdn.net/img/view/2014/5/22/633964.jpg,0,0.9831001162528992,0,0,698,622,698,622,twilight sparkle,berryden
634849.png,https://derpicdn.net/img/view/2014/5/23/634849.png,0,0.9945923686027528,56,0,612,531,556,531,twilight sparkle,4as
635171.png,https://derpicdn.net/img/view/2014/5/24/635171.png,0,0.9930378794670104,4915,0,9977,4503,5062,4503,twilight sparkle,starshinecelestalis
635678.jpg,https://derpicdn.net/img/view/2014/5/24/635678.jpg,0,0.9961289167404176,118,0,442,319,324,319,twilight sparkle,steveholt
64047.jpg,https://derpicdn.net/img/view/2012/8/1/64047.jpg,0,0.9694151282310486,250,134,536,420,286,286,twilight sparkle,alexmakovsky
640981.png,https://derpicdn.net/img/view/2014/5/30/640981.png,0,0.9192696213722228,940,294,1776,1130,836,836,twilight sparkle,cobracookies
642329.png,https://derpicdn.net/img/view/2014/6/1/642329.png,0,0.9959761500358582,45,0,493,437,448,437,twilight sparkle,frostadflakes
642935.jpg,https://derpicdn.net/img/view/2014/6/2/642935.jpg,0,0.9844852685928344,5,3,383,381,378,378,twilight sparkle,mococo
643907.png,https://derpicdn.net/img/view/2014/6/3/643907.png,0,0.9873238205909728,1932,2497,2724,3289,792,792,twilight sparkle,nightsound76
644481.png,https://derpicdn.net/img/view/2014/6/4/644481.png,0,0.9008023738861084,135,0,1023,691,888,691,twilight sparkle,dm29
646867.png,https://derpicdn.net/img/view/2014/6/6/646867.png,0,0.9957993626594543,203,239,431,467,228,228,twilight sparkle,paper-pony
647095.png,https://derpicdn.net/img/view/2014/6/7/647095.png,0,0.9991714358329772,1132,34,1618,520,486,486,twilight sparkle,blackfreya
649134.png,https://derpicdn.net/img/view/2014/6/9/649134.png,0,0.9342002272605896,17,159,1311,1453,1294,1294,twilight sparkle,quila111
649491.png,https://derpicdn.net/img/view/2014/6/10/649491.png,1,0.9735725522041321,433,175,897,639,464,464,twilight sparkle,blackfreya
649823.jpg,https://derpicdn.net/img/view/2014/6/10/649823.jpg,0,0.9962852001190186,83,1,361,279,278,278,twilight sparkle,terpa-apret
652484.png,https://derpicdn.net/img/view/2014/6/13/652484.png,0,0.9908661842346193,722,0,1660,811,938,811,twilight sparkle,malamol
652595.jpg,https://derpicdn.net/img/view/2014/6/14/652595.jpg,0,0.9881873726844788,395,82,753,440,358,358,twilight sparkle,abbystarling
653676.png,https://derpicdn.net/img/view/2014/6/15/653676.png,0,0.9734949469566344,33,0,545,493,512,493,twilight sparkle,wherewolfs
654096.png,https://derpicdn.net/img/view/2014/6/15/654096.png,0,0.9500141739845276,26,26,330,330,304,304,twilight sparkle,roseywingedcat
659227.png,https://derpicdn.net/img/view/2014/6/22/659227.png,0,0.9701921343803406,0,0,529,472,529,472,twilight sparkle,opallene
659935.png,https://derpicdn.net/img/view/2014/6/23/659935.png,0,0.9926917552947998,1253,156,1635,538,382,382,twilight sparkle,blackfreya
660422.png,https://derpicdn.net/img/view/2014/6/24/660422.png,0,0.9925568699836732,609,0,1199,557,590,557,twilight sparkle,mintystitch
661096.png,https://derpicdn.net/img/view/2014/6/25/661096.png,0,0.996984601020813,0,0,533,532,533,532,twilight sparkle,the-aziz
661119.png,https://derpicdn.net/img/view/2014/6/25/661119.png,0,0.9906304478645324,1820,210,3118,1570,1298,1360,twilight sparkle,missy12113
66116.jpg,https://derpicdn.net/img/view/2012/8/3/66116.jpg,0,0.9966669678688048,166,350,784,968,618,618,twilight sparkle,cold-blooded-twilight
661779.png,https://derpicdn.net/img/view/2014/6/26/661779.png,0,0.980401575565338,0,0,793,743,793,743,twilight sparkle,sketchmcreations
6620.png,https://derpicdn.net/img/view/2012/6/18/6620.png,0,0.9699599742889404,359,115,875,631,516,516,twilight sparkle,princesssaros|bri-sta
668315.png,https://derpicdn.net/img/view/2014/7/5/668315.png,0,0.9155402183532716,50,0,1884,1691,1834,1691,twilight sparkle,benybing
668771.png,https://derpicdn.net/img/view/2014/7/6/668771.png,0,0.9984922409057616,148,4,848,704,700,700,twilight sparkle,tengami
670654.png,https://derpicdn.net/img/view/2014/7/8/670654.png,0,0.9994624853134156,2480,50,4660,2230,2180,2180,twilight sparkle,fenixthefox93
670740.png,https://derpicdn.net/img/view/2014/7/9/670740.png,0,0.9963842034339904,0,0,1115,1126,1115,1126,twilight sparkle,flutterflyraptor
674793.png,https://derpicdn.net/img/view/2014/7/14/674793.png,0,0.9420847296714784,220,0,1194,784,974,784,twilight sparkle,keira-chann
675961.png,https://derpicdn.net/img/view/2014/7/16/675961.png,0,0.9836455583572388,529,1057,1667,2195,1138,1138,twilight sparkle,theshadowstone
676174.jpg,https://derpicdn.net/img/view/2014/7/16/676174.jpg,0,0.9839398860931396,313,0,925,533,612,533,twilight sparkle,prismaticstars
677076.png,https://derpicdn.net/img/view/2014/7/17/677076.png,0,0.9924405217170716,212,75,894,757,682,682,twilight sparkle,kaermter
679990.png,https://derpicdn.net/img/view/2014/7/21/679990.png,0,0.998429000377655,303,29,701,427,398,398,twilight sparkle,rue-willings
685817.png,https://derpicdn.net/img/view/2014/7/29/685817.png,0,0.9978876709938048,318,3,670,355,352,352,twilight sparkle,aaronwolf17
686174.png,https://derpicdn.net/img/view/2014/7/29/686174.png,0,0.9311017990112304,0,36,1028,1142,1028,1106,twilight sparkle,puetsua
686839.png,https://derpicdn.net/img/view/2014/7/30/686839.png,0,0.9529173374176024,1473,210,2497,1234,1024,1024,twilight sparkle,heartshielder1991
687290.png,https://derpicdn.net/img/view/2014/7/30/687290.png,0,0.9967377185821532,175,0,701,515,526,515,twilight sparkle,rannva
688596.png,https://derpicdn.net/img/view/2014/8/1/688596.png,0,0.9807875156402588,189,10,651,472,462,462,twilight sparkle,chiakitasso
690074.png,https://derpicdn.net/img/view/2014/8/3/690074.png,0,0.98722243309021,231,0,477,240,246,240,twilight sparkle,meowbox3
690533.jpg,https://derpicdn.net/img/view/2014/8/3/690533.jpg,0,0.9976298213005066,245,87,1379,1221,1134,1134,twilight sparkle,st-el
691771.png,https://derpicdn.net/img/view/2014/8/5/691771.png,0,0.995060384273529,344,275,794,725,450,450,twilight sparkle,alithographica
693929.png,https://derpicdn.net/img/view/2014/8/7/693929.png,1,0.9284198880195618,856,18,1016,178,160,160,twilight sparkle,oneovertwo
696138.png,https://derpicdn.net/img/view/2014/8/10/696138.png,0,0.9941756129264832,773,0,2335,1284,1562,1284,twilight sparkle,
697078.png,https://derpicdn.net/img/view/2014/8/11/697078.png,0,0.9756683707237244,0,122,499,676,499,554,twilight sparkle,tomoe-chi
698428.png,https://derpicdn.net/img/view/2014/8/13/698428.png,0,0.9925045371055604,345,0,701,353,356,353,twilight sparkle,tlatophat
698597.png,https://derpicdn.net/img/view/2014/8/13/698597.png,0,0.9602758288383484,1298,0,2790,1141,1492,1141,twilight sparkle,mugg1991
699800.png,https://derpicdn.net/img/view/2014/8/14/699800.png,0,0.934856414794922,0,0,370,370,370,370,twilight sparkle,maneribbons
700115.png,https://derpicdn.net/img/view/2014/8/15/700115.png,0,0.9874586462974548,104,23,432,351,328,328,twilight sparkle,cuent
700246.png,https://derpicdn.net/img/view/2014/8/15/700246.png,0,0.9854252338409424,0,0,327,342,327,342,twilight sparkle,k.marcy
701091.png,https://derpicdn.net/img/view/2014/8/16/701091.png,0,0.9887449741363524,419,65,793,439,374,374,twilight sparkle,professordoctorc
701526.png,https://derpicdn.net/img/view/2014/8/17/701526.png,0,0.9992602467536926,1155,0,1703,462,548,462,twilight sparkle,blackfreya
7027.png,https://derpicdn.net/img/view/2012/6/18/7027.png,0,0.9660349488258362,589,0,1357,629,768,629,twilight sparkle,stinkehund
703389.png,https://derpicdn.net/img/view/2014/8/19/703389.png,0,0.939807653427124,0,0,541,474,541,474,twilight sparkle,chickeneatsrainbows
704103.png,https://derpicdn.net/img/view/2014/8/20/704103.png,0,0.9781453609466552,356,0,2590,2133,2234,2133,twilight sparkle,lima-hibiki
705545.png,https://derpicdn.net/img/view/2014/8/22/705545.png,0,0.9526398777961732,130,0,614,381,484,381,twilight sparkle,dm29
706677.png,https://derpicdn.net/img/view/2014/8/24/706677.png,0,0.9042048454284668,82,0,956,852,874,852,twilight sparkle,carranzis
709482.jpg,https://derpicdn.net/img/view/2014/8/27/709482.jpg,0,0.9643456935882568,696,641,1010,955,314,314,twilight sparkle,pedrohander
709677.png,https://derpicdn.net/img/view/2014/8/28/709677.png,0,0.9470661282539368,3097,0,8000,5197,4903,5197,twilight sparkle,byteslice
717136.png,https://derpicdn.net/img/view/2014/9/7/717136.png,0,0.977171778678894,3387,0,6012,2696,2625,2696,twilight sparkle,sugar-loop
719463.png,https://derpicdn.net/img/view/2014/9/10/719463.png,0,0.9674778580665588,522,386,1040,904,518,518,twilight sparkle,notenoughapples
722539.png,https://derpicdn.net/img/view/2014/9/15/722539.png,0,0.9970506429672241,327,0,803,471,476,471,twilight sparkle,wolfy-pony
722727.png,https://derpicdn.net/img/view/2014/9/15/722727.png,0,0.9893486499786376,68,0,992,876,924,876,twilight sparkle,inumocchi
724022.png,https://derpicdn.net/img/view/2014/9/17/724022.png,0,0.9677393436431884,0,0,562,505,562,505,twilight sparkle,sion
724682.png,https://derpicdn.net/img/view/2014/9/18/724682.png,0,0.9844822287559508,205,127,521,443,316,316,twilight sparkle,aeritus
726746.png,https://derpicdn.net/img/view/2014/9/21/726746.png,0,0.9696310758590698,21,0,1085,728,1064,728,twilight sparkle,xxmarkingxx
729066.png,https://derpicdn.net/img/view/2014/9/25/729066.png,0,0.9098252654075624,231,119,1101,989,870,870,twilight sparkle,mizzsnow
730731.png,https://derpicdn.net/img/view/2014/9/27/730731.png,0,0.9754618406295776,5,0,523,516,518,516,twilight sparkle,swanlullaby
734871.png,https://derpicdn.net/img/view/2014/10/3/734871.png,0,0.9355796575546264,138,0,512,372,374,372,twilight sparkle,master-of-scarves
735560.png,https://derpicdn.net/img/view/2014/10/4/735560.png,0,0.9629049897193908,34,39,384,363,350,324,twilight sparkle,
737411.png,https://derpicdn.net/img/view/2014/10/7/737411.png,0,0.996794819831848,158,233,1720,1795,1562,1562,twilight sparkle,meowing-ghost
737512.png,https://derpicdn.net/img/view/2014/10/7/737512.png,0,0.9979540109634399,502,0,1638,1123,1136,1123,twilight sparkle,alazak
738918.png,https://derpicdn.net/img/view/2014/10/8/738918.png,0,0.994057297706604,0,0,356,371,356,371,twilight sparkle,faith-wolff
7390.jpg,https://derpicdn.net/img/view/2012/6/18/7390.jpg,0,0.96516615152359,385,3,733,351,348,348,twilight sparkle,laurenmagpie
739094.png,https://derpicdn.net/img/view/2014/10/9/739094.png,0,0.9016110897064208,472,110,886,524,414,414,twilight sparkle,mirululu
739321.png,https://derpicdn.net/img/view/2014/10/9/739321.png,0,0.9902074933052064,0,0,495,488,495,488,twilight sparkle,littlemissfawn
742570.png,https://derpicdn.net/img/view/2014/10/14/742570.png,0,0.9833654165267944,980,176,1434,630,454,454,twilight sparkle,nastylittlecuss
744001.png,https://derpicdn.net/img/view/2014/10/16/744001.png,0,0.997510313987732,0,0,254,238,254,238,twilight sparkle,mido
746798.png,https://derpicdn.net/img/view/2014/10/20/746798.png,0,0.9898659586906432,178,119,1466,1407,1288,1288,twilight sparkle,nadnerbd
749041.png,https://derpicdn.net/img/view/2014/10/23/749041.png,0,0.9998206496238708,801,0,1815,986,1014,986,twilight sparkle,wickedsilly
749041.png,https://derpicdn.net/img/view/2014/10/23/749041.png,1,0.9902478456497192,1556,0,2518,932,962,932,twilight sparkle,wickedsilly
751127.jpg,https://derpicdn.net/img/view/2014/10/26/751127.jpg,0,0.9973598718643188,84,25,564,505,480,480,twilight sparkle,riddleaellinea
757851.jpg,https://derpicdn.net/img/view/2014/11/4/757851.jpg,0,0.9884971380233764,708,163,1452,907,744,744,twilight sparkle,xain-russell
759186.png,https://derpicdn.net/img/view/2014/11/6/759186.png,0,0.9937732219696044,785,602,1849,1666,1064,1064,twilight sparkle,plainoasis
761330.png,https://derpicdn.net/img/view/2014/11/9/761330.png,0,0.9872450828552246,1261,231,2229,1199,968,968,twilight sparkle,loyalwing
762097.png,https://derpicdn.net/img/view/2014/11/10/762097.png,0,0.9922626614570618,0,0,637,766,637,766,twilight sparkle,missitofu
763259.png,https://derpicdn.net/img/view/2014/11/12/763259.png,0,0.999356746673584,259,0,635,361,376,361,twilight sparkle,empyu
763259.png,https://derpicdn.net/img/view/2014/11/12/763259.png,1,0.988935112953186,172,307,452,587,280,280,twilight sparkle,empyu
763580.png,https://derpicdn.net/img/view/2014/11/13/763580.png,0,0.9703079462051392,878,436,1588,1146,710,710,twilight sparkle,ponballoon
764530.png,https://derpicdn.net/img/view/2014/11/14/764530.png,0,0.9907081723213196,896,0,1660,751,764,751,twilight sparkle,magical disaster
765844.png,https://derpicdn.net/img/view/2014/11/16/765844.png,0,0.9929444789886476,422,68,1248,894,826,826,twilight sparkle,silent-shadow-wolf
767142.png,https://derpicdn.net/img/view/2014/11/18/767142.png,0,0.9545138478279114,157,2,631,476,474,474,twilight sparkle,darkhestur
7675.jpg,https://derpicdn.net/img/view/2012/6/18/7675.jpg,0,0.9643065929412842,291,212,529,450,238,238,twilight sparkle,tomatocoup
767645.png,https://derpicdn.net/img/view/2014/11/19/767645.png,0,0.9849663376808168,440,666,1128,1354,688,688,twilight sparkle,drhikari
768340.png,https://derpicdn.net/img/view/2014/11/20/768340.png,0,0.9645155668258668,185,4,697,568,512,564,twilight sparkle,
768342.png,https://derpicdn.net/img/view/2014/11/20/768342.png,0,0.9522446393966676,306,0,790,471,484,471,twilight sparkle,
770864.png,https://derpicdn.net/img/view/2014/11/24/770864.png,0,0.97905296087265,196,366,412,582,216,216,twilight sparkle,draneas
771060.png,https://derpicdn.net/img/view/2014/11/24/771060.png,0,0.984535038471222,351,22,1171,842,820,820,twilight sparkle,everypone
771588.png,https://derpicdn.net/img/view/2014/11/25/771588.png,0,0.9773314595222472,213,0,2200,1956,1987,1956,twilight sparkle,manfartwish
773399.png,https://derpicdn.net/img/view/2014/11/28/773399.png,0,0.9985865950584412,17,90,341,414,324,324,twilight sparkle,thisisdashie
774236.png,https://derpicdn.net/img/view/2014/11/29/774236.png,0,0.9934636950492859,418,0,1066,637,648,637,twilight sparkle,the-kirion
775161.png,https://derpicdn.net/img/view/2014/11/30/775161.png,0,0.9485079050064088,206,0,856,598,650,598,twilight sparkle,spacecat-studios
775833.png,https://derpicdn.net/img/view/2014/12/1/775833.png,0,0.9930641651153564,94,89,440,435,346,346,twilight sparkle,yajima
777896.png,https://derpicdn.net/img/view/2014/12/4/777896.png,0,0.9856367707252502,11,445,323,757,312,312,twilight sparkle,kampfkeks007
777965.png,https://derpicdn.net/img/view/2014/12/4/777965.png,0,0.9604917168617249,158,12,490,344,332,332,twilight sparkle,aleximusprime
778083.jpg,https://derpicdn.net/img/view/2014/12/4/778083.jpg,0,0.9233880043029784,346,172,1732,1558,1386,1386,twilight sparkle,comic-graffiti
782621.png,https://derpicdn.net/img/view/2014/12/11/782621.png,0,0.9912869334220886,746,765,1426,1445,680,680,twilight sparkle,littaly|little-tweenframes
784337.jpg,https://derpicdn.net/img/view/2014/12/13/784337.jpg,0,0.9946805238723756,585,0,1405,803,820,803,twilight sparkle,greyscaleart
786820.png,https://derpicdn.net/img/view/2014/12/17/786820.png,0,0.9898305535316468,420,122,978,680,558,558,twilight sparkle,invertigo
787133.png,https://derpicdn.net/img/view/2014/12/18/787133.png,0,0.9480991959571838,132,110,556,534,424,424,twilight sparkle,carla-92
789491.png,https://derpicdn.net/img/view/2014/12/21/789491.png,0,0.9887253642082214,0,196,840,1248,840,1052,twilight sparkle,goda900
790040.png,https://derpicdn.net/img/view/2014/12/22/790040.png,0,0.9562212228775024,1680,406,2084,810,404,404,twilight sparkle,itsuko103
794108.png,https://derpicdn.net/img/view/2014/12/28/794108.png,0,0.9872621893882751,807,144,1767,1104,960,960,twilight sparkle,artyjoyful
794653.png,https://derpicdn.net/img/view/2014/12/28/794653.png,0,0.9847373962402344,92,0,1232,1112,1140,1112,twilight sparkle,inkytophat
796104.png,https://derpicdn.net/img/view/2014/12/30/796104.png,0,0.9922847151756288,856,111,2342,1597,1486,1486,twilight sparkle,segraece
796174.jpg,https://derpicdn.net/img/view/2014/12/30/796174.jpg,0,0.9357315301895142,2474,1043,3082,1651,608,608,twilight sparkle,osakaoji|namefag.mp3
796458.png,https://derpicdn.net/img/view/2014/12/31/796458.png,0,0.9606818556785583,42,0,1180,718,1138,718,twilight sparkle,facing-worlds
79716.jpg,https://derpicdn.net/img/view/2012/8/22/79716.jpg,0,0.9837551116943359,388,132,808,552,420,420,twilight sparkle,tzelly-el
797290.png,https://derpicdn.net/img/view/2015/1/1/797290.png,0,0.9550763964653016,548,88,1280,820,732,732,twilight sparkle,zvn
801935.png,https://derpicdn.net/img/view/2015/1/8/801935.png,0,0.9544598460197448,1455,512,2359,1416,904,904,twilight sparkle,sewingintherain|katyand
805237.png,https://derpicdn.net/img/view/2015/1/13/805237.png,0,0.9578417539596558,88,0,378,277,290,277,twilight sparkle,woox
810553.png,https://derpicdn.net/img/view/2015/1/20/810553.png,0,0.9984236359596252,1732,0,3545,1673,1813,1673,twilight sparkle,porygon2z
812530.png,https://derpicdn.net/img/view/2015/1/23/812530.png,0,0.9836869239807128,475,0,1495,806,1020,806,twilight sparkle,suzuii
813540.png,https://derpicdn.net/img/view/2015/1/24/813540.png,0,0.9992287755012512,665,159,1277,771,612,612,twilight sparkle,cartoonowl
816365.png,https://derpicdn.net/img/view/2015/1/28/816365.png,0,0.9747703075408936,42,37,486,481,444,444,twilight sparkle,superkeen
816656.png,https://derpicdn.net/img/view/2015/1/28/816656.png,0,0.9881842136383056,0,0,1150,1146,1150,1146,twilight sparkle,jorichi
817992.png,https://derpicdn.net/img/view/2015/1/30/817992.png,0,0.9432341456413268,0,0,3312,3346,3312,3346,twilight sparkle,caranella
818207.png,https://derpicdn.net/img/view/2015/1/31/818207.png,0,0.999407172203064,272,0,906,625,634,625,twilight sparkle,wolfy-pony
818428.png,https://derpicdn.net/img/view/2015/1/31/818428.png,0,0.9532663822174072,1461,104,3559,2202,2098,2098,twilight sparkle,thealjavis
821012.png,https://derpicdn.net/img/view/2015/2/4/821012.png,0,0.9325069785118104,194,0,962,671,768,671,twilight sparkle,uncommented
825435.png,https://derpicdn.net/img/view/2015/2/10/825435.png,0,0.9908490180969238,419,114,1833,1528,1414,1414,twilight sparkle,sketchragon
827579.png,https://derpicdn.net/img/view/2015/2/13/827579.png,0,0.9953340291976928,2041,0,3891,1753,1850,1753,twilight sparkle,estories
827580.png,https://derpicdn.net/img/view/2015/2/13/827580.png,0,0.988778591156006,83,66,2207,2190,2124,2124,twilight sparkle,estories
829590.png,https://derpicdn.net/img/view/2015/2/15/829590.png,0,0.9154809713363647,258,1645,4724,6111,4466,4466,twilight sparkle,decprincess
832739.png,https://derpicdn.net/img/view/2015/2/19/832739.png,0,0.951284646987915,74,27,896,849,822,822,twilight sparkle,shoroch
834068.png,https://derpicdn.net/img/view/2015/2/21/834068.png,1,0.9857670068740844,791,262,1159,630,368,368,twilight sparkle,riddleaellinea
835498.png,https://derpicdn.net/img/view/2015/2/23/835498.png,0,0.9968271851539612,89,0,3393,3224,3304,3224,twilight sparkle,bobsicle0
838146.png,https://derpicdn.net/img/view/2015/2/27/838146.png,0,0.9994165301322936,631,245,955,569,324,324,twilight sparkle,vampirelili
838729.png,https://derpicdn.net/img/view/2015/2/28/838729.png,0,0.9851844906806946,915,677,1671,1433,756,756,twilight sparkle,neuro
839452.png,https://derpicdn.net/img/view/2015/3/1/839452.png,0,0.9905884861946106,247,114,727,594,480,480,twilight sparkle,leffenkitty
844388.png,https://derpicdn.net/img/view/2015/3/7/844388.png,0,0.9551284313201904,997,0,2079,1010,1082,1010,twilight sparkle,vavacung
844898.png,https://derpicdn.net/img/view/2015/3/8/844898.png,0,0.9784327745437622,0,0,675,694,675,694,twilight sparkle,frostadflakes
848627.png,https://derpicdn.net/img/view/2015/3/13/848627.png,0,0.9937092065811156,152,28,486,362,334,334,twilight sparkle,rflzqt
848826.png,https://derpicdn.net/img/view/2015/3/13/848826.png,0,0.9912800788879396,104,31,572,499,468,468,twilight sparkle,deusexequus
850532.png,https://derpicdn.net/img/view/2015/3/16/850532.png,0,0.9971731305122375,1529,1408,3177,3056,1648,1648,twilight sparkle,outlaw-marston
85134.png,https://derpicdn.net/img/view/2012/8/28/85134.png,0,0.9932636618614196,12,16,800,804,788,788,twilight sparkle,ziemniax
852176.png,https://derpicdn.net/img/view/2015/3/18/852176.png,0,0.9920342564582824,602,94,1920,1412,1318,1318,twilight sparkle,detomasko
852414.jpg,https://derpicdn.net/img/view/2015/3/18/852414.jpg,0,0.9915301203727722,982,95,1646,759,664,664,twilight sparkle,seenty
855655.png,https://derpicdn.net/img/view/2015/3/23/855655.png,0,0.9943613409996032,365,22,775,432,410,410,twilight sparkle,suenden-hund
856300.png,https://derpicdn.net/img/view/2015/3/24/856300.png,0,0.981391668319702,581,88,1423,930,842,842,twilight sparkle,sannykat
860874.png,https://derpicdn.net/img/view/2015/3/30/860874.png,0,0.9989972114562988,1313,216,2711,1614,1398,1398,twilight sparkle,roze23
870415.png,https://derpicdn.net/img/view/2015/4/10/870415.png,0,0.9959173798561096,90,31,478,419,388,388,twilight sparkle,billysan727
870528.png,https://derpicdn.net/img/view/2015/4/10/870528.png,0,0.9769302606582642,735,184,1375,824,640,640,twilight sparkle,davidcurser
872236.png,https://derpicdn.net/img/view/2015/4/12/872236.png,0,0.9826287031173706,73,23,941,891,868,868,twilight sparkle,
872792.png,https://derpicdn.net/img/view/2015/4/12/872792.png,0,0.9576018452644348,215,55,479,319,264,264,twilight sparkle,fire-topaz
873446.png,https://derpicdn.net/img/view/2015/4/13/873446.png,0,0.9776015281677246,205,0,1793,1080,1588,1080,twilight sparkle,
875316.png,https://derpicdn.net/img/view/2015/4/16/875316.png,0,0.9944563508033752,0,14,1229,1258,1229,1244,twilight sparkle,dambitail
876105.png,https://derpicdn.net/img/view/2015/4/17/876105.png,0,0.996468424797058,1066,45,1926,905,860,860,twilight sparkle,tizerfiction
879182.jpg,https://derpicdn.net/img/view/2015/4/21/879182.jpg,0,0.9974556565284728,232,0,1616,1354,1384,1354,twilight sparkle,gc-theroseking
880843.png,https://derpicdn.net/img/view/2015/4/23/880843.png,0,0.9408977031707764,0,206,393,604,393,398,twilight sparkle,clouddg
883875.png,https://derpicdn.net/img/view/2015/4/27/883875.png,0,0.9985055327415466,441,0,873,409,432,409,twilight sparkle,mabo3
885015.png,https://derpicdn.net/img/view/2015/4/28/885015.png,0,0.9796248078346252,149,0,1250,1192,1101,1192,twilight sparkle,entou
886995.png,https://derpicdn.net/img/view/2015/5/2/886995.png,0,0.9267073273658752,303,167,703,567,400,400,twilight sparkle,xenalollie
887380.jpg,https://derpicdn.net/img/view/2015/5/2/887380.jpg,0,0.9786559343338012,956,0,2112,1153,1156,1153,twilight sparkle,mrbrunoh1
887419.png,https://derpicdn.net/img/view/2015/5/2/887419.png,0,0.9717903137207032,2452,0,8000,5625,5548,5625,twilight sparkle,djdavid98|uxyd
888391.png,https://derpicdn.net/img/view/2015/5/3/888391.png,1,0.9605574011802672,10,92,402,484,392,392,twilight sparkle,ameshou
888393.png,https://derpicdn.net/img/view/2015/5/3/888393.png,0,0.9890047907829284,1226,0,2350,1073,1124,1073,twilight sparkle,zacatron94
88855.jpg,https://derpicdn.net/img/view/2012/9/3/88855.jpg,0,0.9265976548194884,81,41,500,469,419,428,twilight sparkle,kinkyspree
890558.png,https://derpicdn.net/img/view/2015/5/6/890558.png,0,0.9850196838378906,317,0,1223,871,906,871,twilight sparkle,jessesmash32
891260.png,https://derpicdn.net/img/view/2015/5/7/891260.png,0,0.9941731095314026,3769,415,6347,2993,2578,2578,twilight sparkle,toxic-mario
89149.jpg,https://derpicdn.net/img/view/2012/9/3/89149.jpg,0,0.9878183007240297,951,40,2341,1430,1390,1390,twilight sparkle,72-hours-remain
897491.png,https://derpicdn.net/img/view/2015/5/16/897491.png,0,0.9437440633773804,0,4,298,316,298,312,twilight sparkle,
897584.png,https://derpicdn.net/img/view/2015/5/16/897584.png,0,0.947445273399353,0,100,775,902,775,802,twilight sparkle,
897620.png,https://derpicdn.net/img/view/2015/5/16/897620.png,0,0.9809156060218812,227,34,749,556,522,522,twilight sparkle,cluttercluster
899931.png,https://derpicdn.net/img/view/2015/5/19/899931.png,0,0.9629527926445008,150,0,672,482,522,482,twilight sparkle,tincantim
900147.png,https://derpicdn.net/img/view/2015/5/19/900147.png,0,0.9980081915855408,96,180,510,594,414,414,twilight sparkle,lavasokawaii
900147.png,https://derpicdn.net/img/view/2015/5/19/900147.png,1,0.9655067324638368,1390,232,1814,656,424,424,twilight sparkle,lavasokawaii
901300.png,https://derpicdn.net/img/view/2015/5/21/901300.png,0,0.9917926192283628,1562,99,3414,1951,1852,1852,twilight sparkle,estories
901302.png,https://derpicdn.net/img/view/2015/5/21/901302.png,0,0.9959140419960022,1496,57,3270,1831,1774,1774,twilight sparkle,estories
904846.png,https://derpicdn.net/img/view/2015/5/27/904846.png,0,0.9992413520812988,3213,0,5989,2786,2776,2786,twilight sparkle,slb94
905689.png,https://derpicdn.net/img/view/2015/5/28/905689.png,0,0.9595561027526855,918,105,2052,1239,1134,1134,twilight sparkle,featheredart
906419.png,https://derpicdn.net/img/view/2015/5/29/906419.png,0,0.998018741607666,2780,0,3844,979,1064,979,twilight sparkle,zacatron94
907264.png,https://derpicdn.net/img/view/2015/5/31/907264.png,0,0.9915562868118286,6,98,540,632,534,534,twilight sparkle,rue-willings
907978.png,https://derpicdn.net/img/view/2015/6/1/907978.png,0,0.9969469904899596,0,0,1746,1730,1746,1730,twilight sparkle,shinypikachu25
911778.png,https://derpicdn.net/img/view/2015/6/6/911778.png,0,0.9001225233078003,24,0,1000,945,976,945,twilight sparkle,agentesinrebus
91373.png,https://derpicdn.net/img/view/2012/9/6/91373.png,0,0.9880214929580688,51,0,405,338,354,338,twilight sparkle,matemi-i
915315.png,https://derpicdn.net/img/view/2015/6/12/915315.png,0,0.997443437576294,0,0,2459,2608,2459,2608,twilight sparkle,ikillyou121|djdavid98|uxyd
921334.png,https://derpicdn.net/img/view/2015/6/22/921334.png,0,0.9923672676086426,137,5,1149,1017,1012,1012,twilight sparkle,kinkypinkink
921336.png,https://derpicdn.net/img/view/2015/6/22/921336.png,0,0.9369345903396606,246,7,1244,1005,998,998,twilight sparkle,kinkypinkink
929516.png,https://derpicdn.net/img/view/2015/7/4/929516.png,0,0.9993442893028259,0,0,363,365,363,365,twilight sparkle,amberpendant
931976.png,https://derpicdn.net/img/view/2015/7/7/931976.png,0,0.9487836360931396,562,0,1572,935,1010,935,twilight sparkle,pageturner8
935554.jpg,https://derpicdn.net/img/view/2015/7/12/935554.jpg,0,0.9948139190673828,0,241,254,551,254,310,twilight sparkle,ukingu
941169.png,https://derpicdn.net/img/view/2015/7/21/941169.png,0,0.9858483672142028,1639,108,2535,1004,896,896,twilight sparkle,crusierpl
944985.png,https://derpicdn.net/img/view/2015/7/27/944985.png,0,0.9764351844787598,714,0,2148,1177,1434,1177,twilight sparkle,rdbrony16
945349.png,https://derpicdn.net/img/view/2015/7/27/945349.png,0,0.9482796788215636,4520,0,6942,2097,2422,2097,twilight sparkle,krusiu42
948285.jpg,https://derpicdn.net/img/view/2015/8/1/948285.jpg,0,0.998696506023407,360,0,888,467,528,467,twilight sparkle,php76
953461.png,https://derpicdn.net/img/view/2015/8/8/953461.png,0,0.962715983390808,0,54,2502,3068,2502,3014,twilight sparkle,niegelvonwolf
954285.jpg,https://derpicdn.net/img/view/2015/8/9/954285.jpg,0,0.9797764420509338,505,1026,1497,2018,992,992,twilight sparkle,yellowrobin
954426.jpg,https://derpicdn.net/img/view/2015/8/9/954426.jpg,0,0.9957451224327089,314,144,822,652,508,508,twilight sparkle,dragonblood6400
955974.png,https://derpicdn.net/img/view/2015/8/12/955974.png,0,0.9484741687774658,443,200,2413,2170,1970,1970,twilight sparkle,nutkicker12
957710.png,https://derpicdn.net/img/view/2015/8/14/957710.png,0,0.9898925423622132,1535,189,2893,1547,1358,1358,twilight sparkle,icy wings
960122.jpg,https://derpicdn.net/img/view/2015/8/18/960122.jpg,0,0.9864593744277954,399,209,1111,921,712,712,twilight sparkle,slamjam
964155.png,https://derpicdn.net/img/view/2015/8/23/964155.png,0,0.9061077237129213,115,1273,451,1609,336,336,twilight sparkle,
965390.png,https://derpicdn.net/img/view/2015/8/25/965390.png,0,0.9979090690612792,37,0,769,687,732,687,twilight sparkle,sweetfilthyfun
972211.png,https://derpicdn.net/img/view/2015/9/3/972211.png,0,0.9823158383369446,882,116,1128,362,246,246,twilight sparkle,x-piiu
972487.png,https://derpicdn.net/img/view/2015/9/4/972487.png,0,0.9753660559654236,2023,312,3840,2160,1817,1848,twilight sparkle,dashiesparkle|antylavx
988325.png,https://derpicdn.net/img/view/2015/9/26/988325.png,0,0.9679661393165588,16,31,490,505,474,474,twilight sparkle,sleep-powder
996994.png,https://derpicdn.net/img/view/2015/10/8/996994.png,0,0.9979081153869628,142,0,712,543,570,543,twilight sparkle,totallynotabronyfim|illumnious|kp-shadowsquirrel
997200.jpg,https://derpicdn.net/img/view/2015/10/8/997200.jpg,0,0.9960034489631652,63,521,1023,1481,960,960,twilight sparkle,0strolist
998036.png,https://derpicdn.net/img/view/2015/10/9/998036.png,0,0.9986462593078612,456,321,840,705,384,384,twilight sparkle,redquoz
999455.png,https://derpicdn.net/img/view/2015/10/11/999455.png,1,0.9226422905921936,630,1549,849,1773,219,224,twilight sparkle,skitea
999512.png,https://derpicdn.net/img/view/2015/10/11/999512.png,0,0.9994912147521972,332,23,826,517,494,494,twilight sparkle,discord888
1000127.jpeg,https://derpicdn.net/img/view/2015/10/11/1000127.jpeg,0,0.9974042773246764,262,2,600,346,338,344,twilight sparkle,casara
1002842.jpeg,https://derpicdn.net/img/view/2015/10/15/1002842.jpeg,0,0.991954505443573,142,0,2248,1810,2106,1810,twilight sparkle,magnaluna
1005334.jpeg,https://derpicdn.net/img/view/2015/10/18/1005334.jpeg,0,0.9984842538833618,144,239,358,453,214,214,twilight sparkle,senseijiufu
1005334.jpeg,https://derpicdn.net/img/view/2015/10/18/1005334.jpeg,1,0.9486651420593262,699,192,925,418,226,226,twilight sparkle,senseijiufu
1007527.jpeg,https://derpicdn.net/img/view/2015/10/22/1007527.jpeg,0,0.9980304837226868,262,5,600,347,338,342,twilight sparkle,casara
1010509.jpeg,https://derpicdn.net/img/view/2015/10/28/1010509.jpeg,0,0.9767115712165833,67,0,1535,1406,1468,1406,twilight sparkle,captainpudgemuffin
1011168.jpeg,https://derpicdn.net/img/view/2015/10/28/1011168.jpeg,0,0.9703385829925536,475,214,849,588,374,374,twilight sparkle,sherwoodwhisper
1014916.jpeg,https://derpicdn.net/img/view/2015/11/2/1014916.jpeg,0,0.9988855719566344,392,0,1134,690,742,690,twilight sparkle,captainpudgemuffin
1019666.jpeg,https://derpicdn.net/img/view/2015/11/9/1019666.jpeg,0,0.99762362241745,454,162,1170,878,716,716,twilight sparkle,captainpudgemuffin
1020568.jpeg,https://derpicdn.net/img/view/2015/11/10/1020568.jpeg,0,0.9481225013732908,225,57,621,453,396,396,twilight sparkle,sellyluvsart
1025092.jpeg,https://derpicdn.net/img/view/2015/11/18/1025092.jpeg,0,0.9907538294792176,307,23,971,687,664,664,twilight sparkle,blacki
1025197.jpeg,https://derpicdn.net/img/view/2015/11/18/1025197.jpeg,0,0.9903133511543274,733,0,1871,1057,1138,1057,twilight sparkle,ncmares
1025252.jpeg,https://derpicdn.net/img/view/2015/11/18/1025252.jpeg,0,0.9993144869804382,1008,0,2082,980,1074,980,twilight sparkle,jamesjackobgermany
1025287.jpeg,https://derpicdn.net/img/view/2015/11/18/1025287.jpeg,0,0.993147313594818,296,792,596,1092,300,300,twilight sparkle,crikeydave
1026398.jpeg,https://derpicdn.net/img/view/2015/11/20/1026398.jpeg,0,0.9941953420639038,81,0,939,817,858,817,twilight sparkle,artistcoolpony
1026534.jpeg,https://derpicdn.net/img/view/2015/11/20/1026534.jpeg,0,0.9837592840194702,672,0,1368,663,696,663,twilight sparkle,ariasolarena
1028583.jpeg,https://derpicdn.net/img/view/2015/11/23/1028583.jpeg,0,0.99940687417984,102,0,424,310,322,310,twilight sparkle,sheeppiss
1028875.jpeg,https://derpicdn.net/img/view/2015/11/23/1028875.jpeg,0,0.9994401335716248,90,240,318,468,228,228,twilight sparkle,victoreach
1029514.jpeg,https://derpicdn.net/img/view/2015/11/24/1029514.jpeg,0,0.9252622723579408,291,117,625,451,334,334,twilight sparkle,toughset
1032939.jpeg,https://derpicdn.net/img/view/2015/11/29/1032939.jpeg,0,0.9342524409294128,852,1877,1618,2643,766,766,twilight sparkle,overlord103
1034659.jpeg,https://derpicdn.net/img/view/2015/12/1/1034659.jpeg,0,0.9721443057060242,1651,114,2453,916,802,802,twilight sparkle,waterferret
1036468.jpeg,https://derpicdn.net/img/view/2015/12/4/1036468.jpeg,0,0.9988969564437866,1148,0,2914,1679,1766,1679,twilight sparkle,katrina-mae
1036468.jpeg,https://derpicdn.net/img/view/2015/12/4/1036468.jpeg,1,0.9985766410827636,0,0,1290,1370,1290,1370,twilight sparkle,katrina-mae
1036468.jpeg,https://derpicdn.net/img/view/2015/12/4/1036468.jpeg,2,0.952143132686615,0,1223,1552,2835,1552,1612,twilight sparkle,katrina-mae
1036823.jpeg,https://derpicdn.net/img/view/2015/12/4/1036823.jpeg,0,0.998102605342865,163,6,649,492,486,486,twilight sparkle,heu-hey
1038653.jpeg,https://derpicdn.net/img/view/2015/12/7/1038653.jpeg,0,0.9671474695205688,1689,33,2607,1003,918,970,twilight sparkle,mistydash
1038957.jpeg,https://derpicdn.net/img/view/2015/12/7/1038957.jpeg,0,0.9463579654693604,393,0,1167,728,774,728,twilight sparkle,angelstar063
1040523.jpeg,https://derpicdn.net/img/view/2015/12/9/1040523.jpeg,0,0.9992881417274476,100,0,532,400,432,400,twilight sparkle,pastel-pony-pictures
1041331.jpeg,https://derpicdn.net/img/view/2015/12/10/1041331.jpeg,0,0.9501851797103882,245,6,539,300,294,294,twilight sparkle,zwitterkitsune
1044046.jpeg,https://derpicdn.net/img/view/2015/12/14/1044046.jpeg,0,0.9318580627441406,499,48,972,528,473,480,twilight sparkle,princess-katie
1049806.jpeg,https://derpicdn.net/img/view/2015/12/21/1049806.jpeg,0,0.989965558052063,243,368,473,598,230,230,twilight sparkle,cheetagonzita
1050244.jpeg,https://derpicdn.net/img/view/2015/12/22/1050244.jpeg,0,0.9659015536308287,796,147,1168,519,372,372,twilight sparkle,fuzzyfox11
1053016.jpeg,https://derpicdn.net/img/view/2015/12/26/1053016.jpeg,0,0.9973639845848083,383,135,781,533,398,398,twilight sparkle,nauticalsparrow
1054589.jpeg,https://derpicdn.net/img/view/2015/12/28/1054589.jpeg,0,0.9322174787521362,633,99,1483,949,850,850,twilight sparkle,yukomaussi
1054710.jpeg,https://derpicdn.net/img/view/2015/12/28/1054710.jpeg,0,0.9995481371879578,863,0,1369,459,506,459,twilight sparkle,yukomaussi
1056240.jpeg,https://derpicdn.net/img/view/2015/12/31/1056240.jpeg,0,0.9944981336593628,45,0,573,512,528,512,twilight sparkle,tomoyuuki
1056278.jpeg,https://derpicdn.net/img/view/2015/12/31/1056278.jpeg,0,0.9034045934677124,52,0,472,401,420,401,twilight sparkle,viddi32
1058308.jpeg,https://derpicdn.net/img/view/2016/1/2/1058308.jpeg,0,0.9574463963508606,192,1,602,411,410,410,twilight sparkle,louderpony
1063699.jpeg,https://derpicdn.net/img/view/2016/1/10/1063699.jpeg,0,0.978525698184967,1823,337,3999,2513,2176,2176,twilight sparkle,aurelleah
1065373.jpeg,https://derpicdn.net/img/view/2016/1/12/1065373.jpeg,0,0.9102301597595216,1014,0,1970,889,956,889,twilight sparkle,arielsbx
1065402.jpeg,https://derpicdn.net/img/view/2016/1/12/1065402.jpeg,0,0.948478639125824,938,50,2800,1877,1862,1827,twilight sparkle,mistydash
1065497.jpeg,https://derpicdn.net/img/view/2016/1/13/1065497.jpeg,0,0.992384672164917,0,13,910,983,910,970,twilight sparkle,shira-hedgie
1067623.jpeg,https://derpicdn.net/img/view/2016/1/16/1067623.jpeg,0,0.9836089611053468,562,88,1036,562,474,474,twilight sparkle,pimander1446
1068599.jpeg,https://derpicdn.net/img/view/2016/1/17/1068599.jpeg,0,0.9015904068946838,274,89,388,203,114,114,twilight sparkle,botched_spot
1068604.jpeg,https://derpicdn.net/img/view/2016/1/17/1068604.jpeg,0,0.999190628528595,588,0,1098,463,510,463,twilight sparkle,magnaluna
1071232.jpeg,https://derpicdn.net/img/view/2016/1/22/1071232.jpeg,0,0.9651007652282716,89,119,865,895,776,776,twilight sparkle,solar-slash
1074342.jpeg,https://derpicdn.net/img/view/2016/1/26/1074342.jpeg,0,0.9380177855491638,374,232,772,630,398,398,twilight sparkle,miokomata
1076061.jpeg,https://derpicdn.net/img/view/2016/1/29/1076061.jpeg,1,0.9515134692192078,0,611,373,1057,373,446,twilight sparkle,tyuubatu
1076101.jpeg,https://derpicdn.net/img/view/2016/1/29/1076101.jpeg,0,0.998023808002472,323,0,807,462,484,462,twilight sparkle,souladdicted
1077932.jpeg,https://derpicdn.net/img/view/2016/2/1/1077932.jpeg,0,0.9290848970413208,250,30,890,670,640,640,twilight sparkle,opalacorn
1079739.jpeg,https://derpicdn.net/img/view/2016/2/4/1079739.jpeg,0,0.9126132130622864,486,562,2186,2262,1700,1700,twilight sparkle,asimplerarity
1079918.jpeg,https://derpicdn.net/img/view/2016/2/4/1079918.jpeg,0,0.9907824993133544,542,0,860,288,318,288,twilight sparkle,novabytes
1080381.jpeg,https://derpicdn.net/img/view/2016/2/4/1080381.jpeg,0,0.9920087456703186,0,0,1536,1525,1536,1525,twilight sparkle,mistydash
1080628.jpeg,https://derpicdn.net/img/view/2016/2/5/1080628.jpeg,0,0.9879337549209596,151,13,573,435,422,422,twilight sparkle,pegasisters82
1080641.jpeg,https://derpicdn.net/img/view/2016/2/5/1080641.jpeg,0,0.976096212863922,0,0,655,598,655,598,twilight sparkle,solar-slash
1080882.jpeg,https://derpicdn.net/img/view/2016/2/5/1080882.jpeg,0,0.9751020073890686,1409,82,2013,686,604,604,twilight sparkle,solar-claw
1081575.jpeg,https://derpicdn.net/img/view/2016/2/6/1081575.jpeg,0,0.997352123260498,393,1,585,193,192,192,twilight sparkle,theneithervoid
1081599.jpeg,https://derpicdn.net/img/view/2016/2/6/1081599.jpeg,0,0.992798924446106,55,82,611,638,556,556,twilight sparkle,laptop-pone|joe0316
1082725.jpeg,https://derpicdn.net/img/view/2016/2/7/1082725.jpeg,0,0.9927222728729248,582,0,2084,1401,1502,1401,twilight sparkle,mon311|itarra
1084862.jpeg,https://derpicdn.net/img/view/2016/2/10/1084862.jpeg,0,0.9983311295509338,1059,223,2071,1235,1012,1012,twilight sparkle,miesmauz
1088128.jpeg,https://derpicdn.net/img/view/2016/2/14/1088128.jpeg,0,0.9874248504638672,502,11,762,271,260,260,twilight sparkle,scheadar
1088128.jpeg,https://derpicdn.net/img/view/2016/2/14/1088128.jpeg,1,0.9661760926246644,108,87,302,281,194,194,twilight sparkle,scheadar
1089794.jpeg,https://derpicdn.net/img/view/2016/2/16/1089794.jpeg,0,0.9355846047401428,28,0,476,439,448,439,twilight sparkle,kolshica
1089994.jpeg,https://derpicdn.net/img/view/2016/2/16/1089994.jpeg,0,0.9951711297035216,1251,201,1600,565,349,364,twilight sparkle,sirzi
1089994.jpeg,https://derpicdn.net/img/view/2016/2/16/1089994.jpeg,1,0.9720323085784912,77,145,555,623,478,478,twilight sparkle,sirzi
1089999.jpeg,https://derpicdn.net/img/view/2016/2/16/1089999.jpeg,0,0.9290112853050232,909,163,1371,625,462,462,twilight sparkle,acesential
1092720.jpeg,https://derpicdn.net/img/view/2016/2/20/1092720.jpeg,0,0.9223527908325196,0,37,396,499,396,462,twilight sparkle,jess-choco88
1094454.jpeg,https://derpicdn.net/img/view/2016/2/22/1094454.jpeg,0,0.9885934591293336,598,128,1336,866,738,738,twilight sparkle,zeiram0034
1100969.jpeg,https://derpicdn.net/img/view/2016/3/3/1100969.jpeg,0,0.9901570081710817,2952,179,4972,2199,2020,2020,twilight sparkle,zilvart
1101952.jpeg,https://derpicdn.net/img/view/2016/3/4/1101952.jpeg,0,0.9584606289863586,389,0,1745,1220,1356,1220,twilight sparkle,ncmares
1102478.jpeg,https://derpicdn.net/img/view/2016/3/5/1102478.jpeg,0,0.9995774626731871,593,20,1200,652,607,632,twilight sparkle,tikrs007
1102478.jpeg,https://derpicdn.net/img/view/2016/3/5/1102478.jpeg,1,0.9937971830368042,0,0,679,673,679,673,twilight sparkle,tikrs007
1107180.jpeg,https://derpicdn.net/img/view/2016/3/12/1107180.jpeg,0,0.9881861209869384,233,0,725,441,492,441,twilight sparkle,leamarto
1107200.jpeg,https://derpicdn.net/img/view/2016/3/12/1107200.jpeg,0,0.996351420879364,411,0,1477,913,1066,913,twilight sparkle,skribbler84
1107204.jpeg,https://derpicdn.net/img/view/2016/3/12/1107204.jpeg,0,0.9968927502632141,0,293,406,711,406,418,twilight sparkle,backlash91
1110952.jpeg,https://derpicdn.net/img/view/2016/3/17/1110952.jpeg,0,0.991990327835083,0,22,427,538,427,516,twilight sparkle,drbdnv
1110975.jpeg,https://derpicdn.net/img/view/2016/3/17/1110975.jpeg,0,0.9986721873283386,647,48,1227,628,580,580,twilight sparkle,poecillia-gracilis19
1112274.jpeg,https://derpicdn.net/img/view/2016/3/19/1112274.jpeg,0,0.9732717275619508,550,363,934,747,384,384,twilight sparkle,emeraldgalaxy
1112281.jpeg,https://derpicdn.net/img/view/2016/3/19/1112281.jpeg,0,0.950311243534088,439,562,729,852,290,290,twilight sparkle,emeraldgalaxy
1112298.jpeg,https://derpicdn.net/img/view/2016/3/19/1112298.jpeg,0,0.9679264426231384,308,190,636,518,328,328,twilight sparkle,sambragg
1113182.jpeg,https://derpicdn.net/img/view/2016/3/20/1113182.jpeg,0,0.9848182201385498,191,453,2843,3105,2652,2652,twilight sparkle,alts-art
1116400.jpeg,https://derpicdn.net/img/view/2016/3/25/1116400.jpeg,0,0.9437550902366638,452,9,948,505,496,496,twilight sparkle,odaefnyo
1117371.jpeg,https://derpicdn.net/img/view/2016/3/26/1117371.jpeg,0,0.9878849983215332,609,0,2997,1688,2388,1688,twilight sparkle,alumx
1117568.jpeg,https://derpicdn.net/img/view/2016/3/26/1117568.jpeg,0,0.9988878965377808,434,453,720,739,286,286,twilight sparkle,dfectivedvice|oncewasmine
1117646.jpeg,https://derpicdn.net/img/view/2016/3/26/1117646.jpeg,0,0.9831313490867616,1527,384,2013,870,486,486,twilight sparkle,bluenight01
1122320.jpeg,https://derpicdn.net/img/view/2016/4/2/1122320.jpeg,0,0.9893853068351746,147,7,599,459,452,452,twilight sparkle,charjelly
1123248.jpeg,https://derpicdn.net/img/view/2016/4/3/1123248.jpeg,0,0.9875617027282716,300,37,1242,979,942,942,twilight sparkle,aitureria
1123249.jpeg,https://derpicdn.net/img/view/2016/4/3/1123249.jpeg,0,0.9533416032791138,131,14,843,726,712,712,twilight sparkle,aitureria
1123775.jpeg,https://derpicdn.net/img/view/2016/4/3/1123775.jpeg,0,0.9526352286338806,0,71,814,975,814,904,twilight sparkle,meowcephei
1128503.jpeg,https://derpicdn.net/img/view/2016/4/9/1128503.jpeg,0,0.9931671619415284,3172,329,5370,2527,2198,2198,twilight sparkle,hananpacha
1128930.jpeg,https://derpicdn.net/img/view/2016/4/10/1128930.jpeg,0,0.9951209425926208,528,86,962,520,434,434,twilight sparkle,joe0316|laptop-pone
1129453.jpeg,https://derpicdn.net/img/view/2016/4/10/1129453.jpeg,0,0.9171063303947448,20,109,1112,1201,1092,1092,twilight sparkle,shieltar
1129858.jpeg,https://derpicdn.net/img/view/2016/4/11/1129858.jpeg,0,0.9750224947929382,0,0,1358,1445,1358,1445,twilight sparkle,rariedash
1129859.jpeg,https://derpicdn.net/img/view/2016/4/11/1129859.jpeg,0,0.9229171872138976,291,0,1859,1080,1568,1080,twilight sparkle,rariedash
1131778.jpeg,https://derpicdn.net/img/view/2016/4/14/1131778.jpeg,0,0.993349015712738,326,137,638,449,312,312,twilight sparkle,satoshix1
1131778.jpeg,https://derpicdn.net/img/view/2016/4/14/1131778.jpeg,1,0.9930847883224488,789,364,1024,620,235,256,twilight sparkle,satoshix1
1137699.jpeg,https://derpicdn.net/img/view/2016/4/22/1137699.jpeg,0,0.9413108825683594,46,0,618,548,572,548,twilight sparkle,maytee
1138221.jpeg,https://derpicdn.net/img/view/2016/4/23/1138221.jpeg,0,0.9867144227027892,216,26,948,758,732,732,twilight sparkle,magnaluna
1138666.jpeg,https://derpicdn.net/img/view/2016/4/23/1138666.jpeg,0,0.9852198958396912,127,0,561,406,434,406,twilight sparkle,dvixie
1139346.jpeg,https://derpicdn.net/img/view/2016/4/24/1139346.jpeg,0,0.9978044629096984,389,40,761,412,372,372,twilight sparkle,twixyamber
1140911.jpeg,https://derpicdn.net/img/view/2016/4/27/1140911.jpeg,0,0.9123059511184692,47,0,587,559,540,559,twilight sparkle,lilfunkman
1142619.jpeg,https://derpicdn.net/img/view/2016/4/29/1142619.jpeg,0,0.994231104850769,148,0,1024,778,876,778,twilight sparkle,enyelita
1151885.jpeg,https://derpicdn.net/img/view/2016/5/11/1151885.jpeg,0,0.9938378930091858,626,0,1194,528,568,528,twilight sparkle,hooves-art
1157762.jpeg,https://derpicdn.net/img/view/2016/5/19/1157762.jpeg,0,0.9958956837654114,471,0,1659,1020,1188,1020,twilight sparkle,unousaya
1168554.jpeg,https://derpicdn.net/img/view/2016/6/2/1168554.jpeg,0,0.9932476282119752,141,142,471,472,330,330,twilight sparkle,katemaximova
1172590.jpeg,https://derpicdn.net/img/view/2016/6/7/1172590.jpeg,0,0.9991650581359864,590,0,946,345,356,345,twilight sparkle,squaresausage
1178648.jpeg,https://derpicdn.net/img/view/2016/6/15/1178648.jpeg,0,0.9647127389907836,905,1024,1209,1328,304,304,twilight sparkle,tonyfleecs
1183204.jpeg,https://derpicdn.net/img/view/2016/6/21/1183204.jpeg,0,0.989813268184662,1049,164,1813,928,764,764,twilight sparkle,jcosneverexisted
1183389.jpeg,https://derpicdn.net/img/view/2016/6/21/1183389.jpeg,0,0.9812941551208496,163,27,895,759,732,732,twilight sparkle,tonyfleecs
1184884.jpeg,https://derpicdn.net/img/view/2016/6/23/1184884.jpeg,0,0.9454505443572998,106,135,470,499,364,364,twilight sparkle,fleebites
1185654.jpeg,https://derpicdn.net/img/view/2016/6/24/1185654.jpeg,0,0.9209334850311279,1404,824,2834,2254,1430,1430,twilight sparkle,milky-white-tan
1188566.jpeg,https://derpicdn.net/img/view/2016/6/28/1188566.jpeg,0,0.9945090413093568,448,0,897,463,449,463,twilight sparkle,diamondwhits
1190875.jpeg,https://derpicdn.net/img/view/2016/7/1/1190875.jpeg,0,0.9974810481071472,860,189,1654,983,794,794,twilight sparkle,xenalollie
1191581.jpeg,https://derpicdn.net/img/view/2016/7/2/1191581.jpeg,0,0.9594674706459044,0,83,243,327,243,244,twilight sparkle,tomitake
1192916.jpeg,https://derpicdn.net/img/view/2016/7/4/1192916.jpeg,0,0.9101660847663879,367,21,881,535,514,514,twilight sparkle,caninegalactic
1194708.jpeg,https://derpicdn.net/img/view/2016/7/6/1194708.jpeg,0,0.9678067564964294,263,135,423,295,160,160,twilight sparkle,kianamai
1194708.jpeg,https://derpicdn.net/img/view/2016/7/6/1194708.jpeg,1,0.9416741132736206,651,59,893,301,242,242,twilight sparkle,kianamai
1195360.jpeg,https://derpicdn.net/img/view/2016/7/7/1195360.jpeg,0,0.9966706037521362,322,0,850,528,528,528,twilight sparkle,91o42
1195385.jpeg,https://derpicdn.net/img/view/2016/7/7/1195385.jpeg,0,0.9987140893936156,415,26,1083,694,668,668,twilight sparkle,aphphphphp
1196257.jpeg,https://derpicdn.net/img/view/2016/7/8/1196257.jpeg,0,0.9451982975006104,416,49,998,631,582,582,twilight sparkle,scheadar
1196607.jpeg,https://derpicdn.net/img/view/2016/7/9/1196607.jpeg,0,0.9583842158317566,291,6,603,318,312,312,twilight sparkle,sarikashy
1196607.jpeg,https://derpicdn.net/img/view/2016/7/9/1196607.jpeg,1,0.9547417759895324,121,111,425,415,304,304,twilight sparkle,sarikashy
1200169.jpeg,https://derpicdn.net/img/view/2016/7/13/1200169.jpeg,0,0.9853847026824952,190,0,1794,1532,1604,1532,twilight sparkle,bronybehindthedoor
1206235.jpeg,https://derpicdn.net/img/view/2016/7/21/1206235.jpeg,0,0.9842902421951294,193,61,495,363,302,302,twilight sparkle,lindsay cibos
1210076.jpeg,https://derpicdn.net/img/view/2016/7/27/1210076.jpeg,0,0.9184523820877076,252,113,1068,929,816,816,twilight sparkle,xbi
1215507.jpeg,https://derpicdn.net/img/view/2016/8/2/1215507.jpeg,0,0.9655534029006958,38,0,448,406,410,406,twilight sparkle,raikoh
1215519.jpeg,https://derpicdn.net/img/view/2016/8/2/1215519.jpeg,0,0.9962137341499328,2047,500,5099,3552,3052,3052,twilight sparkle,scarletskitty12
1218765.jpeg,https://derpicdn.net/img/view/2016/8/6/1218765.jpeg,0,0.9619060158729552,165,29,409,273,244,244,twilight sparkle,piripaints
1218897.jpeg,https://derpicdn.net/img/view/2016/8/6/1218897.jpeg,0,0.9992659091949464,150,30,520,400,370,370,twilight sparkle,lindsay cibos
1219298.jpeg,https://derpicdn.net/img/view/2016/8/7/1219298.jpeg,0,0.9802713990211488,109,0,651,542,542,542,twilight sparkle,crade
1219716.jpeg,https://derpicdn.net/img/view/2016/8/7/1219716.jpeg,0,0.9878016114234924,489,129,825,465,336,336,twilight sparkle,kp-shadowsquirrel|harwick
1226802.jpeg,https://derpicdn.net/img/view/2016/8/16/1226802.jpeg,0,0.9564188122749328,585,222,1071,708,486,486,twilight sparkle,ryma2001
1227198.jpeg,https://derpicdn.net/img/view/2016/8/17/1227198.jpeg,0,0.9848976731300354,78,28,1232,1182,1154,1154,twilight sparkle,rocy canvas
1227879.jpeg,https://derpicdn.net/img/view/2016/8/18/1227879.jpeg,0,0.997827649116516,195,0,561,359,366,359,twilight sparkle,squaresausage
1228704.jpeg,https://derpicdn.net/img/view/2016/8/19/1228704.jpeg,0,0.9982388615608216,418,116,730,428,312,312,twilight sparkle,auroriia
1231134.jpeg,https://derpicdn.net/img/view/2016/8/22/1231134.jpeg,0,0.9956015944480896,206,53,556,403,350,350,twilight sparkle,gagman102|limpurtikles
1231978.jpeg,https://derpicdn.net/img/view/2016/8/23/1231978.jpeg,0,0.9979690313339232,661,352,1643,1334,982,982,twilight sparkle,alina-sherl
1232989.jpeg,https://derpicdn.net/img/view/2016/8/24/1232989.jpeg,0,0.990360140800476,33,0,745,674,712,674,twilight sparkle,sibashen
1233325.jpeg,https://derpicdn.net/img/view/2016/8/25/1233325.jpeg,0,0.9360558986663818,208,430,600,822,392,392,twilight sparkle,kinda-l
1234788.jpeg,https://derpicdn.net/img/view/2016/8/27/1234788.jpeg,0,0.9518669843673706,234,63,838,667,604,604,twilight sparkle,phoenixperegrine
1237652.jpeg,https://derpicdn.net/img/view/2016/8/30/1237652.jpeg,0,0.9967660903930664,453,273,773,593,320,320,twilight sparkle,slawomiro
1240286.jpeg,https://derpicdn.net/img/view/2016/9/2/1240286.jpeg,0,0.9909738302230836,282,84,636,438,354,354,twilight sparkle,evehly
1240886.jpeg,https://derpicdn.net/img/view/2016/9/3/1240886.jpeg,1,0.9619383811950684,1503,335,1759,591,256,256,twilight sparkle,silfoe
1243037.jpeg,https://derpicdn.net/img/view/2016/9/6/1243037.jpeg,0,0.9635900259017944,439,531,1015,1107,576,576,twilight sparkle,s4vin
1243133.jpeg,https://derpicdn.net/img/view/2016/9/6/1243133.jpeg,0,0.9548482298851012,573,236,2851,2514,2278,2278,twilight sparkle,akainu_pony
1244343.jpeg,https://derpicdn.net/img/view/2016/9/7/1244343.jpeg,0,0.9871755838394164,1195,841,2007,1653,812,812,twilight sparkle,poecillia-gracilis19
1244574.jpeg,https://derpicdn.net/img/view/2016/9/8/1244574.jpeg,0,0.9935668110847472,191,287,1059,1155,868,868,twilight sparkle,fantazy-mad
1244810.jpeg,https://derpicdn.net/img/view/2016/9/8/1244810.jpeg,0,0.9095316529273988,96,387,2884,3175,2788,2788,twilight sparkle,scarletskitty12
1246990.jpeg,https://derpicdn.net/img/view/2016/9/11/1246990.jpeg,0,0.9906505942344666,0,0,595,623,595,623,twilight sparkle,raikoh
1250284.jpeg,https://derpicdn.net/img/view/2016/9/16/1250284.jpeg,0,0.9498006105422974,7,0,385,334,378,334,twilight sparkle,neko-me
1254647.jpeg,https://derpicdn.net/img/view/2016/9/21/1254647.jpeg,0,0.9346612691879272,206,221,518,533,312,312,twilight sparkle,yoshimarsart
1255572.jpeg,https://derpicdn.net/img/view/2016/9/22/1255572.jpeg,0,0.9737282395362854,628,251,1788,1411,1160,1160,twilight sparkle,deltauraart
1255750.jpeg,https://derpicdn.net/img/view/2016/9/22/1255750.jpeg,0,0.9887332320213318,267,25,600,359,333,334,twilight sparkle,pastel-pony-pictures
1255754.jpeg,https://derpicdn.net/img/view/2016/9/22/1255754.jpeg,0,0.994686484336853,271,29,597,355,326,326,twilight sparkle,pastel-pony-pictures
1258873.jpeg,https://derpicdn.net/img/view/2016/9/26/1258873.jpeg,0,0.9758744239807128,94,17,826,749,732,732,twilight sparkle,miaoxing
1262016.jpeg,https://derpicdn.net/img/view/2016/10/1/1262016.jpeg,0,0.9830982089042664,76,0,574,422,498,422,twilight sparkle,raikoh
1265009.jpeg,https://derpicdn.net/img/view/2016/10/4/1265009.jpeg,0,0.9969483017921448,195,0,827,630,632,630,twilight sparkle,xbi
1265136.jpeg,https://derpicdn.net/img/view/2016/10/4/1265136.jpeg,0,0.9798567891120912,212,0,536,322,324,322,twilight sparkle,91o42
1269662.jpeg,https://derpicdn.net/img/view/2016/10/10/1269662.jpeg,0,0.9971984028816224,180,0,592,390,412,390,twilight sparkle,kryptchild
1270734.jpeg,https://derpicdn.net/img/view/2016/10/11/1270734.jpeg,0,0.9967641234397888,321,0,1719,1378,1398,1378,twilight sparkle,nexcoyotlgt
1271017.jpeg,https://derpicdn.net/img/view/2016/10/12/1271017.jpeg,0,0.986836314201355,212,24,974,786,762,762,twilight sparkle,latecustomer
1272621.jpeg,https://derpicdn.net/img/view/2016/10/14/1272621.jpeg,0,0.9631604552268982,1907,531,2527,1151,620,620,twilight sparkle,avchonline
1279133.jpeg,https://derpicdn.net/img/view/2016/10/22/1279133.jpeg,0,0.9629532694816588,130,61,1280,1229,1150,1168,twilight sparkle,rocy canvas
1279134.jpeg,https://derpicdn.net/img/view/2016/10/22/1279134.jpeg,0,0.9654549360275269,23,0,697,552,674,552,twilight sparkle,rocy canvas
1283177.jpeg,https://derpicdn.net/img/view/2016/10/28/1283177.jpeg,0,0.991845428943634,486,0,1956,1406,1470,1406,twilight sparkle,avchonline
1285465.jpeg,https://derpicdn.net/img/view/2016/10/31/1285465.jpeg,0,0.9547510743141174,191,27,597,433,406,406,twilight sparkle,wolftendragon
1285803.jpeg,https://derpicdn.net/img/view/2016/10/31/1285803.jpeg,0,0.9823063015937804,1602,0,3346,1555,1744,1555,twilight sparkle,nyte-skyez
1288182.jpeg,https://derpicdn.net/img/view/2016/11/3/1288182.jpeg,0,0.9241530895233154,964,209,2160,1405,1196,1196,twilight sparkle,tomboygirl45
1288321.jpeg,https://derpicdn.net/img/view/2016/11/4/1288321.jpeg,0,0.9816079139709472,80,128,1276,1324,1196,1196,twilight sparkle,loveless-nights
1288412.jpeg,https://derpicdn.net/img/view/2016/11/4/1288412.jpeg,0,0.9263550043106079,347,190,983,826,636,636,twilight sparkle,kodabomb
1289602.jpeg,https://derpicdn.net/img/view/2016/11/5/1289602.jpeg,1,0.971429169178009,403,0,817,368,414,368,twilight sparkle,theimmortalwolf
1290870.jpeg,https://derpicdn.net/img/view/2016/11/7/1290870.jpeg,0,0.9944546818733216,1238,363,2960,2085,1722,1722,twilight sparkle,silfoe
1299431.jpeg,https://derpicdn.net/img/view/2016/11/20/1299431.jpeg,0,0.9390531182289124,418,0,1568,913,1150,913,twilight sparkle,toisanemoif
1301267.jpeg,https://derpicdn.net/img/view/2016/11/22/1301267.jpeg,0,0.9476410746574402,378,175,1370,1167,992,992,twilight sparkle,elzzombie
1303576.jpeg,https://derpicdn.net/img/view/2016/11/25/1303576.jpeg,0,0.9973980188369752,108,0,584,468,476,468,twilight sparkle,fishnoel
1304184.jpeg,https://derpicdn.net/img/view/2016/11/26/1304184.jpeg,0,0.9912790656089784,167,0,688,464,521,464,twilight sparkle,tiroil
1304557.jpeg,https://derpicdn.net/img/view/2016/11/27/1304557.jpeg,0,0.9642432928085328,62,3,378,319,316,316,twilight sparkle,emi~ket
1306130.jpeg,https://derpicdn.net/img/view/2016/11/29/1306130.jpeg,0,0.9748660922050476,0,15,1024,1185,1024,1170,twilight sparkle,joshuadraws
1306674.jpeg,https://derpicdn.net/img/view/2016/11/30/1306674.jpeg,0,0.9311361312866212,221,0,501,259,280,259,twilight sparkle,veyou
1306835.jpeg,https://derpicdn.net/img/view/2016/11/30/1306835.jpeg,0,0.962806224822998,129,680,443,994,314,314,twilight sparkle,
1311169.jpeg,https://derpicdn.net/img/view/2016/12/6/1311169.jpeg,0,0.9865943789482116,2647,11,4429,1793,1782,1782,twilight sparkle,auroriia
1312446.jpeg,https://derpicdn.net/img/view/2016/12/8/1312446.jpeg,0,0.998172402381897,217,40,365,188,148,148,twilight sparkle,jellopopsicle
1316832.jpeg,https://derpicdn.net/img/view/2016/12/13/1316832.jpeg,0,0.9707332253456116,0,0,383,371,383,371,twilight sparkle,renderpoint
1318358.jpeg,https://derpicdn.net/img/view/2016/12/15/1318358.jpeg,0,0.9811137914657592,0,61,1080,1323,1080,1262,twilight sparkle,ciyunhe
1319000.jpeg,https://derpicdn.net/img/view/2016/12/16/1319000.jpeg,0,0.9992596507072448,33,0,319,282,286,282,twilight sparkle,ponybone
1319432.jpeg,https://derpicdn.net/img/view/2016/12/17/1319432.jpeg,0,0.9974395632743835,370,0,832,427,462,427,twilight sparkle,louderpony
1319987.jpeg,https://derpicdn.net/img/view/2016/12/18/1319987.jpeg,0,0.9839490056037904,0,17,686,723,686,706,twilight sparkle,varshacoro
1320537.jpeg,https://derpicdn.net/img/view/2016/12/19/1320537.jpeg,0,0.9796042442321776,987,0,1705,676,718,676,twilight sparkle,kawaiipony2
1320538.jpeg,https://derpicdn.net/img/view/2016/12/19/1320538.jpeg,0,0.9816043376922609,984,0,1656,658,672,658,twilight sparkle,kawaiipony2
1320898.jpeg,https://derpicdn.net/img/view/2016/12/19/1320898.jpeg,0,0.9616675972938538,95,63,439,407,344,344,twilight sparkle,slime-tiger
1321593.jpeg,https://derpicdn.net/img/view/2016/12/20/1321593.jpeg,0,0.9334388971328736,17,57,403,443,386,386,twilight sparkle,fur-what-loo
1322002.jpeg,https://derpicdn.net/img/view/2016/12/21/1322002.jpeg,0,0.965082049369812,781,0,1757,907,976,907,twilight sparkle,czywko|devanarcher101
1322066.jpeg,https://derpicdn.net/img/view/2016/12/21/1322066.jpeg,0,0.9693645238876344,27,0,1321,1274,1294,1274,twilight sparkle,ohiekhe
1322899.jpeg,https://derpicdn.net/img/view/2016/12/22/1322899.jpeg,0,0.9761605262756348,49,0,709,613,660,613,twilight sparkle,fur-what-loo
1326843.jpeg,https://derpicdn.net/img/view/2016/12/28/1326843.jpeg,0,0.990439772605896,50,4,190,144,140,140,twilight sparkle,johnraptor
1327313.jpeg,https://derpicdn.net/img/view/2016/12/29/1327313.jpeg,0,0.999309778213501,1897,315,3387,1805,1490,1490,twilight sparkle,scarletskitty12
1330596.jpeg,https://derpicdn.net/img/view/2017/1/2/1330596.jpeg,0,0.9414202570915222,684,372,2532,2220,1848,1848,twilight sparkle,pinkiemelonpie
1331963.jpeg,https://derpicdn.net/img/view/2017/1/4/1331963.jpeg,0,0.9967526197433472,320,31,1270,981,950,950,twilight sparkle,mosamosa_n
1334355.jpeg,https://derpicdn.net/img/view/2017/1/7/1334355.jpeg,0,0.9701411724090576,114,43,458,387,344,344,twilight sparkle,el-yeguero
1335048.jpeg,https://derpicdn.net/img/view/2017/1/8/1335048.jpeg,0,0.9964932799339294,253,20,547,314,294,294,twilight sparkle,el-yeguero
1337309.jpeg,https://derpicdn.net/img/view/2017/1/11/1337309.jpeg,0,0.9855177998542786,323,85,2102,1937,1779,1852,twilight sparkle,starblaze25
1339908.jpeg,https://derpicdn.net/img/view/2017/1/15/1339908.jpeg,0,0.9981029033660888,329,0,1857,1459,1528,1459,twilight sparkle,camyllea
1340990.jpeg,https://derpicdn.net/img/view/2017/1/16/1340990.jpeg,0,0.9881904721260072,449,17,737,305,288,288,twilight sparkle,gingersnap913
1341109.jpeg,https://derpicdn.net/img/view/2017/1/17/1341109.jpeg,0,0.9889802932739258,1324,0,2374,960,1050,960,twilight sparkle,atlas-66
1341805.jpeg,https://derpicdn.net/img/view/2017/1/18/1341805.jpeg,0,0.9189549684524536,619,13,1027,421,408,408,twilight sparkle,oughta
1341832.jpeg,https://derpicdn.net/img/view/2017/1/18/1341832.jpeg,1,0.9321808218955994,566,832,1436,1702,870,870,twilight sparkle,valkyrie-girl
1342830.jpeg,https://derpicdn.net/img/view/2017/1/19/1342830.jpeg,0,0.981688380241394,1215,555,2721,2061,1506,1506,twilight sparkle,bratzoid
1344965.jpeg,https://derpicdn.net/img/view/2017/1/22/1344965.jpeg,0,0.9960018396377563,588,0,2228,1574,1640,1574,twilight sparkle,askbubblelee
1346171.jpeg,https://derpicdn.net/img/view/2017/1/23/1346171.jpeg,0,0.9917879700660706,19,164,2000,2000,1981,1836,twilight sparkle,
1347089.jpeg,https://derpicdn.net/img/view/2017/1/24/1347089.jpeg,0,0.9198641180992126,132,0,764,536,632,536,twilight sparkle,dingorainbow
1349707.jpeg,https://derpicdn.net/img/view/2017/1/28/1349707.jpeg,0,0.9981178641319276,87,23,419,355,332,332,twilight sparkle,shanna1992
1352113.jpeg,https://derpicdn.net/img/view/2017/1/31/1352113.jpeg,0,0.9991046786308287,602,51,826,275,224,224,twilight sparkle,sinjaaussiaangels
1352113.jpeg,https://derpicdn.net/img/view/2017/1/31/1352113.jpeg,1,0.9975130558013916,0,0,258,260,258,260,twilight sparkle,sinjaaussiaangels
1352113.jpeg,https://derpicdn.net/img/view/2017/1/31/1352113.jpeg,2,0.986855924129486,244,7,482,245,238,238,twilight sparkle,sinjaaussiaangels
1352826.jpeg,https://derpicdn.net/img/view/2017/2/1/1352826.jpeg,0,0.9842357635498048,359,0,933,572,574,572,twilight sparkle,jcosneverexisted
1352834.jpeg,https://derpicdn.net/img/view/2017/2/1/1352834.jpeg,0,0.988983988761902,361,0,935,572,574,572,twilight sparkle,jcosneverexisted
1357725.jpeg,https://derpicdn.net/img/view/2017/2/8/1357725.jpeg,0,0.9719851016998292,133,20,677,564,544,544,twilight sparkle,joakaha
1359148.jpeg,https://derpicdn.net/img/view/2017/2/10/1359148.jpeg,0,0.9957820177078248,9,0,867,708,858,708,twilight sparkle,fur-what-loo
1361979.jpeg,https://derpicdn.net/img/view/2017/2/13/1361979.jpeg,0,0.9908933639526368,395,0,1025,624,630,624,twilight sparkle,silfoe
1362714.jpeg,https://derpicdn.net/img/view/2017/2/14/1362714.jpeg,0,0.9898905754089355,329,0,1343,991,1014,991,twilight sparkle,hendro107|an-tonio
1364487.jpeg,https://derpicdn.net/img/view/2017/2/16/1364487.jpeg,0,0.9627496600151062,0,45,2235,2781,2235,2736,twilight sparkle,celestial-rainstorm
1366423.jpeg,https://derpicdn.net/img/view/2017/2/18/1366423.jpeg,0,0.9989445805549622,366,25,1286,945,920,920,twilight sparkle,magnaluna
1367256.jpeg,https://derpicdn.net/img/view/2017/2/19/1367256.jpeg,0,0.9846562147140504,0,0,692,643,692,643,twilight sparkle,bluse
1368951.jpeg,https://derpicdn.net/img/view/2017/2/21/1368951.jpeg,0,0.9920851588249208,250,58,680,488,430,430,twilight sparkle,mysticalpha
1370170.jpeg,https://derpicdn.net/img/view/2017/2/22/1370170.jpeg,0,0.9985058903694152,804,0,1582,744,778,744,twilight sparkle,knightwolf89
1372665.jpeg,https://derpicdn.net/img/view/2017/2/25/1372665.jpeg,0,0.9442221522331238,393,5,811,423,418,418,twilight sparkle,crownhound
1373193.jpeg,https://derpicdn.net/img/view/2017/2/25/1373193.jpeg,0,0.9952719807624816,126,967,566,1407,440,440,twilight sparkle,insanerobocat
1373390.jpeg,https://derpicdn.net/img/view/2017/2/26/1373390.jpeg,0,0.9626114964485168,0,47,594,685,594,638,twilight sparkle,musicfirewind
1374415.jpeg,https://derpicdn.net/img/view/2017/2/27/1374415.jpeg,0,0.963738203048706,162,30,724,592,562,562,twilight sparkle,bluse
1376629.jpeg,https://derpicdn.net/img/view/2017/3/1/1376629.jpeg,0,0.992681622505188,466,129,922,585,456,456,twilight sparkle,mkdiash
1376711.jpeg,https://derpicdn.net/img/view/2017/3/1/1376711.jpeg,0,0.993270754814148,206,0,968,748,762,748,twilight sparkle,sibashen
1377001.jpeg,https://derpicdn.net/img/view/2017/3/2/1377001.jpeg,0,0.94303959608078,760,223,1368,831,608,608,twilight sparkle,shimazun
1380782.jpeg,https://derpicdn.net/img/view/2017/3/6/1380782.jpeg,0,0.9971482753753662,355,0,1325,968,970,968,twilight sparkle,magnaluna
1380829.jpeg,https://derpicdn.net/img/view/2017/3/6/1380829.jpeg,0,0.9834080934524536,473,4,893,424,420,420,twilight sparkle,
1381517.jpeg,https://derpicdn.net/img/view/2017/3/7/1381517.jpeg,0,0.9995274543762208,383,0,671,285,288,285,twilight sparkle,nwinter3
1382978.jpeg,https://derpicdn.net/img/view/2017/3/9/1382978.jpeg,0,0.9822660684585572,349,66,853,570,504,504,twilight sparkle,sibashen
1383456.jpeg,https://derpicdn.net/img/view/2017/3/10/1383456.jpeg,0,0.9800475835800172,204,11,434,241,230,230,twilight sparkle,jellopopsicle
1384438.jpeg,https://derpicdn.net/img/view/2017/3/11/1384438.jpeg,0,0.9943869709968568,378,0,1000,540,622,540,twilight sparkle,thelittlesnake
1385063.jpeg,https://derpicdn.net/img/view/2017/3/12/1385063.jpeg,0,0.9819510579109192,0,25,298,389,298,364,twilight sparkle,
1385063.jpeg,https://derpicdn.net/img/view/2017/3/12/1385063.jpeg,1,0.9565695524215698,0,0,311,355,311,355,twilight sparkle,
1385143.jpeg,https://derpicdn.net/img/view/2017/3/12/1385143.jpeg,0,0.9930667877197266,432,18,808,394,376,376,twilight sparkle,ligerfoxzerox
1386340.jpeg,https://derpicdn.net/img/view/2017/3/13/1386340.jpeg,0,0.9911723136901855,114,0,628,485,514,485,twilight sparkle,grokostimpy
1386443.jpeg,https://derpicdn.net/img/view/2017/3/13/1386443.jpeg,0,0.9897424578666688,270,0,1562,1151,1292,1151,twilight sparkle,vadkram20xd6
1386988.jpeg,https://derpicdn.net/img/view/2017/3/14/1386988.jpeg,0,0.9969590902328492,587,86,1391,890,804,804,twilight sparkle,magnaluna
1390390.jpeg,https://derpicdn.net/img/view/2017/3/18/1390390.jpeg,0,0.9514244198799132,306,293,872,859,566,566,twilight sparkle,unousaya
1391358.jpeg,https://derpicdn.net/img/view/2017/3/19/1391358.jpeg,0,0.9817489981651306,7,0,701,641,694,641,twilight sparkle,kawaiipony2
1392802.jpeg,https://derpicdn.net/img/view/2017/3/21/1392802.jpeg,0,0.966113805770874,383,43,937,597,554,554,twilight sparkle,kelpiemoonknives
1393235.jpeg,https://derpicdn.net/img/view/2017/3/21/1393235.jpeg,0,0.9758757948875428,0,0,512,634,512,634,twilight sparkle,titanium dragon
1395341.jpeg,https://derpicdn.net/img/view/2017/3/24/1395341.jpeg,0,0.9917528033256532,204,29,550,375,346,346,twilight sparkle,xjkenny
1397227.jpeg,https://derpicdn.net/img/view/2017/3/26/1397227.jpeg,0,0.9871525168418884,887,957,3385,3455,2498,2498,twilight sparkle,althyra-nex
1397591.jpeg,https://derpicdn.net/img/view/2017/3/27/1397591.jpeg,0,0.9060077667236328,1058,0,2634,1505,1576,1505,twilight sparkle,flamevulture17|conniethecasanova
1398480.jpeg,https://derpicdn.net/img/view/2017/3/28/1398480.jpeg,1,0.9156590104103088,1135,0,2089,923,954,923,twilight sparkle,silfoe
1398641.jpeg,https://derpicdn.net/img/view/2017/3/28/1398641.jpeg,0,0.9678899645805359,493,0,1243,721,750,721,twilight sparkle,funkybacon
1401568.jpeg,https://derpicdn.net/img/view/2017/4/1/1401568.jpeg,0,0.9949784874916076,2514,1262,3168,1916,654,654,twilight sparkle,aurelleah
1401790.jpeg,https://derpicdn.net/img/view/2017/4/2/1401790.jpeg,0,0.9805340766906738,197,78,699,580,502,502,twilight sparkle,vogelchan
1402870.jpeg,https://derpicdn.net/img/view/2017/4/3/1402870.jpeg,0,0.97161465883255,0,0,883,986,883,986,twilight sparkle,yanamosuda
1404052.jpeg,https://derpicdn.net/img/view/2017/4/4/1404052.jpeg,0,0.9984006881713868,11,282,249,520,238,238,twilight sparkle,aschenstern
1404052.jpeg,https://derpicdn.net/img/view/2017/4/4/1404052.jpeg,1,0.9874472618103028,726,434,1106,814,380,380,twilight sparkle,aschenstern
1404052.jpeg,https://derpicdn.net/img/view/2017/4/4/1404052.jpeg,2,0.9492331743240356,507,259,753,505,246,246,twilight sparkle,aschenstern
1406138.jpeg,https://derpicdn.net/img/view/2017/4/7/1406138.jpeg,0,0.9803125262260436,261,0,709,394,448,394,twilight sparkle,kumikoponylk
1406870.jpeg,https://derpicdn.net/img/view/2017/4/8/1406870.jpeg,0,0.9962830543518066,2444,467,3452,1475,1008,1008,twilight sparkle,silfoe
1406870.jpeg,https://derpicdn.net/img/view/2017/4/8/1406870.jpeg,1,0.9236051440238952,0,188,1828,2088,1828,1900,twilight sparkle,silfoe
1407604.jpeg,https://derpicdn.net/img/view/2017/4/9/1407604.jpeg,0,0.9938981533050536,50,0,258,197,208,197,twilight sparkle,kawaiipony2
1412973.jpeg,https://derpicdn.net/img/view/2017/4/16/1412973.jpeg,0,0.9274391531944276,198,44,726,572,528,528,twilight sparkle,mozgan
1414362.jpeg,https://derpicdn.net/img/view/2017/4/17/1414362.jpeg,0,0.9985687732696532,302,10,622,330,320,320,twilight sparkle,raikoh
1414704.jpeg,https://derpicdn.net/img/view/2017/4/18/1414704.jpeg,0,0.9333592057228088,237,179,639,581,402,402,twilight sparkle,jotakaanimation
1417548.jpeg,https://derpicdn.net/img/view/2017/4/21/1417548.jpeg,0,0.9874451160430908,343,5,1225,887,882,882,twilight sparkle,zigword|calestayumi
1417856.jpeg,https://derpicdn.net/img/view/2017/4/21/1417856.jpeg,0,0.9988963603973388,257,39,649,431,392,392,twilight sparkle,tomatocoup
1418672.jpeg,https://derpicdn.net/img/view/2017/4/22/1418672.jpeg,0,0.9825199246406556,48,0,756,690,708,690,twilight sparkle,raikoh
1422655.jpeg,https://derpicdn.net/img/view/2017/4/27/1422655.jpeg,0,0.9589766263961792,0,0,898,792,898,792,twilight sparkle,gingersnap913
1423345.jpeg,https://derpicdn.net/img/view/2017/4/28/1423345.jpeg,0,0.9988901615142822,330,414,1702,1786,1372,1372,twilight sparkle,scarletskitty12
1423630.jpeg,https://derpicdn.net/img/view/2017/4/28/1423630.jpeg,0,0.9730949401855468,171,113,773,715,602,602,twilight sparkle,celestthepegasus
1426314.jpeg,https://derpicdn.net/img/view/2017/5/1/1426314.jpeg,0,0.9267535209655762,0,0,1141,1167,1141,1167,twilight sparkle,alcor
1426406.jpeg,https://derpicdn.net/img/view/2017/5/1/1426406.jpeg,0,0.9761213660240172,517,72,959,514,442,442,twilight sparkle,fur-what-loo
1426406.jpeg,https://derpicdn.net/img/view/2017/5/1/1426406.jpeg,1,0.9597185254096984,0,67,456,543,456,476,twilight sparkle,fur-what-loo
1427588.jpeg,https://derpicdn.net/img/view/2017/5/3/1427588.jpeg,0,0.9007707834243774,403,130,873,600,470,470,twilight sparkle,fierrequin
1427964.jpeg,https://derpicdn.net/img/view/2017/5/3/1427964.jpeg,0,0.9956891536712646,541,0,2599,1983,2058,1983,twilight sparkle,scarletskitty12
1429670.jpeg,https://derpicdn.net/img/view/2017/5/6/1429670.jpeg,0,0.9166500568389891,568,662,1302,1396,734,734,twilight sparkle,nitrogenowo
1432654.jpeg,https://derpicdn.net/img/view/2017/5/9/1432654.jpeg,0,0.9979906678199768,205,69,863,727,658,658,twilight sparkle,kirasunnight
1435570.jpeg,https://derpicdn.net/img/view/2017/5/13/1435570.jpeg,0,0.9927366971969604,533,148,2145,1760,1612,1612,twilight sparkle,conniethecasanova|doekitty
1437898.jpeg,https://derpicdn.net/img/view/2017/5/16/1437898.jpeg,0,0.9923444986343384,611,0,2015,1304,1404,1304,twilight sparkle,conniethecasanova|doekitty
1440151.jpeg,https://derpicdn.net/img/view/2017/5/19/1440151.jpeg,0,0.9989369511604308,574,253,966,645,392,392,twilight sparkle,xbi
1440716.jpeg,https://derpicdn.net/img/view/2017/5/19/1440716.jpeg,0,0.9847022891044616,176,0,1090,881,914,881,twilight sparkle,unousaya
1441185.jpeg,https://derpicdn.net/img/view/2017/5/20/1441185.jpeg,0,0.9582759737968444,619,0,897,268,278,268,twilight sparkle,
1442608.jpeg,https://derpicdn.net/img/view/2017/5/21/1442608.jpeg,0,0.9884862899780272,188,22,670,504,482,482,twilight sparkle,kaemantis
1442903.jpeg,https://derpicdn.net/img/view/2017/5/22/1442903.jpeg,0,0.9982895851135254,562,45,1358,841,796,796,twilight sparkle,trojan-pony
1443564.jpeg,https://derpicdn.net/img/view/2017/5/22/1443564.jpeg,0,0.989308774471283,366,0,1754,1076,1388,1076,twilight sparkle,flushthebatsanta
1444696.jpeg,https://derpicdn.net/img/view/2017/5/24/1444696.jpeg,0,0.9455995559692384,330,215,822,707,492,492,twilight sparkle,jucamovi1992
1445941.jpeg,https://derpicdn.net/img/view/2017/5/25/1445941.jpeg,0,0.9867456555366516,665,253,975,563,310,310,twilight sparkle,jucamovi1992
1445941.jpeg,https://derpicdn.net/img/view/2017/5/25/1445941.jpeg,1,0.9066988229751588,467,257,777,567,310,310,twilight sparkle,jucamovi1992
1447842.jpeg,https://derpicdn.net/img/view/2017/5/28/1447842.jpeg,0,0.9828424453735352,242,8,552,318,310,310,twilight sparkle,lil miss jay
1448184.jpeg,https://derpicdn.net/img/view/2017/5/28/1448184.jpeg,0,0.9378670454025269,118,0,1268,889,1150,889,twilight sparkle,flushthebatsanta
1448792.jpeg,https://derpicdn.net/img/view/2017/5/29/1448792.jpeg,0,0.9980303645133972,43,42,733,732,690,690,twilight sparkle,plotcore
1449590.jpeg,https://derpicdn.net/img/view/2017/5/30/1449590.jpeg,0,0.9523847103118896,19,9,727,717,708,708,twilight sparkle,
1450318.jpeg,https://derpicdn.net/img/view/2017/5/31/1450318.jpeg,0,0.9756278395652772,0,0,2342,2419,2342,2419,twilight sparkle,scarletskitty12
1451301.jpeg,https://derpicdn.net/img/view/2017/6/1/1451301.jpeg,0,0.9959840774536132,182,5,564,387,382,382,twilight sparkle,magnaluna
1452006.jpeg,https://derpicdn.net/img/view/2017/6/2/1452006.jpeg,0,0.9258080720901488,590,90,1900,1300,1310,1210,twilight sparkle,nekiw
1455982.jpeg,https://derpicdn.net/img/view/2017/6/7/1455982.jpeg,0,0.9703816771507264,0,0,567,542,567,542,twilight sparkle,raikoh
1456169.jpeg,https://derpicdn.net/img/view/2017/6/7/1456169.jpeg,0,0.9971527457237244,340,126,1126,912,786,786,twilight sparkle,kas92
1456737.jpeg,https://derpicdn.net/img/view/2017/6/8/1456737.jpeg,0,0.9985395669937134,226,0,586,334,360,334,twilight sparkle,cakewasgood
1457790.jpeg,https://derpicdn.net/img/view/2017/6/9/1457790.jpeg,0,0.9942564368247986,544,134,1400,1016,856,882,twilight sparkle,bluenight01
1458300.jpeg,https://derpicdn.net/img/view/2017/6/10/1458300.jpeg,0,0.9918782711029052,538,206,1118,786,580,580,twilight sparkle,magnaluna
1459180.jpeg,https://derpicdn.net/img/view/2017/6/11/1459180.jpeg,1,0.9940632581710817,69,237,713,881,644,644,twilight sparkle,tyuubatu
1460325.jpeg,https://derpicdn.net/img/view/2017/6/12/1460325.jpeg,0,0.9584125280380248,136,0,1250,1026,1114,1026,twilight sparkle,flushthebatsanta
1465687.jpeg,https://derpicdn.net/img/view/2017/6/19/1465687.jpeg,0,0.9986446499824524,620,79,974,433,354,354,twilight sparkle,halokatty
1465687.jpeg,https://derpicdn.net/img/view/2017/6/19/1465687.jpeg,1,0.9911178946495056,16,47,324,355,308,308,twilight sparkle,halokatty
1465922.jpeg,https://derpicdn.net/img/view/2017/6/19/1465922.jpeg,0,0.9891769886016846,209,44,2263,2098,2054,2054,twilight sparkle,scarletskitty12
1473637.jpeg,https://derpicdn.net/img/view/2017/6/28/1473637.jpeg,0,0.980406641960144,656,1217,1230,1791,574,574,twilight sparkle,musicfirewind
1473660.jpeg,https://derpicdn.net/img/view/2017/6/28/1473660.jpeg,0,0.9302749633789062,92,86,384,378,292,292,twilight sparkle,zigragirl
1474356.jpeg,https://derpicdn.net/img/view/2017/6/29/1474356.jpeg,0,0.9794493913650512,57,180,371,494,314,314,twilight sparkle,
1475049.jpeg,https://derpicdn.net/img/view/2017/6/30/1475049.jpeg,0,0.9839199781417848,889,216,1359,686,470,470,twilight sparkle,jucamovi1992
1476862.jpeg,https://derpicdn.net/img/view/2017/7/2/1476862.jpeg,0,0.9812442064285278,224,9,592,377,368,368,twilight sparkle,antych
1477070.jpeg,https://derpicdn.net/img/view/2017/7/2/1477070.jpeg,0,0.986323356628418,309,21,929,641,620,620,twilight sparkle,mistydash
1477096.jpeg,https://derpicdn.net/img/view/2017/7/2/1477096.jpeg,0,0.9964495897293092,0,0,1548,1396,1548,1396,twilight sparkle,mistydash
1477799.jpeg,https://derpicdn.net/img/view/2017/7/3/1477799.jpeg,0,0.9942189455032348,398,8,2138,1748,1740,1740,twilight sparkle,a8f12
1478719.jpeg,https://derpicdn.net/img/view/2017/7/5/1478719.jpeg,0,0.9864843487739564,472,429,850,807,378,378,twilight sparkle,yuck
1484261.jpeg,https://derpicdn.net/img/view/2017/7/12/1484261.jpeg,0,0.9736273288726808,6,0,544,531,538,531,twilight sparkle,valkyrie-girl
1485537.jpeg,https://derpicdn.net/img/view/2017/7/13/1485537.jpeg,0,0.9926497340202332,424,0,1606,1103,1182,1103,twilight sparkle,neoshrek
1485794.jpeg,https://derpicdn.net/img/view/2017/7/14/1485794.jpeg,0,0.9844256639480592,2705,595,3627,1517,922,922,twilight sparkle,styroponyworks
1487597.jpeg,https://derpicdn.net/img/view/2017/7/16/1487597.jpeg,0,0.993179202079773,188,28,574,414,386,386,twilight sparkle,yam
1492140.jpeg,https://derpicdn.net/img/view/2017/7/22/1492140.jpeg,0,0.986144483089447,106,98,3368,3360,3262,3262,twilight sparkle,aitureria
1493085.jpeg,https://derpicdn.net/img/view/2017/7/23/1493085.jpeg,0,0.9505594372749328,5,21,859,875,854,854,twilight sparkle,91o42
1495345.jpeg,https://derpicdn.net/img/view/2017/7/26/1495345.jpeg,0,0.9481913447380066,0,0,800,1005,800,1005,twilight sparkle,christadoodles
1496009.jpeg,https://derpicdn.net/img/view/2017/7/27/1496009.jpeg,0,0.9976345300674438,388,0,1338,917,950,917,twilight sparkle,kelpiemoonknives
1496011.jpeg,https://derpicdn.net/img/view/2017/7/27/1496011.jpeg,0,0.9771239161491394,512,9,990,487,478,478,twilight sparkle,kelpiemoonknives
1496890.jpeg,https://derpicdn.net/img/view/2017/7/28/1496890.jpeg,0,0.997037708759308,85,33,645,593,560,560,twilight sparkle,yanamosuda
1497247.jpeg,https://derpicdn.net/img/view/2017/7/29/1497247.jpeg,0,0.9981921315193176,840,0,1672,802,832,802,twilight sparkle,f13proxima
1498719.jpeg,https://derpicdn.net/img/view/2017/7/30/1498719.jpeg,0,0.9788092970848083,85,446,2563,2908,2478,2462,twilight sparkle,duop-qoub
1499353.jpeg,https://derpicdn.net/img/view/2017/7/31/1499353.jpeg,0,0.9687236547470092,115,6,715,606,600,600,twilight sparkle,stdeadra
1500550.jpeg,https://derpicdn.net/img/view/2017/8/1/1500550.jpeg,0,0.9974707961082458,367,0,1381,993,1014,993,twilight sparkle,canvymamamoo
1501571.jpeg,https://derpicdn.net/img/view/2017/8/3/1501571.jpeg,0,0.985426127910614,880,0,1712,818,832,818,twilight sparkle,odiz
1503967.jpeg,https://derpicdn.net/img/view/2017/8/6/1503967.jpeg,0,0.9950246810913086,781,98,1369,686,588,588,twilight sparkle,binkyt11
1503967.jpeg,https://derpicdn.net/img/view/2017/8/6/1503967.jpeg,1,0.956487774848938,425,182,921,678,496,496,twilight sparkle,binkyt11
1504682.jpeg,https://derpicdn.net/img/view/2017/8/6/1504682.jpeg,0,0.9704335927963256,283,85,1100,925,817,840,twilight sparkle,fidzfox
1505956.jpeg,https://derpicdn.net/img/view/2017/8/8/1505956.jpeg,0,0.9973129034042358,85,4,445,364,360,360,twilight sparkle,plunger
1507388.jpeg,https://derpicdn.net/img/view/2017/8/10/1507388.jpeg,0,0.985329806804657,15,45,407,437,392,392,twilight sparkle,thealjavis
1507984.jpeg,https://derpicdn.net/img/view/2017/8/11/1507984.jpeg,0,0.919973850250244,868,0,1870,994,1002,994,twilight sparkle,liu ting
1512309.jpeg,https://derpicdn.net/img/view/2017/8/16/1512309.jpeg,0,0.9630483388900756,118,47,616,545,498,498,twilight sparkle,dingdingdi
1512875.jpeg,https://derpicdn.net/img/view/2017/8/17/1512875.jpeg,0,0.9867015480995178,464,0,992,493,528,493,twilight sparkle,jeki
1515261.jpeg,https://derpicdn.net/img/view/2017/8/20/1515261.jpeg,0,0.9706026315689088,94,887,666,1459,572,572,twilight sparkle,illuminatiums
1517326.jpeg,https://derpicdn.net/img/view/2017/8/22/1517326.jpeg,0,0.9012690782546996,523,139,1047,663,524,524,twilight sparkle,woofmaple
1517759.jpeg,https://derpicdn.net/img/view/2017/8/23/1517759.jpeg,0,0.9940118789672852,331,18,1133,820,802,802,twilight sparkle,v747
1517867.jpeg,https://derpicdn.net/img/view/2017/8/23/1517867.jpeg,0,0.9597625732421876,82,74,876,868,794,794,twilight sparkle,sorcerushorserus
1519335.jpeg,https://derpicdn.net/img/view/2017/8/25/1519335.jpeg,0,0.9260008931159972,339,0,1659,1055,1320,1055,twilight sparkle,flushthebatsanta
1519433.jpeg,https://derpicdn.net/img/view/2017/8/25/1519433.jpeg,0,0.9907415509223938,422,0,1260,828,838,828,twilight sparkle,
1519704.jpeg,https://derpicdn.net/img/view/2017/8/25/1519704.jpeg,0,0.9989418387413024,1226,48,1932,754,706,706,twilight sparkle,atlas-66
1520854.jpeg,https://derpicdn.net/img/view/2017/8/27/1520854.jpeg,0,0.9949192404747008,456,0,974,511,518,511,twilight sparkle,dstears
1521171.jpeg,https://derpicdn.net/img/view/2017/8/27/1521171.jpeg,0,0.9971019625663756,348,0,3046,2614,2698,2614,twilight sparkle,silentwulv
1524096.jpeg,https://derpicdn.net/img/view/2017/8/31/1524096.jpeg,0,0.9986065030097958,883,0,1671,765,788,765,twilight sparkle,silfoe
1524096.jpeg,https://derpicdn.net/img/view/2017/8/31/1524096.jpeg,1,0.9880064725875854,89,653,493,1057,404,404,twilight sparkle,silfoe
1524377.jpeg,https://derpicdn.net/img/view/2017/8/31/1524377.jpeg,0,0.9854240417480468,292,0,2000,1713,1708,1713,twilight sparkle,adagiostring
1524377.jpeg,https://derpicdn.net/img/view/2017/8/31/1524377.jpeg,1,0.9368521571159364,0,100,1510,1656,1510,1556,twilight sparkle,adagiostring
1524671.jpeg,https://derpicdn.net/img/view/2017/8/31/1524671.jpeg,0,0.960187554359436,498,0,843,334,345,334,twilight sparkle,
1524671.jpeg,https://derpicdn.net/img/view/2017/8/31/1524671.jpeg,1,0.9597324132919312,16,96,254,334,238,238,twilight sparkle,
1525495.jpeg,https://derpicdn.net/img/view/2017/9/2/1525495.jpeg,0,0.944614827632904,2257,0,4000,1533,1743,1533,twilight sparkle,thevioletghost
1525731.jpeg,https://derpicdn.net/img/view/2017/9/2/1525731.jpeg,0,0.9987810254096984,315,21,613,319,298,298,twilight sparkle,queenbloodysky
1525733.jpeg,https://derpicdn.net/img/view/2017/9/2/1525733.jpeg,0,0.9975279569625854,180,77,534,431,354,354,twilight sparkle,queenbloodysky
1526756.jpeg,https://derpicdn.net/img/view/2017/9/3/1526756.jpeg,0,0.9963310956954956,1747,133,2435,821,688,688,twilight sparkle,skitsniga
1529615.jpeg,https://derpicdn.net/img/view/2017/9/6/1529615.jpeg,0,0.9733981490135192,665,38,1077,450,412,412,twilight sparkle,racoonsan
1532798.jpeg,https://derpicdn.net/img/view/2017/9/11/1532798.jpeg,0,0.9786192774772644,125,0,417,257,292,257,twilight sparkle,maarthul
1535041.jpeg,https://derpicdn.net/img/view/2017/9/14/1535041.jpeg,0,0.9983795881271362,554,162,770,378,216,216,twilight sparkle,earthsong9405
1535041.jpeg,https://derpicdn.net/img/view/2017/9/14/1535041.jpeg,1,0.9879072904586792,80,169,306,395,226,226,twilight sparkle,earthsong9405
1535041.jpeg,https://derpicdn.net/img/view/2017/9/14/1535041.jpeg,2,0.98506361246109,859,430,1065,636,206,206,twilight sparkle,earthsong9405
1535625.jpeg,https://derpicdn.net/img/view/2017/9/15/1535625.jpeg,0,0.9988843202590942,355,0,965,513,610,513,twilight sparkle,togeticisa
1538675.jpeg,https://derpicdn.net/img/view/2017/9/18/1538675.jpeg,0,0.9824519753456116,103,0,1139,867,1036,867,twilight sparkle,
1539401.jpeg,https://derpicdn.net/img/view/2017/9/19/1539401.jpeg,0,0.9945813417434692,256,167,754,665,498,498,twilight sparkle,jcosneverexisted
1540114.jpeg,https://derpicdn.net/img/view/2017/9/20/1540114.jpeg,0,0.9614544510841372,341,45,827,531,486,486,twilight sparkle,jcosneverexisted
1540873.jpeg,https://derpicdn.net/img/view/2017/9/21/1540873.jpeg,0,0.981156051158905,11,11,451,451,440,440,twilight sparkle,
1542989.jpeg,https://derpicdn.net/img/view/2017/9/23/1542989.jpeg,0,0.9811891317367554,87,0,969,736,882,736,twilight sparkle,tangomangoes
1543364.jpeg,https://derpicdn.net/img/view/2017/9/24/1543364.jpeg,0,0.9864341616630554,0,0,2032,2267,2032,2267,twilight sparkle,liaaqila
1545910.jpeg,https://derpicdn.net/img/view/2017/9/27/1545910.jpeg,0,0.9676119089126588,224,9,850,635,626,626,twilight sparkle,lamar_bone
1549956.jpeg,https://derpicdn.net/img/view/2017/10/2/1549956.jpeg,0,0.9967737197875975,232,192,894,854,662,662,twilight sparkle,tangankittentail
1551506.jpeg,https://derpicdn.net/img/view/2017/10/4/1551506.jpeg,0,0.990459442138672,191,0,2833,2437,2642,2437,twilight sparkle,ncmares
1553284.jpeg,https://derpicdn.net/img/view/2017/10/6/1553284.jpeg,0,0.9933640360832214,178,0,532,351,354,351,twilight sparkle,yam
1553355.jpeg,https://derpicdn.net/img/view/2017/10/6/1553355.jpeg,0,0.9624544382095336,1039,292,1709,962,670,670,twilight sparkle,thesilverlightshines
1555432.jpeg,https://derpicdn.net/img/view/2017/10/8/1555432.jpeg,0,0.9844905138015748,45,0,1801,1080,1756,1080,twilight sparkle,
1555660.jpeg,https://derpicdn.net/img/view/2017/10/8/1555660.jpeg,0,0.9199630618095398,210,0,1636,1080,1426,1080,twilight sparkle,flushthebatsanta
1557108.jpeg,https://derpicdn.net/img/view/2017/10/10/1557108.jpeg,1,0.9298702478408812,0,22,342,364,342,342,twilight sparkle,extraluna
1558090.jpeg,https://derpicdn.net/img/view/2017/10/11/1558090.jpeg,0,0.9771094918251038,2367,42,3753,1428,1386,1386,twilight sparkle,conrad-hauser
1560324.jpeg,https://derpicdn.net/img/view/2017/10/13/1560324.jpeg,0,0.9849364757537842,277,0,654,401,377,401,twilight sparkle,negasun
1562115.jpeg,https://derpicdn.net/img/view/2017/10/15/1562115.jpeg,0,0.9987666010856628,388,39,856,507,468,468,twilight sparkle,
1563679.jpeg,https://derpicdn.net/img/view/2017/10/17/1563679.jpeg,0,0.999440610408783,374,17,822,465,448,448,twilight sparkle,
1564572.jpeg,https://derpicdn.net/img/view/2017/10/18/1564572.jpeg,0,0.9991070032119752,413,13,815,415,402,402,twilight sparkle,nolycs
1564572.jpeg,https://derpicdn.net/img/view/2017/10/18/1564572.jpeg,1,0.9927538633346558,153,151,493,491,340,340,twilight sparkle,nolycs
1567890.jpeg,https://derpicdn.net/img/view/2017/10/22/1567890.jpeg,0,0.9975239038467408,2346,296,4284,2234,1938,1938,twilight sparkle,duop-qoub
1567977.jpeg,https://derpicdn.net/img/view/2017/10/22/1567977.jpeg,0,0.9853359460830688,898,135,4294,3531,3396,3396,twilight sparkle,ryured
1570171.jpeg,https://derpicdn.net/img/view/2017/10/25/1570171.jpeg,0,0.961875319480896,204,0,568,357,364,357,twilight sparkle,tawni-tailwind
1570545.jpeg,https://derpicdn.net/img/view/2017/10/26/1570545.jpeg,1,0.9740130305290222,1637,72,2455,890,818,818,twilight sparkle,zipskyblue
1570676.jpeg,https://derpicdn.net/img/view/2017/10/26/1570676.jpeg,0,0.9830992817878724,294,131,2608,2445,2314,2314,twilight sparkle,duop-qoub
1570961.jpeg,https://derpicdn.net/img/view/2017/10/27/1570961.jpeg,0,0.9793626070022584,122,262,2384,2628,2262,2366,twilight sparkle,earthsong9405
1572722.jpeg,https://derpicdn.net/img/view/2017/10/29/1572722.jpeg,0,0.9947732090950012,143,45,315,217,172,172,twilight sparkle,eminya
1572722.jpeg,https://derpicdn.net/img/view/2017/10/29/1572722.jpeg,1,0.919216513633728,399,253,561,415,162,162,twilight sparkle,eminya
1572873.jpeg,https://derpicdn.net/img/view/2017/10/29/1572873.jpeg,0,0.9705392122268676,0,29,526,559,526,530,twilight sparkle,
1574816.jpeg,https://derpicdn.net/img/view/2017/10/31/1574816.jpeg,0,0.9962626099586488,1571,56,2557,1042,986,986,twilight sparkle,danton-y17
1575458.jpeg,https://derpicdn.net/img/view/2017/11/1/1575458.jpeg,0,0.996379017829895,0,0,900,964,900,964,twilight sparkle,enderbee
1576115.jpeg,https://derpicdn.net/img/view/2017/11/2/1576115.jpeg,0,0.9623695015907288,24,210,1792,1978,1768,1768,twilight sparkle,liaaqila
1578068.jpeg,https://derpicdn.net/img/view/2017/11/4/1578068.jpeg,0,0.9486920833587646,513,0,821,245,308,245,twilight sparkle,oneofyouare
1579082.jpeg,https://derpicdn.net/img/view/2017/11/5/1579082.jpeg,0,0.947540283203125,555,0,2181,1153,1626,1153,twilight sparkle,v747
1579463.jpeg,https://derpicdn.net/img/view/2017/11/6/1579463.jpeg,0,0.9745008945465088,1412,139,2260,987,848,848,twilight sparkle,ncmares
1579594.jpeg,https://derpicdn.net/img/view/2017/11/6/1579594.jpeg,0,0.9719775915145874,1308,0,1766,447,458,447,twilight sparkle,viistar
1581098.jpeg,https://derpicdn.net/img/view/2017/11/8/1581098.jpeg,0,0.9829774498939514,793,5,2539,1600,1746,1595,twilight sparkle,minusclass
1581556.jpeg,https://derpicdn.net/img/view/2017/11/8/1581556.jpeg,1,0.9394497275352478,455,191,699,435,244,244,twilight sparkle,shokly
1581652.jpeg,https://derpicdn.net/img/view/2017/11/8/1581652.jpeg,0,0.9587069153785706,536,0,1704,935,1168,935,twilight sparkle,scalelover
1583213.jpeg,https://derpicdn.net/img/view/2017/11/10/1583213.jpeg,0,0.9891258478164672,33,153,2300,2455,2267,2302,twilight sparkle,skitsniga
1585480.jpeg,https://derpicdn.net/img/view/2017/11/13/1585480.jpeg,0,0.9878332018852234,491,204,805,518,314,314,twilight sparkle,kerydarling
1585480.jpeg,https://derpicdn.net/img/view/2017/11/13/1585480.jpeg,1,0.9799168705940248,764,141,1130,507,366,366,twilight sparkle,kerydarling
1585869.jpeg,https://derpicdn.net/img/view/2017/11/14/1585869.jpeg,0,0.9789715409278872,4,0,512,500,508,500,twilight sparkle,
1587711.jpeg,https://derpicdn.net/img/view/2017/11/16/1587711.jpeg,0,0.9986995458602904,1182,71,2332,1221,1150,1150,twilight sparkle,yvt-jp
1588247.jpeg,https://derpicdn.net/img/view/2017/11/17/1588247.jpeg,0,0.973350703716278,257,19,1075,837,818,818,twilight sparkle,incendiaryboobs
1588584.jpeg,https://derpicdn.net/img/view/2017/11/17/1588584.jpeg,0,0.996932864189148,494,687,1650,1843,1156,1156,twilight sparkle,maroonillustrator
1589317.jpeg,https://derpicdn.net/img/view/2017/11/18/1589317.jpeg,0,0.9976546764373779,1452,270,3862,2680,2410,2410,twilight sparkle,duop-qoub
1590043.jpeg,https://derpicdn.net/img/view/2017/11/19/1590043.jpeg,0,0.9195983409881592,0,0,808,757,808,757,twilight sparkle,ccc
1590825.jpeg,https://derpicdn.net/img/view/2017/11/20/1590825.jpeg,0,0.995410978794098,256,296,876,916,620,620,twilight sparkle,songbirdserenade
1591460.jpeg,https://derpicdn.net/img/view/2017/11/21/1591460.jpeg,0,0.9920652508735656,0,0,1271,1447,1271,1447,twilight sparkle,earthsong9405
1591982.jpeg,https://derpicdn.net/img/view/2017/11/22/1591982.jpeg,0,0.985584795475006,1064,158,1606,700,542,542,twilight sparkle,ncmares
1593115.jpeg,https://derpicdn.net/img/view/2017/11/24/1593115.jpeg,0,0.9946506023406982,853,0,1603,678,750,678,twilight sparkle,dashy21
1593268.jpeg,https://derpicdn.net/img/view/2017/11/24/1593268.jpeg,0,0.9661185145378112,444,27,1024,635,580,608,twilight sparkle,fazzfuck
1593268.jpeg,https://derpicdn.net/img/view/2017/11/24/1593268.jpeg,1,0.9074360728263856,0,0,696,678,696,678,twilight sparkle,fazzfuck
1593530.jpeg,https://derpicdn.net/img/view/2017/11/25/1593530.jpeg,0,0.9744431972503662,0,108,2246,2508,2246,2400,twilight sparkle,duop-qoub
1596829.jpeg,https://derpicdn.net/img/view/2017/11/29/1596829.jpeg,0,0.9648767113685608,232,0,1742,1329,1510,1329,twilight sparkle,
1598617.jpeg,https://derpicdn.net/img/view/2017/12/2/1598617.jpeg,0,0.9989808797836304,176,0,564,309,388,309,twilight sparkle,raikoh
1599275.jpeg,https://derpicdn.net/img/view/2017/12/3/1599275.jpeg,0,0.978127658367157,171,127,1161,1117,990,990,twilight sparkle,amarynceus
1599943.jpeg,https://derpicdn.net/img/view/2017/12/3/1599943.jpeg,0,0.9683790802955629,329,47,993,711,664,664,twilight sparkle,shiinadrawmiku
1600542.jpeg,https://derpicdn.net/img/view/2017/12/4/1600542.jpeg,0,0.9881957769393921,235,0,699,462,464,462,twilight sparkle,teranen
1603250.jpeg,https://derpicdn.net/img/view/2017/12/8/1603250.jpeg,0,0.9599066376686096,130,220,980,1000,850,780,twilight sparkle,mirroredsea
1604151.jpeg,https://derpicdn.net/img/view/2017/12/10/1604151.jpeg,0,0.9689766764640808,0,0,1410,1532,1410,1532,twilight sparkle,imalou
1604436.jpeg,https://derpicdn.net/img/view/2017/12/10/1604436.jpeg,0,0.9815722107887268,5374,48,6782,1456,1408,1408,twilight sparkle,shuxer59
1604436.jpeg,https://derpicdn.net/img/view/2017/12/10/1604436.jpeg,1,0.9783304333686828,1850,130,3236,1516,1386,1386,twilight sparkle,shuxer59
1605118.jpeg,https://derpicdn.net/img/view/2017/12/11/1605118.jpeg,0,0.9997130036354064,340,0,704,360,364,360,twilight sparkle,cpwny
1605609.jpeg,https://derpicdn.net/img/view/2017/12/11/1605609.jpeg,0,0.90173077583313,357,0,2138,1731,1781,1731,twilight sparkle,dilarus
1605863.jpeg,https://derpicdn.net/img/view/2017/12/12/1605863.jpeg,0,0.9866856336593628,219,79,463,323,244,244,twilight sparkle,ximsketchs
1606439.jpeg,https://derpicdn.net/img/view/2017/12/13/1606439.jpeg,1,0.938878893852234,600,718,1240,1358,640,640,twilight sparkle,clockworkquartet
1606869.jpeg,https://derpicdn.net/img/view/2017/12/13/1606869.jpeg,0,0.9296489357948304,501,0,985,482,484,482,twilight sparkle,clefficia
1607271.jpeg,https://derpicdn.net/img/view/2017/12/14/1607271.jpeg,0,0.9939343929290771,185,13,539,367,354,354,twilight sparkle,lengyou
1611838.jpeg,https://derpicdn.net/img/view/2017/12/20/1611838.jpeg,0,0.9540855884552002,51,30,539,518,488,488,twilight sparkle,candasaurus
1614764.jpeg,https://derpicdn.net/img/view/2017/12/24/1614764.jpeg,0,0.965787410736084,0,0,400,462,400,462,twilight sparkle,nadairead
1614770.jpeg,https://derpicdn.net/img/view/2017/12/24/1614770.jpeg,1,0.9120486378669742,81,10,341,270,260,260,twilight sparkle,nadairead
1614920.jpeg,https://derpicdn.net/img/view/2017/12/24/1614920.jpeg,0,0.9976830482482908,56,50,548,542,492,492,twilight sparkle,stratodraw
1614991.jpeg,https://derpicdn.net/img/view/2017/12/24/1614991.jpeg,0,0.9980673789978028,204,100,888,784,684,684,twilight sparkle,magnaluna
1619185.jpeg,https://derpicdn.net/img/view/2017/12/29/1619185.jpeg,0,0.9990086555480956,318,18,744,444,426,426,twilight sparkle,maarthul
1620005.jpeg,https://derpicdn.net/img/view/2017/12/30/1620005.jpeg,0,0.9962180256843568,662,0,3088,2384,2426,2384,twilight sparkle,yumeyuuheii
1621214.jpeg,https://derpicdn.net/img/view/2018/1/1/1621214.jpeg,0,0.957634210586548,204,217,572,585,368,368,twilight sparkle,stratodraw
1622062.jpeg,https://derpicdn.net/img/view/2018/1/2/1622062.jpeg,0,0.9984302520751952,146,32,1338,1224,1192,1192,twilight sparkle,nickhowell
1623124.jpeg,https://derpicdn.net/img/view/2018/1/3/1623124.jpeg,0,0.9988279938697816,33,0,583,541,550,541,twilight sparkle,tyuubatu
1624648.jpeg,https://derpicdn.net/img/view/2018/1/5/1624648.jpeg,0,0.9882105588912964,164,0,2322,2120,2158,2120,twilight sparkle,pembroke
1624988.jpeg,https://derpicdn.net/img/view/2018/1/5/1624988.jpeg,0,0.9877453446388244,248,0,1856,1080,1608,1080,twilight sparkle,flushthebatsanta
1625289.jpeg,https://derpicdn.net/img/view/2018/1/6/1625289.jpeg,0,0.9624112248420716,136,1,1169,1037,1033,1036,twilight sparkle,yukkuripalehorse
1626542.jpeg,https://derpicdn.net/img/view/2018/1/7/1626542.jpeg,0,0.9843740463256836,259,45,685,471,426,426,twilight sparkle,zoxriver503
1626942.jpeg,https://derpicdn.net/img/view/2018/1/8/1626942.jpeg,0,0.9892688393592834,1127,84,2988,2070,1861,1986,twilight sparkle,faron-draws
1626942.jpeg,https://derpicdn.net/img/view/2018/1/8/1626942.jpeg,1,0.9652445316314696,0,0,2168,2277,2168,2277,twilight sparkle,faron-draws
1627022.jpeg,https://derpicdn.net/img/view/2018/1/8/1627022.jpeg,0,0.9965826272964478,416,67,808,459,392,392,twilight sparkle,seanica
1627501.jpeg,https://derpicdn.net/img/view/2018/1/8/1627501.jpeg,0,0.9944143891334534,945,112,1705,872,760,760,twilight sparkle,dreadlime
1628278.jpeg,https://derpicdn.net/img/view/2018/1/9/1628278.jpeg,0,0.9803519248962402,696,0,1590,732,894,732,twilight sparkle,lilapudelpony
1628908.jpeg,https://derpicdn.net/img/view/2018/1/10/1628908.jpeg,0,0.982674479484558,883,1816,1745,2678,862,862,twilight sparkle,xjenn9
1629276.jpeg,https://derpicdn.net/img/view/2018/1/10/1629276.jpeg,0,0.9987415075302124,36,5,396,365,360,360,twilight sparkle,maytee
1629560.jpeg,https://derpicdn.net/img/view/2018/1/11/1629560.jpeg,0,0.9891514182090759,0,0,734,716,734,716,twilight sparkle,bunsogen
1630644.jpeg,https://derpicdn.net/img/view/2018/1/12/1630644.jpeg,0,0.9879484772682192,670,138,1122,590,452,452,twilight sparkle,jotakaanimation
1631272.jpeg,https://derpicdn.net/img/view/2018/1/13/1631272.jpeg,0,0.9705542325973512,627,214,2311,1898,1684,1684,twilight sparkle,duop-qoub
1632412.jpeg,https://derpicdn.net/img/view/2018/1/14/1632412.jpeg,0,0.9946989417076112,1858,1240,3234,2616,1376,1376,twilight sparkle,duop-qoub
1633574.jpeg,https://derpicdn.net/img/view/2018/1/16/1633574.jpeg,0,0.9668982625007628,120,53,2168,2101,2048,2048,twilight sparkle,xbi
1634029.jpeg,https://derpicdn.net/img/view/2018/1/17/1634029.jpeg,0,0.9989072680473328,140,0,1450,1285,1310,1285,twilight sparkle,duop-qoub
1634592.jpeg,https://derpicdn.net/img/view/2018/1/17/1634592.jpeg,0,0.9807326793670654,372,0,1678,1161,1306,1161,twilight sparkle,m-al
1635969.jpeg,https://derpicdn.net/img/view/2018/1/19/1635969.jpeg,0,0.9947436451911926,128,395,460,727,332,332,twilight sparkle,ouijasmolakefia
1636439.jpeg,https://derpicdn.net/img/view/2018/1/20/1636439.jpeg,0,0.9210839867591858,69,162,973,1050,904,888,twilight sparkle,xbi
1637140.jpeg,https://derpicdn.net/img/view/2018/1/21/1637140.jpeg,0,0.9393832087516784,473,33,1193,753,720,720,twilight sparkle,mysticalpha
1637517.jpeg,https://derpicdn.net/img/view/2018/1/21/1637517.jpeg,0,0.9956259727478028,45,0,523,470,478,470,twilight sparkle,gamijack
1638390.jpeg,https://derpicdn.net/img/view/2018/1/22/1638390.jpeg,1,0.9971218705177308,1061,81,2375,1395,1314,1314,twilight sparkle,albusfs
1639829.jpeg,https://derpicdn.net/img/view/2018/1/24/1639829.jpeg,0,0.9865294694900512,172,50,450,328,278,278,twilight sparkle,hardbrony
1641345.jpeg,https://derpicdn.net/img/view/2018/1/26/1641345.jpeg,0,0.9331533908843994,1851,1645,3827,3621,1976,1976,twilight sparkle,yui
1642181.jpeg,https://derpicdn.net/img/view/2018/1/27/1642181.jpeg,0,0.993427574634552,1532,770,2664,1902,1132,1132,twilight sparkle,earthsong9405
1643253.jpeg,https://derpicdn.net/img/view/2018/1/29/1643253.jpeg,0,0.9996563196182252,385,0,739,320,354,320,twilight sparkle,badgerben|coralleaf
1644730.jpeg,https://derpicdn.net/img/view/2018/1/30/1644730.jpeg,0,0.9940036535263062,2109,942,3179,2012,1070,1070,twilight sparkle,earthsong9405
1647116.jpeg,https://derpicdn.net/img/view/2018/2/3/1647116.jpeg,0,0.9727032780647278,796,845,2324,2373,1528,1528,twilight sparkle,earthsong9405
1647847.jpeg,https://derpicdn.net/img/view/2018/2/4/1647847.jpeg,0,0.9739329218864441,244,0,796,546,552,546,twilight sparkle,seamaggie
1652742.jpeg,https://derpicdn.net/img/view/2018/2/10/1652742.jpeg,0,0.9004027843475342,442,88,808,454,366,366,twilight sparkle,nivek15
1657336.jpeg,https://derpicdn.net/img/view/2018/2/16/1657336.jpeg,0,0.963505208492279,69,14,599,544,530,530,twilight sparkle,neonishe
1659659.jpeg,https://derpicdn.net/img/view/2018/2/18/1659659.jpeg,1,0.9992330074310304,516,193,1258,935,742,742,twilight sparkle,gigason
1660146.jpeg,https://derpicdn.net/img/view/2018/2/19/1660146.jpeg,0,0.9156714677810668,714,135,1024,445,310,310,twilight sparkle,kirillk
1661575.jpeg,https://derpicdn.net/img/view/2018/2/20/1661575.jpeg,0,0.9885705709457396,1108,106,1784,782,676,676,twilight sparkle,blackjack42
1661638.jpeg,https://derpicdn.net/img/view/2018/2/20/1661638.jpeg,0,0.9964150190353394,528,0,992,428,464,428,twilight sparkle,tangankittentail
1661646.jpeg,https://derpicdn.net/img/view/2018/2/20/1661646.jpeg,0,0.982967972755432,37,0,583,522,546,522,twilight sparkle,tangankittentail
1661662.jpeg,https://derpicdn.net/img/view/2018/2/21/1661662.jpeg,1,0.943629801273346,466,276,764,574,298,298,twilight sparkle,xu
1662086.jpeg,https://derpicdn.net/img/view/2018/2/21/1662086.jpeg,0,0.9829882383346558,179,0,593,409,414,409,twilight sparkle,fur-what-loo
1663014.jpeg,https://derpicdn.net/img/view/2018/2/22/1663014.jpeg,0,0.997934877872467,1299,556,3593,2850,2294,2294,twilight sparkle,amyskyblazer
1664086.jpeg,https://derpicdn.net/img/view/2018/2/24/1664086.jpeg,0,0.9396396279335022,93,0,837,700,744,700,twilight sparkle,darksly
1664232.jpeg,https://derpicdn.net/img/view/2018/2/24/1664232.jpeg,0,0.9303990006446838,48,36,504,492,456,456,twilight sparkle,xp_r6
1665449.jpeg,https://derpicdn.net/img/view/2018/2/25/1665449.jpeg,0,0.9979993104934692,416,0,1718,1132,1302,1132,twilight sparkle,nanook123
1665528.jpeg,https://derpicdn.net/img/view/2018/2/25/1665528.jpeg,0,0.9676706790924072,443,51,1631,1239,1188,1188,twilight sparkle,nanook123
1668370.jpeg,https://derpicdn.net/img/view/2018/2/28/1668370.jpeg,0,0.9953387975692748,278,0,754,451,476,451,twilight sparkle,bojack_mlplove
1668372.jpeg,https://derpicdn.net/img/view/2018/2/28/1668372.jpeg,0,0.9916312098503112,140,0,764,568,624,568,twilight sparkle,bojack_mlplove
1670027.jpeg,https://derpicdn.net/img/view/2018/3/2/1670027.jpeg,0,0.9618003964424132,104,33,552,481,448,448,twilight sparkle,milkymitsuki
1673005.jpeg,https://derpicdn.net/img/view/2018/3/6/1673005.jpeg,0,0.9980096817016602,723,602,1367,1246,644,644,twilight sparkle,luciferamon
1673872.jpeg,https://derpicdn.net/img/view/2018/3/7/1673872.jpeg,0,0.99053955078125,325,0,1391,1043,1066,1043,twilight sparkle,ku-ma
1674086.jpeg,https://derpicdn.net/img/view/2018/3/7/1674086.jpeg,1,0.9426594376564026,640,0,1022,378,382,378,twilight sparkle,fur-what-loo
1674520.jpeg,https://derpicdn.net/img/view/2018/3/8/1674520.jpeg,0,0.9795539379119872,510,60,1288,838,778,778,twilight sparkle,rd_3024
1675398.jpeg,https://derpicdn.net/img/view/2018/3/9/1675398.jpeg,0,0.953468143939972,20,578,298,856,278,278,twilight sparkle,brendahickey
1677916.jpeg,https://derpicdn.net/img/view/2018/3/12/1677916.jpeg,0,0.9874282479286194,14,34,284,304,270,270,twilight sparkle,kraytt-05
1679069.jpeg,https://derpicdn.net/img/view/2018/3/13/1679069.jpeg,0,0.9222319722175598,0,0,530,552,530,552,twilight sparkle,nanima
1680462.jpeg,https://derpicdn.net/img/view/2018/3/14/1680462.jpeg,0,0.9962734580039978,170,31,644,505,474,474,twilight sparkle,scarletfoxtail
1686942.jpeg,https://derpicdn.net/img/view/2018/3/21/1686942.jpeg,0,0.99711811542511,436,24,740,328,304,304,twilight sparkle,saladbomb
1688001.jpeg,https://derpicdn.net/img/view/2018/3/23/1688001.jpeg,0,0.9980596899986268,0,153,1264,1655,1264,1502,twilight sparkle,kuroran
1688479.jpeg,https://derpicdn.net/img/view/2018/3/23/1688479.jpeg,0,0.9636254310607908,17,38,473,494,456,456,twilight sparkle,potetecyu_to
1689293.jpeg,https://derpicdn.net/img/view/2018/3/24/1689293.jpeg,0,0.9863878488540648,41,138,2237,2334,2196,2196,twilight sparkle,stardep
1689863.jpeg,https://derpicdn.net/img/view/2018/3/25/1689863.jpeg,0,0.9970198273658752,145,0,811,647,666,647,twilight sparkle,iloota
1694448.jpeg,https://derpicdn.net/img/view/2018/3/30/1694448.jpeg,0,0.9640865325927734,331,343,561,573,230,230,twilight sparkle,crazydragonqueen
1698982.jpeg,https://derpicdn.net/img/view/2018/4/4/1698982.jpeg,0,0.9989038109779358,118,0,686,539,568,539,twilight sparkle,iloota
1700677.jpeg,https://derpicdn.net/img/view/2018/4/6/1700677.jpeg,0,0.9589789509773254,419,88,717,386,298,298,twilight sparkle,racoonsan
1701676.jpeg,https://derpicdn.net/img/view/2018/4/7/1701676.jpeg,0,0.9971905946731568,608,0,1970,1313,1362,1313,twilight sparkle,gagpal3
1702947.jpeg,https://derpicdn.net/img/view/2018/4/8/1702947.jpeg,0,0.9793636798858644,61,0,801,690,740,690,twilight sparkle,sugarheartart
1703208.jpeg,https://derpicdn.net/img/view/2018/4/9/1703208.jpeg,0,0.9791545867919922,106,60,808,762,702,702,twilight sparkle,hobbes-maxwell
1703399.jpeg,https://derpicdn.net/img/view/2018/4/9/1703399.jpeg,0,0.99906986951828,813,20,1451,658,638,638,twilight sparkle,shmel
1703401.jpeg,https://derpicdn.net/img/view/2018/4/9/1703401.jpeg,0,0.9836469292640686,617,26,1131,540,514,514,twilight sparkle,shmel
1703869.jpeg,https://derpicdn.net/img/view/2018/4/9/1703869.jpeg,0,0.9591922163963318,244,0,964,683,720,683,twilight sparkle,amandameade
1704019.jpeg,https://derpicdn.net/img/view/2018/4/10/1704019.jpeg,0,0.974556028842926,80,281,332,533,252,252,twilight sparkle,colourstrike
1704019.jpeg,https://derpicdn.net/img/view/2018/4/10/1704019.jpeg,1,0.9460393786430359,518,135,842,459,324,324,twilight sparkle,colourstrike
1705889.jpeg,https://derpicdn.net/img/view/2018/4/12/1705889.jpeg,0,0.9843300580978394,173,52,467,346,294,294,twilight sparkle,biakela
1707222.jpeg,https://derpicdn.net/img/view/2018/4/14/1707222.jpeg,0,0.99787575006485,1095,64,2645,1614,1550,1550,twilight sparkle,flicker-show
1710263.jpeg,https://derpicdn.net/img/view/2018/4/17/1710263.jpeg,0,0.9957516193389891,498,0,1908,1347,1410,1347,twilight sparkle,andelai
1710299.jpeg,https://derpicdn.net/img/view/2018/4/17/1710299.jpeg,0,0.958978533744812,0,0,1310,1295,1310,1295,twilight sparkle,darktenor5
1710351.jpeg,https://derpicdn.net/img/view/2018/4/17/1710351.jpeg,0,0.9935651421546936,203,9,659,465,456,456,twilight sparkle,el-yeguero
1710678.jpeg,https://derpicdn.net/img/view/2018/4/18/1710678.jpeg,0,0.9099822640419006,447,167,767,487,320,320,twilight sparkle,sanfin
1713458.jpeg,https://derpicdn.net/img/view/2018/4/21/1713458.jpeg,0,0.9721139073371888,103,0,1463,1327,1360,1327,twilight sparkle,ekkosan
1713883.jpeg,https://derpicdn.net/img/view/2018/4/21/1713883.jpeg,0,0.9997212290763856,558,0,1410,814,852,814,twilight sparkle,xjenn9
1714329.jpeg,https://derpicdn.net/img/view/2018/4/22/1714329.jpeg,0,0.9979760646820068,208,36,420,248,212,212,twilight sparkle,born-to-die
1715547.jpeg,https://derpicdn.net/img/view/2018/4/23/1715547.jpeg,0,0.940152943134308,748,1279,1660,2191,912,912,twilight sparkle,
1716063.jpeg,https://derpicdn.net/img/view/2018/4/24/1716063.jpeg,0,0.9813947677612304,48,216,1524,1692,1476,1476,twilight sparkle,chepelitaxd
1718771.jpeg,https://derpicdn.net/img/view/2018/4/28/1718771.jpeg,0,0.9911853075027466,57,0,635,577,578,577,twilight sparkle,zidanemina
1719425.jpeg,https://derpicdn.net/img/view/2018/4/28/1719425.jpeg,0,0.998343825340271,295,0,635,310,340,310,twilight sparkle,mr-murder
1719557.jpeg,https://derpicdn.net/img/view/2018/4/29/1719557.jpeg,0,0.9922640323638916,144,0,4318,4055,4174,4055,twilight sparkle,girlunicorn
1720426.jpeg,https://derpicdn.net/img/view/2018/4/29/1720426.jpeg,0,0.9000822901725769,639,1327,1685,2373,1046,1046,twilight sparkle,misucats
1720651.jpeg,https://derpicdn.net/img/view/2018/4/30/1720651.jpeg,0,0.9592753648757936,1348,120,2000,774,652,654,twilight sparkle,kary-draws
1721212.jpeg,https://derpicdn.net/img/view/2018/4/30/1721212.jpeg,0,0.92380291223526,566,179,2000,1701,1434,1522,twilight sparkle,plotcore
1723199.jpeg,https://derpicdn.net/img/view/2018/5/3/1723199.jpeg,0,0.9919305443763732,1583,73,2613,1103,1030,1030,twilight sparkle,dashy21
1724141.jpeg,https://derpicdn.net/img/view/2018/5/4/1724141.jpeg,0,0.910886526107788,192,9,780,597,588,588,twilight sparkle,
1725629.jpeg,https://derpicdn.net/img/view/2018/5/6/1725629.jpeg,0,0.9911054372787476,27,0,451,411,424,411,twilight sparkle,green brush
1726349.jpeg,https://derpicdn.net/img/view/2018/5/7/1726349.jpeg,0,0.9985023736953736,330,10,698,378,368,368,twilight sparkle,texasuberalles
1727961.jpeg,https://derpicdn.net/img/view/2018/5/9/1727961.jpeg,0,0.9998205304145812,1494,463,2270,1239,776,776,twilight sparkle,skitsniga
1732248.jpeg,https://derpicdn.net/img/view/2018/5/14/1732248.jpeg,0,0.9998241066932678,585,0,1039,449,454,449,twilight sparkle,matchstickman
1733163.jpeg,https://derpicdn.net/img/view/2018/5/15/1733163.jpeg,0,0.9906402826309204,0,0,169,172,169,172,twilight sparkle,pembroke
1733163.jpeg,https://derpicdn.net/img/view/2018/5/15/1733163.jpeg,1,0.9884801506996156,313,74,576,372,263,298,twilight sparkle,pembroke
1733523.jpeg,https://derpicdn.net/img/view/2018/5/15/1733523.jpeg,0,0.9583659768104552,16,14,724,722,708,708,twilight sparkle,zoomiso
1733858.jpeg,https://derpicdn.net/img/view/2018/5/16/1733858.jpeg,0,0.9519325494766236,178,0,546,352,368,352,twilight sparkle,pembroke
1735865.jpeg,https://derpicdn.net/img/view/2018/5/18/1735865.jpeg,0,0.9078325629234314,639,181,895,437,256,256,twilight sparkle,seshirukun
1736061.jpeg,https://derpicdn.net/img/view/2018/5/19/1736061.jpeg,0,0.992676854133606,50,90,2170,2210,2120,2120,twilight sparkle,imalou
1738275.jpeg,https://derpicdn.net/img/view/2018/5/21/1738275.jpeg,0,0.9936688542366028,77,0,643,504,566,504,twilight sparkle,fazzfuck
1738752.jpeg,https://derpicdn.net/img/view/2018/5/22/1738752.jpeg,0,0.9991772174835204,1943,0,4909,2580,2966,2580,twilight sparkle,sweethearts11
1740101.jpeg,https://derpicdn.net/img/view/2018/5/24/1740101.jpeg,0,0.9416080117225648,0,0,783,717,783,717,twilight sparkle,nuryndork|neulreen
1740230.jpeg,https://derpicdn.net/img/view/2018/5/24/1740230.jpeg,0,0.955418586730957,107,0,639,496,532,496,twilight sparkle,talimingi
1740580.jpeg,https://derpicdn.net/img/view/2018/5/24/1740580.jpeg,0,0.966795027256012,207,0,1019,779,812,779,twilight sparkle,kumikoponylk
1742022.jpeg,https://derpicdn.net/img/view/2018/5/26/1742022.jpeg,0,0.9957157373428344,1577,852,2223,1498,646,646,twilight sparkle,tingsan
1742022.jpeg,https://derpicdn.net/img/view/2018/5/26/1742022.jpeg,1,0.906848669052124,377,494,887,1004,510,510,twilight sparkle,tingsan
1743458.jpeg,https://derpicdn.net/img/view/2018/5/28/1743458.jpeg,0,0.999234974384308,217,112,527,422,310,310,twilight sparkle,oneofyouare
1744772.jpeg,https://derpicdn.net/img/view/2018/5/29/1744772.jpeg,0,0.9390656352043152,351,36,1123,808,772,772,twilight sparkle,hoodie
1745004.jpeg,https://derpicdn.net/img/view/2018/5/30/1745004.jpeg,0,0.9961581826210022,184,0,642,434,458,434,twilight sparkle,balooga
1745013.jpeg,https://derpicdn.net/img/view/2018/5/30/1745013.jpeg,0,0.9299960732460022,263,0,521,256,258,256,twilight sparkle,pembroke
1751860.jpeg,https://derpicdn.net/img/view/2018/6/7/1751860.jpeg,0,0.9379390478134156,3137,601,4227,1691,1090,1090,twilight sparkle,earthsong9405
1752426.jpeg,https://derpicdn.net/img/view/2018/6/8/1752426.jpeg,0,0.9502381682395936,119,0,521,332,402,332,twilight sparkle,youhoujou
1755183.jpeg,https://derpicdn.net/img/view/2018/6/11/1755183.jpeg,0,0.9978206753730774,386,259,806,679,420,420,twilight sparkle,jotakaanimation
1755183.jpeg,https://derpicdn.net/img/view/2018/6/11/1755183.jpeg,1,0.9946978092193604,723,224,1217,718,494,494,twilight sparkle,jotakaanimation
1755553.jpeg,https://derpicdn.net/img/view/2018/6/11/1755553.jpeg,0,0.9925083518028259,180,0,1804,1080,1624,1080,twilight sparkle,imalou
1755757.jpeg,https://derpicdn.net/img/view/2018/6/12/1755757.jpeg,0,0.9600762128829956,327,0,713,379,386,379,twilight sparkle,lil miss jay
1758037.jpeg,https://derpicdn.net/img/view/2018/6/15/1758037.jpeg,0,0.9802334308624268,213,0,635,415,422,415,twilight sparkle,lil miss jay
1759847.jpeg,https://derpicdn.net/img/view/2018/6/17/1759847.jpeg,0,0.9899170398712158,421,122,1535,1236,1114,1114,twilight sparkle,akweer
1764324.jpeg,https://derpicdn.net/img/view/2018/6/23/1764324.jpeg,0,0.9827202558517456,259,0,1317,1013,1058,1013,twilight sparkle,bbtasu
1764335.jpeg,https://derpicdn.net/img/view/2018/6/23/1764335.jpeg,0,0.9995047450065612,33,34,1575,1576,1542,1542,twilight sparkle,bbtasu
1765318.jpeg,https://derpicdn.net/img/view/2018/6/25/1765318.jpeg,0,0.9979543089866638,492,159,1262,929,770,770,twilight sparkle,edonovaillustrator
1765493.jpeg,https://derpicdn.net/img/view/2018/6/25/1765493.jpeg,0,0.9995594620704652,505,378,1121,994,616,616,twilight sparkle,duop-qoub
1765493.jpeg,https://derpicdn.net/img/view/2018/6/25/1765493.jpeg,1,0.9995576739311218,1353,336,1961,944,608,608,twilight sparkle,duop-qoub
1765495.jpeg,https://derpicdn.net/img/view/2018/6/25/1765495.jpeg,0,0.996495246887207,1089,617,2263,1708,1174,1091,twilight sparkle,duop-qoub
1765495.jpeg,https://derpicdn.net/img/view/2018/6/25/1765495.jpeg,1,0.9869049787521362,65,606,1271,1708,1206,1102,twilight sparkle,duop-qoub
1765496.jpeg,https://derpicdn.net/img/view/2018/6/25/1765496.jpeg,0,0.9957822561264038,834,312,2022,1370,1188,1058,twilight sparkle,duop-qoub
1765496.jpeg,https://derpicdn.net/img/view/2018/6/25/1765496.jpeg,1,0.979026973247528,61,482,833,1254,772,772,twilight sparkle,duop-qoub
1766270.jpeg,https://derpicdn.net/img/view/2018/6/26/1766270.jpeg,0,0.9416438937187196,0,0,522,561,522,561,twilight sparkle,tohupo
1766305.jpeg,https://derpicdn.net/img/view/2018/6/26/1766305.jpeg,0,0.9772140979766846,86,626,2184,2724,2098,2098,twilight sparkle,darksly
1766494.jpeg,https://derpicdn.net/img/view/2018/6/26/1766494.jpeg,0,0.9952991008758544,147,0,1377,1458,1230,1458,twilight sparkle,oberon826
1766506.jpeg,https://derpicdn.net/img/view/2018/6/26/1766506.jpeg,1,0.984488844871521,654,502,996,844,342,342,twilight sparkle,tingsan
1767224.jpeg,https://derpicdn.net/img/view/2018/6/27/1767224.jpeg,0,0.9380266666412354,358,591,1174,1407,816,816,twilight sparkle,basiliskfree
1767693.jpeg,https://derpicdn.net/img/view/2018/6/28/1767693.jpeg,0,0.981156051158905,234,246,586,598,352,352,twilight sparkle,sanfin
1770368.jpeg,https://derpicdn.net/img/view/2018/7/1/1770368.jpeg,0,0.9847420454025269,267,40,987,760,720,720,twilight sparkle,xjenn9
1771922.jpeg,https://derpicdn.net/img/view/2018/7/3/1771922.jpeg,0,0.9959673285484314,365,0,935,569,570,569,twilight sparkle,ponime11
1772654.jpeg,https://derpicdn.net/img/view/2018/7/4/1772654.jpeg,0,0.9757993817329408,0,430,2397,3456,2397,3026,twilight sparkle,divlight
1773234.jpeg,https://derpicdn.net/img/view/2018/7/5/1773234.jpeg,0,0.9562191367149352,0,69,1069,1151,1069,1082,twilight sparkle,earthsong9405
1773926.jpeg,https://derpicdn.net/img/view/2018/7/6/1773926.jpeg,0,0.994175910949707,0,0,919,951,919,951,twilight sparkle,noupu
1774077.jpeg,https://derpicdn.net/img/view/2018/7/6/1774077.jpeg,0,0.9574817419052124,0,9,825,929,825,920,twilight sparkle,
1774319.jpeg,https://derpicdn.net/img/view/2018/7/6/1774319.jpeg,0,0.9918200373649596,8,39,300,300,292,261,twilight sparkle,
1774319.jpeg,https://derpicdn.net/img/view/2018/7/6/1774319.jpeg,1,0.9152206182479858,3,4,259,260,256,256,twilight sparkle,
1774455.jpeg,https://derpicdn.net/img/view/2018/7/6/1774455.jpeg,0,0.9833783507347108,0,63,701,797,701,734,twilight sparkle,770nanao15
1775106.jpeg,https://derpicdn.net/img/view/2018/7/7/1775106.jpeg,0,0.96394544839859,210,183,498,471,288,288,twilight sparkle,kirillk
1775468.jpeg,https://derpicdn.net/img/view/2018/7/8/1775468.jpeg,2,0.9137737154960632,88,256,884,1052,796,796,twilight sparkle,mashoart
1775581.jpeg,https://derpicdn.net/img/view/2018/7/8/1775581.jpeg,0,0.9701302647590636,206,0,650,444,444,444,twilight sparkle,samarina
1779984.jpeg,https://derpicdn.net/img/view/2018/7/13/1779984.jpeg,0,0.9997543692588806,244,0,722,461,478,461,twilight sparkle,kloudmutt
1780653.jpeg,https://derpicdn.net/img/view/2018/7/14/1780653.jpeg,0,0.9748553037643432,278,0,610,297,332,297,twilight sparkle,akira bano
1781509.jpeg,https://derpicdn.net/img/view/2018/7/15/1781509.jpeg,0,0.9945141673088074,304,0,794,468,490,468,twilight sparkle,baigak
1781563.jpeg,https://derpicdn.net/img/view/2018/7/15/1781563.jpeg,0,0.9202398657798768,90,16,813,800,723,784,twilight sparkle,dumddeer
1782815.jpeg,https://derpicdn.net/img/view/2018/7/17/1782815.jpeg,0,0.9946921467781068,57,0,929,778,872,778,twilight sparkle,fotasy
1784343.jpeg,https://derpicdn.net/img/view/2018/7/19/1784343.jpeg,0,0.9857662320137024,247,38,507,298,260,260,twilight sparkle,shunya yamashita
1784343.jpeg,https://derpicdn.net/img/view/2018/7/19/1784343.jpeg,1,0.9354848861694336,364,532,766,934,402,402,twilight sparkle,shunya yamashita
1784678.jpeg,https://derpicdn.net/img/view/2018/7/19/1784678.jpeg,0,0.9841459393501282,0,46,614,662,614,616,twilight sparkle,colorfulcolor233
1784710.jpeg,https://derpicdn.net/img/view/2018/7/19/1784710.jpeg,0,0.9742143154144288,1,69,919,987,918,918,twilight sparkle,colorfulcolor233
1784729.jpeg,https://derpicdn.net/img/view/2018/7/19/1784729.jpeg,0,0.9945740699768066,43,0,431,357,388,357,twilight sparkle,colorfulcolor233
1785252.jpeg,https://derpicdn.net/img/view/2018/7/20/1785252.jpeg,0,0.976166605949402,687,0,3007,1899,2320,1899,twilight sparkle,hosikawa
1786167.jpeg,https://derpicdn.net/img/view/2018/7/21/1786167.jpeg,0,0.9476616978645324,497,2,1203,708,706,706,twilight sparkle,xp_r6
1786782.jpeg,https://derpicdn.net/img/view/2018/7/22/1786782.jpeg,0,0.9874486923217772,61,61,679,679,618,618,twilight sparkle,zidanemina
1787489.jpeg,https://derpicdn.net/img/view/2018/7/23/1787489.jpeg,0,0.9738404154777528,0,34,424,498,424,464,twilight sparkle,baigak
1790815.jpeg,https://derpicdn.net/img/view/2018/7/27/1790815.jpeg,0,0.9918063282966614,267,112,689,534,422,422,twilight sparkle,lollipony
1791357.jpeg,https://derpicdn.net/img/view/2018/7/27/1791357.jpeg,0,0.9308602809906006,218,222,454,458,236,236,twilight sparkle,lmkyouki
1791527.jpeg,https://derpicdn.net/img/view/2018/7/28/1791527.jpeg,0,0.989427387714386,551,127,949,525,398,398,twilight sparkle,lollipony
1793844.jpeg,https://derpicdn.net/img/view/2018/7/31/1793844.jpeg,0,0.9989683628082277,737,332,1320,938,583,606,twilight sparkle,silfoe
1794735.jpeg,https://derpicdn.net/img/view/2018/8/1/1794735.jpeg,0,0.9964991807937622,120,0,1498,1360,1378,1360,twilight sparkle,heir-of-rick
1795778.jpeg,https://derpicdn.net/img/view/2018/8/2/1795778.jpeg,0,0.9182758331298828,415,0,1159,743,744,743,twilight sparkle,lollipony
1796426.jpeg,https://derpicdn.net/img/view/2018/8/3/1796426.jpeg,0,0.9721097946166992,162,23,750,611,588,588,twilight sparkle,greyscaleart
1797167.jpeg,https://derpicdn.net/img/view/2018/8/3/1797167.jpeg,0,0.9696536660194396,0,133,720,895,720,762,twilight sparkle,killme2paza
1798825.jpeg,https://derpicdn.net/img/view/2018/8/5/1798825.jpeg,0,0.9988011121749878,545,648,955,1058,410,410,twilight sparkle,darkdabula
1799512.jpeg,https://derpicdn.net/img/view/2018/8/6/1799512.jpeg,0,0.9788190126419068,675,0,3859,2517,3184,2517,twilight sparkle,flushthebatsanta
1799707.jpeg,https://derpicdn.net/img/view/2018/8/6/1799707.jpeg,0,0.9946588277816772,972,250,1542,820,570,570,twilight sparkle,flutterluv
1800559.jpeg,https://derpicdn.net/img/view/2018/8/7/1800559.jpeg,0,0.9871920347213744,49,155,193,299,144,144,twilight sparkle,lmkyouki
1800910.jpeg,https://derpicdn.net/img/view/2018/8/7/1800910.jpeg,0,0.9983711838722228,261,189,959,887,698,698,twilight sparkle,harwick
1801297.jpeg,https://derpicdn.net/img/view/2018/8/8/1801297.jpeg,0,0.9768391251564026,1346,965,2140,1759,794,794,twilight sparkle,mynameisma
1802792.jpeg,https://derpicdn.net/img/view/2018/8/10/1802792.jpeg,0,0.9976593852043152,0,0,624,602,624,602,twilight sparkle,lispp
1803498.jpeg,https://derpicdn.net/img/view/2018/8/10/1803498.jpeg,0,0.9949922561645508,0,0,602,713,602,713,twilight sparkle,amarynceus
1804188.jpeg,https://derpicdn.net/img/view/2018/8/11/1804188.jpeg,0,0.995833694934845,1599,0,2833,1067,1234,1067,twilight sparkle,anonopony
1804993.jpeg,https://derpicdn.net/img/view/2018/8/12/1804993.jpeg,0,0.9740152955055236,19,0,459,437,440,437,twilight sparkle,divlight
1805915.jpeg,https://derpicdn.net/img/view/2018/8/13/1805915.jpeg,0,0.9736661911010742,0,0,714,638,714,638,twilight sparkle,baigak
1806258.jpeg,https://derpicdn.net/img/view/2018/8/14/1806258.jpeg,0,0.988290011882782,141,282,829,970,688,688,twilight sparkle,yukkuripalehorse
1806798.jpeg,https://derpicdn.net/img/view/2018/8/14/1806798.jpeg,0,0.9954773187637328,0,0,1103,900,1103,900,twilight sparkle,amarynceus
1807861.jpeg,https://derpicdn.net/img/view/2018/8/16/1807861.jpeg,0,0.9423207640647888,407,293,1975,1861,1568,1568,twilight sparkle,skitsniga
1808084.jpeg,https://derpicdn.net/img/view/2018/8/16/1808084.jpeg,0,0.9960238337516784,99,0,1881,1080,1782,1080,twilight sparkle,
1808308.jpeg,https://derpicdn.net/img/view/2018/8/16/1808308.jpeg,0,0.9966800808906556,1,0,931,907,930,907,twilight sparkle,magnaluna
1808325.jpeg,https://derpicdn.net/img/view/2018/8/16/1808325.jpeg,0,0.9782352447509766,525,145,1027,647,502,502,twilight sparkle,magnaluna
1808349.jpeg,https://derpicdn.net/img/view/2018/8/16/1808349.jpeg,0,0.999312162399292,107,46,845,784,738,738,twilight sparkle,magnaluna
1808624.jpeg,https://derpicdn.net/img/view/2018/8/16/1808624.jpeg,0,0.9868792295455932,789,51,1479,741,690,690,twilight sparkle,akweer
1808724.jpeg,https://derpicdn.net/img/view/2018/8/16/1808724.jpeg,0,0.9882197976112366,23,99,501,577,478,478,twilight sparkle,magnaluna
1809984.jpeg,https://derpicdn.net/img/view/2018/8/18/1809984.jpeg,0,0.96675044298172,629,319,1125,815,496,496,twilight sparkle,strebiskunk
1811777.jpeg,https://derpicdn.net/img/view/2018/8/20/1811777.jpeg,0,0.964402973651886,221,0,1455,1222,1234,1222,twilight sparkle,lummh|light262
1812243.jpeg,https://derpicdn.net/img/view/2018/8/21/1812243.jpeg,0,0.9794465899467468,68,0,926,858,858,858,twilight sparkle,magnaluna
1812747.jpeg,https://derpicdn.net/img/view/2018/8/21/1812747.jpeg,0,0.9586337804794312,1518,976,2472,1930,954,954,twilight sparkle,duop-qoub
1815830.jpeg,https://derpicdn.net/img/view/2018/8/25/1815830.jpeg,0,0.9080671072006226,248,0,1336,1039,1088,1039,twilight sparkle,mandumustbasukanemen
1817203.jpeg,https://derpicdn.net/img/view/2018/8/26/1817203.jpeg,0,0.9952226877212524,85,76,363,354,278,278,twilight sparkle,raiokai
1818523.jpeg,https://derpicdn.net/img/view/2018/8/28/1818523.jpeg,0,0.967249870300293,114,0,608,472,494,472,twilight sparkle,master_0130
1821776.jpeg,https://derpicdn.net/img/view/2018/9/1/1821776.jpeg,0,0.9996581077575684,591,0,1313,704,722,704,twilight sparkle,stratodraw
1824046.jpeg,https://derpicdn.net/img/view/2018/9/3/1824046.jpeg,0,0.986263632774353,42,53,600,673,558,620,twilight sparkle,flashlighttwi
1824046.jpeg,https://derpicdn.net/img/view/2018/9/3/1824046.jpeg,1,0.9161794781684875,0,183,481,713,481,530,twilight sparkle,flashlighttwi
1824200.jpeg,https://derpicdn.net/img/view/2018/9/3/1824200.jpeg,0,0.9976755976676941,405,0,1989,1581,1584,1581,twilight sparkle,bossmeow
1824433.jpeg,https://derpicdn.net/img/view/2018/9/4/1824433.jpeg,0,0.9689401984214784,626,317,1128,819,502,502,twilight sparkle,strebiskunk
1825483.jpeg,https://derpicdn.net/img/view/2018/9/5/1825483.jpeg,0,0.9005512595176697,291,43,679,431,388,388,twilight sparkle,xjenn9
1829943.jpeg,https://derpicdn.net/img/view/2018/9/11/1829943.jpeg,0,0.9755127429962158,70,27,882,839,812,812,twilight sparkle,angelface2006
1833299.jpeg,https://derpicdn.net/img/view/2018/9/15/1833299.jpeg,0,0.9810948967933656,126,0,1218,728,1092,728,twilight sparkle,
1834079.jpeg,https://derpicdn.net/img/view/2018/9/16/1834079.jpeg,0,0.9766266345977784,2174,511,3772,2109,1598,1598,twilight sparkle,yukomaussi
1834582.jpeg,https://derpicdn.net/img/view/2018/9/17/1834582.jpeg,0,0.9991778731346128,586,0,1376,769,790,769,twilight sparkle,stratodraw
1836752.jpeg,https://derpicdn.net/img/view/2018/9/20/1836752.jpeg,0,0.9898430705070496,334,480,1284,1430,950,950,twilight sparkle,colorfulcolor233
1839058.jpeg,https://derpicdn.net/img/view/2018/9/23/1839058.jpeg,0,0.987500548362732,389,0,1081,674,692,674,twilight sparkle,kelpiemoonknives
1839862.jpeg,https://derpicdn.net/img/view/2018/9/23/1839862.jpeg,0,0.9996314048767092,106,425,380,699,274,274,twilight sparkle,thegreatrouge
1840824.jpeg,https://derpicdn.net/img/view/2018/9/25/1840824.jpeg,0,0.9945536851882936,557,514,895,852,338,338,twilight sparkle,
1840824.jpeg,https://derpicdn.net/img/view/2018/9/25/1840824.jpeg,1,0.9843180179595948,103,546,367,810,264,264,twilight sparkle,
1841501.jpeg,https://derpicdn.net/img/view/2018/9/26/1841501.jpeg,0,0.9829116463661194,61,0,750,669,689,669,twilight sparkle,amarynceus
1842650.jpeg,https://derpicdn.net/img/view/2018/9/27/1842650.jpeg,0,0.9408687353134156,671,3,1397,729,726,726,twilight sparkle,jucamovi1992
1842700.jpeg,https://derpicdn.net/img/view/2018/9/27/1842700.jpeg,0,0.9695934653282166,111,0,993,806,882,806,twilight sparkle,baigak
1843619.jpeg,https://derpicdn.net/img/view/2018/9/29/1843619.jpeg,0,0.9961800575256348,147,117,929,899,782,782,twilight sparkle,royal
1843793.jpeg,https://derpicdn.net/img/view/2018/9/29/1843793.jpeg,0,0.9784773588180542,609,12,1159,562,550,550,twilight sparkle,shadowthedarkninja
1845289.jpeg,https://derpicdn.net/img/view/2018/10/1/1845289.jpeg,0,0.9858046174049376,333,1531,757,1955,424,424,twilight sparkle,tingsan
1845377.jpeg,https://derpicdn.net/img/view/2018/10/1/1845377.jpeg,0,0.9330768585205078,0,0,539,549,539,549,twilight sparkle,manachaaaaaaaa|up
1849602.jpeg,https://derpicdn.net/img/view/2018/10/6/1849602.jpeg,0,0.9935892820358276,208,16,1336,1144,1128,1128,twilight sparkle,舟boat
1851143.jpeg,https://derpicdn.net/img/view/2018/10/8/1851143.jpeg,0,0.9674238562583924,286,106,992,812,706,706,twilight sparkle,kuroorcas
1851165.jpeg,https://derpicdn.net/img/view/2018/10/8/1851165.jpeg,0,0.9207327365875244,38,32,496,490,458,458,twilight sparkle,
1853173.jpeg,https://derpicdn.net/img/view/2018/10/10/1853173.jpeg,0,0.9975677728652954,772,0,1092,264,320,264,twilight sparkle,sozglitch
1853173.jpeg,https://derpicdn.net/img/view/2018/10/10/1853173.jpeg,1,0.9973704814910888,85,0,409,295,324,295,twilight sparkle,sozglitch
1853173.jpeg,https://derpicdn.net/img/view/2018/10/10/1853173.jpeg,3,0.9573988914489746,1194,0,1484,237,290,237,twilight sparkle,sozglitch
1853173.jpeg,https://derpicdn.net/img/view/2018/10/10/1853173.jpeg,4,0.9280585646629332,1152,551,1486,885,334,334,twilight sparkle,sozglitch
1853438.jpeg,https://derpicdn.net/img/view/2018/10/11/1853438.jpeg,0,0.9918679594993592,2430,154,4414,2138,1984,1984,twilight sparkle,scarlet-spectrum
1855126.jpeg,https://derpicdn.net/img/view/2018/10/13/1855126.jpeg,0,0.9150896668434144,219,0,1759,1080,1540,1080,twilight sparkle,flushthebatsanta
1855127.jpeg,https://derpicdn.net/img/view/2018/10/13/1855127.jpeg,0,0.909533441066742,399,0,1471,874,1072,874,twilight sparkle,flushthebatsanta
1861985.jpeg,https://derpicdn.net/img/view/2018/10/21/1861985.jpeg,0,0.9751783609390259,18,6,358,346,340,340,twilight sparkle,marybellamy
1862183.jpeg,https://derpicdn.net/img/view/2018/10/21/1862183.jpeg,0,0.9910100102424622,191,0,865,608,674,608,twilight sparkle,tyuubatu
1862207.jpeg,https://derpicdn.net/img/view/2018/10/21/1862207.jpeg,0,0.9791395664215088,0,6,323,362,323,356,twilight sparkle,yukandasama
1862286.jpeg,https://derpicdn.net/img/view/2018/10/21/1862286.jpeg,0,0.9686142206192015,0,0,949,926,949,926,twilight sparkle,php97
1862389.jpeg,https://derpicdn.net/img/view/2018/10/21/1862389.jpeg,0,0.9011846780776978,307,14,1202,922,895,908,twilight sparkle,mirroredsea
1863333.jpeg,https://derpicdn.net/img/view/2018/10/22/1863333.jpeg,0,0.9071616530418396,25,24,731,730,706,706,twilight sparkle,jenndylyon
1863852.jpeg,https://derpicdn.net/img/view/2018/10/23/1863852.jpeg,0,0.9881457686424256,461,0,1641,1148,1180,1148,twilight sparkle,love2eategg
1864346.jpeg,https://derpicdn.net/img/view/2018/10/23/1864346.jpeg,0,0.9785041809082032,349,67,913,631,564,564,twilight sparkle,pearlyiridescence
1865511.jpeg,https://derpicdn.net/img/view/2018/10/25/1865511.jpeg,0,0.9018147587776184,939,0,1549,536,610,536,twilight sparkle,backlash91
1865899.jpeg,https://derpicdn.net/img/view/2018/10/25/1865899.jpeg,0,0.985913634300232,79,0,718,589,639,589,twilight sparkle,tingsan
1866163.jpeg,https://derpicdn.net/img/view/2018/10/26/1866163.jpeg,0,0.9992114305496216,179,228,543,592,364,364,twilight sparkle,pencilbrony
1866582.jpeg,https://derpicdn.net/img/view/2018/10/26/1866582.jpeg,0,0.9981703758239746,501,420,921,840,420,420,twilight sparkle,shirleycreates
1867805.jpeg,https://derpicdn.net/img/view/2018/10/27/1867805.jpeg,0,0.9823307394981384,47,0,687,635,640,635,twilight sparkle,
1868639.jpeg,https://derpicdn.net/img/view/2018/10/28/1868639.jpeg,0,0.9357733726501464,31,0,643,368,612,368,twilight sparkle,
1869340.jpeg,https://derpicdn.net/img/view/2018/10/29/1869340.jpeg,0,0.9335451126098632,493,352,963,822,470,470,twilight sparkle,lollipony
1870582.jpeg,https://derpicdn.net/img/view/2018/10/30/1870582.jpeg,0,0.9972503185272216,464,0,1228,736,764,736,twilight sparkle,silbersternenlicht
1874932.jpeg,https://derpicdn.net/img/view/2018/11/4/1874932.jpeg,0,0.9860841631889344,195,136,1024,1096,829,960,twilight sparkle,angusdra
1875875.jpeg,https://derpicdn.net/img/view/2018/11/5/1875875.jpeg,0,0.9706162810325624,1654,477,2342,1165,688,688,twilight sparkle,mylittleyuri
1876865.jpeg,https://derpicdn.net/img/view/2018/11/7/1876865.jpeg,0,0.9778566360473632,205,98,587,480,382,382,twilight sparkle,stratodraw
1879139.jpeg,https://derpicdn.net/img/view/2018/11/10/1879139.jpeg,0,0.9664759039878844,25,48,553,576,528,528,twilight sparkle,roya
1879217.jpeg,https://derpicdn.net/img/view/2018/11/10/1879217.jpeg,0,0.9993409514427184,940,378,2626,2064,1686,1686,twilight sparkle,latecustomer
1881491.jpeg,https://derpicdn.net/img/view/2018/11/13/1881491.jpeg,0,0.995671272277832,96,0,1144,892,1048,892,twilight sparkle,lucaaegus
1881709.jpeg,https://derpicdn.net/img/view/2018/11/13/1881709.jpeg,0,0.9568595886230468,201,254,633,686,432,432,twilight sparkle,yoshimarsart
188272.jpeg,https://derpicdn.net/img/view/2012/12/20/188272.jpeg,0,0.9049316644668579,0,0,554,568,554,568,twilight sparkle,
188284.jpeg,https://derpicdn.net/img/view/2012/12/20/188284.jpeg,0,0.977679967880249,134,0,660,538,526,538,twilight sparkle,viwrastupr
1883154.jpeg,https://derpicdn.net/img/view/2018/11/15/1883154.jpeg,0,0.9977016448974608,161,5,471,315,310,310,twilight sparkle,bhawk
1883711.jpeg,https://derpicdn.net/img/view/2018/11/16/1883711.jpeg,0,0.9781965613365172,0,0,730,697,730,697,twilight sparkle,duop-qoub
1884860.jpeg,https://derpicdn.net/img/view/2018/11/18/1884860.jpeg,0,0.9986677765846252,601,0,1065,403,464,403,twilight sparkle,roya
188547.jpeg,https://derpicdn.net/img/view/2012/12/20/188547.jpeg,0,0.9533944129943848,1576,0,4738,2664,3162,2664,twilight sparkle,forgotten-wings
1887279.jpeg,https://derpicdn.net/img/view/2018/11/21/1887279.jpeg,0,0.9939193129539492,759,477,1565,1283,806,806,twilight sparkle,post-it
1887574.jpeg,https://derpicdn.net/img/view/2018/11/21/1887574.jpeg,0,0.9829238057136536,84,176,1152,1244,1068,1068,twilight sparkle,tjpones
1888384.jpeg,https://derpicdn.net/img/view/2018/11/22/1888384.jpeg,0,0.9982370138168336,142,0,636,449,494,449,twilight sparkle,ume89s
1888569.jpeg,https://derpicdn.net/img/view/2018/11/22/1888569.jpeg,0,0.9899208545684814,308,0,624,312,316,312,twilight sparkle,koveliana
1889589.jpeg,https://derpicdn.net/img/view/2018/11/24/1889589.jpeg,0,0.994214415550232,123,0,521,360,398,360,twilight sparkle,ridgessky
1890318.jpeg,https://derpicdn.net/img/view/2018/11/25/1890318.jpeg,0,0.9886111617088318,40,413,1136,1509,1096,1096,twilight sparkle,rimmes-broose
1890326.jpeg,https://derpicdn.net/img/view/2018/11/25/1890326.jpeg,0,0.992100179195404,472,14,990,532,518,518,twilight sparkle,lupeylycan
1890326.jpeg,https://derpicdn.net/img/view/2018/11/25/1890326.jpeg,1,0.9734156131744384,157,0,759,549,602,549,twilight sparkle,lupeylycan
1890943.jpeg,https://derpicdn.net/img/view/2018/11/25/1890943.jpeg,0,0.9892725348472596,803,87,1375,659,572,572,twilight sparkle,queenofsilvers
1892856.jpeg,https://derpicdn.net/img/view/2018/11/28/1892856.jpeg,0,0.9657811522483826,867,446,1493,1072,626,626,twilight sparkle,groomlake
1893108.jpeg,https://derpicdn.net/img/view/2018/11/28/1893108.jpeg,0,0.9942660331726074,886,142,1800,1056,914,914,twilight sparkle,kunshomo
1893373.jpeg,https://derpicdn.net/img/view/2018/11/29/1893373.jpeg,0,0.9132669568061828,37,19,455,437,418,418,twilight sparkle,bloodatius
1893413.jpeg,https://derpicdn.net/img/view/2018/11/29/1893413.jpeg,0,0.9443817138671876,503,5,1513,1015,1010,1010,twilight sparkle,sourspot
1894022.jpeg,https://derpicdn.net/img/view/2018/11/29/1894022.jpeg,0,0.9921421408653259,163,0,467,301,304,301,twilight sparkle,bhawk
1894376.jpeg,https://derpicdn.net/img/view/2018/11/30/1894376.jpeg,0,0.9658015966415404,1004,0,3226,1920,2222,1920,twilight sparkle,angusdra
1894411.jpeg,https://derpicdn.net/img/view/2018/11/30/1894411.jpeg,0,0.9986259937286376,371,50,1158,878,787,828,twilight sparkle,canvymamamoo
1894419.jpeg,https://derpicdn.net/img/view/2018/11/30/1894419.jpeg,0,0.997547686100006,369,0,1021,601,652,601,twilight sparkle,canvymamamoo
1894543.jpeg,https://derpicdn.net/img/view/2018/11/30/1894543.jpeg,0,0.9695932269096376,252,0,644,377,392,377,twilight sparkle,sozglitch
1895005.jpeg,https://derpicdn.net/img/view/2018/12/1/1895005.jpeg,0,0.9975892305374146,0,0,371,373,371,373,twilight sparkle,scarletskitty12
1895663.jpeg,https://derpicdn.net/img/view/2018/12/1/1895663.jpeg,0,0.992767870426178,183,96,497,410,314,314,twilight sparkle,yowza-buckaroo
1895666.jpeg,https://derpicdn.net/img/view/2018/12/1/1895666.jpeg,0,0.97943913936615,250,5,786,541,536,536,twilight sparkle,fuufuucuddles
1895666.jpeg,https://derpicdn.net/img/view/2018/12/1/1895666.jpeg,1,0.9197443723678588,390,1716,882,2208,492,492,twilight sparkle,fuufuucuddles
1895785.jpeg,https://derpicdn.net/img/view/2018/12/1/1895785.jpeg,0,0.9891483783721924,129,0,857,688,728,688,twilight sparkle,amarynceus
1896393.jpeg,https://derpicdn.net/img/view/2018/12/2/1896393.jpeg,0,0.9353931546211244,128,63,340,275,212,212,twilight sparkle,lin-麟乜
1896441.jpeg,https://derpicdn.net/img/view/2018/12/2/1896441.jpeg,0,0.985083281993866,38,0,278,226,240,226,twilight sparkle,kura
1896744.jpeg,https://derpicdn.net/img/view/2018/12/3/1896744.jpeg,0,0.9505376219749452,61,3,751,693,690,690,twilight sparkle,
1896832.jpeg,https://derpicdn.net/img/view/2018/12/3/1896832.jpeg,0,0.9678201079368592,66,401,462,797,396,396,twilight sparkle,xoxobellatrixxx
1897453.jpeg,https://derpicdn.net/img/view/2018/12/3/1897453.jpeg,0,0.9451225399971008,36,64,654,673,618,609,twilight sparkle,dimwitdog
1897698.jpeg,https://derpicdn.net/img/view/2018/12/4/1897698.jpeg,0,0.9979910850524902,2360,0,3740,1362,1380,1362,twilight sparkle,kawaiipony2
1899379.jpeg,https://derpicdn.net/img/view/2018/12/5/1899379.jpeg,0,0.994131565093994,218,130,1384,1296,1166,1166,twilight sparkle,yunlongchen
1899842.jpeg,https://derpicdn.net/img/view/2018/12/6/1899842.jpeg,0,0.999040424823761,224,22,610,408,386,386,twilight sparkle,cold-blooded-twilight
1900412.jpeg,https://derpicdn.net/img/view/2018/12/6/1900412.jpeg,0,0.9627503752708436,5,166,800,998,795,832,twilight sparkle,konnyart
1900483.jpeg,https://derpicdn.net/img/view/2018/12/6/1900483.jpeg,0,0.9923314452171326,699,0,1621,851,922,851,twilight sparkle,duop-qoub
1900654.jpeg,https://derpicdn.net/img/view/2018/12/6/1900654.jpeg,0,0.950817048549652,139,0,900,780,761,780,twilight sparkle,amarynceus
1901632.jpeg,https://derpicdn.net/img/view/2018/12/7/1901632.jpeg,0,0.963406264781952,742,195,1912,1365,1170,1170,twilight sparkle,graphenescloset
1902367.jpeg,https://derpicdn.net/img/view/2018/12/8/1902367.jpeg,0,0.9053961634635924,189,338,1293,1442,1104,1104,twilight sparkle,drawingjules
1903646.jpeg,https://derpicdn.net/img/view/2018/12/9/1903646.jpeg,0,0.9962708950042723,446,6,954,514,508,508,twilight sparkle,d-xross
1903662.jpeg,https://derpicdn.net/img/view/2018/12/9/1903662.jpeg,0,0.9934684038162231,295,0,1349,1028,1054,1028,twilight sparkle,zazush-una
1905087.jpeg,https://derpicdn.net/img/view/2018/12/11/1905087.jpeg,0,0.996514618396759,383,1277,1535,2429,1152,1152,twilight sparkle,bloodatius
1907603.jpeg,https://derpicdn.net/img/view/2018/12/13/1907603.jpeg,0,0.9980526566505432,843,0,2003,1154,1160,1154,twilight sparkle,graphenescloset
1907883.jpeg,https://derpicdn.net/img/view/2018/12/14/1907883.jpeg,0,0.9797213673591614,372,194,830,652,458,458,twilight sparkle,
1908661.jpeg,https://derpicdn.net/img/view/2018/12/15/1908661.jpeg,0,0.9845404028892516,761,453,1088,795,327,342,twilight sparkle,wangkingfun
1910242.jpeg,https://derpicdn.net/img/view/2018/12/16/1910242.jpeg,0,0.9830349087715148,728,721,1058,1051,330,330,twilight sparkle,tingsan
1910696.jpeg,https://derpicdn.net/img/view/2018/12/17/1910696.jpeg,0,0.999664306640625,869,390,1733,1254,864,864,twilight sparkle,graphenescloset
1910757.jpeg,https://derpicdn.net/img/view/2018/12/17/1910757.jpeg,0,0.9099622964859008,188,18,624,454,436,436,twilight sparkle,dragbax
1911176.jpeg,https://derpicdn.net/img/view/2018/12/17/1911176.jpeg,0,0.9956405162811279,182,55,364,237,182,182,twilight sparkle,ronniesponies
1911712.jpeg,https://derpicdn.net/img/view/2018/12/18/1911712.jpeg,2,0.9708441495895386,1282,811,1708,1237,426,426,twilight sparkle,nolycs
1911762.jpeg,https://derpicdn.net/img/view/2018/12/18/1911762.jpeg,0,0.9830895066261292,0,60,934,1000,934,940,twilight sparkle,lollipony
1911920.jpeg,https://derpicdn.net/img/view/2018/12/18/1911920.jpeg,0,0.945845901966095,1342,831,2696,2185,1354,1354,twilight sparkle,darksly
1913378.jpeg,https://derpicdn.net/img/view/2018/12/20/1913378.jpeg,0,0.9158868789672852,761,175,2621,2035,1860,1860,twilight sparkle,blackligerth
1913473.jpeg,https://derpicdn.net/img/view/2018/12/20/1913473.jpeg,0,0.9973768591880798,1192,515,2000,1323,808,808,twilight sparkle,magnaluna
1914826.jpeg,https://derpicdn.net/img/view/2018/12/21/1914826.jpeg,0,0.9548379778862,321,45,1103,827,782,782,twilight sparkle,mrs1989
1914858.jpeg,https://derpicdn.net/img/view/2018/12/21/1914858.jpeg,0,0.9482078552246094,177,11,1043,877,866,866,twilight sparkle,rakuen_295
1914859.jpeg,https://derpicdn.net/img/view/2018/12/21/1914859.jpeg,0,0.9776395559310912,36,41,438,443,402,402,twilight sparkle,duop-qoub
1914865.jpeg,https://derpicdn.net/img/view/2018/12/21/1914865.jpeg,0,0.98871910572052,119,0,1385,1141,1266,1141,twilight sparkle,magnaluna
1915615.jpeg,https://derpicdn.net/img/view/2018/12/22/1915615.jpeg,0,0.9591633081436156,59,92,720,834,661,742,twilight sparkle,
1916403.jpeg,https://derpicdn.net/img/view/2018/12/23/1916403.jpeg,0,0.9888591766357422,215,214,1024,1024,809,810,twilight sparkle,hilloty
1918303.jpeg,https://derpicdn.net/img/view/2018/12/25/1918303.jpeg,0,0.994420051574707,449,0,1267,710,818,710,twilight sparkle,alexmakovsky
1918966.jpeg,https://derpicdn.net/img/view/2018/12/26/1918966.jpeg,0,0.9424447417259216,346,0,1218,781,872,781,twilight sparkle,stratodraw
1919735.jpeg,https://derpicdn.net/img/view/2018/12/27/1919735.jpeg,0,0.9983050227165222,971,10,2017,1056,1046,1046,twilight sparkle,stratodraw
1920753.jpeg,https://derpicdn.net/img/view/2018/12/28/1920753.jpeg,0,0.994426429271698,112,0,1340,1187,1228,1187,twilight sparkle,momizi_bee
1922133.jpeg,https://derpicdn.net/img/view/2018/12/30/1922133.jpeg,0,0.9874417781829834,1028,139,2510,1621,1482,1482,twilight sparkle,darksly
1923903.jpeg,https://derpicdn.net/img/view/2019/1/1/1923903.jpeg,0,0.9797719717025756,34,24,706,696,672,672,twilight sparkle,
1924793.jpeg,https://derpicdn.net/img/view/2019/1/2/1924793.jpeg,0,0.9940592050552368,678,3,994,319,316,316,twilight sparkle,ciciya
1925214.jpeg,https://derpicdn.net/img/view/2019/1/2/1925214.jpeg,0,0.9973968863487244,156,50,566,460,410,410,twilight sparkle,cinderdmutt
1925698.jpeg,https://derpicdn.net/img/view/2019/1/3/1925698.jpeg,0,0.9912038445472716,284,47,720,483,436,436,twilight sparkle,mysticalpha
1925981.jpeg,https://derpicdn.net/img/view/2019/1/3/1925981.jpeg,0,0.9940173625946044,440,6,1022,588,582,582,twilight sparkle,rd_3024
1926083.jpeg,https://derpicdn.net/img/view/2019/1/4/1926083.jpeg,0,0.92279452085495,51,0,944,883,893,883,twilight sparkle,
1926899.jpeg,https://derpicdn.net/img/view/2019/1/5/1926899.jpeg,0,0.993477702140808,21,0,649,615,628,615,twilight sparkle,tohupo
1927760.jpeg,https://derpicdn.net/img/view/2019/1/6/1927760.jpeg,0,0.9971755743026732,422,0,942,477,520,477,twilight sparkle,tyuubatu
1928364.jpeg,https://derpicdn.net/img/view/2019/1/6/1928364.jpeg,0,0.9918375015258788,202,0,668,466,466,466,twilight sparkle,jezzabelle
1928831.jpeg,https://derpicdn.net/img/view/2019/1/7/1928831.jpeg,0,0.9966588020324708,14,0,302,268,288,268,twilight sparkle,tsukuda
1929863.jpeg,https://derpicdn.net/img/view/2019/1/8/1929863.jpeg,0,0.9120312333106996,618,0,2048,1323,1430,1323,twilight sparkle,filama
1930712.jpeg,https://derpicdn.net/img/view/2019/1/9/1930712.jpeg,0,0.9896665811538696,1157,63,2559,1465,1402,1402,twilight sparkle,kikineta
1932227.jpeg,https://derpicdn.net/img/view/2019/1/11/1932227.jpeg,0,0.9825613498687744,517,73,1119,675,602,602,twilight sparkle,kurogewapony
1932647.jpeg,https://derpicdn.net/img/view/2019/1/11/1932647.jpeg,0,0.9535449743270874,1326,221,2882,1777,1556,1556,twilight sparkle,silfoe
1934604.jpeg,https://derpicdn.net/img/view/2019/1/13/1934604.jpeg,0,0.9991028904914856,543,75,1083,615,540,540,twilight sparkle,riukime
1934609.jpeg,https://derpicdn.net/img/view/2019/1/13/1934609.jpeg,0,0.912284016609192,42,0,1094,1005,1052,1005,twilight sparkle,
1935127.jpeg,https://derpicdn.net/img/view/2019/1/14/1935127.jpeg,0,0.9989358186721802,613,77,1141,605,528,528,twilight sparkle,riukime
1935997.jpeg,https://derpicdn.net/img/view/2019/1/15/1935997.jpeg,0,0.9988358020782472,24,25,310,311,286,286,twilight sparkle,riukime
1935997.jpeg,https://derpicdn.net/img/view/2019/1/15/1935997.jpeg,1,0.9987938404083252,769,0,1249,409,480,409,twilight sparkle,riukime
1936263.jpeg,https://derpicdn.net/img/view/2019/1/15/1936263.jpeg,0,0.9873030185699464,0,0,597,612,597,612,twilight sparkle,tohupo
1936986.jpeg,https://derpicdn.net/img/view/2019/1/16/1936986.jpeg,0,0.921990692615509,443,170,1111,838,668,668,twilight sparkle,1drfl_world_end
1937769.jpeg,https://derpicdn.net/img/view/2019/1/17/1937769.jpeg,0,0.998810350894928,204,19,846,661,642,642,twilight sparkle,n_thing
1940591.jpeg,https://derpicdn.net/img/view/2019/1/21/1940591.jpeg,0,0.932374119758606,589,0,1053,429,464,429,twilight sparkle,pinkkoffin
1941257.jpeg,https://derpicdn.net/img/view/2019/1/21/1941257.jpeg,0,0.9848193526268004,1445,849,1953,1357,508,508,twilight sparkle,stratodraw
1943706.jpeg,https://derpicdn.net/img/view/2019/1/25/1943706.jpeg,0,0.9939407110214232,430,355,800,725,370,370,twilight sparkle,strebiskunk
1943939.jpeg,https://derpicdn.net/img/view/2019/1/25/1943939.jpeg,0,0.9537766575813292,42,230,844,987,802,757,twilight sparkle,spaboofy
1944390.jpeg,https://derpicdn.net/img/view/2019/1/25/1944390.jpeg,0,0.987169086933136,280,0,780,401,500,401,twilight sparkle,h0mi3
1945892.jpeg,https://derpicdn.net/img/view/2019/1/27/1945892.jpeg,0,0.996578574180603,24,17,302,295,278,278,twilight sparkle,hanada
1946800.jpeg,https://derpicdn.net/img/view/2019/1/28/1946800.jpeg,0,0.921034812927246,444,0,1720,1237,1276,1237,twilight sparkle,icychamber
1947704.jpeg,https://derpicdn.net/img/view/2019/1/29/1947704.jpeg,0,0.9931678771972656,244,57,712,525,468,468,twilight sparkle,holivi
1947729.jpeg,https://derpicdn.net/img/view/2019/1/29/1947729.jpeg,0,0.9506233334541321,114,115,314,315,200,200,twilight sparkle,kittiara
1947867.jpeg,https://derpicdn.net/img/view/2019/1/29/1947867.jpeg,0,0.9427051544189452,14,0,503,499,489,499,twilight sparkle,
1948398.jpeg,https://derpicdn.net/img/view/2019/1/30/1948398.jpeg,0,0.9899918437004088,228,153,1324,1249,1096,1096,twilight sparkle,lightningflame
1949167.jpeg,https://derpicdn.net/img/view/2019/1/31/1949167.jpeg,0,0.9323239326477052,422,0,932,394,510,394,twilight sparkle,theprince
1951341.jpeg,https://derpicdn.net/img/view/2019/2/2/1951341.jpeg,0,0.9728228449821472,97,0,723,581,626,581,twilight sparkle,colorfulcolor233
1953619.jpeg,https://derpicdn.net/img/view/2019/2/4/1953619.jpeg,0,0.9929301142692566,273,0,2106,1900,1833,1900,twilight sparkle,小huhu狸君呀
1954606.jpeg,https://derpicdn.net/img/view/2019/2/5/1954606.jpeg,0,0.9877092242240906,1011,140,1317,446,306,306,twilight sparkle,lupiarts
1955069.jpeg,https://derpicdn.net/img/view/2019/2/6/1955069.jpeg,2,0.9949952960014344,104,584,378,858,274,274,twilight sparkle,sozglitch
1955082.jpeg,https://derpicdn.net/img/view/2019/2/6/1955082.jpeg,0,0.9457939267158508,471,504,1537,1570,1066,1066,twilight sparkle,yunlongchen
1955828.jpeg,https://derpicdn.net/img/view/2019/2/7/1955828.jpeg,0,0.9793377518653872,0,0,700,758,700,758,twilight sparkle,tohupo
1955990.jpeg,https://derpicdn.net/img/view/2019/2/7/1955990.jpeg,0,0.9985401034355164,380,0,1052,664,672,664,twilight sparkle,holivi
1956538.jpeg,https://derpicdn.net/img/view/2019/2/8/1956538.jpeg,0,0.9990019798278807,132,0,540,377,408,377,twilight sparkle,pink-pinktooth
1956550.jpeg,https://derpicdn.net/img/view/2019/2/8/1956550.jpeg,0,0.9891250729560852,131,6,517,392,386,386,twilight sparkle,这是一只草履虫
1957165.jpeg,https://derpicdn.net/img/view/2019/2/9/1957165.jpeg,0,0.9155129790306092,153,3,633,483,480,480,twilight sparkle,raikoh
1957275.jpeg,https://derpicdn.net/img/view/2019/2/9/1957275.jpeg,0,0.9920346736907959,89,0,521,371,432,371,twilight sparkle,radiantrealm
1957340.jpeg,https://derpicdn.net/img/view/2019/2/9/1957340.jpeg,0,0.9826765060424804,343,113,645,415,302,302,twilight sparkle,fab3716
1957654.jpeg,https://derpicdn.net/img/view/2019/2/9/1957654.jpeg,0,0.9514104127883912,837,457,1603,1223,766,766,twilight sparkle,mashiromiku
1957980.jpeg,https://derpicdn.net/img/view/2019/2/10/1957980.jpeg,0,0.9303479194641112,376,112,630,366,254,254,twilight sparkle,shunya yamashita
1957980.jpeg,https://derpicdn.net/img/view/2019/2/10/1957980.jpeg,1,0.9149032831192015,580,804,924,1148,344,344,twilight sparkle,shunya yamashita
1958471.jpeg,https://derpicdn.net/img/view/2019/2/10/1958471.jpeg,0,0.9991263151168824,210,114,452,356,242,242,twilight sparkle,御喵子w
1958477.jpeg,https://derpicdn.net/img/view/2019/2/10/1958477.jpeg,0,0.9993223547935486,399,25,699,325,300,300,twilight sparkle,御喵子w
1958570.jpeg,https://derpicdn.net/img/view/2019/2/10/1958570.jpeg,0,0.9123027324676514,0,22,840,872,840,850,twilight sparkle,rikadiane
1960633.jpeg,https://derpicdn.net/img/view/2019/2/13/1960633.jpeg,0,0.9589693546295166,180,28,634,482,454,454,twilight sparkle,rainbowchaserrr
1961620.jpeg,https://derpicdn.net/img/view/2019/2/14/1961620.jpeg,0,0.9909647107124328,85,0,699,599,614,599,twilight sparkle,watawata_pony
1962583.jpeg,https://derpicdn.net/img/view/2019/2/15/1962583.jpeg,0,0.9670068621635436,222,154,912,844,690,690,twilight sparkle,gintoki23
1963043.jpeg,https://derpicdn.net/img/view/2019/2/15/1963043.jpeg,0,0.9492883086204528,146,0,810,624,664,624,twilight sparkle,acry-artwork
1963654.jpeg,https://derpicdn.net/img/view/2019/2/16/1963654.jpeg,0,0.9869632720947266,287,164,1059,936,772,772,twilight sparkle,stratodraw
1965008.jpeg,https://derpicdn.net/img/view/2019/2/18/1965008.jpeg,0,0.9852309823036194,0,0,593,569,593,569,twilight sparkle,toroitimu
1965263.jpeg,https://derpicdn.net/img/view/2019/2/18/1965263.jpeg,0,0.9653229117393494,0,106,696,968,696,862,twilight sparkle,tohupo
1965349.jpeg,https://derpicdn.net/img/view/2019/2/18/1965349.jpeg,0,0.9986575245857242,418,0,916,470,498,470,twilight sparkle,dstears
1966595.jpeg,https://derpicdn.net/img/view/2019/2/20/1966595.jpeg,0,0.9757396578788756,9,7,792,859,783,852,twilight sparkle,stratodraw
1966858.jpeg,https://derpicdn.net/img/view/2019/2/20/1966858.jpeg,0,0.9875580668449402,338,0,2390,2019,2052,2019,twilight sparkle,crystal2riolu
1967161.jpeg,https://derpicdn.net/img/view/2019/2/20/1967161.jpeg,0,0.9634281396865844,36,434,1500,1914,1464,1480,twilight sparkle,burgerkiss
1969493.jpeg,https://derpicdn.net/img/view/2019/2/23/1969493.jpeg,0,0.9569159746170044,583,0,1118,549,535,549,twilight sparkle,
1969493.jpeg,https://derpicdn.net/img/view/2019/2/23/1969493.jpeg,1,0.9414827227592468,12,0,628,590,616,590,twilight sparkle,
1971164.jpeg,https://derpicdn.net/img/view/2019/2/25/1971164.jpeg,0,0.9307615160942078,166,104,1168,1106,1002,1002,twilight sparkle,catlion3
1972817.jpeg,https://derpicdn.net/img/view/2019/2/27/1972817.jpeg,0,0.99605393409729,0,0,377,379,377,379,twilight sparkle,xjenn9
1973228.jpeg,https://derpicdn.net/img/view/2019/2/27/1973228.jpeg,0,0.9775742888450624,0,6,379,414,379,408,twilight sparkle,dreamyri
1973511.jpeg,https://derpicdn.net/img/view/2019/2/28/1973511.jpeg,0,0.9984055161476136,266,85,692,511,426,426,twilight sparkle,katalean
1975731.jpeg,https://derpicdn.net/img/view/2019/3/2/1975731.jpeg,0,0.9581246376037598,209,105,1929,1825,1720,1720,twilight sparkle,malinetourmaline
1977815.jpeg,https://derpicdn.net/img/view/2019/3/5/1977815.jpeg,0,0.9697751998901368,191,82,979,870,788,788,twilight sparkle,tohupo
1977877.jpeg,https://derpicdn.net/img/view/2019/3/5/1977877.jpeg,0,0.9995239973068236,226,54,516,344,290,290,twilight sparkle,d.lycaon
1978939.jpeg,https://derpicdn.net/img/view/2019/3/6/1978939.jpeg,0,0.9578914642333984,564,47,880,363,316,316,twilight sparkle,probablyfakeblonde
1979855.jpeg,https://derpicdn.net/img/view/2019/3/7/1979855.jpeg,0,0.9994146227836608,2,0,346,344,344,344,twilight sparkle,yoditax
1983339.jpeg,https://derpicdn.net/img/view/2019/3/11/1983339.jpeg,0,0.9859954118728638,226,152,886,812,660,660,twilight sparkle,honeybeepony
1983553.jpeg,https://derpicdn.net/img/view/2019/3/12/1983553.jpeg,0,0.997815191745758,391,10,935,554,544,544,twilight sparkle,yukomaussi
1983622.jpeg,https://derpicdn.net/img/view/2019/3/12/1983622.jpeg,0,0.9698521494865416,792,0,1240,429,448,429,twilight sparkle,nebychko
1983674.jpeg,https://derpicdn.net/img/view/2019/3/12/1983674.jpeg,0,0.9875965714454652,0,0,1052,1057,1052,1057,twilight sparkle,yuyutsuka_0130
1983975.jpeg,https://derpicdn.net/img/view/2019/3/12/1983975.jpeg,0,0.9821650385856628,377,20,713,356,336,336,twilight sparkle,andelai
1984956.jpeg,https://derpicdn.net/img/view/2019/3/14/1984956.jpeg,0,0.99773108959198,431,808,1375,1752,944,944,twilight sparkle,skitsniga
1986816.jpeg,https://derpicdn.net/img/view/2019/3/16/1986816.jpeg,0,0.9931825399398804,259,14,1075,830,816,816,twilight sparkle,roya
1987288.jpeg,https://derpicdn.net/img/view/2019/3/16/1987288.jpeg,0,0.995833694934845,253,150,623,520,370,370,twilight sparkle,joselyn565
1987515.jpeg,https://derpicdn.net/img/view/2019/3/16/1987515.jpeg,0,0.9297050833702089,87,0,529,422,442,422,twilight sparkle,royal
1987521.jpeg,https://derpicdn.net/img/view/2019/3/16/1987521.jpeg,0,0.9101132154464722,759,0,1549,702,790,702,twilight sparkle,royal
1988427.jpeg,https://derpicdn.net/img/view/2019/3/17/1988427.jpeg,0,0.9989033937454224,1003,37,2063,1097,1060,1060,twilight sparkle,cyonixcymatro
1989107.jpeg,https://derpicdn.net/img/view/2019/3/18/1989107.jpeg,0,0.972382426261902,233,24,577,368,344,344,twilight sparkle,vale-bandicoot96
1990965.jpeg,https://derpicdn.net/img/view/2019/3/20/1990965.jpeg,0,0.9885464310646056,38,50,694,706,656,656,twilight sparkle,acelinjack
1990997.jpeg,https://derpicdn.net/img/view/2019/3/20/1990997.jpeg,0,0.9873757362365724,157,0,1191,720,1034,720,twilight sparkle,marsclaws
1991366.jpeg,https://derpicdn.net/img/view/2019/3/21/1991366.jpeg,0,0.9951505661010742,567,192,1159,784,592,592,twilight sparkle,greenbrothersart
1991456.jpeg,https://derpicdn.net/img/view/2019/3/21/1991456.jpeg,0,0.9942683577537536,501,0,905,380,404,380,twilight sparkle,12irinchan
1992519.jpeg,https://derpicdn.net/img/view/2019/3/23/1992519.jpeg,0,0.9989417791366576,588,0,1200,548,612,548,twilight sparkle,redpalette
1992585.jpeg,https://derpicdn.net/img/view/2019/3/23/1992585.jpeg,0,0.9224069714546204,0,0,677,661,677,661,twilight sparkle,gigi_kitten
1992833.jpeg,https://derpicdn.net/img/view/2019/3/23/1992833.jpeg,0,0.9880412220954896,0,0,517,512,517,512,twilight sparkle,colorfulcolor233
199329.jpeg,https://derpicdn.net/img/view/2013/1/1/199329.jpeg,0,0.9956400990486144,101,2,383,284,282,282,twilight sparkle,shepherd0821
1995591.jpeg,https://derpicdn.net/img/view/2019/3/26/1995591.jpeg,0,0.936425507068634,539,34,1705,1200,1166,1166,twilight sparkle,argos90
1996652.jpeg,https://derpicdn.net/img/view/2019/3/28/1996652.jpeg,0,0.9898441433906556,47,0,497,450,450,450,twilight sparkle,
1998413.jpeg,https://derpicdn.net/img/view/2019/3/30/1998413.jpeg,0,0.9666128754615784,0,0,380,514,380,514,twilight sparkle,
1998468.jpeg,https://derpicdn.net/img/view/2019/3/30/1998468.jpeg,0,0.98208886384964,0,39,1171,1211,1171,1172,twilight sparkle,abbykaskaya
1998964.jpeg,https://derpicdn.net/img/view/2019/3/31/1998964.jpeg,0,0.9786334037780762,0,0,969,1082,969,1082,twilight sparkle,glitteronin
1999043.jpeg,https://derpicdn.net/img/view/2019/3/31/1999043.jpeg,0,0.99979430437088,7,0,705,649,698,649,twilight sparkle,
1999043.jpeg,https://derpicdn.net/img/view/2019/3/31/1999043.jpeg,1,0.9935110807418824,0,649,780,1451,780,802,twilight sparkle,
1999043.jpeg,https://derpicdn.net/img/view/2019/3/31/1999043.jpeg,2,0.9845196008682252,794,0,1412,605,618,605,twilight sparkle,
2000196.jpeg,https://derpicdn.net/img/view/2019/4/1/2000196.jpeg,0,0.9991592168807985,341,90,709,458,368,368,twilight sparkle,akweer
2003504.jpeg,https://derpicdn.net/img/view/2019/4/5/2003504.jpeg,0,0.9609378576278688,549,21,1287,759,738,738,twilight sparkle,potetecyu_to
2004682.jpeg,https://derpicdn.net/img/view/2019/4/6/2004682.jpeg,0,0.9902940988540648,479,240,921,682,442,442,twilight sparkle,stratodraw
2005389.jpeg,https://derpicdn.net/img/view/2019/4/7/2005389.jpeg,0,0.9993010759353638,372,0,1100,696,728,696,twilight sparkle,kurogewapony
2007564.jpeg,https://derpicdn.net/img/view/2019/4/9/2007564.jpeg,0,0.9794868230819702,266,0,558,263,292,263,twilight sparkle,alexbroanimator
2007814.jpeg,https://derpicdn.net/img/view/2019/4/10/2007814.jpeg,0,0.9005619883537292,323,0,793,391,470,391,twilight sparkle,jonfawkes
2009965.jpeg,https://derpicdn.net/img/view/2019/4/12/2009965.jpeg,0,0.9770224094390868,503,0,2805,2070,2302,2070,twilight sparkle,mashiromiku
2010409.jpeg,https://derpicdn.net/img/view/2019/4/13/2010409.jpeg,0,0.9654849767684937,0,0,2061,2110,2061,2110,twilight sparkle,plone|pabbley
2010967.jpeg,https://derpicdn.net/img/view/2019/4/13/2010967.jpeg,0,0.9970330595970154,660,0,2470,1779,1810,1779,twilight sparkle,happyanthro
2011237.jpeg,https://derpicdn.net/img/view/2019/4/13/2011237.jpeg,0,0.9274311661720276,726,0,1874,1143,1148,1143,twilight sparkle,blackligerth
2012982.jpeg,https://derpicdn.net/img/view/2019/4/15/2012982.jpeg,0,0.9723025560379028,1111,227,1731,847,620,620,twilight sparkle,luciferamon
2013831.jpeg,https://derpicdn.net/img/view/2019/4/16/2013831.jpeg,0,0.9826800227165222,495,311,747,563,252,252,twilight sparkle,turnipberry
2013954.jpeg,https://derpicdn.net/img/view/2019/4/16/2013954.jpeg,0,0.9919355511665344,364,99,2120,1887,1756,1788,twilight sparkle,liaaqila
2014311.jpeg,https://derpicdn.net/img/view/2019/4/16/2014311.jpeg,0,0.9309110641479492,763,0,2051,1184,1288,1184,twilight sparkle,lightisanasshole
2015485.jpeg,https://derpicdn.net/img/view/2019/4/18/2015485.jpeg,0,0.9830549359321594,97,49,1205,1157,1108,1108,twilight sparkle,nocturne1113
2016379.jpeg,https://derpicdn.net/img/view/2019/4/19/2016379.jpeg,0,0.9960108995437622,195,50,613,468,418,418,twilight sparkle,netburst-celeron
2016880.jpeg,https://derpicdn.net/img/view/2019/4/19/2016880.jpeg,0,0.9983720183372498,233,0,1125,875,892,875,twilight sparkle,php97
2016895.jpeg,https://derpicdn.net/img/view/2019/4/19/2016895.jpeg,0,0.9994572401046752,305,106,2879,2680,2574,2574,twilight sparkle,xbi
2017025.jpeg,https://derpicdn.net/img/view/2019/4/19/2017025.jpeg,0,0.9574702382087708,17,0,732,791,715,791,twilight sparkle,mlpfwb
2017089.jpeg,https://derpicdn.net/img/view/2019/4/19/2017089.jpeg,0,0.9915147423744202,156,0,2988,2802,2832,2802,twilight sparkle,xbi
2017693.jpeg,https://derpicdn.net/img/view/2019/4/20/2017693.jpeg,0,0.9283456802368164,64,0,1542,935,1478,935,twilight sparkle,
2017845.jpeg,https://derpicdn.net/img/view/2019/4/20/2017845.jpeg,1,0.9013518691062928,168,0,858,595,690,595,twilight sparkle,
2019030.jpeg,https://derpicdn.net/img/view/2019/4/21/2019030.jpeg,0,0.9829227328300476,106,585,1098,1532,992,947,twilight sparkle,
2019030.jpeg,https://derpicdn.net/img/view/2019/4/21/2019030.jpeg,1,0.9760918617248536,0,0,945,876,945,876,twilight sparkle,
2020086.jpeg,https://derpicdn.net/img/view/2019/4/22/2020086.jpeg,0,0.999405562877655,823,50,1685,912,862,862,twilight sparkle,superanina
2021087.jpeg,https://derpicdn.net/img/view/2019/4/23/2021087.jpeg,0,0.949289083480835,134,0,1304,1009,1170,1009,twilight sparkle,91o42
2021667.jpeg,https://derpicdn.net/img/view/2019/4/24/2021667.jpeg,0,0.9972304701805116,117,0,281,142,164,142,twilight sparkle,mongos
2022147.jpeg,https://derpicdn.net/img/view/2019/4/24/2022147.jpeg,0,0.9855352640151978,109,36,475,402,366,366,twilight sparkle,earthsong9405
2022506.jpeg,https://derpicdn.net/img/view/2019/4/25/2022506.jpeg,0,0.9991870522499084,242,0,870,610,628,610,twilight sparkle,bloodrizer|trollie trollenberg
2026618.jpeg,https://derpicdn.net/img/view/2019/4/29/2026618.jpeg,0,0.988257110118866,55,59,1479,1483,1424,1424,twilight sparkle,php97
2027062.jpeg,https://derpicdn.net/img/view/2019/4/30/2027062.jpeg,0,0.9945590496063232,119,21,407,309,288,288,twilight sparkle,astraldog
2027275.jpeg,https://derpicdn.net/img/view/2019/4/30/2027275.jpeg,0,0.9923107624053956,70,0,908,665,838,665,twilight sparkle,tohupo
2028593.jpeg,https://derpicdn.net/img/view/2019/5/1/2028593.jpeg,0,0.9292089343070984,487,82,845,440,358,358,twilight sparkle,akurion
2029119.jpeg,https://derpicdn.net/img/view/2019/5/2/2029119.jpeg,0,0.993622362613678,319,27,667,375,348,348,twilight sparkle,sozglitch
2029295.jpeg,https://derpicdn.net/img/view/2019/5/2/2029295.jpeg,0,0.9808057546615601,503,83,1109,689,606,606,twilight sparkle,jotakaanimation
2031239.jpeg,https://derpicdn.net/img/view/2019/5/5/2031239.jpeg,0,0.951947808265686,345,2,1367,1024,1022,1022,twilight sparkle,shkura2011
2032537.jpeg,https://derpicdn.net/img/view/2019/5/6/2032537.jpeg,0,0.9788192510604858,404,0,1334,888,930,888,twilight sparkle,91o42
2032545.jpeg,https://derpicdn.net/img/view/2019/5/6/2032545.jpeg,0,0.9702718257904052,222,0,1536,1247,1314,1247,twilight sparkle,kurogewapony
2032754.jpeg,https://derpicdn.net/img/view/2019/5/6/2032754.jpeg,0,0.9426557421684264,0,42,769,814,769,772,twilight sparkle,pastel-pony-pictures
2034339.jpeg,https://derpicdn.net/img/view/2019/5/9/2034339.jpeg,0,0.9858595728874208,0,0,581,570,581,570,twilight sparkle,tomness
2034818.jpeg,https://derpicdn.net/img/view/2019/5/9/2034818.jpeg,0,0.906071662902832,84,0,1086,974,1002,974,twilight sparkle,tohupo
2035192.jpeg,https://derpicdn.net/img/view/2019/5/10/2035192.jpeg,0,0.9792307019233704,59,0,840,779,781,779,twilight sparkle,cottonbudfilly
2035899.jpeg,https://derpicdn.net/img/view/2019/5/11/2035899.jpeg,0,0.976863443851471,0,0,547,562,547,562,twilight sparkle,cornflake-chan-art
2036346.jpeg,https://derpicdn.net/img/view/2019/5/11/2036346.jpeg,0,0.9962898492813108,474,572,1006,1104,532,532,twilight sparkle,pixelkitties
2039598.jpeg,https://derpicdn.net/img/view/2019/5/15/2039598.jpeg,0,0.9556017518043518,0,0,639,638,639,638,twilight sparkle,tohupo
2043407.jpeg,https://derpicdn.net/img/view/2019/5/19/2043407.jpeg,0,0.9946526885032654,701,36,2461,1796,1760,1760,twilight sparkle,magnaluna
2043837.jpeg,https://derpicdn.net/img/view/2019/5/19/2043837.jpeg,0,0.9831428527832032,1415,0,3003,1293,1588,1293,twilight sparkle,vittorionobile
2044230.jpeg,https://derpicdn.net/img/view/2019/5/20/2044230.jpeg,0,0.9455345273017884,0,0,753,753,753,753,twilight sparkle,tohupo
2046994.jpeg,https://derpicdn.net/img/view/2019/5/23/2046994.jpeg,0,0.9954898953437804,846,192,1686,1032,840,840,twilight sparkle,schizoidtomii
2048038.jpeg,https://derpicdn.net/img/view/2019/5/24/2048038.jpeg,0,0.9963330030441284,280,130,636,486,356,356,twilight sparkle,putt125
2049212.jpeg,https://derpicdn.net/img/view/2019/5/26/2049212.jpeg,0,0.9988836646080016,911,367,1743,1199,832,832,twilight sparkle,reptilianbirds
2051685.jpeg,https://derpicdn.net/img/view/2019/5/28/2051685.jpeg,0,0.9497025012969972,98,52,846,800,748,748,twilight sparkle,papadragon69
2051863.jpeg,https://derpicdn.net/img/view/2019/5/28/2051863.jpeg,0,0.9590650200843812,174,101,834,761,660,660,twilight sparkle,lollipony
2053445.jpeg,https://derpicdn.net/img/view/2019/5/30/2053445.jpeg,0,0.998604416847229,841,206,1081,446,240,240,twilight sparkle,l1nkoln
2053445.jpeg,https://derpicdn.net/img/view/2019/5/30/2053445.jpeg,1,0.97030907869339,1058,199,1294,435,236,236,twilight sparkle,l1nkoln
2054012.jpeg,https://derpicdn.net/img/view/2019/5/31/2054012.jpeg,0,0.9857203364372252,0,0,493,479,493,479,twilight sparkle,dalapony
2054272.jpeg,https://derpicdn.net/img/view/2019/5/31/2054272.jpeg,0,0.9439460635185242,913,41,2293,1421,1380,1380,twilight sparkle,tohupo
2054734.jpeg,https://derpicdn.net/img/view/2019/6/1/2054734.jpeg,0,0.9191483855247498,154,0,930,712,776,712,twilight sparkle,770nanao15
2054909.jpeg,https://derpicdn.net/img/view/2019/6/1/2054909.jpeg,0,0.9873480796813964,187,0,597,399,410,399,twilight sparkle,norithecat
2055134.jpeg,https://derpicdn.net/img/view/2019/6/1/2055134.jpeg,0,0.9549027681350708,298,291,758,751,460,460,twilight sparkle,cartoon-eric
2055368.jpeg,https://derpicdn.net/img/view/2019/6/1/2055368.jpeg,0,0.9570800065994264,12,3,1099,1101,1087,1098,twilight sparkle,tohupo
2057326.jpeg,https://derpicdn.net/img/view/2019/6/4/2057326.jpeg,0,0.9928333759307858,94,51,986,943,892,892,twilight sparkle,frostedvulpix
2058664.jpeg,https://derpicdn.net/img/view/2019/6/5/2058664.jpeg,0,0.9981095790863036,178,149,1238,1209,1060,1060,twilight sparkle,cali luminos
2058806.jpeg,https://derpicdn.net/img/view/2019/6/5/2058806.jpeg,0,0.9957379102706908,0,13,615,699,615,686,twilight sparkle,wickedwind
2059525.jpeg,https://derpicdn.net/img/view/2019/6/7/2059525.jpeg,0,0.9365750551223756,79,19,387,327,308,308,twilight sparkle,
2059658.jpeg,https://derpicdn.net/img/view/2019/6/7/2059658.jpeg,0,0.9917672872543336,550,62,1046,558,496,496,twilight sparkle,empress-twilight
2059905.jpeg,https://derpicdn.net/img/view/2019/6/7/2059905.jpeg,0,0.9607299566268921,290,171,824,705,534,534,twilight sparkle,xjenn9
2060526.jpeg,https://derpicdn.net/img/view/2019/6/8/2060526.jpeg,0,0.9900688529014589,1944,1285,3668,3009,1724,1724,twilight sparkle,hunternif
2060701.jpeg,https://derpicdn.net/img/view/2019/6/8/2060701.jpeg,0,0.9738744497299194,213,65,1155,1007,942,942,twilight sparkle,bbtasu
2063981.jpeg,https://derpicdn.net/img/view/2019/6/12/2063981.jpeg,0,0.9985159039497375,225,10,557,342,332,332,twilight sparkle,bel-assa
2066010.jpeg,https://derpicdn.net/img/view/2019/6/15/2066010.jpeg,0,0.9724370837211608,51,0,409,357,358,357,twilight sparkle,yakieringi014
2071494.jpeg,https://derpicdn.net/img/view/2019/6/21/2071494.jpeg,0,0.9928876757621764,114,0,1084,879,970,879,twilight sparkle,noxi1_48
2071833.jpeg,https://derpicdn.net/img/view/2019/6/22/2071833.jpeg,0,0.9016759991645812,225,153,613,541,388,388,twilight sparkle,orchidpony
2072517.jpeg,https://derpicdn.net/img/view/2019/6/22/2072517.jpeg,0,0.9534540176391602,0,87,1222,1481,1222,1394,twilight sparkle,tohupo
2072738.jpeg,https://derpicdn.net/img/view/2019/6/23/2072738.jpeg,0,0.997093379497528,174,0,710,482,536,482,twilight sparkle,shadeysix
2072797.jpeg,https://derpicdn.net/img/view/2019/6/23/2072797.jpeg,0,0.9990994334220886,442,83,1162,803,720,720,twilight sparkle,mohrm_mlp2
2073581.jpeg,https://derpicdn.net/img/view/2019/6/23/2073581.jpeg,0,0.9993460178375244,1937,10,3599,1672,1662,1662,twilight sparkle,poltergyst
2074221.jpeg,https://derpicdn.net/img/view/2019/6/24/2074221.jpeg,0,0.998795747756958,222,0,470,247,248,247,twilight sparkle,iloota
2074847.jpeg,https://derpicdn.net/img/view/2019/6/25/2074847.jpeg,0,0.9932615756988524,372,69,644,341,272,272,twilight sparkle,geminineart
2076040.jpeg,https://derpicdn.net/img/view/2019/6/26/2076040.jpeg,0,0.9202154278755188,62,0,822,677,760,677,twilight sparkle,kisaradoesart16
2076884.jpeg,https://derpicdn.net/img/view/2019/6/27/2076884.jpeg,0,0.939996302127838,359,36,729,406,370,370,twilight sparkle,rainbowstar2015
2077813.jpeg,https://derpicdn.net/img/view/2019/6/28/2077813.jpeg,0,0.9858426451683044,124,0,1196,928,1072,928,twilight sparkle,pesty_skillengton
2078496.jpeg,https://derpicdn.net/img/view/2019/6/29/2078496.jpeg,0,0.950401484966278,0,7,659,737,659,730,twilight sparkle,tohupo
2078504.jpeg,https://derpicdn.net/img/view/2019/6/29/2078504.jpeg,0,0.9994636774063108,478,75,1372,969,894,894,twilight sparkle,ask-colorsound
2078527.jpeg,https://derpicdn.net/img/view/2019/6/29/2078527.jpeg,0,0.9362207651138306,648,80,1352,784,704,704,twilight sparkle,
2078684.jpeg,https://derpicdn.net/img/view/2019/6/29/2078684.jpeg,0,0.9888091087341307,338,0,1966,1367,1628,1367,twilight sparkle,cottonbudfilly
2082257.jpeg,https://derpicdn.net/img/view/2019/7/3/2082257.jpeg,0,0.9807401895523072,249,0,959,678,710,678,twilight sparkle,cascayd
2083585.jpeg,https://derpicdn.net/img/view/2019/7/5/2083585.jpeg,0,0.9655311703681946,59,9,523,473,464,464,twilight sparkle,770nanao15
2083626.jpeg,https://derpicdn.net/img/view/2019/7/5/2083626.jpeg,0,0.9862439632415771,133,64,579,510,446,446,twilight sparkle,carnifex
2083751.jpeg,https://derpicdn.net/img/view/2019/7/5/2083751.jpeg,0,0.9269415140151978,0,0,385,364,385,364,twilight sparkle,
2083940.jpeg,https://derpicdn.net/img/view/2019/7/5/2083940.jpeg,0,0.9291664361953736,0,52,752,824,752,772,twilight sparkle,jazzwolf347
2084507.jpeg,https://derpicdn.net/img/view/2019/7/6/2084507.jpeg,0,0.9947920441627502,118,300,470,652,352,352,twilight sparkle,cottonbudfilly
2084507.jpeg,https://derpicdn.net/img/view/2019/7/6/2084507.jpeg,1,0.9947838187217712,319,17,741,439,422,422,twilight sparkle,cottonbudfilly
2084576.jpeg,https://derpicdn.net/img/view/2019/7/6/2084576.jpeg,0,0.9912598133087158,346,50,638,342,292,292,twilight sparkle,yewdee
2085076.jpeg,https://derpicdn.net/img/view/2019/7/7/2085076.jpeg,0,0.9585739374160768,84,0,578,441,494,441,twilight sparkle,
2085212.jpeg,https://derpicdn.net/img/view/2019/7/7/2085212.jpeg,0,0.9788001775741576,626,0,1126,421,500,421,twilight sparkle,sadelinav
2085396.jpeg,https://derpicdn.net/img/view/2019/7/7/2085396.jpeg,0,0.9976845979690552,372,125,688,441,316,316,twilight sparkle,stratodraw
2085891.jpeg,https://derpicdn.net/img/view/2019/7/8/2085891.jpeg,0,0.9833842515945436,479,141,1309,971,830,830,twilight sparkle,tinybenz
2086797.jpeg,https://derpicdn.net/img/view/2019/7/8/2086797.jpeg,0,0.9969427585601808,511,0,1447,931,936,931,twilight sparkle,newyorkx3
2087640.jpeg,https://derpicdn.net/img/view/2019/7/10/2087640.jpeg,0,0.9240869283676147,0,0,266,260,266,260,twilight sparkle,soeru
2088258.jpeg,https://derpicdn.net/img/view/2019/7/10/2088258.jpeg,0,0.9886001944541932,88,0,566,457,478,457,twilight sparkle,cottonbudfilly
2088566.jpeg,https://derpicdn.net/img/view/2019/7/11/2088566.jpeg,0,0.9246184825897216,63,92,583,612,520,520,twilight sparkle,tjpones
2089291.jpeg,https://derpicdn.net/img/view/2019/7/11/2089291.jpeg,0,0.995719850063324,649,11,1251,613,602,602,twilight sparkle,silfoe
2089739.jpeg,https://derpicdn.net/img/view/2019/7/12/2089739.jpeg,0,0.9280198812484741,116,155,1816,1855,1700,1700,twilight sparkle,kirasunnight
2090052.jpeg,https://derpicdn.net/img/view/2019/7/12/2090052.jpeg,0,0.9619576930999756,538,493,1214,1169,676,676,twilight sparkle,ponime11
2091287.jpeg,https://derpicdn.net/img/view/2019/7/14/2091287.jpeg,0,0.9957056045532228,597,0,1221,620,624,620,twilight sparkle,tingsan
2092381.jpeg,https://derpicdn.net/img/view/2019/7/15/2092381.jpeg,0,0.9363325834274292,118,288,516,686,398,398,twilight sparkle,scarlett_wing
2092393.jpeg,https://derpicdn.net/img/view/2019/7/15/2092393.jpeg,0,0.99764221906662,464,39,978,553,514,514,twilight sparkle,agaberu
2093206.jpeg,https://derpicdn.net/img/view/2019/7/16/2093206.jpeg,0,0.9870250821113586,131,440,745,1054,614,614,twilight sparkle,moh_mlp2
2093206.jpeg,https://derpicdn.net/img/view/2019/7/16/2093206.jpeg,1,0.9672560095787048,691,104,1319,732,628,628,twilight sparkle,moh_mlp2
2093527.jpeg,https://derpicdn.net/img/view/2019/7/16/2093527.jpeg,0,0.9963457584381104,975,586,1433,1044,458,458,twilight sparkle,anontheanon
2094321.jpeg,https://derpicdn.net/img/view/2019/7/17/2094321.jpeg,0,0.990827202796936,107,26,859,778,752,752,twilight sparkle,mu-zizi
2096802.jpeg,https://derpicdn.net/img/view/2019/7/20/2096802.jpeg,0,0.9753602743148804,337,198,945,806,608,608,twilight sparkle,cottonbudfilly
2096879.jpeg,https://derpicdn.net/img/view/2019/7/20/2096879.jpeg,0,0.9343364238739014,110,0,862,701,752,701,twilight sparkle,phallen1
2096917.jpeg,https://derpicdn.net/img/view/2019/7/20/2096917.jpeg,0,0.9978337287902832,980,0,1432,377,452,377,twilight sparkle,thelunarmoon
2097158.jpeg,https://derpicdn.net/img/view/2019/7/21/2097158.jpeg,0,0.9839762449264526,153,601,939,1387,786,786,twilight sparkle,zetamad
2098028.jpeg,https://derpicdn.net/img/view/2019/7/21/2098028.jpeg,0,0.9973928332328796,789,188,1413,812,624,624,twilight sparkle,cottonbudfilly
209813.jpeg,https://derpicdn.net/img/view/2013/1/12/209813.jpeg,0,0.9701856970787048,219,272,541,594,322,322,twilight sparkle,author-chan
2099458.jpeg,https://derpicdn.net/img/view/2019/7/23/2099458.jpeg,0,0.9975502490997314,102,6,546,450,444,444,twilight sparkle,stratodraw
2100179.jpeg,https://derpicdn.net/img/view/2019/7/24/2100179.jpeg,0,0.9979364275932312,636,141,1488,993,852,852,twilight sparkle,nanima
2101177.jpeg,https://derpicdn.net/img/view/2019/7/25/2101177.jpeg,0,0.9970848560333252,877,135,1685,943,808,808,twilight sparkle,mercurysparkle
2101389.jpeg,https://derpicdn.net/img/view/2019/7/26/2101389.jpeg,0,0.9979763031005859,414,1,708,295,294,294,twilight sparkle,tonyfleecs
2101389.jpeg,https://derpicdn.net/img/view/2019/7/26/2101389.jpeg,1,0.9915893077850342,769,166,1077,474,308,308,twilight sparkle,tonyfleecs
2101507.jpeg,https://derpicdn.net/img/view/2019/7/26/2101507.jpeg,0,0.9632188081741332,0,34,389,442,389,408,twilight sparkle,snowillusory
2103344.jpeg,https://derpicdn.net/img/view/2019/7/28/2103344.jpeg,0,0.9979665279388428,30,9,604,583,574,574,twilight sparkle,stratodraw
2103581.jpeg,https://derpicdn.net/img/view/2019/7/28/2103581.jpeg,0,0.9019215106964112,37,0,1057,975,1020,975,twilight sparkle,tohupo
2104654.jpeg,https://derpicdn.net/img/view/2019/7/30/2104654.jpeg,0,0.9996793866157532,111,2,553,444,442,442,twilight sparkle,stratodraw
2104747.jpeg,https://derpicdn.net/img/view/2019/7/30/2104747.jpeg,0,0.9939766526222228,304,35,1236,987,932,952,twilight sparkle,vird-gi
2106584.jpeg,https://derpicdn.net/img/view/2019/8/1/2106584.jpeg,0,0.9697152376174928,0,0,451,430,451,430,twilight sparkle,snowillusory
2107981.jpeg,https://derpicdn.net/img/view/2019/8/3/2107981.jpeg,0,0.975717306137085,78,1,498,337,420,336,twilight sparkle,
2109403.jpeg,https://derpicdn.net/img/view/2019/8/5/2109403.jpeg,0,0.962670624256134,969,421,2835,2287,1866,1866,twilight sparkle,celestial-rainstorm
2109403.jpeg,https://derpicdn.net/img/view/2019/8/5/2109403.jpeg,1,0.9120951890945436,2144,140,4036,2032,1892,1892,twilight sparkle,celestial-rainstorm
2110482.jpeg,https://derpicdn.net/img/view/2019/8/6/2110482.jpeg,0,0.988050639629364,142,35,576,469,434,434,twilight sparkle,littlebibbo
2111020.jpeg,https://derpicdn.net/img/view/2019/8/7/2111020.jpeg,0,0.9913002252578736,132,46,550,464,418,418,twilight sparkle,hotomura
2112977.jpeg,https://derpicdn.net/img/view/2019/8/9/2112977.jpeg,0,0.9875616431236268,0,71,770,864,770,793,twilight sparkle,
2112977.jpeg,https://derpicdn.net/img/view/2019/8/9/2112977.jpeg,1,0.981709897518158,131,0,966,812,835,812,twilight sparkle,
2113703.jpeg,https://derpicdn.net/img/view/2019/8/10/2113703.jpeg,0,0.9911962747573853,178,0,444,265,266,265,twilight sparkle,maarthul
2113724.jpeg,https://derpicdn.net/img/view/2019/8/10/2113724.jpeg,0,0.9929420948028564,289,0,589,249,300,249,twilight sparkle,kirinit
2114404.jpeg,https://derpicdn.net/img/view/2019/8/10/2114404.jpeg,0,0.9973206520080566,486,0,1118,618,632,618,twilight sparkle,moondrop
2119113.jpeg,https://derpicdn.net/img/view/2019/8/15/2119113.jpeg,0,0.9813828468322754,323,102,2749,2528,2426,2426,twilight sparkle,annakitsun3
2120227.jpeg,https://derpicdn.net/img/view/2019/8/17/2120227.jpeg,0,0.9957187175750732,472,885,1118,1531,646,646,twilight sparkle,bluewolfavenger
2121190.jpeg,https://derpicdn.net/img/view/2019/8/18/2121190.jpeg,0,0.9898190498352052,1,65,859,900,858,835,twilight sparkle,
2123101.jpeg,https://derpicdn.net/img/view/2019/8/20/2123101.jpeg,0,0.9571549892425536,192,88,772,668,580,580,twilight sparkle,noupie
2124738.jpeg,https://derpicdn.net/img/view/2019/8/22/2124738.jpeg,0,0.9884047508239746,475,82,849,456,374,374,twilight sparkle,pastel-pony-pictures
2128229.jpeg,https://derpicdn.net/img/view/2019/8/26/2128229.jpeg,0,0.9732391238212584,0,0,538,502,538,502,twilight sparkle,tre
2129750.jpeg,https://derpicdn.net/img/view/2019/8/28/2129750.jpeg,0,0.9851471185684204,15,0,323,288,308,288,twilight sparkle,yakieringi014
2131247.jpeg,https://derpicdn.net/img/view/2019/8/30/2131247.jpeg,0,0.991909682750702,2763,4514,5555,7306,2792,2792,twilight sparkle,brekrofmadness
2131247.jpeg,https://derpicdn.net/img/view/2019/8/30/2131247.jpeg,1,0.9906659126281738,926,0,3650,2702,2724,2702,twilight sparkle,brekrofmadness
2131247.jpeg,https://derpicdn.net/img/view/2019/8/30/2131247.jpeg,2,0.9780223369598388,3614,1771,6662,4819,3048,3048,twilight sparkle,brekrofmadness
2132042.jpeg,https://derpicdn.net/img/view/2019/8/31/2132042.jpeg,0,0.9657551050186156,292,0,1316,773,1024,773,twilight sparkle,amy-gamy
2132647.jpeg,https://derpicdn.net/img/view/2019/8/31/2132647.jpeg,0,0.9483012557029724,234,306,490,562,256,256,twilight sparkle,lilfunkman
2133195.jpeg,https://derpicdn.net/img/view/2019/9/1/2133195.jpeg,0,0.9838185906410216,805,54,1327,576,522,522,twilight sparkle,tyuubatu
2134054.jpeg,https://derpicdn.net/img/view/2019/9/2/2134054.jpeg,0,0.9516214728355408,354,6,1128,780,774,774,twilight sparkle,mirroredsea
2134178.jpeg,https://derpicdn.net/img/view/2019/9/2/2134178.jpeg,0,0.9704313874244692,299,103,789,593,490,490,twilight sparkle,mysticalpha
2135687.jpeg,https://derpicdn.net/img/view/2019/9/3/2135687.jpeg,0,0.9654289484024048,80,47,1364,1331,1284,1284,twilight sparkle,purplemilka
2136048.jpeg,https://derpicdn.net/img/view/2019/9/4/2136048.jpeg,0,0.9767167568206788,478,39,930,491,452,452,twilight sparkle,zatma
2136120.jpeg,https://derpicdn.net/img/view/2019/9/4/2136120.jpeg,0,0.998898148536682,496,46,1286,836,790,790,twilight sparkle,moh_mlp2
2136222.jpeg,https://derpicdn.net/img/view/2019/9/4/2136222.jpeg,0,0.9855676293373108,359,135,639,415,280,280,twilight sparkle,skyearts
2136553.jpeg,https://derpicdn.net/img/view/2019/9/4/2136553.jpeg,0,0.9996901154518129,297,0,805,506,508,506,twilight sparkle,hobilo
2137090.jpeg,https://derpicdn.net/img/view/2019/9/5/2137090.jpeg,0,0.9340035915374756,206,14,918,726,712,712,twilight sparkle,tohupo
2138024.jpeg,https://derpicdn.net/img/view/2019/9/6/2138024.jpeg,0,0.9975187182426452,769,399,1355,985,586,586,twilight sparkle,tillie-tmb
2138241.jpeg,https://derpicdn.net/img/view/2019/9/7/2138241.jpeg,0,0.9880114197731018,62,0,832,735,770,735,twilight sparkle,cascayd
2140226.jpeg,https://derpicdn.net/img/view/2019/9/9/2140226.jpeg,0,0.9332964420318604,16,65,674,723,658,658,twilight sparkle,bbtasu
2141521.jpeg,https://derpicdn.net/img/view/2019/9/11/2141521.jpeg,0,0.9984363913536072,269,20,1227,978,958,958,twilight sparkle,mykegreywolf
2141522.jpeg,https://derpicdn.net/img/view/2019/9/11/2141522.jpeg,0,0.9983927607536316,269,20,1229,980,960,960,twilight sparkle,mykegreywolf
2143389.jpeg,https://derpicdn.net/img/view/2019/9/13/2143389.jpeg,0,0.987008273601532,351,430,759,838,408,408,twilight sparkle,silfoe
2144464.jpeg,https://derpicdn.net/img/view/2019/9/15/2144464.jpeg,0,0.9957448840141296,163,0,391,224,228,224,twilight sparkle,scarletskitty12
2144585.jpeg,https://derpicdn.net/img/view/2019/9/15/2144585.jpeg,0,0.9924282431602478,442,155,1170,883,728,728,twilight sparkle,satv12
2144934.jpeg,https://derpicdn.net/img/view/2019/9/15/2144934.jpeg,0,0.9855194687843324,375,0,745,367,370,367,twilight sparkle,rurihal
2145800.jpeg,https://derpicdn.net/img/view/2019/9/16/2145800.jpeg,0,0.9974446296691896,508,0,1664,1086,1156,1086,twilight sparkle,emerald-light
2145800.jpeg,https://derpicdn.net/img/view/2019/9/16/2145800.jpeg,1,0.9364945888519288,680,1463,1436,2219,756,756,twilight sparkle,emerald-light
2146245.jpeg,https://derpicdn.net/img/view/2019/9/17/2146245.jpeg,0,0.9719948172569276,13,0,337,309,324,309,twilight sparkle,
2146556.jpeg,https://derpicdn.net/img/view/2019/9/17/2146556.jpeg,0,0.9964879155158995,136,1239,1564,2667,1428,1428,twilight sparkle,nutsfify
2146556.jpeg,https://derpicdn.net/img/view/2019/9/17/2146556.jpeg,1,0.9457896947860718,921,93,2559,1731,1638,1638,twilight sparkle,nutsfify
2146627.jpeg,https://derpicdn.net/img/view/2019/9/17/2146627.jpeg,0,0.997978448867798,262,63,2162,1963,1900,1900,twilight sparkle,empress-twilight
2149467.jpeg,https://derpicdn.net/img/view/2019/9/21/2149467.jpeg,0,0.9932653307914734,0,0,1302,1169,1302,1169,twilight sparkle,dumddeer
2152737.jpeg,https://derpicdn.net/img/view/2019/9/25/2152737.jpeg,0,0.9580077528953552,253,73,1161,981,908,908,twilight sparkle,tohupo
2153569.jpeg,https://derpicdn.net/img/view/2019/9/26/2153569.jpeg,0,0.9836937785148621,3,0,643,600,640,600,twilight sparkle,dddreamdraw
2154937.jpeg,https://derpicdn.net/img/view/2019/9/28/2154937.jpeg,0,0.9370368123054504,711,2,1361,652,650,650,twilight sparkle,ljdamz1119
2155685.jpeg,https://derpicdn.net/img/view/2019/9/29/2155685.jpeg,0,0.9443618655204772,603,0,2321,1577,1718,1577,twilight sparkle,tf-sential
2156900.jpeg,https://derpicdn.net/img/view/2019/9/30/2156900.jpeg,0,0.9970101118087769,565,179,2129,1743,1564,1564,twilight sparkle,cuddlehooves
2157106.jpeg,https://derpicdn.net/img/view/2019/9/30/2157106.jpeg,0,0.984071671962738,0,0,660,648,660,648,twilight sparkle,hunnybunny009
2157382.jpeg,https://derpicdn.net/img/view/2019/10/1/2157382.jpeg,0,0.98646342754364,238,0,706,434,468,434,twilight sparkle,vylfgor
2157383.jpeg,https://derpicdn.net/img/view/2019/10/1/2157383.jpeg,0,0.9865900874137878,238,0,706,433,468,433,twilight sparkle,vylfgor
2157384.jpeg,https://derpicdn.net/img/view/2019/10/1/2157384.jpeg,0,0.9871469140052797,238,0,704,432,466,432,twilight sparkle,vylfgor
2158040.jpeg,https://derpicdn.net/img/view/2019/10/2/2158040.jpeg,0,0.9940029382705688,120,31,430,341,310,310,twilight sparkle,mykegreywolf
2158040.jpeg,https://derpicdn.net/img/view/2019/10/2/2158040.jpeg,1,0.9863008260726928,621,473,779,631,158,158,twilight sparkle,mykegreywolf
2159560.jpeg,https://derpicdn.net/img/view/2019/10/4/2159560.jpeg,0,0.9954161643981934,172,0,670,477,498,477,twilight sparkle,lil miss jay
2160314.jpeg,https://derpicdn.net/img/view/2019/10/4/2160314.jpeg,0,0.992475688457489,0,0,1156,1212,1156,1212,twilight sparkle,ask-colorsound
2162598.jpeg,https://derpicdn.net/img/view/2019/10/7/2162598.jpeg,0,0.9937801361083984,426,140,716,430,290,290,twilight sparkle,icychamber
2163664.jpeg,https://derpicdn.net/img/view/2019/10/9/2163664.jpeg,0,0.9998082518577576,356,347,1288,1279,932,932,twilight sparkle,helemaranth
2163843.jpeg,https://derpicdn.net/img/view/2019/10/9/2163843.jpeg,0,0.9544917345046996,38,0,878,781,840,781,twilight sparkle,ask-colorsound
2163891.jpeg,https://derpicdn.net/img/view/2019/10/9/2163891.jpeg,0,0.9938842654228208,84,0,1508,1372,1424,1372,twilight sparkle,siripim111
2164510.jpeg,https://derpicdn.net/img/view/2019/10/10/2164510.jpeg,0,0.9733866453170776,267,35,585,353,318,318,twilight sparkle,siripim111
2164739.jpeg,https://derpicdn.net/img/view/2019/10/10/2164739.jpeg,0,0.9829723834991456,0,0,1240,1464,1240,1464,twilight sparkle,tohupo
2165622.jpeg,https://derpicdn.net/img/view/2019/10/11/2165622.jpeg,0,0.9097820520401,340,146,818,624,478,478,twilight sparkle,amphoera
2167050.jpeg,https://derpicdn.net/img/view/2019/10/13/2167050.jpeg,0,0.9163475632667542,0,0,1035,1243,1035,1243,twilight sparkle,tohupo
2167190.jpeg,https://derpicdn.net/img/view/2019/10/13/2167190.jpeg,0,0.999177634716034,551,0,1207,636,656,636,twilight sparkle,mashoart
2167996.jpeg,https://derpicdn.net/img/view/2019/10/13/2167996.jpeg,0,0.9986048936843872,0,0,1292,1303,1292,1303,twilight sparkle,mrscroup
2168064.jpeg,https://derpicdn.net/img/view/2019/10/13/2168064.jpeg,0,0.9988154768943788,888,55,1332,499,444,444,twilight sparkle,dinkydoolove
2168146.jpeg,https://derpicdn.net/img/view/2019/10/14/2168146.jpeg,0,0.9056602716445924,50,312,848,1110,798,798,twilight sparkle,acesential
2168175.jpeg,https://derpicdn.net/img/view/2019/10/14/2168175.jpeg,0,0.9805083274841307,348,0,1808,1288,1460,1288,twilight sparkle,siripim111
2168333.jpeg,https://derpicdn.net/img/view/2019/10/14/2168333.jpeg,0,0.9154758453369141,156,100,452,396,296,296,twilight sparkle,lumineko
2169774.jpeg,https://derpicdn.net/img/view/2019/10/15/2169774.jpeg,0,0.9981273412704468,1418,60,2704,1346,1286,1286,twilight sparkle,empress-twilight
2170075.jpeg,https://derpicdn.net/img/view/2019/10/15/2170075.jpeg,0,0.9939397573471068,690,609,1210,1129,520,520,twilight sparkle,farewelldecency
2170497.jpeg,https://derpicdn.net/img/view/2019/10/16/2170497.jpeg,0,0.9909585118293762,917,156,1371,610,454,454,twilight sparkle,oc_ponys
2170590.jpeg,https://derpicdn.net/img/view/2019/10/16/2170590.jpeg,0,0.972042977809906,1147,0,2048,843,901,843,twilight sparkle,tingsan
2171508.jpeg,https://derpicdn.net/img/view/2019/10/17/2171508.jpeg,0,0.9933039546012878,191,43,1289,1141,1098,1098,twilight sparkle,wkirin
2173971.jpeg,https://derpicdn.net/img/view/2019/10/19/2173971.jpeg,0,0.9892413020133972,340,0,703,351,363,351,twilight sparkle,benyablinkakaeto
2173997.jpeg,https://derpicdn.net/img/view/2019/10/19/2173997.jpeg,1,0.9613342881202698,521,67,1399,945,878,878,twilight sparkle,chub-wub
2174236.jpeg,https://derpicdn.net/img/view/2019/10/20/2174236.jpeg,0,0.9567974209785458,1288,519,2678,1909,1390,1390,twilight sparkle,vantiss
2174698.jpeg,https://derpicdn.net/img/view/2019/10/20/2174698.jpeg,0,0.9667757153511048,11,4,613,606,602,602,twilight sparkle,sleepykoinu
2174800.jpeg,https://derpicdn.net/img/view/2019/10/20/2174800.jpeg,0,0.9924541711807252,87,0,1627,1452,1540,1452,twilight sparkle,sharkam0
2174994.jpeg,https://derpicdn.net/img/view/2019/10/21/2174994.jpeg,0,0.9857480525970459,270,63,900,693,630,630,twilight sparkle,hogg_draws
2175660.jpeg,https://derpicdn.net/img/view/2019/10/21/2175660.jpeg,0,0.9975358247756958,318,0,1210,782,892,782,twilight sparkle,reterica
2175803.jpeg,https://derpicdn.net/img/view/2019/10/22/2175803.jpeg,0,0.998432993888855,224,0,940,687,716,687,twilight sparkle,menko_e
2175809.jpeg,https://derpicdn.net/img/view/2019/10/22/2175809.jpeg,0,0.9993815422058104,126,28,468,370,342,342,twilight sparkle,mesuyoru
2176595.jpeg,https://derpicdn.net/img/view/2019/10/23/2176595.jpeg,0,0.9582388997077942,227,75,459,307,232,232,twilight sparkle,scarletskitty12
2176846.jpeg,https://derpicdn.net/img/view/2019/10/23/2176846.jpeg,0,0.968786895275116,1028,1269,2890,3131,1862,1862,twilight sparkle,twilytwilytwinkletwily
2177346.jpeg,https://derpicdn.net/img/view/2019/10/24/2177346.jpeg,0,0.9952728748321532,62,1047,830,1815,768,768,twilight sparkle,bokkitoki
2177693.jpeg,https://derpicdn.net/img/view/2019/10/24/2177693.jpeg,0,0.905184268951416,313,353,535,575,222,222,twilight sparkle,weird--fish
2178949.jpeg,https://derpicdn.net/img/view/2019/10/25/2178949.jpeg,0,0.9981126189231871,186,11,1288,1113,1102,1102,twilight sparkle,mrscurlystyles
2179227.jpeg,https://derpicdn.net/img/view/2019/10/26/2179227.jpeg,0,0.9803903102874756,340,0,700,358,360,358,twilight sparkle,mizoreame
2179838.jpeg,https://derpicdn.net/img/view/2019/10/26/2179838.jpeg,0,0.9995202422142028,34,5,256,227,222,222,twilight sparkle,anticular
2180107.jpeg,https://derpicdn.net/img/view/2019/10/27/2180107.jpeg,0,0.9972943663597108,472,53,722,303,250,250,twilight sparkle,yakieringi014
2180107.jpeg,https://derpicdn.net/img/view/2019/10/27/2180107.jpeg,1,0.9441084265708924,106,0,410,264,304,264,twilight sparkle,yakieringi014
2180530.jpeg,https://derpicdn.net/img/view/2019/10/27/2180530.jpeg,0,0.9908462166786194,205,4,629,428,424,424,twilight sparkle,stratodraw
2180625.jpeg,https://derpicdn.net/img/view/2019/10/27/2180625.jpeg,0,0.9979609847068788,326,0,956,617,630,617,twilight sparkle,tiroil
2181602.jpeg,https://derpicdn.net/img/view/2019/10/28/2181602.jpeg,0,0.9832316637039183,124,19,512,407,388,388,twilight sparkle,luciferamon
2181824.jpeg,https://derpicdn.net/img/view/2019/10/29/2181824.jpeg,0,0.9992998838424684,427,46,1823,1442,1396,1396,twilight sparkle,spidershii
2182361.jpeg,https://derpicdn.net/img/view/2019/10/29/2182361.jpeg,0,0.9824691414833068,324,173,878,727,554,554,twilight sparkle,mn27
2183342.jpeg,https://derpicdn.net/img/view/2019/10/31/2183342.jpeg,0,0.9992300868034364,1095,49,1803,757,708,708,twilight sparkle,scarletskitty12
2183894.jpeg,https://derpicdn.net/img/view/2019/10/31/2183894.jpeg,0,0.9750794768333436,189,40,541,392,352,352,twilight sparkle,jen-neigh
2184497.jpeg,https://derpicdn.net/img/view/2019/11/1/2184497.jpeg,0,0.9970251321792604,472,154,1782,1464,1310,1310,twilight sparkle,liaaqila
2185155.jpeg,https://derpicdn.net/img/view/2019/11/2/2185155.jpeg,0,0.9452599883079528,50,43,852,845,802,802,twilight sparkle,herfaithfulstudent
2185839.jpeg,https://derpicdn.net/img/view/2019/11/2/2185839.jpeg,0,0.9987415075302124,842,124,1502,784,660,660,twilight sparkle,rurihal
2187467.jpeg,https://derpicdn.net/img/view/2019/11/4/2187467.jpeg,0,0.9932954907417296,46,0,1172,1075,1126,1075,twilight sparkle,tohupo
2187961.jpeg,https://derpicdn.net/img/view/2019/11/5/2187961.jpeg,0,0.9946498870849608,340,169,684,513,344,344,twilight sparkle,reterica
2188061.jpeg,https://derpicdn.net/img/view/2019/11/5/2188061.jpeg,0,0.9882075786590576,0,0,2613,2651,2613,2651,twilight sparkle,toisanemoif
2188521.jpeg,https://derpicdn.net/img/view/2019/11/6/2188521.jpeg,0,0.9295395612716676,248,0,594,310,346,310,twilight sparkle,rutkotka
2189125.jpeg,https://derpicdn.net/img/view/2019/11/6/2189125.jpeg,0,0.9975168108940125,0,0,846,718,846,718,twilight sparkle,peparonipizza
2189184.jpeg,https://derpicdn.net/img/view/2019/11/6/2189184.jpeg,0,0.980899453163147,424,90,2048,1836,1624,1746,twilight sparkle,ljdamz1119
2190224.jpeg,https://derpicdn.net/img/view/2019/11/8/2190224.jpeg,0,0.980136513710022,1985,160,3129,1304,1144,1144,twilight sparkle,smg11-on-ddjrb
2191029.jpeg,https://derpicdn.net/img/view/2019/11/9/2191029.jpeg,0,0.9781685471534728,181,87,1105,1011,924,924,twilight sparkle,tohupo
2191904.jpeg,https://derpicdn.net/img/view/2019/11/10/2191904.jpeg,0,0.9921855330467224,614,294,878,558,264,264,twilight sparkle,jucamovi1992
2191926.jpeg,https://derpicdn.net/img/view/2019/11/10/2191926.jpeg,0,0.994060218334198,118,0,412,285,294,285,twilight sparkle,mococo
2192352.jpeg,https://derpicdn.net/img/view/2019/11/10/2192352.jpeg,0,0.951577603816986,1316,309,2222,1215,906,906,twilight sparkle,mesuyoru
2192428.jpeg,https://derpicdn.net/img/view/2019/11/10/2192428.jpeg,0,0.987925946712494,198,276,1860,2094,1662,1818,twilight sparkle,kelniferion
2192778.jpeg,https://derpicdn.net/img/view/2019/11/11/2192778.jpeg,0,0.9360294342041016,428,79,732,383,304,304,twilight sparkle,airadyarhahs
2193392.jpeg,https://derpicdn.net/img/view/2019/11/11/2193392.jpeg,0,0.9973815083503724,1333,876,2255,1798,922,922,twilight sparkle,vilkadvanoli
2193392.jpeg,https://derpicdn.net/img/view/2019/11/11/2193392.jpeg,1,0.996712327003479,2285,736,3019,1470,734,734,twilight sparkle,vilkadvanoli
2193392.jpeg,https://derpicdn.net/img/view/2019/11/11/2193392.jpeg,3,0.9956110715866088,2440,0,3220,773,780,773,twilight sparkle,vilkadvanoli
2193392.jpeg,https://derpicdn.net/img/view/2019/11/11/2193392.jpeg,4,0.988962709903717,1616,12,2404,800,788,788,twilight sparkle,vilkadvanoli
2193423.jpeg,https://derpicdn.net/img/view/2019/11/11/2193423.jpeg,0,0.9901251792907716,1310,0,2036,693,726,693,twilight sparkle,vilkadvanoli
2193538.jpeg,https://derpicdn.net/img/view/2019/11/11/2193538.jpeg,0,0.9913127422332764,9,0,751,714,742,714,twilight sparkle,um89s
2193729.jpeg,https://derpicdn.net/img/view/2019/11/12/2193729.jpeg,0,0.9234380722045898,66,0,1160,720,1094,720,twilight sparkle,
2193811.jpeg,https://derpicdn.net/img/view/2019/11/12/2193811.jpeg,0,0.9242409467697144,473,0,1447,837,974,837,twilight sparkle,colorfulcolor233
2196339.jpeg,https://derpicdn.net/img/view/2019/11/15/2196339.jpeg,0,0.9976693987846376,396,304,1102,1010,706,706,twilight sparkle,bloodatius
2196385.jpeg,https://derpicdn.net/img/view/2019/11/15/2196385.jpeg,0,0.9436697959899902,209,110,1321,1222,1112,1112,twilight sparkle,moh_mlp2
2197511.jpeg,https://derpicdn.net/img/view/2019/11/16/2197511.jpeg,0,0.9889153838157654,197,12,729,544,532,532,twilight sparkle,tiroil
2197730.jpeg,https://derpicdn.net/img/view/2019/11/16/2197730.jpeg,0,0.9867014884948728,630,206,1144,720,514,514,twilight sparkle,zevironmoniroth
2198296.jpeg,https://derpicdn.net/img/view/2019/11/17/2198296.jpeg,0,0.9784590601921082,218,0,714,490,496,490,twilight sparkle,evergreen-gemdust
2198508.jpeg,https://derpicdn.net/img/view/2019/11/17/2198508.jpeg,0,0.938369631767273,163,0,1247,1035,1084,1035,twilight sparkle,tohupo
2199631.jpeg,https://derpicdn.net/img/view/2019/11/18/2199631.jpeg,0,0.9954349398612976,1546,29,1904,387,358,358,twilight sparkle,andrew hickinbottom
2200029.jpeg,https://derpicdn.net/img/view/2019/11/19/2200029.jpeg,0,0.9524183869361876,169,0,1467,975,1298,975,twilight sparkle,yinglongfujun
2200421.jpeg,https://derpicdn.net/img/view/2019/11/19/2200421.jpeg,0,0.9800558686256408,308,27,1544,1263,1236,1236,twilight sparkle,artmadebyred
2200441.jpeg,https://derpicdn.net/img/view/2019/11/19/2200441.jpeg,0,0.9876095056533812,1698,1180,2514,1996,816,816,twilight sparkle,ringteam
2200522.jpeg,https://derpicdn.net/img/view/2019/11/20/2200522.jpeg,0,0.9833274483680724,120,0,1096,789,976,789,twilight sparkle,reterica
2200524.jpeg,https://derpicdn.net/img/view/2019/11/20/2200524.jpeg,0,0.9297719597816468,16,33,1020,960,1004,927,twilight sparkle,reterica
2202314.jpeg,https://derpicdn.net/img/view/2019/11/21/2202314.jpeg,0,0.9858697056770324,0,40,722,762,722,722,twilight sparkle,drawsputin
2202412.jpeg,https://derpicdn.net/img/view/2019/11/22/2202412.jpeg,0,0.9949900507926941,1217,467,2673,1923,1456,1456,twilight sparkle,riocin765
2202960.jpeg,https://derpicdn.net/img/view/2019/11/22/2202960.jpeg,0,0.9640459418296814,146,92,894,840,748,748,twilight sparkle,musicfirewind
2203949.jpeg,https://derpicdn.net/img/view/2019/11/23/2203949.jpeg,0,0.9897191524505616,37,0,479,425,442,425,twilight sparkle,derrorro
2204151.jpeg,https://derpicdn.net/img/view/2019/11/24/2204151.jpeg,0,0.9840931296348572,516,238,2072,1794,1556,1556,twilight sparkle,thefloatingtree
2205367.jpeg,https://derpicdn.net/img/view/2019/11/25/2205367.jpeg,0,0.9747467637062072,1908,911,2198,1201,290,290,twilight sparkle,xander
2205398.jpeg,https://derpicdn.net/img/view/2019/11/25/2205398.jpeg,0,0.9745602011680604,72,0,1070,975,998,975,twilight sparkle,tohupo
2207248.jpeg,https://derpicdn.net/img/view/2019/11/27/2207248.jpeg,0,0.9902012348175048,122,88,806,772,684,684,twilight sparkle,yukkuripalehorse
2208205.jpeg,https://derpicdn.net/img/view/2019/11/29/2208205.jpeg,0,0.9883850812911988,2087,1096,3127,2136,1040,1040,twilight sparkle,darksly
2208205.jpeg,https://derpicdn.net/img/view/2019/11/29/2208205.jpeg,1,0.9597459435462952,1534,512,2418,1396,884,884,twilight sparkle,darksly
2209519.jpeg,https://derpicdn.net/img/view/2019/11/30/2209519.jpeg,0,0.9920192360877992,17,0,1057,1006,1040,1006,twilight sparkle,cutepencilcase
2211294.jpeg,https://derpicdn.net/img/view/2019/12/3/2211294.jpeg,0,0.9451199769973756,27,40,285,298,258,258,twilight sparkle,jj
2212715.jpeg,https://derpicdn.net/img/view/2019/12/5/2212715.jpeg,0,0.9938812255859376,491,0,1041,521,550,521,twilight sparkle,styroponyworks
2213095.jpeg,https://derpicdn.net/img/view/2019/12/5/2213095.jpeg,0,0.996394157409668,507,0,1447,928,940,928,twilight sparkle,newyorkx3
2215024.jpeg,https://derpicdn.net/img/view/2019/12/7/2215024.jpeg,0,0.9584239721298218,0,58,1001,1166,1001,1108,twilight sparkle,tohupo
2215287.jpeg,https://derpicdn.net/img/view/2019/12/7/2215287.jpeg,0,0.9951552748680116,120,104,646,630,526,526,twilight sparkle,milnaro
2215617.jpeg,https://derpicdn.net/img/view/2019/12/8/2215617.jpeg,0,0.9839504361152648,1384,0,2450,1035,1066,1035,twilight sparkle,seatbelt|seatbeltdraws
2215764.jpeg,https://derpicdn.net/img/view/2019/12/8/2215764.jpeg,0,0.9935235977172852,441,36,803,398,362,362,twilight sparkle,probablyfakeblonde
2216202.jpeg,https://derpicdn.net/img/view/2019/12/9/2216202.jpeg,0,0.9886557459831238,10,0,2344,2320,2334,2320,twilight sparkle,bloodatius
2217313.jpeg,https://derpicdn.net/img/view/2019/12/10/2217313.jpeg,0,0.927714467048645,141,0,675,485,534,485,twilight sparkle,yelowcrom
2218364.jpeg,https://derpicdn.net/img/view/2019/12/11/2218364.jpeg,0,0.9990907907485962,828,0,1336,461,508,461,twilight sparkle,akweer
2218898.jpeg,https://derpicdn.net/img/view/2019/12/12/2218898.jpeg,0,0.9605506658554076,0,0,876,885,876,885,twilight sparkle,tohupo
2220077.jpeg,https://derpicdn.net/img/view/2019/12/14/2220077.jpeg,0,0.9966189861297609,170,159,936,925,766,766,twilight sparkle,musicfirewind
2221326.jpeg,https://derpicdn.net/img/view/2019/12/15/2221326.jpeg,0,0.9879297018051147,459,565,1189,1295,730,730,twilight sparkle,rurihal
2221361.jpeg,https://derpicdn.net/img/view/2019/12/15/2221361.jpeg,0,0.985591471195221,611,103,1089,581,478,478,twilight sparkle,forgalorga
2221529.jpeg,https://derpicdn.net/img/view/2019/12/15/2221529.jpeg,1,0.958469033241272,1622,1460,2170,2008,548,548,twilight sparkle,jojohernandez
2221751.jpeg,https://derpicdn.net/img/view/2019/12/16/2221751.jpeg,0,0.9879411458969116,206,0,1890,1440,1684,1440,twilight sparkle,littleblackraencloud
2222721.jpeg,https://derpicdn.net/img/view/2019/12/17/2222721.jpeg,0,0.9008828401565552,364,63,954,653,590,590,twilight sparkle,stratodraw
2222888.jpeg,https://derpicdn.net/img/view/2019/12/17/2222888.jpeg,0,0.9736371040344238,76,0,436,352,360,352,twilight sparkle,colorfulcolor233
2222979.jpeg,https://derpicdn.net/img/view/2019/12/17/2222979.jpeg,0,0.9924175143241882,221,0,1377,1048,1156,1048,twilight sparkle,ejlightning007arts
2223795.jpeg,https://derpicdn.net/img/view/2019/12/18/2223795.jpeg,0,0.9838821887969972,27,7,369,349,342,342,twilight sparkle,
2224393.jpeg,https://derpicdn.net/img/view/2019/12/19/2224393.jpeg,0,0.9544934034347534,384,0,1540,1143,1156,1143,twilight sparkle,angusdra
2224859.jpeg,https://derpicdn.net/img/view/2019/12/20/2224859.jpeg,0,0.99473637342453,343,42,839,538,496,496,twilight sparkle,scarletskitty12
225676.jpeg,https://derpicdn.net/img/view/2013/1/27/225676.jpeg,0,0.9984803199768066,171,0,735,544,564,544,twilight sparkle,katiramoon
226169.jpeg,https://derpicdn.net/img/view/2013/1/28/226169.jpeg,0,0.9795014262199402,0,0,472,462,472,462,twilight sparkle,majorfreddy|wisdom-thumbs
228104.jpeg,https://derpicdn.net/img/view/2013/1/30/228104.jpeg,0,0.9313620328903198,29,103,321,395,292,292,twilight sparkle,hasana-chan
228815.jpeg,https://derpicdn.net/img/view/2013/1/31/228815.jpeg,0,0.9640641808509828,958,1254,1932,2228,974,974,twilight sparkle,colourbee
229157.jpeg,https://derpicdn.net/img/view/2013/1/31/229157.jpeg,0,0.9566099047660828,126,122,402,398,276,276,twilight sparkle,imanika
230041.jpeg,https://derpicdn.net/img/view/2013/2/1/230041.jpeg,0,0.9406067132949828,387,0,1219,799,832,799,twilight sparkle,sepla
230185.jpeg,https://derpicdn.net/img/view/2013/2/1/230185.jpeg,0,0.9690676927566528,201,0,498,268,297,268,twilight sparkle,rustybuckett
230346.jpeg,https://derpicdn.net/img/view/2013/2/1/230346.jpeg,0,0.9730250239372252,231,54,393,216,162,162,twilight sparkle,el-yeguero
230444.jpeg,https://derpicdn.net/img/view/2013/2/1/230444.jpeg,0,0.9752368927001952,43,46,523,526,480,480,twilight sparkle,dany-the-hell-fox
231499.jpeg,https://derpicdn.net/img/view/2013/2/2/231499.jpeg,0,0.9957036972045898,869,0,2667,1724,1798,1724,twilight sparkle,shinodage
231827.jpeg,https://derpicdn.net/img/view/2013/2/3/231827.jpeg,0,0.999222457408905,244,92,830,678,586,586,twilight sparkle,solar-slash
231987.jpeg,https://derpicdn.net/img/view/2013/2/3/231987.jpeg,0,0.9997426867485046,331,0,731,390,400,390,twilight sparkle,zonkpunch
235522.jpeg,https://derpicdn.net/img/view/2013/2/6/235522.jpeg,0,0.989374041557312,277,0,685,401,408,401,twilight sparkle,itsuko103
245326.jpeg,https://derpicdn.net/img/view/2013/2/16/245326.jpeg,0,0.9601098299026488,378,96,658,376,280,280,twilight sparkle,hinoraito
245498.jpeg,https://derpicdn.net/img/view/2013/2/16/245498.jpeg,0,0.9506688117980956,17,303,613,899,596,596,twilight sparkle,mysticalpha
246373.jpeg,https://derpicdn.net/img/view/2013/2/17/246373.jpeg,1,0.9866073727607728,509,0,985,401,476,401,twilight sparkle,devanstar
246373.jpeg,https://derpicdn.net/img/view/2013/2/17/246373.jpeg,2,0.9822816252708436,1523,782,1915,1174,392,392,twilight sparkle,devanstar
246847.jpeg,https://derpicdn.net/img/view/2013/2/17/246847.jpeg,0,0.907861590385437,91,0,991,860,900,860,twilight sparkle,nabe
247088.jpeg,https://derpicdn.net/img/view/2013/2/17/247088.jpeg,0,0.9478896260261536,473,34,899,460,426,426,twilight sparkle,laurenmagpie
247147.jpeg,https://derpicdn.net/img/view/2013/2/18/247147.jpeg,0,0.9032134413719176,87,112,347,372,260,260,twilight sparkle,starkindlerstudio
247451.jpeg,https://derpicdn.net/img/view/2013/2/18/247451.jpeg,0,0.9622217416763306,577,47,1773,1243,1196,1196,twilight sparkle,daughter-of-fantasy
247838.jpeg,https://derpicdn.net/img/view/2013/2/18/247838.jpeg,0,0.9751493334770204,291,119,907,735,616,616,twilight sparkle,wolfjedisamuel
247947.jpeg,https://derpicdn.net/img/view/2013/2/18/247947.jpeg,0,0.9925861358642578,0,0,681,597,681,597,twilight sparkle,solar-slash
248128.jpeg,https://derpicdn.net/img/view/2013/2/18/248128.jpeg,0,0.9913066029548644,449,1394,1223,2168,774,774,twilight sparkle,hattonslayden
249411.jpeg,https://derpicdn.net/img/view/2013/2/19/249411.jpeg,0,0.9452869892120358,282,0,819,545,537,545,twilight sparkle,derpiihooves
250213.jpeg,https://derpicdn.net/img/view/2013/2/20/250213.jpeg,0,0.9550156593322754,324,13,510,199,186,186,twilight sparkle,
253319.jpeg,https://derpicdn.net/img/view/2013/2/24/253319.jpeg,0,0.9560450315475464,129,56,385,312,256,256,twilight sparkle,pocki07
254011.jpeg,https://derpicdn.net/img/view/2013/2/24/254011.jpeg,0,0.9986294507980348,1040,0,2308,1263,1268,1263,twilight sparkle,hieronymuswhite
254204.jpeg,https://derpicdn.net/img/view/2013/2/24/254204.jpeg,0,0.9396448731422424,383,131,1677,1425,1294,1294,twilight sparkle,neroscottkennedy
258961.jpeg,https://derpicdn.net/img/view/2013/3/1/258961.jpeg,0,0.9412394165992736,369,199,639,469,270,270,twilight sparkle,malliya
262707.jpeg,https://derpicdn.net/img/view/2013/3/4/262707.jpeg,0,0.9799605011940002,764,104,1498,838,734,734,twilight sparkle,missyasylum
272240.jpeg,https://derpicdn.net/img/view/2013/3/16/272240.jpeg,0,0.989738702774048,80,17,376,313,296,296,twilight sparkle,trojan-pony
272657.jpeg,https://derpicdn.net/img/view/2013/3/17/272657.jpeg,0,0.9992358684539796,419,6,803,390,384,384,twilight sparkle,hasana-chan
275525.jpeg,https://derpicdn.net/img/view/2013/3/20/275525.jpeg,0,0.990746021270752,323,0,800,496,477,496,twilight sparkle,laurenmagpie
277292.jpeg,https://derpicdn.net/img/view/2013/3/23/277292.jpeg,0,0.9701279401779176,140,88,544,492,404,404,twilight sparkle,raikoh|edouard manet
279638.jpeg,https://derpicdn.net/img/view/2013/3/26/279638.jpeg,0,0.9021413922309875,170,0,458,276,288,276,twilight sparkle,foxenawolf
281524.jpeg,https://derpicdn.net/img/view/2013/3/28/281524.jpeg,0,0.9859356880187988,630,52,884,306,254,254,twilight sparkle,ponilaminator
281524.jpeg,https://derpicdn.net/img/view/2013/3/28/281524.jpeg,2,0.9385605454444884,10,205,208,403,198,198,twilight sparkle,ponilaminator
284755.jpeg,https://derpicdn.net/img/view/2013/4/1/284755.jpeg,0,0.9977226853370668,620,1308,1156,1844,536,536,twilight sparkle,jedieldaniel
284755.jpeg,https://derpicdn.net/img/view/2013/4/1/284755.jpeg,1,0.9857275485992432,516,2,1118,604,602,602,twilight sparkle,jedieldaniel
284843.jpeg,https://derpicdn.net/img/view/2013/4/1/284843.jpeg,0,0.9968751668930054,329,169,583,423,254,254,twilight sparkle,omny87
287016.jpeg,https://derpicdn.net/img/view/2013/4/3/287016.jpeg,0,0.9992407560348512,236,132,1338,1234,1102,1102,twilight sparkle,geminas0wng
287416.jpeg,https://derpicdn.net/img/view/2013/4/3/287416.jpeg,0,0.9731531143188475,0,0,951,940,951,940,twilight sparkle,dshou
294041.jpeg,https://derpicdn.net/img/view/2013/4/10/294041.jpeg,0,0.9961904883384703,559,403,755,599,196,196,twilight sparkle,rosieu|dutchgirl626
294041.jpeg,https://derpicdn.net/img/view/2013/4/10/294041.jpeg,1,0.9871996641159058,375,402,601,628,226,226,twilight sparkle,rosieu|dutchgirl626
294041.jpeg,https://derpicdn.net/img/view/2013/4/10/294041.jpeg,2,0.969762682914734,556,9,730,183,174,174,twilight sparkle,rosieu|dutchgirl626
297619.jpeg,https://derpicdn.net/img/view/2013/4/14/297619.jpeg,0,0.9974749088287354,320,129,832,641,512,512,twilight sparkle,surgicalarts
299391.jpeg,https://derpicdn.net/img/view/2013/4/15/299391.jpeg,0,0.9427708387374878,262,14,808,560,546,546,twilight sparkle,newyorkx3
299839.jpeg,https://derpicdn.net/img/view/2013/4/16/299839.jpeg,0,0.997708797454834,368,34,636,302,268,268,twilight sparkle,cow41087
300671.jpeg,https://derpicdn.net/img/view/2013/4/17/300671.jpeg,0,0.9928537011146544,0,21,262,293,262,272,twilight sparkle,kyle23emma
301655.jpeg,https://derpicdn.net/img/view/2013/4/18/301655.jpeg,0,0.998981773853302,1095,398,1465,768,370,370,twilight sparkle,shepherd0821
301655.jpeg,https://derpicdn.net/img/view/2013/4/18/301655.jpeg,1,0.99852454662323,833,284,1183,634,350,350,twilight sparkle,shepherd0821
301655.jpeg,https://derpicdn.net/img/view/2013/4/18/301655.jpeg,3,0.9128367900848388,532,190,850,508,318,318,twilight sparkle,shepherd0821
308489.jpeg,https://derpicdn.net/img/view/2013/4/26/308489.jpeg,0,0.9326659440994264,473,288,687,502,214,214,twilight sparkle,ichibangravity
317726.jpeg,https://derpicdn.net/img/view/2013/5/6/317726.jpeg,1,0.9232919812202454,180,0,1000,687,820,687,twilight sparkle,suirano
320461.jpeg,https://derpicdn.net/img/view/2013/5/9/320461.jpeg,0,0.9690507650375366,48,0,412,349,364,349,twilight sparkle,
324463.jpeg,https://derpicdn.net/img/view/2013/5/14/324463.jpeg,0,0.9988025426864624,267,96,645,474,378,378,twilight sparkle,strebiskunk
325727.jpeg,https://derpicdn.net/img/view/2013/5/15/325727.jpeg,0,0.9550113081932068,405,222,609,426,204,204,twilight sparkle,ichibangravity
331107.jpeg,https://derpicdn.net/img/view/2013/5/22/331107.jpeg,0,0.9840542078018188,287,202,525,440,238,238,twilight sparkle,harwick
332571.jpeg,https://derpicdn.net/img/view/2013/5/24/332571.jpeg,0,0.9786267280578612,426,8,824,406,398,398,twilight sparkle,si1vr
332846.jpeg,https://derpicdn.net/img/view/2013/5/24/332846.jpeg,0,0.9916685223579408,292,0,842,483,550,483,twilight sparkle,tsitra360
333053.jpeg,https://derpicdn.net/img/view/2013/5/25/333053.jpeg,0,0.9844586849212646,123,47,283,207,160,160,twilight sparkle,ethanqix
334017.jpeg,https://derpicdn.net/img/view/2013/5/26/334017.jpeg,0,0.9231454730033876,116,0,920,748,804,748,twilight sparkle,b---k
335524.jpeg,https://derpicdn.net/img/view/2013/5/28/335524.jpeg,0,0.9944535493850708,134,0,596,455,462,455,twilight sparkle,foxda
336706.jpeg,https://derpicdn.net/img/view/2013/5/30/336706.jpeg,0,0.9868809580802916,391,31,867,507,476,476,twilight sparkle,lizzyoli-ravioli
343382.jpeg,https://derpicdn.net/img/view/2013/6/8/343382.jpeg,0,0.9992009997367859,521,123,903,505,382,382,twilight sparkle,spacehunt
343848.jpeg,https://derpicdn.net/img/view/2013/6/9/343848.jpeg,0,0.9901573061943054,204,0,1548,1308,1344,1308,twilight sparkle,iokusanagi
345608.jpeg,https://derpicdn.net/img/view/2013/6/11/345608.jpeg,0,0.9990195035934448,325,9,629,313,304,304,twilight sparkle,plankboy
345608.jpeg,https://derpicdn.net/img/view/2013/6/11/345608.jpeg,1,0.959033727645874,88,3,396,311,308,308,twilight sparkle,plankboy
346927.jpeg,https://derpicdn.net/img/view/2013/6/12/346927.jpeg,0,0.9947803616523744,238,157,486,405,248,248,twilight sparkle,bakki
350688.jpeg,https://derpicdn.net/img/view/2013/6/17/350688.jpeg,0,0.9958072900772096,535,1,867,333,332,332,twilight sparkle,pippy
350688.jpeg,https://derpicdn.net/img/view/2013/6/17/350688.jpeg,1,0.9936729073524476,458,553,840,935,382,382,twilight sparkle,pippy
351186.jpeg,https://derpicdn.net/img/view/2013/6/18/351186.jpeg,0,0.9433359503746032,482,137,1660,1315,1178,1178,twilight sparkle,romaniz
352892.jpeg,https://derpicdn.net/img/view/2013/6/20/352892.jpeg,0,0.9968087673187256,136,90,360,314,224,224,twilight sparkle,jayelle-anderson
356040.jpeg,https://derpicdn.net/img/view/2013/6/24/356040.jpeg,0,0.9796808958053588,220,30,426,236,206,206,twilight sparkle,odiz
357683.jpeg,https://derpicdn.net/img/view/2013/6/26/357683.jpeg,0,0.9986838102340698,493,0,1129,597,636,597,twilight sparkle,igriega13
360602.jpeg,https://derpicdn.net/img/view/2013/6/30/360602.jpeg,0,0.9328526258468628,47,0,515,420,468,420,twilight sparkle,hobby
364013.jpeg,https://derpicdn.net/img/view/2013/7/4/364013.jpeg,0,0.9828590154647828,11,33,363,385,352,352,twilight sparkle,xwhitex77
364291.jpeg,https://derpicdn.net/img/view/2013/7/4/364291.jpeg,0,0.9590575098991394,345,73,1015,743,670,670,twilight sparkle,mirapony
364567.jpeg,https://derpicdn.net/img/view/2013/7/4/364567.jpeg,0,0.96948903799057,64,0,498,418,434,418,twilight sparkle,shepherd0821
367828.jpeg,https://derpicdn.net/img/view/2013/7/9/367828.jpeg,0,0.9970874786376952,306,0,1014,644,708,644,twilight sparkle,ss2sonic
367828.jpeg,https://derpicdn.net/img/view/2013/7/9/367828.jpeg,1,0.993637204170227,1002,257,1710,965,708,708,twilight sparkle,ss2sonic
368231.jpeg,https://derpicdn.net/img/view/2013/7/9/368231.jpeg,0,0.9806895852088928,38,0,434,373,396,373,twilight sparkle,bluntwhiskey
370411.jpeg,https://derpicdn.net/img/view/2013/7/11/370411.jpeg,0,0.9159942865371704,110,143,454,487,344,344,twilight sparkle,rubypm|blood-soaked
377384.jpeg,https://derpicdn.net/img/view/2013/7/18/377384.jpeg,0,0.9931313991546632,345,31,691,377,346,346,twilight sparkle,shepherd0821
390956.jpeg,https://derpicdn.net/img/view/2013/8/4/390956.jpeg,0,0.9629226326942444,22,12,416,406,394,394,twilight sparkle,catsandcoffins
393840.jpeg,https://derpicdn.net/img/view/2013/8/7/393840.jpeg,0,0.9149665832519532,1178,0,3200,1847,2022,1847,twilight sparkle,viwrastupr
400845.jpeg,https://derpicdn.net/img/view/2013/8/15/400845.jpeg,0,0.9418993592262268,357,219,571,433,214,214,twilight sparkle,uotapo
403504.jpeg,https://derpicdn.net/img/view/2013/8/18/403504.jpeg,0,0.9892290830612184,2,16,948,962,946,946,twilight sparkle,neodokuro
406714.jpeg,https://derpicdn.net/img/view/2013/8/22/406714.jpeg,0,0.9909304976463318,177,217,453,493,276,276,twilight sparkle,advanceddefense
409194.jpeg,https://derpicdn.net/img/view/2013/8/24/409194.jpeg,0,0.9803606271743774,1191,172,1593,574,402,402,twilight sparkle,kp-shadowsquirrel
410897.jpeg,https://derpicdn.net/img/view/2013/8/26/410897.jpeg,0,0.9473513960838318,1032,37,1720,725,688,688,twilight sparkle,raikoh
412148.jpeg,https://derpicdn.net/img/view/2013/8/27/412148.jpeg,0,0.9549369215965272,447,314,871,738,424,424,twilight sparkle,whatsapokemon
413326.jpeg,https://derpicdn.net/img/view/2013/8/29/413326.jpeg,0,0.995333194732666,91,0,577,469,486,469,twilight sparkle,raikoh
415016.jpeg,https://derpicdn.net/img/view/2013/8/31/415016.jpeg,0,0.9874275326728821,12,0,518,504,506,504,twilight sparkle,morits
422712.jpeg,https://derpicdn.net/img/view/2013/9/8/422712.jpeg,0,0.9848824739456176,131,99,529,497,398,398,twilight sparkle,suirano
424390.jpeg,https://derpicdn.net/img/view/2013/9/10/424390.jpeg,0,0.949053943157196,190,211,852,873,662,662,twilight sparkle,camaine
426203.jpeg,https://derpicdn.net/img/view/2013/9/12/426203.jpeg,0,0.9929937720298768,409,62,845,498,436,436,twilight sparkle,locksto
430021.jpeg,https://derpicdn.net/img/view/2013/9/18/430021.jpeg,0,0.9957752227783204,337,300,637,600,300,300,twilight sparkle,ruhje
430806.jpeg,https://derpicdn.net/img/view/2013/9/19/430806.jpeg,0,0.9991273880004884,669,0,1579,867,910,867,twilight sparkle,mysticalpha
431684.jpeg,https://derpicdn.net/img/view/2013/9/21/431684.jpeg,0,0.9968708753585817,85,18,307,240,222,222,twilight sparkle,kairean
434489.jpeg,https://derpicdn.net/img/view/2013/9/25/434489.jpeg,0,0.999178111553192,184,0,630,443,446,443,twilight sparkle,skyraptor
443218.jpeg,https://derpicdn.net/img/view/2013/10/6/443218.jpeg,0,0.9960771203041076,861,1537,1471,2147,610,610,twilight sparkle,jowybean
445986.jpeg,https://derpicdn.net/img/view/2013/10/11/445986.jpeg,0,0.9005386829376221,515,350,967,802,452,452,twilight sparkle,leffenkitty
446882.jpeg,https://derpicdn.net/img/view/2013/10/12/446882.jpeg,0,0.9820272922515868,125,0,475,333,350,333,twilight sparkle,negativefox
447826.jpeg,https://derpicdn.net/img/view/2013/10/13/447826.jpeg,0,0.9779965877532959,404,37,744,377,340,340,twilight sparkle,veritasket
454903.jpeg,https://derpicdn.net/img/view/2013/10/23/454903.jpeg,0,0.9933252334594728,276,0,964,659,688,659,twilight sparkle,joakaha
456779.jpeg,https://derpicdn.net/img/view/2013/10/26/456779.jpeg,0,0.9807751178741456,55,0,597,490,542,490,twilight sparkle,yukandasama
457179.jpeg,https://derpicdn.net/img/view/2013/10/26/457179.jpeg,0,0.9928194880485536,0,0,270,239,270,239,twilight sparkle,bakki
457179.jpeg,https://derpicdn.net/img/view/2013/10/26/457179.jpeg,1,0.9602715969085692,274,0,550,269,276,269,twilight sparkle,bakki
458253.jpeg,https://derpicdn.net/img/view/2013/10/28/458253.jpeg,0,0.9748151302337646,3,19,507,523,504,504,twilight sparkle,jinzhan
462460.jpeg,https://derpicdn.net/img/view/2013/11/2/462460.jpeg,0,0.9916724562644958,81,0,489,372,408,372,twilight sparkle,earthsong9405
462942.jpeg,https://derpicdn.net/img/view/2013/11/2/462942.jpeg,0,0.9996463060379028,213,0,659,437,446,437,twilight sparkle,fuzon-s
464046.jpeg,https://derpicdn.net/img/view/2013/11/4/464046.jpeg,0,0.961747407913208,353,126,551,324,198,198,twilight sparkle,art-2u
473553.jpeg,https://derpicdn.net/img/view/2013/11/16/473553.jpeg,0,0.9976293444633484,732,58,1532,858,800,800,twilight sparkle,balloons504
474510.jpeg,https://derpicdn.net/img/view/2013/11/17/474510.jpeg,0,0.9971592426300048,328,0,674,333,346,333,twilight sparkle,thatamystalker
476897.jpeg,https://derpicdn.net/img/view/2013/11/20/476897.jpeg,0,0.939369022846222,275,149,673,547,398,398,twilight sparkle,bakki
479334.jpeg,https://derpicdn.net/img/view/2013/11/23/479334.jpeg,0,0.9851178526878356,0,0,399,416,399,416,twilight sparkle,raikoh
479751.jpeg,https://derpicdn.net/img/view/2013/11/24/479751.jpeg,0,0.9207636713981628,183,45,415,277,232,232,twilight sparkle,scorpdk
480131.jpeg,https://derpicdn.net/img/view/2013/11/24/480131.jpeg,0,0.9737154841423036,278,16,932,670,654,654,twilight sparkle,onicka12
483684.jpeg,https://derpicdn.net/img/view/2013/11/27/483684.jpeg,0,0.9809408187866212,624,324,1118,818,494,494,twilight sparkle,asimos
483829.jpeg,https://derpicdn.net/img/view/2013/11/28/483829.jpeg,0,0.9913744330406188,534,57,1668,1191,1134,1134,twilight sparkle,derpiliciouspony
484155.jpeg,https://derpicdn.net/img/view/2013/11/28/484155.jpeg,0,0.990792751312256,220,257,558,595,338,338,twilight sparkle,cyneko
485262.jpeg,https://derpicdn.net/img/view/2013/11/29/485262.jpeg,0,0.98986154794693,239,83,847,691,608,608,twilight sparkle,xcopyen002
488437.jpeg,https://derpicdn.net/img/view/2013/12/3/488437.jpeg,0,0.9972227811813354,325,42,823,540,498,498,twilight sparkle,lizzyoli-ravioli
491356.jpeg,https://derpicdn.net/img/view/2013/12/7/491356.jpeg,0,0.98179429769516,638,607,796,765,158,158,twilight sparkle,malwinters
491356.jpeg,https://derpicdn.net/img/view/2013/12/7/491356.jpeg,1,0.9289793372154236,0,145,691,869,691,724,twilight sparkle,malwinters
495609.jpeg,https://derpicdn.net/img/view/2013/12/12/495609.jpeg,0,0.9485610127449036,511,0,1943,1353,1432,1353,twilight sparkle,mistydash
499706.jpeg,https://derpicdn.net/img/view/2013/12/17/499706.jpeg,0,0.9602938890457152,19,0,341,320,322,320,twilight sparkle,lizombie
500026.jpeg,https://derpicdn.net/img/view/2013/12/18/500026.jpeg,0,0.9762374758720398,138,71,802,735,664,664,twilight sparkle,
501050.jpeg,https://derpicdn.net/img/view/2013/12/19/501050.jpeg,0,0.9858899116516112,529,0,869,318,340,318,twilight sparkle,greeny-nyte
501781.jpeg,https://derpicdn.net/img/view/2013/12/20/501781.jpeg,1,0.9206392168998718,734,1132,1600,1998,866,866,twilight sparkle,gsphere
507767.jpeg,https://derpicdn.net/img/view/2013/12/27/507767.jpeg,0,0.9971209168434144,763,125,1831,1193,1068,1068,twilight sparkle,otakuap
509126.jpeg,https://derpicdn.net/img/view/2013/12/29/509126.jpeg,0,0.9419984817504884,329,0,848,464,519,464,twilight sparkle,
511226.jpeg,https://derpicdn.net/img/view/2013/12/31/511226.jpeg,0,0.9554677605628968,81,38,507,464,426,426,twilight sparkle,ichibangravity
513945.jpeg,https://derpicdn.net/img/view/2014/1/3/513945.jpeg,0,0.9964377284049988,1196,236,1654,694,458,458,twilight sparkle,cyanaeolin
518360.jpeg,https://derpicdn.net/img/view/2014/1/8/518360.jpeg,1,0.9647460579872132,378,38,706,366,328,328,twilight sparkle,ellamred
522684.jpeg,https://derpicdn.net/img/view/2014/1/12/522684.jpeg,0,0.9926161766052246,729,227,1631,1129,902,902,twilight sparkle,otakuap
524319.jpeg,https://derpicdn.net/img/view/2014/1/14/524319.jpeg,0,0.904859721660614,306,196,680,570,374,374,twilight sparkle,bluespaceling
524656.jpeg,https://derpicdn.net/img/view/2014/1/15/524656.jpeg,0,0.99532151222229,1565,400,2701,1568,1136,1168,twilight sparkle,carligercarl
534080.jpeg,https://derpicdn.net/img/view/2014/1/25/534080.jpeg,1,0.9690625071525574,92,14,359,294,267,280,twilight sparkle,
539462.jpeg,https://derpicdn.net/img/view/2014/1/31/539462.jpeg,0,0.9655741453170776,240,7,576,343,336,336,twilight sparkle,suirano
539525.jpeg,https://derpicdn.net/img/view/2014/1/31/539525.jpeg,0,0.9954586029052734,787,205,1315,733,528,528,twilight sparkle,blacksunarmada1993
540008.jpeg,https://derpicdn.net/img/view/2014/2/1/540008.jpeg,0,0.9911622405052184,284,0,946,648,662,648,twilight sparkle,blacksunarmada1993
544251.jpeg,https://derpicdn.net/img/view/2014/2/5/544251.jpeg,0,0.9990039467811584,257,384,537,664,280,280,twilight sparkle,grasspainter
544826.jpeg,https://derpicdn.net/img/view/2014/2/6/544826.jpeg,0,0.9359657764434814,1402,1030,1960,1588,558,558,twilight sparkle,kianamai
545075.jpeg,https://derpicdn.net/img/view/2014/2/6/545075.jpeg,0,0.9998366832733154,145,56,519,430,374,374,twilight sparkle,lyllisa
545105.jpeg,https://derpicdn.net/img/view/2014/2/6/545105.jpeg,0,0.9976654648780824,677,137,1543,1003,866,866,twilight sparkle,mysticalpha
552244.jpeg,https://derpicdn.net/img/view/2014/2/15/552244.jpeg,0,0.9979771375656128,238,0,512,268,274,268,twilight sparkle,stigma-photon
556763.jpeg,https://derpicdn.net/img/view/2014/2/20/556763.jpeg,0,0.9984279274940492,889,359,1753,1223,864,864,twilight sparkle,kelisah
557474.jpeg,https://derpicdn.net/img/view/2014/2/20/557474.jpeg,0,0.9842348098754884,344,0,908,528,564,528,twilight sparkle,futaku
564118.jpeg,https://derpicdn.net/img/view/2014/3/1/564118.jpeg,0,0.9783964157104492,172,36,600,464,428,428,twilight sparkle,sharpieboss
565309.jpeg,https://derpicdn.net/img/view/2014/3/2/565309.jpeg,0,0.9910890460014344,325,0,1365,956,1040,956,twilight sparkle,bubble kitten17
570695.jpeg,https://derpicdn.net/img/view/2014/3/9/570695.jpeg,0,0.9869807958602904,67,192,433,558,366,366,twilight sparkle,artsymaria
573429.jpeg,https://derpicdn.net/img/view/2014/3/12/573429.jpeg,0,0.9806510210037231,378,106,1110,838,732,732,twilight sparkle,carligercarl
573450.jpeg,https://derpicdn.net/img/view/2014/3/12/573450.jpeg,0,0.999471127986908,215,0,627,387,412,387,twilight sparkle,crade
575372.jpeg,https://derpicdn.net/img/view/2014/3/15/575372.jpeg,0,0.9216898083686828,705,420,1253,968,548,548,twilight sparkle,ostichristian
582747.jpeg,https://derpicdn.net/img/view/2014/3/23/582747.jpeg,0,0.931890606880188,142,4,868,730,726,726,twilight sparkle,vocalmaker|grendeleev
585009.jpeg,https://derpicdn.net/img/view/2014/3/25/585009.jpeg,0,0.9991143941879272,352,198,892,738,540,540,twilight sparkle,joycall6
586765.jpeg,https://derpicdn.net/img/view/2014/3/28/586765.jpeg,0,0.9525807499885559,231,25,975,769,744,744,twilight sparkle,cruelladevil84
587164.jpeg,https://derpicdn.net/img/view/2014/3/28/587164.jpeg,0,0.998308002948761,273,32,875,634,602,602,twilight sparkle,joycall6
591460.jpeg,https://derpicdn.net/img/view/2014/4/3/591460.jpeg,0,0.9407949447631836,161,0,781,542,620,542,twilight sparkle,garlandgala
591527.jpeg,https://derpicdn.net/img/view/2014/4/3/591527.jpeg,0,0.9921776056289672,237,45,657,465,420,420,twilight sparkle,frozenpyro71
595228.jpeg,https://derpicdn.net/img/view/2014/4/7/595228.jpeg,0,0.9384177923202516,286,136,486,336,200,200,twilight sparkle,nairondragon
597556.jpeg,https://derpicdn.net/img/view/2014/4/11/597556.jpeg,0,0.9810230135917664,881,0,2241,1328,1360,1328,twilight sparkle,xwhitedreamsx
598239.jpeg,https://derpicdn.net/img/view/2014/4/12/598239.jpeg,0,0.9888733625411988,1873,195,2631,953,758,758,twilight sparkle,bludraconoid
602925.jpeg,https://derpicdn.net/img/view/2014/4/17/602925.jpeg,0,0.9767168760299684,127,0,2362,2265,2235,2265,twilight sparkle,pitchyy
603317.jpeg,https://derpicdn.net/img/view/2014/4/18/603317.jpeg,0,0.9982706904411316,244,1,766,523,522,522,twilight sparkle,lil miss jay
609349.jpeg,https://derpicdn.net/img/view/2014/4/25/609349.jpeg,0,0.9993679523468018,176,0,1130,846,954,846,twilight sparkle,theparagon
609349.jpeg,https://derpicdn.net/img/view/2014/4/25/609349.jpeg,1,0.9773545861244202,1613,12,2427,826,814,814,twilight sparkle,theparagon
610576.jpeg,https://derpicdn.net/img/view/2014/4/26/610576.jpeg,0,0.9831224679946899,66,4,490,428,424,424,twilight sparkle,ichibangravity
613315.jpeg,https://derpicdn.net/img/view/2014/4/29/613315.jpeg,0,0.9912062287330629,100,80,386,366,286,286,twilight sparkle,sticky-plaster
615526.jpeg,https://derpicdn.net/img/view/2014/5/2/615526.jpeg,0,0.9967478513717652,296,57,860,621,564,564,twilight sparkle,joycall6
616570.jpeg,https://derpicdn.net/img/view/2014/5/3/616570.jpeg,0,0.98217111825943,212,11,504,303,292,292,twilight sparkle,lazysstorm
616933.jpeg,https://derpicdn.net/img/view/2014/5/3/616933.jpeg,0,0.9981522560119628,152,0,522,306,370,306,twilight sparkle,pornomagnum
617026.jpeg,https://derpicdn.net/img/view/2014/5/4/617026.jpeg,0,0.927998960018158,362,368,598,604,236,236,twilight sparkle,dragonfoxgirl
617523.jpeg,https://derpicdn.net/img/view/2014/5/4/617523.jpeg,0,0.9973639249801636,53,67,405,419,352,352,twilight sparkle,yulyeen
617523.jpeg,https://derpicdn.net/img/view/2014/5/4/617523.jpeg,1,0.989468276500702,373,155,693,475,320,320,twilight sparkle,yulyeen
621929.jpeg,https://derpicdn.net/img/view/2014/5/9/621929.jpeg,0,0.9949134588241576,117,74,549,506,432,432,twilight sparkle,joakaha
621962.jpeg,https://derpicdn.net/img/view/2014/5/10/621962.jpeg,0,0.9995130300521852,416,261,652,497,236,236,twilight sparkle,thecreator9
622396.jpeg,https://derpicdn.net/img/view/2014/5/10/622396.jpeg,0,0.9181237816810608,614,123,2230,1739,1616,1616,twilight sparkle,otakuap
624256.jpeg,https://derpicdn.net/img/view/2014/5/11/624256.jpeg,0,0.9869909286499025,336,426,1066,1156,730,730,twilight sparkle,vombavr
624834.jpeg,https://derpicdn.net/img/view/2014/5/12/624834.jpeg,0,0.9861246943473816,234,0,800,548,566,548,twilight sparkle,je-lly
625614.jpeg,https://derpicdn.net/img/view/2014/5/13/625614.jpeg,0,0.9534117579460144,1770,335,2844,1409,1074,1074,twilight sparkle,otakuap
626689.jpeg,https://derpicdn.net/img/view/2014/5/14/626689.jpeg,0,0.9594010710716248,448,3,1245,961,797,958,twilight sparkle,zodiacnicola
628790.jpeg,https://derpicdn.net/img/view/2014/5/17/628790.jpeg,0,0.9991890788078308,363,138,511,286,148,148,twilight sparkle,choedan-kal
630719.jpeg,https://derpicdn.net/img/view/2014/5/19/630719.jpeg,0,0.9960917234420776,470,156,735,428,265,272,twilight sparkle,hazurasinner
630961.jpeg,https://derpicdn.net/img/view/2014/5/19/630961.jpeg,0,0.9943503141403198,413,227,717,531,304,304,twilight sparkle,scruffytoto
632320.jpeg,https://derpicdn.net/img/view/2014/5/20/632320.jpeg,0,0.995059609413147,638,168,1580,1110,942,942,twilight sparkle,fur-what-loo
633047.jpeg,https://derpicdn.net/img/view/2014/5/21/633047.jpeg,0,0.9449968934059144,86,0,952,700,866,700,twilight sparkle,mr-samson
635686.jpeg,https://derpicdn.net/img/view/2014/5/24/635686.jpeg,0,0.9941572546958924,255,21,691,457,436,436,twilight sparkle,joycall6
637578.jpeg,https://derpicdn.net/img/view/2014/5/26/637578.jpeg,0,0.9803699254989624,18,7,340,329,322,322,twilight sparkle,kounyoukai
638375.jpeg,https://derpicdn.net/img/view/2014/5/27/638375.jpeg,0,0.9821081757545472,284,77,796,589,512,512,twilight sparkle,joycall6
640489.jpeg,https://derpicdn.net/img/view/2014/5/30/640489.jpeg,0,0.995435893535614,322,0,596,268,274,268,twilight sparkle,collinscorpio
640619.jpeg,https://derpicdn.net/img/view/2014/5/30/640619.jpeg,0,0.9995720982551576,385,0,1011,496,626,496,twilight sparkle,lightningflame
640622.jpeg,https://derpicdn.net/img/view/2014/5/30/640622.jpeg,0,0.9238877892494202,148,14,500,366,352,352,twilight sparkle,lightningflame
645132.jpeg,https://derpicdn.net/img/view/2014/6/4/645132.jpeg,0,0.9956527948379515,121,0,497,343,376,343,twilight sparkle,mistydash
646380.jpeg,https://derpicdn.net/img/view/2014/6/6/646380.jpeg,0,0.9991556406021118,491,24,855,388,364,364,twilight sparkle,ss2sonic
648341.jpeg,https://derpicdn.net/img/view/2014/6/8/648341.jpeg,0,0.9316831827163696,0,70,638,734,638,664,twilight sparkle,newyorkx3
649370.jpeg,https://derpicdn.net/img/view/2014/6/10/649370.jpeg,0,0.9802512526512146,0,0,1572,1570,1572,1570,twilight sparkle,xwhitedreamsx
656757.jpeg,https://derpicdn.net/img/view/2014/6/19/656757.jpeg,0,0.9912509322166444,111,27,653,569,542,542,twilight sparkle,eternyan|yukomaussi|vardastouch
658727.jpeg,https://derpicdn.net/img/view/2014/6/22/658727.jpeg,0,0.9827985763549804,543,523,1337,1317,794,794,twilight sparkle,the-revered-dragon
658729.jpeg,https://derpicdn.net/img/view/2014/6/22/658729.jpeg,0,0.9934731125831604,2,40,744,782,742,742,twilight sparkle,tonyfleecs
660917.jpeg,https://derpicdn.net/img/view/2014/6/25/660917.jpeg,0,0.9491959810256958,14,0,172,151,158,151,twilight sparkle,whazzam95
661813.jpeg,https://derpicdn.net/img/view/2014/6/26/661813.jpeg,0,0.9987157583236694,210,592,820,1202,610,610,twilight sparkle,audrarius
661813.jpeg,https://derpicdn.net/img/view/2014/6/26/661813.jpeg,1,0.9978072643280028,34,882,426,1274,392,392,twilight sparkle,audrarius
661813.jpeg,https://derpicdn.net/img/view/2014/6/26/661813.jpeg,2,0.9977160692214966,885,303,1545,963,660,660,twilight sparkle,audrarius
661813.jpeg,https://derpicdn.net/img/view/2014/6/26/661813.jpeg,4,0.9733360409736632,633,769,1161,1297,528,528,twilight sparkle,audrarius
664184.jpeg,https://derpicdn.net/img/view/2014/6/29/664184.jpeg,0,0.9891734719276428,319,0,885,543,566,543,twilight sparkle,iluvhalo
667399.jpeg,https://derpicdn.net/img/view/2014/7/4/667399.jpeg,0,0.9973657131195068,708,246,1062,600,354,354,twilight sparkle,joycall6
667831.jpeg,https://derpicdn.net/img/view/2014/7/5/667831.jpeg,0,0.9730110168457032,145,0,1027,822,882,822,twilight sparkle,wrenhat
670643.jpeg,https://derpicdn.net/img/view/2014/7/8/670643.jpeg,0,0.9950639009475708,211,0,597,358,386,358,twilight sparkle,cannibalus
671235.jpeg,https://derpicdn.net/img/view/2014/7/9/671235.jpeg,0,0.9952459931373596,600,0,1628,855,1028,855,twilight sparkle,mysticalpha
671310.jpeg,https://derpicdn.net/img/view/2014/7/9/671310.jpeg,0,0.9888156652450562,120,6,676,562,556,556,twilight sparkle,dclzexon
672420.jpeg,https://derpicdn.net/img/view/2014/7/11/672420.jpeg,0,0.9976340532302856,170,110,420,360,250,250,twilight sparkle,stigma-photon
675002.jpeg,https://derpicdn.net/img/view/2014/7/14/675002.jpeg,0,0.9050586223602296,566,253,772,459,206,206,twilight sparkle,tarantad0
675093.jpeg,https://derpicdn.net/img/view/2014/7/15/675093.jpeg,0,0.9413750767707824,851,0,1627,631,776,631,twilight sparkle,yoksaharat
676718.jpeg,https://derpicdn.net/img/view/2014/7/17/676718.jpeg,0,0.9981046319007874,149,0,1199,1002,1050,1002,twilight sparkle,bluespaceling
678555.jpeg,https://derpicdn.net/img/view/2014/7/19/678555.jpeg,0,0.9945288896560668,370,61,2162,1853,1792,1792,twilight sparkle,neekophobia
680509.jpeg,https://derpicdn.net/img/view/2014/7/22/680509.jpeg,0,0.9963176250457764,425,77,935,587,510,510,twilight sparkle,hieronymuswhite
680676.jpeg,https://derpicdn.net/img/view/2014/7/22/680676.jpeg,0,0.9847537279129028,37,0,697,623,660,623,twilight sparkle,dawkinsia
680918.jpeg,https://derpicdn.net/img/view/2014/7/22/680918.jpeg,0,0.9709138274192808,82,134,350,402,268,268,twilight sparkle,rarityforever
680963.jpeg,https://derpicdn.net/img/view/2014/7/22/680963.jpeg,0,0.9969072341918944,129,35,641,547,512,512,twilight sparkle,begomiku
681647.jpeg,https://derpicdn.net/img/view/2014/7/23/681647.jpeg,0,0.9346069097518921,977,348,1163,534,186,186,twilight sparkle,viwrastupr
682349.jpeg,https://derpicdn.net/img/view/2014/7/24/682349.jpeg,0,0.9962002038955688,408,62,1522,1176,1114,1114,twilight sparkle,danmakuman|xwhitedreamsx
682701.jpeg,https://derpicdn.net/img/view/2014/7/25/682701.jpeg,0,0.9970501065254213,500,58,1362,920,862,862,twilight sparkle,kianamai
683593.jpeg,https://derpicdn.net/img/view/2014/7/26/683593.jpeg,0,0.9952505826950072,346,133,646,433,300,300,twilight sparkle,tonyfleecs
685230.jpeg,https://derpicdn.net/img/view/2014/7/28/685230.jpeg,0,0.9611374735832214,130,22,834,726,704,704,twilight sparkle,coldbest
685504.jpeg,https://derpicdn.net/img/view/2014/7/28/685504.jpeg,0,0.9925144910812378,252,48,644,440,392,392,twilight sparkle,joycall6
687045.jpeg,https://derpicdn.net/img/view/2014/7/30/687045.jpeg,0,0.9990804195404052,557,139,1703,1285,1146,1146,twilight sparkle,anonopony
687046.jpeg,https://derpicdn.net/img/view/2014/7/30/687046.jpeg,0,0.9867013096809388,868,0,1652,774,784,774,twilight sparkle,anonopony
688513.jpeg,https://derpicdn.net/img/view/2014/8/1/688513.jpeg,0,0.9196920990943908,1023,42,1451,470,428,428,twilight sparkle,luximus17
688615.jpeg,https://derpicdn.net/img/view/2014/8/1/688615.jpeg,0,0.99834007024765,666,123,1628,1085,962,962,twilight sparkle,xwhitedreamsx
689336.jpeg,https://derpicdn.net/img/view/2014/8/2/689336.jpeg,0,0.9931836724281312,298,164,996,862,698,698,twilight sparkle,mrs1989
695564.jpeg,https://derpicdn.net/img/view/2014/8/9/695564.jpeg,0,0.9723078608512878,255,58,629,432,374,374,twilight sparkle,aidmoon
695668.jpeg,https://derpicdn.net/img/view/2014/8/9/695668.jpeg,0,0.9995989203453064,112,5,402,295,290,290,twilight sparkle,caldark
695913.jpeg,https://derpicdn.net/img/view/2014/8/9/695913.jpeg,0,0.9986910820007324,471,245,1145,919,674,674,twilight sparkle,ncmares
698313.jpeg,https://derpicdn.net/img/view/2014/8/13/698313.jpeg,0,0.9161118268966676,133,6,453,326,320,320,twilight sparkle,ranban
698340.jpeg,https://derpicdn.net/img/view/2014/8/13/698340.jpeg,0,0.9850149154663086,889,0,2095,1199,1206,1199,twilight sparkle,mrbrunoh1
701487.jpeg,https://derpicdn.net/img/view/2014/8/17/701487.jpeg,1,0.9927353858947754,300,219,594,513,294,294,twilight sparkle,bluntwhiskey
706647.jpeg,https://derpicdn.net/img/view/2014/8/24/706647.jpeg,0,0.9925186634063721,377,48,869,540,492,492,twilight sparkle,erysz
710054.jpeg,https://derpicdn.net/img/view/2014/8/28/710054.jpeg,0,0.9916471838951112,344,7,1430,1093,1086,1086,twilight sparkle,nekojackun
711474.jpeg,https://derpicdn.net/img/view/2014/8/30/711474.jpeg,0,0.9589157104492188,221,62,539,380,318,318,twilight sparkle,drawing-heart
711877.jpeg,https://derpicdn.net/img/view/2014/8/31/711877.jpeg,0,0.9855615496635436,48,21,664,637,616,616,twilight sparkle,joycall6
716239.jpeg,https://derpicdn.net/img/view/2014/9/6/716239.jpeg,0,0.9794336557388306,120,0,1090,918,970,918,twilight sparkle,rariedash
720550.jpeg,https://derpicdn.net/img/view/2014/9/12/720550.jpeg,0,0.9982605576515198,149,76,571,498,422,422,twilight sparkle,skaiah
726241.jpeg,https://derpicdn.net/img/view/2014/9/21/726241.jpeg,0,0.9921092987060548,262,241,632,611,370,370,twilight sparkle,fensu-san
726816.jpeg,https://derpicdn.net/img/view/2014/9/21/726816.jpeg,0,0.9925378561019896,547,46,1449,948,902,902,twilight sparkle,xwhitedreamsx
726917.jpeg,https://derpicdn.net/img/view/2014/9/21/726917.jpeg,0,0.9957354664802552,440,0,868,374,428,374,twilight sparkle,bluefeathercat
727516.jpeg,https://derpicdn.net/img/view/2014/9/22/727516.jpeg,0,0.940028727054596,20,0,358,266,338,266,twilight sparkle,meb90
731336.jpeg,https://derpicdn.net/img/view/2014/9/28/731336.jpeg,0,0.9052443504333496,0,0,800,894,800,894,twilight sparkle,joycall6
734086.jpeg,https://derpicdn.net/img/view/2014/10/2/734086.jpeg,0,0.9124228954315186,528,0,1360,624,832,624,twilight sparkle,dream--chan
738903.jpeg,https://derpicdn.net/img/view/2014/10/8/738903.jpeg,0,0.9885144233703612,1940,968,3460,2488,1520,1520,twilight sparkle,theonedzaan
738933.jpeg,https://derpicdn.net/img/view/2014/10/8/738933.jpeg,0,0.9865260720252992,628,236,1304,912,676,676,twilight sparkle,autumnsmonologue8
740240.jpeg,https://derpicdn.net/img/view/2014/10/10/740240.jpeg,0,0.983532965183258,1907,1501,2835,2429,928,928,twilight sparkle,silfoe
741424.jpeg,https://derpicdn.net/img/view/2014/10/12/741424.jpeg,0,0.993565559387207,11,19,551,559,540,540,twilight sparkle,maritimelightningp
741541.jpeg,https://derpicdn.net/img/view/2014/10/12/741541.jpeg,0,0.9805307984352112,69,134,421,486,352,352,twilight sparkle,andypriceart
742201.jpeg,https://derpicdn.net/img/view/2014/10/13/742201.jpeg,0,0.9459229111671448,1072,532,1640,1100,568,568,twilight sparkle,vipeydashie|cyanaeolin
744206.jpeg,https://derpicdn.net/img/view/2014/10/16/744206.jpeg,0,0.9875582456588744,0,0,553,555,553,555,twilight sparkle,moonlight-ki
744289.jpeg,https://derpicdn.net/img/view/2014/10/16/744289.jpeg,0,0.9254427552223206,282,25,730,473,448,448,twilight sparkle,mysticalpha
744608.jpeg,https://derpicdn.net/img/view/2014/10/17/744608.jpeg,0,0.9093835949897766,787,43,999,255,212,212,twilight sparkle,backlash91|denmawarlight
744615.jpeg,https://derpicdn.net/img/view/2014/10/17/744615.jpeg,0,0.9852394461631776,10,43,276,300,266,257,twilight sparkle,kolshica
744615.jpeg,https://derpicdn.net/img/view/2014/10/17/744615.jpeg,1,0.9045414924621582,0,0,235,240,235,240,twilight sparkle,kolshica
746288.jpeg,https://derpicdn.net/img/view/2014/10/19/746288.jpeg,0,0.9934527277946472,1542,0,2792,1079,1250,1079,twilight sparkle,zombie-burrito
746363.jpeg,https://derpicdn.net/img/view/2014/10/19/746363.jpeg,0,0.9951227903366088,159,15,777,633,618,618,twilight sparkle,macheteponies
752305.jpeg,https://derpicdn.net/img/view/2014/10/28/752305.jpeg,0,0.9305633902549744,132,0,1300,950,1168,950,twilight sparkle,asika-aida
754979.jpeg,https://derpicdn.net/img/view/2014/10/31/754979.jpeg,0,0.94948148727417,251,0,823,530,572,530,twilight sparkle,fewderpewders
756713.jpeg,https://derpicdn.net/img/view/2014/11/3/756713.jpeg,0,0.997666597366333,0,0,1201,1253,1201,1253,twilight sparkle,hayley1432
757501.jpeg,https://derpicdn.net/img/view/2014/11/4/757501.jpeg,0,0.982591450214386,1449,2138,2969,3658,1520,1520,twilight sparkle,anadukune
764308.jpeg,https://derpicdn.net/img/view/2014/11/14/764308.jpeg,0,0.9971216917037964,323,1,1061,739,738,738,twilight sparkle,iponylover
772015.jpeg,https://derpicdn.net/img/view/2014/11/26/772015.jpeg,0,0.96200031042099,8,41,1804,2015,1796,1974,twilight sparkle,tsitra360
772283.jpeg,https://derpicdn.net/img/view/2014/11/26/772283.jpeg,0,0.994632601737976,99,0,391,279,292,279,twilight sparkle,tinacrazy29
778146.jpeg,https://derpicdn.net/img/view/2014/12/4/778146.jpeg,0,0.9844337105751038,58,235,988,1165,930,930,twilight sparkle,lolperson99
779162.jpeg,https://derpicdn.net/img/view/2014/12/6/779162.jpeg,0,0.9770078659057616,657,302,1673,1318,1016,1016,twilight sparkle,jorobro
782641.jpeg,https://derpicdn.net/img/view/2014/12/11/782641.jpeg,0,0.9872902631759644,299,0,867,505,568,505,twilight sparkle,ronniesponies
783660.jpeg,https://derpicdn.net/img/view/2014/12/12/783660.jpeg,0,0.9981193542480468,156,141,498,483,342,342,twilight sparkle,tikrs007
783851.jpeg,https://derpicdn.net/img/view/2014/12/13/783851.jpeg,0,0.9994369149208068,637,174,1439,976,802,802,twilight sparkle,andyfirelife
784602.jpeg,https://derpicdn.net/img/view/2014/12/14/784602.jpeg,0,0.986380934715271,230,32,498,300,268,268,twilight sparkle,tsitra360
785405.jpeg,https://derpicdn.net/img/view/2014/12/15/785405.jpeg,0,0.977578103542328,69,26,497,454,428,428,twilight sparkle,sheandog
786230.jpeg,https://derpicdn.net/img/view/2014/12/16/786230.jpeg,0,0.9947590827941896,221,195,1129,1103,908,908,twilight sparkle,mrbrunoh1
786252.jpeg,https://derpicdn.net/img/view/2014/12/16/786252.jpeg,0,0.994798183441162,415,0,900,473,485,473,twilight sparkle,bluse
790745.jpeg,https://derpicdn.net/img/view/2014/12/23/790745.jpeg,0,0.997097373008728,70,0,821,733,751,733,twilight sparkle,yukomaussi
791188.jpeg,https://derpicdn.net/img/view/2014/12/23/791188.jpeg,0,0.9657742977142334,128,0,738,502,610,502,twilight sparkle,aquaticsun
793577.jpeg,https://derpicdn.net/img/view/2014/12/27/793577.jpeg,0,0.987855851650238,163,118,489,444,326,326,twilight sparkle,snorlaxshamen|dfectivedvice
794479.jpeg,https://derpicdn.net/img/view/2014/12/28/794479.jpeg,0,0.9926359057426452,834,241,2466,1873,1632,1632,twilight sparkle,otakuap
798468.jpeg,https://derpicdn.net/img/view/2015/1/3/798468.jpeg,0,0.9957218766212464,266,0,730,399,464,399,twilight sparkle,noben
799485.jpeg,https://derpicdn.net/img/view/2015/1/4/799485.jpeg,0,0.9665829539299012,0,0,487,481,487,481,twilight sparkle,emberkaese
800833.jpeg,https://derpicdn.net/img/view/2015/1/6/800833.jpeg,0,0.9987835884094238,464,0,1084,579,620,579,twilight sparkle,tetrodotoxine
801606.jpeg,https://derpicdn.net/img/view/2015/1/7/801606.jpeg,0,0.9971296787261964,272,146,762,636,490,490,twilight sparkle,sonikku001
801997.jpeg,https://derpicdn.net/img/view/2015/1/8/801997.jpeg,0,0.9652448892593384,141,22,669,550,528,528,twilight sparkle,baid-woo
803990.jpeg,https://derpicdn.net/img/view/2015/1/11/803990.jpeg,0,0.9918218851089478,87,0,963,823,876,823,twilight sparkle,tokipeach
808973.jpeg,https://derpicdn.net/img/view/2015/1/18/808973.jpeg,0,0.9993560314178468,382,94,978,690,596,596,twilight sparkle,fairdahlia
809282.jpeg,https://derpicdn.net/img/view/2015/1/18/809282.jpeg,0,0.9881713390350342,236,0,1110,795,874,795,twilight sparkle,cold-blooded-twilight
809320.jpeg,https://derpicdn.net/img/view/2015/1/18/809320.jpeg,0,0.9564510583877563,201,39,599,437,398,398,twilight sparkle,zigword
810118.jpeg,https://derpicdn.net/img/view/2015/1/19/810118.jpeg,0,0.982996106147766,79,57,383,361,304,304,twilight sparkle,spainfischer
812221.jpeg,https://derpicdn.net/img/view/2015/1/22/812221.jpeg,0,0.9126005172729492,2,0,700,681,698,681,twilight sparkle,coke-brother
813529.jpeg,https://derpicdn.net/img/view/2015/1/24/813529.jpeg,0,0.9926159977912904,124,15,416,307,292,292,twilight sparkle,steveholt
819835.jpeg,https://derpicdn.net/img/view/2015/2/2/819835.jpeg,0,0.9988639950752258,117,28,397,308,280,280,twilight sparkle,ende26
821646.jpeg,https://derpicdn.net/img/view/2015/2/5/821646.jpeg,0,0.9931379556655884,42,0,468,382,426,382,twilight sparkle,suzuii
823478.jpeg,https://derpicdn.net/img/view/2015/2/7/823478.jpeg,0,0.932393491268158,79,7,497,425,418,418,twilight sparkle,mmishee
823613.jpeg,https://derpicdn.net/img/view/2015/2/7/823613.jpeg,0,0.983340620994568,382,21,630,269,248,248,twilight sparkle,bookxworm89
826049.jpeg,https://derpicdn.net/img/view/2015/2/11/826049.jpeg,0,0.9824623465538024,219,9,707,497,488,488,twilight sparkle,lil miss jay
827537.jpeg,https://derpicdn.net/img/view/2015/2/13/827537.jpeg,0,0.9761210680007936,460,277,862,679,402,402,twilight sparkle,reavz
827929.jpeg,https://derpicdn.net/img/view/2015/2/14/827929.jpeg,0,0.9990389943122864,346,28,672,354,326,326,twilight sparkle,silverscarf
828102.jpeg,https://derpicdn.net/img/view/2015/2/14/828102.jpeg,0,0.9908990859985352,0,0,602,621,602,621,twilight sparkle,bluse
828899.jpeg,https://derpicdn.net/img/view/2015/2/15/828899.jpeg,0,0.9933496117591858,656,110,1190,644,534,534,twilight sparkle,newyorkx3
828899.jpeg,https://derpicdn.net/img/view/2015/2/15/828899.jpeg,1,0.9542554616928101,289,202,763,676,474,474,twilight sparkle,newyorkx3
828899.jpeg,https://derpicdn.net/img/view/2015/2/15/828899.jpeg,2,0.9523088932037354,0,26,342,414,342,388,twilight sparkle,newyorkx3
831095.jpeg,https://derpicdn.net/img/view/2015/2/17/831095.jpeg,0,0.9597182869911194,1028,0,1946,871,918,871,twilight sparkle,ncmares
831777.jpeg,https://derpicdn.net/img/view/2015/2/18/831777.jpeg,0,0.9976611137390136,331,0,823,434,492,434,twilight sparkle,mixipony
831873.jpeg,https://derpicdn.net/img/view/2015/2/18/831873.jpeg,0,0.9912103414535522,221,0,697,476,476,476,twilight sparkle,sheandog
839468.jpeg,https://derpicdn.net/img/view/2015/3/1/839468.jpeg,0,0.9814316034317015,327,127,537,337,210,210,twilight sparkle,fluffyblarg
839512.jpeg,https://derpicdn.net/img/view/2015/3/1/839512.jpeg,0,0.9946999549865724,336,268,636,568,300,300,twilight sparkle,vixelzf
840176.jpeg,https://derpicdn.net/img/view/2015/3/1/840176.jpeg,0,0.9932289123535156,932,510,1564,1142,632,632,twilight sparkle,zevironmoniroth
841641.jpeg,https://derpicdn.net/img/view/2015/3/3/841641.jpeg,0,0.9993996620178224,47,157,477,587,430,430,twilight sparkle,silfoe
845505.jpeg,https://derpicdn.net/img/view/2015/3/8/845505.jpeg,0,0.998883068561554,241,714,733,1206,492,492,twilight sparkle,dahtamnay
847519.jpeg,https://derpicdn.net/img/view/2015/3/11/847519.jpeg,0,0.9954019784927368,181,32,769,620,588,588,twilight sparkle,mistydash
849888.jpeg,https://derpicdn.net/img/view/2015/3/15/849888.jpeg,0,0.9520158171653748,0,16,800,842,800,826,twilight sparkle,joycall6
850826.jpeg,https://derpicdn.net/img/view/2015/3/16/850826.jpeg,0,0.9621729254722596,282,0,856,506,574,506,twilight sparkle,bluse
852703.jpeg,https://derpicdn.net/img/view/2015/3/19/852703.jpeg,0,0.992804229259491,366,0,2428,2062,2062,2062,twilight sparkle,shira-hedgie
858942.jpeg,https://derpicdn.net/img/view/2015/3/28/858942.jpeg,0,0.9862269163131714,405,32,903,530,498,498,twilight sparkle,ncmares
859195.jpeg,https://derpicdn.net/img/view/2015/3/28/859195.jpeg,0,0.9963293671607972,892,227,1250,585,358,358,twilight sparkle,spacechickennerd
859617.jpeg,https://derpicdn.net/img/view/2015/3/29/859617.jpeg,0,0.9937863349914552,545,0,1417,780,872,780,twilight sparkle,ncmares
861069.jpeg,https://derpicdn.net/img/view/2015/3/31/861069.jpeg,0,0.9979338049888612,1026,233,1678,885,652,652,twilight sparkle,ncmares
866728.jpeg,https://derpicdn.net/img/view/2015/4/6/866728.jpeg,1,0.9810828566551208,956,499,1200,765,244,266,twilight sparkle,kraden
867414.jpeg,https://derpicdn.net/img/view/2015/4/7/867414.jpeg,0,0.9561681151390076,438,0,1994,1500,1556,1500,twilight sparkle,mrs1989
867957.jpeg,https://derpicdn.net/img/view/2015/4/7/867957.jpeg,0,0.9888678193092346,623,458,1503,1338,880,880,twilight sparkle,sceathlet
867982.jpeg,https://derpicdn.net/img/view/2015/4/7/867982.jpeg,0,0.9331411123275756,314,98,770,554,456,456,twilight sparkle,joycall6
869905.jpeg,https://derpicdn.net/img/view/2015/4/9/869905.jpeg,0,0.9363450407981871,0,0,2423,2364,2423,2364,twilight sparkle,magnaluna
871718.jpeg,https://derpicdn.net/img/view/2015/4/11/871718.jpeg,0,0.939039409160614,340,0,750,367,410,367,twilight sparkle,tc
871855.jpeg,https://derpicdn.net/img/view/2015/4/11/871855.jpeg,0,0.9064480662345886,0,0,7765,7067,7765,7067,twilight sparkle,owlvortex
871893.jpeg,https://derpicdn.net/img/view/2015/4/11/871893.jpeg,0,0.9825907945632936,0,0,1231,1454,1231,1454,twilight sparkle,imalou
872345.jpeg,https://derpicdn.net/img/view/2015/4/12/872345.jpeg,0,0.9815616011619568,282,85,1390,1193,1108,1108,twilight sparkle,bratzoid
872541.jpeg,https://derpicdn.net/img/view/2015/4/12/872541.jpeg,0,0.9972458481788636,491,1,1037,547,546,546,twilight sparkle,animeculture
875475.jpeg,https://derpicdn.net/img/view/2015/4/16/875475.jpeg,0,0.9101321697235109,69,44,357,332,288,288,twilight sparkle,shutter-frame
880839.jpeg,https://derpicdn.net/img/view/2015/4/23/880839.jpeg,0,0.9731859564781188,290,13,714,437,424,424,twilight sparkle,naminzo
884949.jpeg,https://derpicdn.net/img/view/2015/4/28/884949.jpeg,0,0.9991488456726074,649,0,1319,503,670,503,twilight sparkle,zigword
885803.jpeg,https://derpicdn.net/img/view/2015/4/30/885803.jpeg,0,0.961508572101593,0,197,834,1146,834,949,twilight sparkle,raikoh
886047.jpeg,https://derpicdn.net/img/view/2015/4/30/886047.jpeg,0,0.959733784198761,0,8,810,868,810,860,twilight sparkle,boxedsurprise
890067.jpeg,https://derpicdn.net/img/view/2015/5/5/890067.jpeg,0,0.9924254417419434,199,0,939,676,740,676,twilight sparkle,shira-hedgie
891408.jpeg,https://derpicdn.net/img/view/2015/5/7/891408.jpeg,0,0.9935289025306702,389,119,1367,1097,978,978,twilight sparkle,mistydash
893281.jpeg,https://derpicdn.net/img/view/2015/5/10/893281.jpeg,0,0.9910881519317628,73,7,341,275,268,268,twilight sparkle,frali
898701.jpeg,https://derpicdn.net/img/view/2015/5/17/898701.jpeg,0,0.9929866194725036,279,0,1537,1200,1258,1200,twilight sparkle,robothehoobo
899425.jpeg,https://derpicdn.net/img/view/2015/5/18/899425.jpeg,0,0.9613029956817628,510,0,1436,899,926,899,twilight sparkle,skipsy
903187.jpeg,https://derpicdn.net/img/view/2015/5/24/903187.jpeg,0,0.9802807569503784,17,50,549,582,532,532,twilight sparkle,amishy
904238.jpeg,https://derpicdn.net/img/view/2015/5/26/904238.jpeg,0,0.9930625557899476,140,1,470,331,330,330,twilight sparkle,snibako
906242.jpeg,https://derpicdn.net/img/view/2015/5/29/906242.jpeg,0,0.9094855785369872,597,57,1081,541,484,484,twilight sparkle,manestreamstudios
906309.jpeg,https://derpicdn.net/img/view/2015/5/29/906309.jpeg,0,0.9936001300811768,188,0,588,367,400,367,twilight sparkle,von-seay
907721.jpeg,https://derpicdn.net/img/view/2015/5/31/907721.jpeg,0,0.9922668933868408,241,104,435,298,194,194,twilight sparkle,el-yeguero
909723.jpeg,https://derpicdn.net/img/view/2015/6/4/909723.jpeg,0,0.9763184189796448,328,57,750,479,422,422,twilight sparkle,sunbusting
910632.jpeg,https://derpicdn.net/img/view/2015/6/5/910632.jpeg,0,0.9936286807060242,2435,0,4841,2269,2406,2269,twilight sparkle,kyuniko
920756.jpeg,https://derpicdn.net/img/view/2015/6/21/920756.jpeg,0,0.9838700294494628,270,0,754,467,484,467,twilight sparkle,wirelesspony
921812.jpeg,https://derpicdn.net/img/view/2015/6/22/921812.jpeg,0,0.9890509843826294,446,0,1000,537,554,537,twilight sparkle,[redacted]
921812.jpeg,https://derpicdn.net/img/view/2015/6/22/921812.jpeg,1,0.972159206867218,0,0,600,508,600,508,twilight sparkle,[redacted]
923798.jpeg,https://derpicdn.net/img/view/2015/6/26/923798.jpeg,0,0.9948800206184388,406,755,648,997,242,242,twilight sparkle,ende26
924153.jpeg,https://derpicdn.net/img/view/2015/6/26/924153.jpeg,0,0.9919640421867372,0,1036,1054,2144,1054,1108,twilight sparkle,unousaya
924844.jpeg,https://derpicdn.net/img/view/2015/6/27/924844.jpeg,0,0.989591896533966,686,57,876,247,190,190,twilight sparkle,nukilik
925114.jpeg,https://derpicdn.net/img/view/2015/6/27/925114.jpeg,0,0.9989017248153688,352,216,926,790,574,574,twilight sparkle,joakaha
929649.jpeg,https://derpicdn.net/img/view/2015/7/4/929649.jpeg,0,0.9959227442741394,1442,301,1994,853,552,552,twilight sparkle,mysticalpha
929649.jpeg,https://derpicdn.net/img/view/2015/7/4/929649.jpeg,2,0.9912407994270324,48,157,774,883,726,726,twilight sparkle,mysticalpha
929649.jpeg,https://derpicdn.net/img/view/2015/7/4/929649.jpeg,3,0.9729514718055724,1213,368,1633,788,420,420,twilight sparkle,mysticalpha
929708.jpeg,https://derpicdn.net/img/view/2015/7/4/929708.jpeg,0,0.9987313151359558,75,6,345,276,270,270,twilight sparkle,ellamred
930063.jpeg,https://derpicdn.net/img/view/2015/7/5/930063.jpeg,0,0.9630852341651917,2927,707,3600,1473,673,766,twilight sparkle,raikoh
936721.jpeg,https://derpicdn.net/img/view/2015/7/14/936721.jpeg,0,0.9940308928489684,487,525,1159,1197,672,672,twilight sparkle,emcrasher
938075.jpeg,https://derpicdn.net/img/view/2015/7/16/938075.jpeg,0,0.9310026168823242,176,48,884,756,708,708,twilight sparkle,koku-chan
941951.jpeg,https://derpicdn.net/img/view/2015/7/23/941951.jpeg,0,0.9530984163284302,297,1191,929,1823,632,632,twilight sparkle,namygaga
949891.jpeg,https://derpicdn.net/img/view/2015/8/3/949891.jpeg,1,0.9847574234008788,433,225,809,601,376,376,twilight sparkle,magnaluna
950973.jpeg,https://derpicdn.net/img/view/2015/8/5/950973.jpeg,0,0.9978869557380676,237,342,469,574,232,232,twilight sparkle,tsitra360
951780.jpeg,https://derpicdn.net/img/view/2015/8/6/951780.jpeg,0,0.9695686101913452,0,0,3709,3523,3709,3523,twilight sparkle,pajama-ham
957434.jpeg,https://derpicdn.net/img/view/2015/8/14/957434.jpeg,0,0.9966837763786316,190,0,638,442,448,442,twilight sparkle,osaru_onsen|nanoha-osaru
959696.jpeg,https://derpicdn.net/img/view/2015/8/17/959696.jpeg,0,0.9602642059326172,0,0,1104,768,1104,768,twilight sparkle,小凱
961763.jpeg,https://derpicdn.net/img/view/2015/8/20/961763.jpeg,0,0.9946941137313844,630,190,928,488,298,298,twilight sparkle,biosonic100
961763.jpeg,https://derpicdn.net/img/view/2015/8/20/961763.jpeg,1,0.9915719032287598,448,186,742,480,294,294,twilight sparkle,biosonic100
961763.jpeg,https://derpicdn.net/img/view/2015/8/20/961763.jpeg,2,0.9457933306694032,206,147,522,463,316,316,twilight sparkle,biosonic100
965009.jpeg,https://derpicdn.net/img/view/2015/8/24/965009.jpeg,0,0.9774274230003356,97,0,815,584,718,584,twilight sparkle,supernoncutie
966391.jpeg,https://derpicdn.net/img/view/2015/8/26/966391.jpeg,0,0.9741328358650208,26,128,632,734,606,606,twilight sparkle,cold-blooded-twilight
967337.jpeg,https://derpicdn.net/img/view/2015/8/28/967337.jpeg,1,0.9614481329917908,291,53,925,687,634,634,twilight sparkle,patty-plmh
969701.jpeg,https://derpicdn.net/img/view/2015/8/31/969701.jpeg,0,0.9894571304321288,196,107,570,481,374,374,twilight sparkle,manestreamstudios
971918.jpeg,https://derpicdn.net/img/view/2015/9/3/971918.jpeg,0,0.9804752469062804,0,12,546,656,546,644,twilight sparkle,iponylover
971918.jpeg,https://derpicdn.net/img/view/2015/9/3/971918.jpeg,1,0.9729080200195312,183,0,768,621,585,621,twilight sparkle,iponylover
972988.jpeg,https://derpicdn.net/img/view/2015/9/5/972988.jpeg,0,0.9805601835250854,93,0,573,413,480,413,twilight sparkle,bakki
976773.jpeg,https://derpicdn.net/img/view/2015/9/10/976773.jpeg,0,0.9847872257232666,127,278,800,1000,673,722,twilight sparkle,joycall6
980175.jpeg,https://derpicdn.net/img/view/2015/9/15/980175.jpeg,0,0.9980727434158324,683,195,1021,533,338,338,twilight sparkle,bakki
980175.jpeg,https://derpicdn.net/img/view/2015/9/15/980175.jpeg,1,0.9875158667564392,274,217,620,563,346,346,twilight sparkle,bakki
980476.jpeg,https://derpicdn.net/img/view/2015/9/15/980476.jpeg,0,0.9689286947250366,514,312,1722,1520,1208,1208,twilight sparkle,thebeckmanator
981138.jpeg,https://derpicdn.net/img/view/2015/9/16/981138.jpeg,0,0.9930121302604676,2451,0,4861,2349,2410,2349,twilight sparkle,handmantoot
989471.jpeg,https://derpicdn.net/img/view/2015/9/27/989471.jpeg,0,0.998956024646759,255,0,557,289,302,289,twilight sparkle,vladiverse
990171.jpeg,https://derpicdn.net/img/view/2015/9/28/990171.jpeg,0,0.9857921004295348,798,380,1444,1026,646,646,twilight sparkle,elzzombie
990784.jpeg,https://derpicdn.net/img/view/2015/9/29/990784.jpeg,0,0.9860253930091858,246,88,668,510,422,422,twilight sparkle,patty-plmh
994981.jpeg,https://derpicdn.net/img/view/2015/10/5/994981.jpeg,0,0.9681278467178344,148,26,438,316,290,290,twilight sparkle,sylph-space
996414.jpeg,https://derpicdn.net/img/view/2015/10/7/996414.jpeg,0,0.9147782325744628,503,342,751,590,248,248,twilight sparkle,viwrastupr
998281.jpeg,https://derpicdn.net/img/view/2015/10/10/998281.jpeg,0,0.9853794574737548,0,8,804,902,804,894,twilight sparkle,andypriceart
